Source Port,Destination Port,NAT Source Port,NAT Destination Port,Bytes,Bytes Sent,Bytes Received,Packets,Elapsed Time (sec),pkts_sent,pkts_received,Action
57222,53,54587,53,177,94,83,2,30,1,1,allow
56258,3389,56258,3389,4768,1600,3168,19,17,10,9,allow
6881,50321,43265,50321,238,118,120,2,1199,1,1,allow
50553,3389,50553,3389,3327,1438,1889,15,17,8,7,allow
50002,443,45848,443,25358,6778,18580,31,16,13,18,allow
51465,443,39975,443,3961,1595,2366,21,16,12,9,allow
60513,47094,45469,47094,320,140,180,6,7,3,3,allow
50049,443,21285,443,7912,3269,4643,23,96,12,11,allow
52244,58774,2211,58774,70,70,0,1,5,1,0,allow
50627,443,16215,443,8256,1674,6582,31,75,15,16,allow
43676,80,45378,80,696,378,318,12,35,7,5,allow
52190,443,16680,443,7942,870,7072,22,15,10,12,allow
50690,80,20479,80,4805,3639,1166,16,31,9,7,allow
55597,53,45448,53,168,86,82,2,30,1,1,allow
49164,443,45916,443,7292,950,6342,19,75,9,10,allow
36887,443,63451,443,10922,2532,8390,27,28,13,14,allow
1939,53,33288,53,210,78,132,2,30,1,1,allow
50281,53,33175,53,195,102,93,2,30,1,1,allow
57222,53,51448,53,177,94,83,2,30,1,1,allow
56710,53,57885,53,177,94,83,2,30,1,1,allow
48488,443,26104,443,12993,3240,9753,36,24,18,18,allow
50691,80,62082,80,4237,3610,627,15,31,8,7,allow
50693,80,54649,80,4465,3390,1075,14,30,8,6,allow
1940,53,23603,53,210,78,132,2,30,1,1,allow
50172,53,37056,53,211,78,133,2,30,1,1,allow
38802,53,38802,53,216,90,126,2,30,1,1,allow
50281,53,8038,53,195,102,93,2,30,1,1,allow
50051,443,1683,443,7912,3269,4643,23,96,12,11,allow
52192,443,41129,443,13948,1150,12798,29,15,14,15,allow
57886,443,10717,443,33667,25477,8190,60,33,34,26,allow
50289,80,7131,80,7166,1086,6080,18,87,9,9,allow
58615,443,30095,443,6796,1541,5255,23,121,11,12,allow
38551,53,14191,53,168,78,90,2,30,1,1,allow
64787,53,29856,53,728,102,626,2,30,1,1,allow
34529,443,30445,443,62652,30891,31761,158,381,67,91,allow
52184,443,13267,443,13902,3253,10649,26,135,14,12,allow
60377,443,34261,443,8678,2974,5704,50,123,27,23,allow
59347,80,59347,80,108790,4633,104157,192,15,66,126,allow
50077,443,40548,443,7976,3333,4643,23,25,12,11,allow
50149,80,2917,80,11574,901,10673,20,46,11,9,allow
50004,443,10108,443,8745,2603,6142,19,15,11,8,allow
60411,80,48309,80,1589,941,648,11,121,6,5,allow
60354,80,7611,80,644,256,388,8,124,5,3,allow
60399,80,36861,80,1168,815,353,10,122,6,4,allow
60348,80,15161,80,10335,1617,8718,19,124,9,10,allow
60420,80,1065,80,14498,6454,8044,24,120,12,12,allow
60423,443,61729,443,6849,1103,5746,23,120,12,11,allow
60360,443,62556,443,5212,1101,4111,22,123,12,10,allow
60363,443,28558,443,5214,1101,4113,22,123,12,10,allow
9523,443,27776,443,7199,1410,5789,22,33,11,11,allow
63842,45682,31353,45682,4687209,3850148,837061,4974,107,3004,1970,allow
60430,443,49199,443,5696,1143,4553,23,119,12,11,allow
59878,443,30562,443,3864,2812,1052,17,112,8,9,allow
53179,12502,28254,12502,70,70,0,2,7,2,0,allow
60414,80,46472,80,5124,3499,1625,14,121,8,6,allow
60400,80,41884,80,1704,808,896,10,122,6,4,allow
60407,443,49458,443,8328,1611,6717,25,121,14,11,allow
60398,80,57820,80,378,192,186,7,122,4,3,allow
60339,80,1887,80,35136,7862,27274,53,124,26,27,allow
38641,443,31615,443,318,192,126,6,14,4,2,allow
54996,53,2476,53,168,86,82,2,31,1,1,allow
48066,443,56844,443,62,62,0,1,4,1,0,allow
60811,40010,33835,40010,316,136,180,6,5,3,3,allow
52103,80,61932,80,68083,5515,62568,90,38,40,50,allow
52195,443,11275,443,13948,1150,12798,29,15,14,15,allow
50000,53,16568,53,502,115,387,4,52,2,2,allow
52193,443,50924,443,13948,1150,12798,29,15,14,15,allow
55234,53,5157,53,177,94,83,2,29,1,1,allow
50692,80,30484,80,5727,3584,2143,15,31,8,7,allow
60370,80,40899,80,1243,769,474,9,123,6,3,allow
65401,53,57745,53,235,102,133,2,29,1,1,allow
51737,53,3505,53,231,78,153,2,30,1,1,allow
50685,80,6959,80,63891,26626,37265,86,34,39,47,allow
52191,443,46265,443,7882,810,7072,21,15,9,12,allow
54557,80,41721,80,2091,799,1292,10,15,6,4,allow
48818,443,11974,443,4167,1669,2498,23,15,12,11,allow
64223,53,57211,53,199,94,105,2,30,1,1,allow
49245,53,34102,53,376,126,250,2,29,1,1,allow
65258,443,17337,443,6043,1568,4475,11,120,4,7,allow
64399,53,50659,53,230,110,120,2,29,1,1,allow
55234,53,22160,53,177,94,83,2,30,1,1,allow
64593,53,56394,53,94,94,0,1,30,1,0,allow
56911,53,36658,53,177,94,83,2,31,1,1,allow
53977,22266,9645,22266,492,306,186,8,17,5,3,allow
50148,80,57004,80,9058,868,8190,18,46,10,8,allow
53178,42671,48767,42671,70,70,0,2,8,2,0,allow
52181,443,64436,443,7855,815,7040,21,15,9,12,allow
65004,53,23515,53,323,94,229,2,30,1,1,allow
46265,443,19534,443,173828,9311,164517,245,448,118,127,allow
49158,443,27828,443,14490,4227,10263,35,36,19,16,allow
33067,53,47200,53,168,78,90,2,30,1,1,allow
56911,53,39355,53,177,94,83,2,30,1,1,allow
22767,53,22767,53,226,106,120,2,30,1,1,allow
52715,443,38027,443,164840,5975,158865,179,122,61,118,allow
33845,80,39303,80,424,210,214,7,27,4,3,allow
61442,443,19223,443,3403,1891,1512,24,42,13,11,allow
9446,443,50836,443,8672,1863,6809,22,46,11,11,allow
52194,443,38386,443,12374,1090,11284,27,15,13,14,allow
58306,443,59387,443,864,436,428,13,29,7,6,allow
42412,443,55628,443,204,70,134,4,26,2,2,allow
56710,53,52813,53,177,94,83,2,30,1,1,allow
61396,443,45721,443,550484,8433,542051,541,246,99,442,allow
61273,443,55960,443,19675,8597,11078,137,480,68,69,allow
50016,53,14072,53,766,103,663,4,41,2,2,allow
58307,443,36806,443,934,506,428,14,29,8,6,allow
55182,53,36739,53,293,94,199,2,30,1,1,allow
56911,53,31733,53,177,94,83,2,30,1,1,allow
41631,443,38429,443,20180,2917,17263,35,124,14,21,allow
38637,443,8499,443,12339,2392,9947,36,287,15,21,allow
45317,53,22055,53,86,86,0,1,30,1,0,allow
56704,53,2427,53,318,94,224,2,30,1,1,allow
49410,53,62890,53,177,94,83,2,30,1,1,allow
56504,53,45710,53,102,102,0,1,30,1,0,allow
50003,443,32664,443,13812,3042,10770,29,16,15,14,allow
40737,443,35009,443,44004,3909,40095,80,135,38,42,allow
38082,443,14308,443,284,164,120,4,15,2,2,allow
36036,443,36036,443,261234,32183,229051,326,212,153,173,allow
55476,53,58894,53,232,110,122,2,30,1,1,allow
49395,53,40831,53,390,111,279,4,53,2,2,allow
56172,53,35826,53,253,87,166,4,30,2,2,allow
56624,53,36589,53,177,94,83,2,31,1,1,allow
57470,20220,32069,20220,870,330,540,12,2308,6,6,allow
33856,443,15413,443,8171028,105740,8065288,6637,149,745,5892,allow
59983,443,26904,443,296863,14073,282790,351,127,130,221,allow
15503,63425,41497,63425,481,150,331,2,1200,1,1,allow
53987,16571,20059,16571,70,70,0,1,5,1,0,allow
53986,54070,39036,54070,70,70,0,1,5,1,0,allow
64094,1024,62040,1024,70,70,0,1,5,1,0,allow
64095,1976,59706,1976,70,70,0,1,5,1,0,allow
52126,443,21159,443,1672,1149,523,13,37,8,5,allow
52144,80,16896,80,366,240,126,7,33,5,2,allow
50816,443,50681,443,134,60,74,3,6,2,1,allow
50057,80,26007,80,1570,754,816,10,16,6,4,allow
52146,80,44068,80,366,240,126,7,33,5,2,allow
54139,53,64934,53,168,78,90,2,31,1,1,allow
49410,53,29049,53,177,94,83,2,31,1,1,allow
53994,16605,15809,16605,70,70,0,2,8,2,0,allow
35242,8635,35242,8635,138,78,60,2,6,1,1,allow
52148,80,27900,80,366,240,126,7,33,5,2,allow
49900,443,28761,443,1820,1101,719,18,73,10,8,allow
43931,53,36161,53,168,78,90,2,31,1,1,allow
51048,445,0,0,70,70,0,1,0,1,0,drop
51045,445,0,0,70,70,0,1,0,1,0,drop
13394,23,0,0,60,60,0,1,0,1,0,deny
61078,57470,0,0,62,62,0,1,0,1,0,deny
55725,445,0,0,70,70,0,1,0,1,0,drop
55723,445,0,0,70,70,0,1,0,1,0,drop
55724,445,0,0,70,70,0,1,0,1,0,drop
51125,445,0,0,66,66,0,1,0,1,0,drop
51123,445,0,0,66,66,0,1,0,1,0,drop
51122,445,0,0,66,66,0,1,0,1,0,drop
51121,445,0,0,66,66,0,1,0,1,0,drop
51126,445,0,0,66,66,0,1,0,1,0,drop
51124,445,0,0,66,66,0,1,0,1,0,drop
51120,445,0,0,66,66,0,1,0,1,0,drop
51119,445,0,0,66,66,0,1,0,1,0,drop
62776,62413,0,0,146,146,0,1,0,1,0,deny
51041,445,0,0,70,70,0,1,0,1,0,drop
46448,30170,0,0,159,159,0,1,0,1,0,deny
10688,25174,0,0,146,146,0,1,0,1,0,deny
34086,25174,0,0,62,62,0,1,0,1,0,deny
64605,25174,0,0,62,62,0,1,0,1,0,deny
51039,445,0,0,70,70,0,1,0,1,0,drop
56688,25174,0,0,62,62,0,1,0,1,0,deny
57015,42707,0,0,62,62,0,1,0,1,0,deny
41213,25174,0,0,62,62,0,1,0,1,0,deny
57131,8055,0,0,145,145,0,1,0,1,0,deny
45855,25174,0,0,62,62,0,1,0,1,0,deny
54483,25174,0,0,66,66,0,1,0,1,0,deny
45855,25174,0,0,146,146,0,1,0,1,0,deny
49990,62413,0,0,66,66,0,1,0,1,0,deny
1582,56205,0,0,62,62,0,1,0,1,0,deny
65003,57470,0,0,78,78,0,1,0,1,0,deny
55718,445,0,0,70,70,0,1,0,1,0,drop
55717,445,0,0,70,70,0,1,0,1,0,drop
55713,445,0,0,70,70,0,1,0,1,0,drop
55708,445,0,0,70,70,0,1,0,1,0,drop
63486,51505,0,0,66,66,0,1,0,1,0,deny
54100,37965,0,0,62,62,0,1,0,1,0,deny
51034,445,0,0,70,70,0,1,0,1,0,drop
51107,445,0,0,66,66,0,1,0,1,0,drop
51105,445,0,0,66,66,0,1,0,1,0,drop
51104,445,0,0,66,66,0,1,0,1,0,drop
1815,22114,0,0,66,66,0,1,0,1,0,deny
443,47582,0,0,60,60,0,1,0,1,0,deny
443,47582,0,0,85,85,0,1,0,1,0,deny
443,47582,0,0,100,100,0,1,0,1,0,deny
59126,57470,0,0,66,66,0,1,0,1,0,deny
27621,50584,0,0,62,62,0,1,0,1,0,deny
52266,50038,0,0,66,66,0,1,0,1,0,deny
56456,1433,0,0,60,60,0,1,0,1,0,deny
43537,2323,0,0,60,60,0,1,0,1,0,deny
40772,15503,0,0,74,74,0,1,0,1,0,deny
50594,25174,0,0,66,66,0,1,0,1,0,deny
4323,64147,0,0,62,62,0,1,0,1,0,deny
55703,445,0,0,70,70,0,1,0,1,0,drop
55701,445,0,0,70,70,0,1,0,1,0,drop
55696,445,0,0,70,70,0,1,0,1,0,drop
55698,445,0,0,70,70,0,1,0,1,0,drop
34349,25174,0,0,146,146,0,1,0,1,0,deny
39587,22114,0,0,62,62,0,1,0,1,0,deny
42542,25174,0,0,62,62,0,1,0,1,0,deny
49529,21247,0,0,62,62,0,1,0,1,0,deny
64579,37965,0,0,66,66,0,1,0,1,0,deny
51021,445,0,0,70,70,0,1,0,1,0,drop
53771,57470,0,0,66,66,0,1,0,1,0,deny
15701,37965,0,0,146,146,0,1,0,1,0,deny
4529,56205,0,0,62,62,0,1,0,1,0,deny
45060,37965,0,0,62,62,0,1,0,1,0,deny
32554,34729,0,0,62,62,0,1,0,1,0,deny
51018,445,0,0,70,70,0,1,0,1,0,drop
47913,25174,0,0,146,146,0,1,0,1,0,deny
55686,445,0,0,70,70,0,1,0,1,0,drop
55683,445,0,0,70,70,0,1,0,1,0,drop
55679,445,0,0,70,70,0,1,0,1,0,drop
2206,25174,0,0,62,62,0,1,0,1,0,deny
64808,62413,0,0,62,62,0,1,0,1,0,deny
17244,22114,0,0,62,62,0,1,0,1,0,deny
51095,445,0,0,66,66,0,1,0,1,0,drop
51014,445,0,0,70,70,0,1,0,1,0,drop
58925,25174,0,0,66,66,0,1,0,1,0,deny
32549,37807,0,0,146,146,0,1,0,1,0,deny
51012,445,0,0,70,70,0,1,0,1,0,drop
52838,37965,0,0,66,66,0,1,0,1,0,deny
34217,23,0,0,60,60,0,1,0,1,0,deny
52459,33890,0,0,60,60,0,1,0,1,0,deny
51010,445,0,0,70,70,0,1,0,1,0,drop
55678,445,0,0,70,70,0,1,0,1,0,drop
6666,3389,0,0,60,60,0,1,0,1,0,deny
1024,21854,0,0,157,157,0,1,0,1,0,reset-both
55677,445,0,0,70,70,0,1,0,1,0,drop
25533,22114,0,0,62,62,0,1,0,1,0,deny
47132,1433,0,0,60,60,0,1,0,1,0,deny
56119,37965,0,0,62,62,0,1,0,1,0,deny
51080,445,0,0,66,66,0,1,0,1,0,drop
51076,445,0,0,66,66,0,1,0,1,0,drop
51003,445,0,0,70,70,0,1,0,1,0,drop
54502,34729,0,0,66,66,0,1,0,1,0,deny
53626,30317,0,0,66,66,0,1,0,1,0,deny
53712,25174,0,0,66,66,0,1,0,1,0,deny
51001,445,0,0,70,70,0,1,0,1,0,drop
33726,44847,0,0,62,62,0,1,0,1,0,deny
22568,37965,0,0,66,66,0,1,0,1,0,deny
443,49988,0,0,82,82,0,1,0,1,0,deny
55667,445,0,0,70,70,0,1,0,1,0,drop
55665,445,0,0,70,70,0,1,0,1,0,drop
55660,445,0,0,70,70,0,1,0,1,0,drop
55658,445,0,0,70,70,0,1,0,1,0,drop
53985,30188,0,0,62,62,0,1,0,1,0,deny
57613,42707,0,0,62,62,0,1,0,1,0,deny
6666,6001,0,0,60,60,0,1,0,1,0,deny
45941,23386,0,0,60,60,0,1,0,1,0,deny
51000,445,0,0,70,70,0,1,0,1,0,drop
51071,445,0,0,66,66,0,1,0,1,0,drop
50999,445,0,0,70,70,0,1,0,1,0,drop
50998,445,0,0,70,70,0,1,0,1,0,drop
55759,5900,0,0,60,60,0,1,0,1,0,deny
50995,445,0,0,70,70,0,1,0,1,0,drop
50992,445,0,0,70,70,0,1,0,1,0,drop
51067,445,0,0,66,66,0,1,0,1,0,drop
51066,445,0,0,66,66,0,1,0,1,0,drop
51065,445,0,0,66,66,0,1,0,1,0,drop
51062,445,0,0,66,66,0,1,0,1,0,drop
51057,445,0,0,66,66,0,1,0,1,0,drop
51063,445,0,0,66,66,0,1,0,1,0,drop
51059,445,0,0,66,66,0,1,0,1,0,drop
55651,445,0,0,70,70,0,1,0,1,0,drop
21268,62609,0,0,146,146,0,1,0,1,0,deny
21268,62609,0,0,146,146,0,1,0,1,0,deny
55648,445,0,0,70,70,0,1,0,1,0,drop
55646,445,0,0,70,70,0,1,0,1,0,drop
55644,445,0,0,70,70,0,1,0,1,0,drop
50980,445,0,0,70,70,0,1,0,1,0,drop
50979,445,0,0,70,70,0,1,0,1,0,drop
23758,44847,0,0,62,62,0,1,0,1,0,deny
50975,445,0,0,70,70,0,1,0,1,0,drop
53324,44847,0,0,66,66,0,1,0,1,0,deny
50970,445,0,0,70,70,0,1,0,1,0,drop
50969,445,0,0,70,70,0,1,0,1,0,drop
53243,57470,0,0,74,74,0,1,0,1,0,deny
64776,25174,0,0,66,66,0,1,0,1,0,deny
50547,22197,0,0,66,66,0,1,0,1,0,deny
64298,50584,0,0,66,66,0,1,0,1,0,deny
30456,36237,0,0,62,62,0,1,0,1,0,deny
56816,443,16188,443,7956,1967,5989,20,15,11,9,allow
52011,80,26180,80,23580,10536,13044,36,39,18,18,allow
50198,3389,50198,3389,3343,1454,1889,15,16,8,7,allow
56624,53,45708,53,170,87,83,2,30,1,1,allow
56813,443,32005,443,8021,2001,6020,20,16,11,9,allow
52007,443,2667,443,10217,8266,1951,33,39,20,13,allow
64092,14447,29856,14447,66,66,0,1,5,1,0,allow
64270,443,64270,443,4747,1840,2907,19,27,11,8,allow
51163,443,48007,443,9466,2602,6864,41,185,20,21,allow
52469,443,22069,443,29896,14149,15747,61,209,35,26,allow
46898,53,46898,53,194,87,107,2,30,1,1,allow
53198,443,53198,443,4591,1684,2907,19,28,11,8,allow
5886,80,5886,80,138678,5557,133121,152,16,58,94,allow
56815,443,53722,443,7903,1914,5989,20,15,11,9,allow
52270,3708,62556,3708,316,136,180,6,6,3,3,allow
52264,43015,38341,43015,70,70,0,2,7,2,0,allow
62685,443,28394,443,7023,2352,4671,18,75,10,8,allow
49333,443,8337,443,50226,4284,45942,76,75,31,45,allow
62892,443,62892,443,4377,1470,2907,19,30,11,8,allow
50487,3389,50487,3389,6312,2620,3692,25,24,12,13,allow
39430,443,21846,443,506,292,214,8,50,5,3,allow
45232,80,45232,80,2895,1484,1411,10,15,6,4,allow
51164,443,28609,443,5040,2743,2297,34,185,18,16,allow
64099,55470,50878,55470,66,66,0,1,5,1,0,allow
52240,52893,2825,52893,66,66,0,1,5,1,0,allow
48550,443,45303,443,778,358,420,12,43,6,6,allow
47845,53,47845,53,243,94,149,2,32,1,1,allow
52263,16350,50284,16350,70,70,0,2,8,2,0,allow
53177,8595,28264,8595,70,70,0,2,9,2,0,allow
53984,57077,2292,57077,70,70,0,1,5,1,0,allow
56674,443,44964,443,237,177,60,3,5,2,1,allow
34440,53,34440,53,235,90,145,2,32,1,1,allow
44389,443,27883,443,3067,1817,1250,18,16,8,10,allow
52265,32078,35097,32078,70,70,0,2,7,2,0,allow
54996,53,39612,53,168,86,82,2,35,1,1,allow
35609,443,35165,443,237,177,60,3,5,2,1,allow
55727,43736,19578,43736,70,70,0,1,5,1,0,allow
56911,53,21649,53,170,87,83,2,30,1,1,allow
50193,3389,50193,3389,3409,1454,1955,16,16,8,8,allow
49935,53,10954,53,75,75,0,1,30,1,0,allow
52852,53,0,0,82,82,0,1,30,1,0,allow
59226,53,59226,53,194,87,107,2,30,1,1,allow
60286,443,29238,443,7576,1897,5679,23,136,13,10,allow
27313,53,27313,53,194,87,107,2,31,1,1,allow
55674,53,14625,53,744,89,655,2,31,1,1,allow
40814,53,40814,53,213,87,126,2,31,1,1,allow
53067,4040,59736,4040,115,115,0,1,31,1,0,allow
56730,53,30044,53,170,87,83,2,31,1,1,allow
46713,53,46713,53,217,87,130,2,31,1,1,allow
32806,53,32806,53,194,87,107,2,31,1,1,allow
56434,53,6758,53,701,88,613,2,31,1,1,allow
51221,64767,41578,64767,330,330,0,6,1200,6,0,allow
19502,53,19502,53,198,89,109,2,31,1,1,allow
53151,53,29237,53,168,78,90,2,31,1,1,allow
56086,443,31892,443,6817,3598,3219,32,143,15,17,allow
27839,53,27839,53,213,87,126,2,31,1,1,allow
22835,51221,0,0,62,62,0,1,0,1,0,deny
65305,51221,0,0,66,66,0,1,0,1,0,deny
23001,64147,0,0,62,62,0,1,0,1,0,deny
52128,37807,0,0,62,62,0,1,0,1,0,deny
23632,64147,0,0,66,66,0,1,0,1,0,deny
48706,23393,0,0,60,60,0,1,0,1,0,deny
64288,53,54415,53,398,103,295,4,41,2,2,allow
52041,80,18599,80,2901,1407,1494,15,38,9,6,allow
64087,80,46757,80,314,192,122,6,15,4,2,allow
56052,53,22562,53,177,94,83,2,30,1,1,allow
52150,80,40663,80,546,300,246,10,32,6,4,allow
48706,23393,0,0,60,60,0,1,0,1,0,deny
55641,445,0,0,70,70,0,1,0,1,0,drop
55642,445,0,0,70,70,0,1,0,1,0,drop
55640,445,0,0,70,70,0,1,0,1,0,drop
51050,445,0,0,66,66,0,1,0,1,0,drop
35207,22114,0,0,62,62,0,1,0,1,0,deny
55635,445,0,0,70,70,0,1,0,1,0,drop
50957,445,0,0,70,70,0,1,0,1,0,drop
51432,25174,0,0,146,146,0,1,0,1,0,deny
51047,445,0,0,66,66,0,1,0,1,0,drop
51046,445,0,0,66,66,0,1,0,1,0,drop
51045,445,0,0,66,66,0,1,0,1,0,drop
17925,26467,0,0,66,66,0,1,0,1,0,deny
34993,15503,0,0,62,62,0,1,0,1,0,deny
8040,44847,0,0,66,66,0,1,0,1,0,deny
39588,25174,0,0,66,66,0,1,0,1,0,deny
51042,445,0,0,66,66,0,1,0,1,0,drop
2978,48817,0,0,66,66,0,1,0,1,0,deny
1536,48817,0,0,62,62,0,1,0,1,0,deny
43269,50584,0,0,66,66,0,1,0,1,0,deny
33453,64147,0,0,62,62,0,1,0,1,0,deny
51414,22,0,0,60,60,0,1,0,1,0,deny
34810,25174,0,0,62,62,0,1,0,1,0,deny
50951,445,0,0,70,70,0,1,0,1,0,drop
5685,35440,0,0,62,62,0,1,0,1,0,deny
55633,445,0,0,70,70,0,1,0,1,0,drop
51598,56079,0,0,66,66,0,1,0,1,0,deny
40239,22114,0,0,146,146,0,1,0,1,0,deny
443,18368,0,0,60,60,0,1,0,1,0,deny
55622,445,0,0,70,70,0,1,0,1,0,drop
52145,80,50375,80,366,240,126,7,32,5,2,allow
50039,7000,50039,7000,3050,1659,1391,16,15,9,7,allow
56717,80,40230,80,3894448,104279,3790169,4041,97,1411,2630,allow
52162,443,20113,443,1461,924,537,13,31,7,6,allow
52272,37105,49502,37105,316,136,180,6,6,3,3,allow
56504,53,24881,53,198,102,96,2,32,1,1,allow
64098,10096,50669,10096,70,70,0,1,4,1,0,allow
52241,51717,19106,51717,70,70,0,1,4,1,0,allow
52143,80,6472,80,366,240,126,7,32,5,2,allow
50050,443,8381,443,7912,3269,4643,23,95,12,11,allow
52164,443,54936,443,4187,773,3414,16,30,9,7,allow
52115,443,22081,443,11551,3870,7681,29,37,16,13,allow
52147,80,1117,80,366,240,126,7,32,5,2,allow
52157,80,19874,80,366,240,126,7,32,5,2,allow
55526,80,37218,80,78,78,0,2,8,2,0,allow
52151,80,38473,80,546,300,246,10,32,6,4,allow
49359,443,64650,443,63494,7222,56272,107,81,49,58,allow
60512,6881,33887,6881,320,140,180,6,6,3,3,allow
53982,24226,55007,24226,70,70,0,1,4,1,0,allow
53985,26515,42482,26515,70,70,0,1,4,1,0,allow
16965,3389,16965,3389,4085,1916,2169,21,18,12,9,allow
52000,80,35679,80,3604,2064,1540,15,40,10,5,allow
38717,443,31292,443,958865,18695,940170,908,16,266,642,allow
56624,53,34436,53,177,94,83,2,30,1,1,allow
49795,53,44891,53,263,94,169,2,30,1,1,allow
50057,53,37422,53,177,94,83,2,30,1,1,allow
55306,53,39881,53,177,94,83,2,30,1,1,allow
52159,80,23650,80,502,310,192,9,31,6,3,allow
52153,80,26645,80,366,240,126,7,32,5,2,allow
55725,14704,64431,14704,70,70,0,1,5,1,0,allow
50711,80,19117,80,1658,1247,411,8,15,5,3,allow
58304,443,13109,443,13442,1200,12242,26,29,11,15,allow
58305,443,38970,443,11659,1027,10632,25,29,11,14,allow
60291,53,5136,53,78,78,0,1,30,1,0,allow
56555,53,42493,53,348,94,254,2,30,1,1,allow
49436,53,61599,53,718,94,624,2,30,1,1,allow
64226,53,54672,53,245,94,151,2,30,1,1,allow
55379,443,27244,443,13679,7277,6402,35,262,15,20,allow
33825,443,41237,443,9407,2233,7174,38,96,16,22,allow
19763,53,19763,53,216,82,134,2,32,1,1,allow
56741,53,5499,53,370,94,276,2,30,1,1,allow
51041,80,59300,80,1514,480,1034,11,15,6,5,allow
56663,53,41717,53,181,94,87,2,33,1,1,allow
56440,53,62063,53,212,102,110,2,30,1,1,allow
49961,443,64983,443,16890,7125,9765,33,98,19,14,allow
52236,15313,26526,15313,70,70,0,1,5,1,0,allow
56052,53,19569,53,177,94,83,2,30,1,1,allow
53971,80,16324,80,662,448,214,10,15,7,3,allow
64196,53,65372,53,262,94,168,2,30,1,1,allow
38330,123,58815,123,184,94,90,2,30,1,1,allow
49935,53,45170,53,168,86,82,2,30,1,1,allow
55639,53,27613,53,244,94,150,2,30,1,1,allow
53470,53,29709,53,168,78,90,2,30,1,1,allow
51986,80,28001,80,1420,888,532,11,49,7,4,allow
40831,80,63406,80,1614,1300,314,10,15,5,5,allow
36138,443,58693,443,50384,5218,45166,76,99,26,50,allow
33151,53,41502,53,168,78,90,2,30,1,1,allow
50563,53,11644,53,718,94,624,2,30,1,1,allow
50480,443,25461,443,57535,3735,53800,70,122,26,44,allow
57138,443,59763,443,70379,4205,66174,101,403,51,50,allow
52152,80,10469,80,366,240,126,7,32,5,2,allow
55724,45682,6518,45682,70,70,0,1,5,1,0,allow
51999,80,34655,80,20433,10970,9463,34,42,19,15,allow
51934,443,39970,443,9735,2891,6844,36,82,17,19,allow
56521,53,35277,53,305,86,219,2,30,1,1,allow
50056,27018,7128,27018,468,390,78,5,30,4,1,allow
65078,53,19268,53,177,94,83,2,30,1,1,allow
55999,443,53262,443,45632,2078,43554,58,120,22,36,allow
43088,5228,50878,5228,4708,1753,2955,27,4133,12,15,allow
37647,443,55661,443,697381,19797,677584,725,106,247,478,allow
58424,443,8670,443,81295,4140,77155,114,117,42,72,allow
52142,80,50942,80,246,120,126,5,32,3,2,allow
52155,80,52769,80,366,240,126,7,32,5,2,allow
65524,443,51488,443,282968,9210,273758,296,15,106,190,allow
52163,443,4704,443,4187,773,3414,16,30,9,7,allow
52161,443,17095,443,1461,924,537,13,31,7,6,allow
53995,41985,42236,41985,70,70,0,2,7,2,0,allow
51221,51413,17316,51413,460,150,310,2,1200,1,1,allow
65525,443,9387,443,92247,4799,87448,107,15,43,64,allow
52080,80,40918,80,27100,21684,5416,39,38,25,14,allow
52158,80,31502,80,502,310,192,9,31,6,3,allow
10151,11888,57602,11888,491,150,341,2,1200,1,1,allow
52154,80,54882,80,366,240,126,7,32,5,2,allow
49899,443,6307,443,1820,1101,719,18,72,10,8,allow
53983,40500,9041,40500,70,70,0,1,4,1,0,allow
49668,443,64842,443,1288,754,534,13,50,5,8,allow
64093,64828,53558,64828,70,70,0,1,4,1,0,allow
52237,16801,7817,16801,70,70,0,1,5,1,0,allow
57242,53,53275,53,184,86,98,2,29,1,1,allow
60833,443,43148,443,1157,817,340,10,26,5,5,allow
32971,443,57614,443,300,180,120,4,15,2,2,allow
52027,80,10157,80,9732,8170,1562,18,38,10,8,allow
56172,53,12622,53,253,87,166,4,29,2,2,allow
56663,53,55920,53,181,94,87,2,30,1,1,allow
56773,80,16432,80,1462,703,759,8,16,5,3,allow
44421,443,9990,443,2548,1565,983,20,330,11,9,allow
55806,53,2252,53,200,102,98,2,30,1,1,allow
17129,53,49932,53,225,78,147,2,31,1,1,allow
51404,443,29692,443,9076,2650,6426,35,247,15,20,allow
36503,443,18047,443,3549,899,2650,13,120,6,7,allow
53660,443,62189,443,2955,864,2091,11,119,5,6,allow
54401,443,33851,443,11527127,373718,11153409,12286,144,4090,8196,allow
52018,80,60048,80,4988,2667,2321,15,38,10,5,allow
55726,32463,19971,32463,70,70,0,1,5,1,0,allow
50054,443,33481,443,7630,839,6791,20,79,9,11,allow
56624,53,60055,53,328,87,241,4,52,2,2,allow
56667,53,36173,53,232,94,138,2,30,1,1,allow
56684,53,5087,53,194,94,100,2,30,1,1,allow
65001,53,27011,53,200,78,122,2,30,1,1,allow
56751,53,35800,53,177,94,83,2,30,1,1,allow
52127,80,9783,80,2412,1750,662,13,36,9,4,allow
12939,53,12939,53,216,82,134,2,32,1,1,allow
52486,443,26318,443,57366,41661,15705,111,440,66,45,allow
52238,48996,43886,48996,70,70,0,1,5,1,0,allow
55848,53,3289,53,387,134,253,2,30,1,1,allow
65484,53,10578,53,195,86,109,2,30,1,1,allow
49695,53,29724,53,240,102,138,2,30,1,1,allow
64877,53,41929,53,209,110,99,2,30,1,1,allow
43516,53,56876,53,168,78,90,2,30,1,1,allow
52865,443,19165,443,13139,6481,6658,36,262,16,20,allow
50684,443,36548,443,6909,2495,4414,20,15,11,9,allow
52013,80,47338,80,27271,12050,15221,45,38,24,21,allow
51946,80,42668,80,1716,952,764,13,69,8,5,allow
52160,80,10438,80,502,310,192,9,31,6,3,allow
52267,55982,31620,55982,70,70,0,2,6,2,0,allow
24965,53,24965,53,247,98,149,2,32,1,1,allow
52266,31225,1238,31225,70,70,0,1,5,1,0,allow
51930,443,10848,443,9114,2713,6401,33,82,15,18,allow
38999,443,34634,443,12742,1983,10759,47,123,14,33,allow
57986,80,48652,80,1056,682,374,10,15,6,4,allow
49410,53,59985,53,324,87,237,4,55,2,2,allow
54877,53,59244,53,199,94,105,2,30,1,1,allow
49432,53,21540,53,199,94,105,2,30,1,1,allow
49743,53,1715,53,210,94,116,2,30,1,1,allow
49913,53,15271,53,177,94,83,2,30,1,1,allow
39311,443,39728,443,12825,8114,4711,63,269,25,38,allow
42046,443,15950,443,10195,2175,8020,25,187,14,11,allow
44323,5228,8392,5228,7292,4509,2783,50,6392,25,25,allow
55072,53,55776,53,177,94,83,2,30,1,1,allow
49980,53,9358,53,168,94,74,2,31,1,1,allow
55306,53,44864,53,177,94,83,2,31,1,1,allow
47739,5228,19332,5228,2852,2143,709,16,121,8,8,allow
6881,6881,13981,6881,150,150,0,1,1200,1,0,allow
65078,53,50659,53,177,94,83,2,30,1,1,allow
49980,53,26131,53,152,78,74,2,30,1,1,allow
55065,53,9474,53,168,78,90,2,30,1,1,allow
45151,53,40658,53,168,78,90,2,30,1,1,allow
55072,53,50967,53,177,94,83,2,31,1,1,allow
57470,13613,53702,13613,1577,594,983,20,1638,10,10,allow
53637,443,7341,443,8473,1099,7374,20,119,9,11,allow
50064,80,16215,80,186,64,122,4,25,2,2,allow
50065,80,29478,80,4709,4006,703,11,25,6,5,allow
58964,80,7375,80,5541,4758,783,16,16,8,8,allow
57262,53,45135,53,94,94,0,1,30,1,0,allow
53638,443,29587,443,2090,1100,990,17,119,9,8,allow
28007,443,40494,443,31586,15587,15999,213,884,105,108,allow
49964,53,64934,53,749,94,655,2,30,1,1,allow
49854,443,20438,443,5578,2780,2798,14,120,7,7,allow
64112,24707,56635,24707,66,66,0,2,8,2,0,allow
53895,443,16317,443,375374,160846,214528,633,1412,294,339,allow
56751,53,10691,53,177,94,83,2,30,1,1,allow
55563,53,42353,53,177,94,83,2,30,1,1,allow
55619,445,0,0,70,70,0,1,0,1,0,drop
3456,11392,0,0,62,62,0,1,0,1,0,deny
50942,445,0,0,70,70,0,1,0,1,0,drop
50939,445,0,0,70,70,0,1,0,1,0,drop
50941,445,0,0,70,70,0,1,0,1,0,drop
443,34920,0,0,60,60,0,1,0,1,0,deny
15774,56205,0,0,66,66,0,1,0,1,0,deny
50937,445,0,0,70,70,0,1,0,1,0,drop
443,14591,0,0,131,131,0,1,0,1,0,deny
63421,44847,0,0,66,66,0,1,0,1,0,deny
62949,37965,0,0,62,62,0,1,0,1,0,deny
55517,25174,0,0,66,66,0,1,0,1,0,deny
50935,445,0,0,70,70,0,1,0,1,0,drop
63346,37965,0,0,66,66,0,1,0,1,0,deny
42564,50584,0,0,62,62,0,1,0,1,0,deny
51032,445,0,0,66,66,0,1,0,1,0,drop
45652,10214,0,0,62,62,0,1,0,1,0,deny
33314,44847,0,0,62,62,0,1,0,1,0,deny
52470,14037,0,0,66,66,0,1,0,1,0,deny
1024,35894,0,0,62,62,0,1,0,1,0,deny
43704,37965,0,0,66,66,0,1,0,1,0,deny
48830,5900,0,0,60,60,0,1,0,1,0,deny
51024,445,0,0,66,66,0,1,0,1,0,drop
55608,445,0,0,70,70,0,1,0,1,0,drop
56039,50584,0,0,62,62,0,1,0,1,0,deny
50928,445,0,0,70,70,0,1,0,1,0,drop
59977,30188,0,0,66,66,0,1,0,1,0,deny
26884,57866,0,0,74,74,0,1,0,1,0,deny
61624,30317,0,0,66,66,0,1,0,1,0,deny
51021,445,0,0,66,66,0,1,0,1,0,drop
60141,30188,0,0,66,66,0,1,0,1,0,deny
52812,25174,0,0,62,62,0,1,0,1,0,deny
11643,81,0,0,60,60,0,1,0,1,0,deny
52769,51221,0,0,62,62,0,1,0,1,0,deny
50920,445,0,0,70,70,0,1,0,1,0,drop
11056,6881,0,0,62,62,0,1,0,1,0,deny
50917,445,0,0,70,70,0,1,0,1,0,drop
51014,445,0,0,66,66,0,1,0,1,0,drop
6666,62078,0,0,60,60,0,1,0,1,0,deny
39213,25174,0,0,62,62,0,1,0,1,0,deny
47063,15503,0,0,146,146,0,1,0,1,0,deny
56428,30317,0,0,66,66,0,1,0,1,0,deny
51007,445,0,0,66,66,0,1,0,1,0,drop
24534,50584,0,0,62,62,0,1,0,1,0,deny
50913,445,0,0,70,70,0,1,0,1,0,drop
50912,445,0,0,70,70,0,1,0,1,0,drop
42981,44847,0,0,146,146,0,1,0,1,0,deny
7151,37965,0,0,66,66,0,1,0,1,0,deny
60722,37965,0,0,62,62,0,1,0,1,0,deny
56940,5900,0,0,60,60,0,1,0,1,0,deny
65003,57470,0,0,78,78,0,1,0,1,0,deny
56366,51221,0,0,66,66,0,1,0,1,0,deny
3945,35440,0,0,66,66,0,1,0,1,0,deny
55597,445,0,0,70,70,0,1,0,1,0,drop
55595,445,0,0,70,70,0,1,0,1,0,drop
55596,445,0,0,70,70,0,1,0,1,0,drop
50996,445,0,0,66,66,0,1,0,1,0,drop
50997,445,0,0,66,66,0,1,0,1,0,drop
50998,445,0,0,66,66,0,1,0,1,0,drop
50991,445,0,0,66,66,0,1,0,1,0,drop
50995,445,0,0,66,66,0,1,0,1,0,drop
50994,445,0,0,66,66,0,1,0,1,0,drop
50993,445,0,0,66,66,0,1,0,1,0,drop
50990,445,0,0,66,66,0,1,0,1,0,drop
50908,445,0,0,70,70,0,1,0,1,0,drop
36357,25174,0,0,62,62,0,1,0,1,0,deny
64333,57470,0,0,78,78,0,1,0,1,0,deny
35319,51505,0,0,62,62,0,1,0,1,0,deny
56876,11392,0,0,66,66,0,1,0,1,0,deny
50907,445,0,0,70,70,0,1,0,1,0,drop
47141,50584,0,0,62,62,0,1,0,1,0,deny
52340,22114,0,0,62,62,0,1,0,1,0,deny
6889,5529,0,0,143,143,0,1,0,1,0,deny
5151,50584,0,0,62,62,0,1,0,1,0,deny
40988,60043,0,0,146,146,0,1,0,1,0,deny
50902,445,0,0,70,70,0,1,0,1,0,drop
55593,445,0,0,70,70,0,1,0,1,0,drop
55592,445,0,0,70,70,0,1,0,1,0,drop
55582,445,0,0,70,70,0,1,0,1,0,drop
55580,445,0,0,70,70,0,1,0,1,0,drop
20012,8443,0,0,60,60,0,1,0,1,0,deny
50978,445,0,0,66,66,0,1,0,1,0,drop
50976,445,0,0,66,66,0,1,0,1,0,drop
50975,445,0,0,66,66,0,1,0,1,0,drop
59610,51505,0,0,66,66,0,1,0,1,0,deny
64406,25174,0,0,62,62,0,1,0,1,0,deny
50506,10214,0,0,66,66,0,1,0,1,0,deny
7110,25174,0,0,66,66,0,1,0,1,0,deny
55575,445,0,0,70,70,0,1,0,1,0,drop
443,49988,0,0,82,82,0,1,0,1,0,deny
62111,35440,0,0,66,66,0,1,0,1,0,deny
60799,25174,0,0,66,66,0,1,0,1,0,deny
6666,5000,0,0,60,60,0,1,0,1,0,deny
1116,44847,0,0,66,66,0,1,0,1,0,deny
61202,35894,0,0,66,66,0,1,0,1,0,deny
55569,445,0,0,70,70,0,1,0,1,0,drop
55568,445,0,0,70,70,0,1,0,1,0,drop
55567,445,0,0,70,70,0,1,0,1,0,drop
50889,445,0,0,70,70,0,1,0,1,0,drop
35744,64147,0,0,66,66,0,1,0,1,0,deny
26424,27189,0,0,66,66,0,1,0,1,0,deny
1038,37965,0,0,62,62,0,1,0,1,0,deny
50886,445,0,0,70,70,0,1,0,1,0,drop
50127,64147,0,0,62,62,0,1,0,1,0,deny
61183,25174,0,0,62,62,0,1,0,1,0,deny
59972,25174,0,0,62,62,0,1,0,1,0,deny
55558,445,0,0,70,70,0,1,0,1,0,drop
55555,445,0,0,70,70,0,1,0,1,0,drop
55551,445,0,0,70,70,0,1,0,1,0,drop
55043,57470,0,0,78,78,0,1,0,1,0,deny
60128,22114,0,0,62,62,0,1,0,1,0,deny
14263,22114,0,0,66,66,0,1,0,1,0,deny
7521,20234,0,0,157,157,0,1,0,1,0,deny
27153,50584,0,0,146,146,0,1,0,1,0,deny
50963,445,0,0,66,66,0,1,0,1,0,drop
50882,445,0,0,70,70,0,1,0,1,0,drop
50880,445,0,0,70,70,0,1,0,1,0,drop
10669,49756,0,0,60,60,0,1,0,1,0,deny
10669,49756,0,0,60,60,0,1,0,1,0,deny
10669,49756,0,0,60,60,0,1,0,1,0,deny
10669,49756,0,0,60,60,0,1,0,1,0,deny
10669,49756,0,0,60,60,0,1,0,1,0,deny
10594,25174,0,0,146,146,0,1,0,1,0,deny
50878,445,0,0,70,70,0,1,0,1,0,drop
49001,48817,0,0,160,160,0,1,0,1,0,deny
56432,35253,0,0,66,66,0,1,0,1,0,deny
55550,445,0,0,70,70,0,1,0,1,0,drop
63321,37807,0,0,66,66,0,1,0,1,0,deny
55512,23718,0,0,66,66,0,1,0,1,0,deny
55547,445,0,0,70,70,0,1,0,1,0,drop
19875,30170,0,0,145,145,0,1,0,1,0,deny
43671,17372,0,0,62,62,0,1,0,1,0,deny
45941,23386,0,0,60,60,0,1,0,1,0,deny
50871,445,0,0,70,70,0,1,0,1,0,drop
48071,25174,0,0,62,62,0,1,0,1,0,deny
50950,445,0,0,66,66,0,1,0,1,0,drop
50947,445,0,0,66,66,0,1,0,1,0,drop
54280,3385,0,0,60,60,0,1,0,1,0,deny
47266,25174,0,0,146,146,0,1,0,1,0,deny
50869,445,0,0,70,70,0,1,0,1,0,drop
28875,51505,0,0,62,62,0,1,0,1,0,deny
36229,62413,0,0,62,62,0,1,0,1,0,deny
52225,31985,35881,31985,66,66,0,1,5,1,0,allow
52234,64624,43132,64624,136,136,0,3,14,3,0,allow
57575,443,57575,443,206737,25710,181027,212,180,75,137,allow
57573,443,57573,443,775362,32338,743024,683,180,169,514,allow
55410,53,27764,53,711,87,624,2,30,1,1,allow
55059,53,53925,53,711,87,624,2,30,1,1,allow
2182,53,2182,53,643,88,555,2,30,1,1,allow
55613,53,34338,53,170,87,83,2,30,1,1,allow
64775,443,64775,443,4559,1652,2907,19,27,11,8,allow
52277,443,52277,443,1880,941,939,17,21,7,10,allow
51493,80,21444,80,9524,736,8788,18,131,9,9,allow
57570,443,57570,443,175212,28668,146544,186,180,69,117,allow
52224,37178,41727,37178,136,136,0,3,14,3,0,allow
56434,53,56434,53,243,94,149,2,32,1,1,allow
52259,25011,50909,25011,70,70,0,2,8,2,0,allow
55589,443,3953,443,7894,1557,6337,20,150,9,11,allow
53527,443,25088,443,127391,26326,101065,179,172,76,103,allow
55893,53,56779,53,711,87,624,2,30,1,1,allow
55836,53,8077,53,170,87,83,2,31,1,1,allow
64928,53,11072,53,762,98,664,2,30,1,1,allow
56752,53,39858,53,701,88,613,2,30,1,1,allow
49241,443,49241,443,31778,6075,25703,54,49,28,26,allow
60443,443,1656,443,10961,4286,6675,53,320,21,32,allow
52235,48910,47820,48910,136,136,0,3,14,3,0,allow
53993,6881,30701,6881,70,70,0,2,8,2,0,allow
52221,33166,38901,33166,66,66,0,1,5,1,0,allow
56597,443,50431,443,10135129,248530,9886599,9808,64,3124,6684,allow
64089,20260,49392,20260,66,66,0,1,5,1,0,allow
50895,443,61149,443,130,70,60,3,5,2,1,allow
64114,64126,30827,64126,66,66,0,2,8,2,0,allow
59937,443,15432,443,7701,3981,3720,27,70,12,15,allow
55592,443,17919,443,8049,1560,6489,19,150,9,10,allow
55591,443,37425,443,7902,1565,6337,20,150,9,11,allow
56811,443,16024,443,8020,2000,6020,20,15,11,9,allow
49336,80,14005,80,3060,1219,1841,11,19,7,4,allow
53527,5228,55667,5228,9674,1776,7898,29,3764,11,18,allow
51152,443,11725,443,44048,4441,39607,97,317,43,54,allow
64111,1830,17922,1830,66,66,0,2,8,2,0,allow
52230,47803,46448,47803,136,136,0,3,14,3,0,allow
56812,443,34534,443,8073,2053,6020,20,15,11,9,allow
55590,443,56220,443,7906,1569,6337,20,150,9,11,allow
52260,52142,32000,52142,70,70,0,2,8,2,0,allow
55100,53,57209,53,711,87,624,2,30,1,1,allow
56810,443,52495,443,8072,2052,6020,20,16,11,9,allow
59895,53,59895,53,643,88,555,2,30,1,1,allow
42625,443,18977,443,218298,5904,212394,220,120,63,157,allow
46422,80,48489,80,1447,468,979,9,181,5,4,allow
44847,18659,47289,18659,150,150,0,1,1200,1,0,allow
54153,443,43773,443,5008,2097,2911,13,121,6,7,allow
3376,35440,0,0,66,66,0,1,0,1,0,deny
50868,445,0,0,70,70,0,1,0,1,0,drop
55538,445,0,0,70,70,0,1,0,1,0,drop
55532,445,0,0,70,70,0,1,0,1,0,drop
55530,445,0,0,70,70,0,1,0,1,0,drop
55529,445,0,0,70,70,0,1,0,1,0,drop
50867,445,0,0,70,70,0,1,0,1,0,drop
53243,57470,0,0,74,74,0,1,0,1,0,deny
50866,445,0,0,70,70,0,1,0,1,0,drop
50862,445,0,0,70,70,0,1,0,1,0,drop
50861,445,0,0,70,70,0,1,0,1,0,drop
2815,62413,0,0,66,66,0,1,0,1,0,deny
41477,50584,0,0,66,66,0,1,0,1,0,deny
59393,25174,0,0,66,66,0,1,0,1,0,deny
50945,445,0,0,66,66,0,1,0,1,0,drop
53089,24211,0,0,62,62,0,1,0,1,0,deny
55206,22114,0,0,66,66,0,1,0,1,0,deny
13406,22114,0,0,62,62,0,1,0,1,0,deny
18745,64147,0,0,62,62,0,1,0,1,0,deny
53189,62413,0,0,62,62,0,1,0,1,0,deny
50934,445,0,0,66,66,0,1,0,1,0,drop
50936,445,0,0,66,66,0,1,0,1,0,drop
50938,445,0,0,66,66,0,1,0,1,0,drop
50932,445,0,0,66,66,0,1,0,1,0,drop
55590,53,20424,53,177,94,83,2,30,1,1,allow
50929,445,0,0,66,66,0,1,0,1,0,drop
50927,445,0,0,66,66,0,1,0,1,0,drop
50928,445,0,0,66,66,0,1,0,1,0,drop
50848,445,0,0,70,70,0,1,0,1,0,drop
50847,445,0,0,70,70,0,1,0,1,0,drop
443,49988,0,0,82,82,0,1,0,1,0,deny
443,41237,0,0,89,89,0,1,0,1,0,deny
50843,445,0,0,70,70,0,1,0,1,0,drop
55523,445,0,0,70,70,0,1,0,1,0,drop
50838,445,0,0,70,70,0,1,0,1,0,drop
50837,445,0,0,70,70,0,1,0,1,0,drop
45964,2777,0,0,60,60,0,1,0,1,0,deny
55520,445,0,0,70,70,0,1,0,1,0,drop
55518,445,0,0,70,70,0,1,0,1,0,drop
55516,445,0,0,70,70,0,1,0,1,0,drop
53275,21247,0,0,62,62,0,1,0,1,0,deny
53750,25174,0,0,62,62,0,1,0,1,0,deny
65288,44847,0,0,66,66,0,1,0,1,0,deny
60003,36829,0,0,66,66,0,1,0,1,0,deny
53667,22114,0,0,62,62,0,1,0,1,0,deny
65270,3855,0,0,78,78,0,1,0,1,0,deny
51827,56205,0,0,66,66,0,1,0,1,0,deny
58835,17372,0,0,66,66,0,1,0,1,0,deny
42674,22114,0,0,62,62,0,1,0,1,0,deny
49587,35776,0,0,157,157,0,1,0,1,0,deny
50826,445,0,0,70,70,0,1,0,1,0,drop
12655,30627,0,0,62,62,0,1,0,1,0,deny
55514,445,0,0,70,70,0,1,0,1,0,drop
55515,445,0,0,70,70,0,1,0,1,0,drop
55509,445,0,0,70,70,0,1,0,1,0,drop
52102,443,62995,443,343074,14649,328425,390,41,159,231,allow
52262,14418,18744,14418,70,70,0,2,8,2,0,allow
52231,1026,54310,1026,136,136,0,3,14,3,0,allow
42873,443,33511,443,3379,2111,1268,19,15,10,9,allow
57441,53,7425,53,177,94,83,2,30,1,1,allow
54571,443,54134,443,10546,2453,8093,28,15,16,12,allow
51502,80,42285,80,1515,481,1034,11,15,6,5,allow
64581,53,7849,53,514,88,426,4,42,2,2,allow
34220,443,12969,443,7946,2731,5215,27,18,15,12,allow
50008,53,2633,53,232,94,138,2,29,1,1,allow
57470,21158,39017,21158,2182,798,1384,19,1199,10,9,allow
52211,80,22459,80,8559,5109,3450,23,160,12,11,allow
47159,443,53350,443,777,432,345,10,15,5,5,allow
49291,443,62267,443,18607,4906,13701,47,255,20,27,allow
49255,80,49255,80,8453,961,7492,18,20,9,9,allow
49300,443,26110,443,8282,3240,5042,40,255,20,20,allow
46452,53,46452,53,247,98,149,2,32,1,1,allow
21018,53,21018,53,235,90,145,2,31,1,1,allow
49913,53,61333,53,177,94,83,2,29,1,1,allow
55563,53,47396,53,177,94,83,2,29,1,1,allow
55135,53,55135,53,220,90,130,2,29,1,1,allow
50705,80,25198,80,499,192,307,6,26,4,2,allow
50697,80,65344,80,318,192,126,6,27,4,2,allow
35671,443,43722,443,6824,1142,5682,24,134,13,11,allow
52228,49974,17167,49974,230,136,94,4,14,3,1,allow
50746,443,34629,443,8422,1676,6746,25,16,13,12,allow
49486,7000,49486,7000,3370,1595,1775,16,15,9,7,allow
59877,443,61626,443,9024,1533,7491,25,110,11,14,allow
60526,443,60526,443,1462,863,599,15,37,9,6,allow
47009,53,0,0,86,86,0,1,30,1,0,allow
55067,443,5248,443,17968,12031,5937,38,63,21,17,allow
65077,53,33139,53,734,86,648,2,30,1,1,allow
52258,58792,14441,58792,316,136,180,6,8,3,3,allow
41431,443,64563,443,190,70,120,4,15,2,2,allow
49508,443,20014,443,13719,5017,8702,40,283,20,20,allow
52256,41337,31273,41337,316,136,180,6,8,3,3,allow
37419,443,55901,443,558,210,348,9,28,4,5,allow
51817,443,24496,443,2811130,115323,2695807,3382,206,1445,1937,allow
52232,35126,13178,35126,70,70,0,1,5,1,0,allow
60372,53,60372,53,222,90,132,2,30,1,1,allow
52220,65128,1362,65128,70,70,0,1,5,1,0,allow
52223,11979,45106,11979,70,70,0,1,5,1,0,allow
40189,443,26952,443,7221,2940,4281,30,23,16,14,allow
55836,53,20362,53,177,94,83,2,30,1,1,allow
52802,443,30052,443,4202,1924,2278,27,80,13,14,allow
55613,53,57785,53,177,94,83,2,30,1,1,allow
35216,123,45101,123,184,94,90,2,30,1,1,allow
51221,49857,1668,49857,791,266,525,8,1200,4,4,allow
65139,53,12315,53,210,102,108,2,30,1,1,allow
52101,80,34628,80,55117,3792,51325,69,36,29,40,allow
49474,7000,49474,7000,2990,1599,1391,15,15,8,7,allow
37466,443,58228,443,13829,1724,12105,28,516,13,15,allow
50700,80,14024,80,648,256,392,8,27,5,3,allow
50704,80,8069,80,499,192,307,6,26,4,2,allow
43744,53,43744,53,235,90,145,2,32,1,1,allow
50226,80,13987,80,1746,780,966,19,102,7,12,allow
50665,443,2947,443,2626,1638,988,19,83,11,8,allow
56441,80,54346,80,17008,1379,15629,22,25,7,15,allow
57441,53,33174,53,177,94,83,2,30,1,1,allow
1935,53,17873,53,260,86,174,2,30,1,1,allow
56022,53,29566,53,728,102,626,2,30,1,1,allow
50265,17555,24395,17555,1488,930,558,21,1200,12,9,allow
53973,50546,28275,50546,2069,1081,988,12,16,7,5,allow
57913,80,64220,80,6515,1210,5305,15,23,8,7,allow
49240,443,49240,443,8448,3368,5080,25,48,15,10,allow
53705,443,25596,443,1579,988,591,13,44,7,6,allow
64110,51617,13818,51617,66,66,0,2,7,2,0,allow
52233,42673,65112,42673,136,136,0,3,14,3,0,allow
56275,53,54180,53,177,94,83,2,30,1,1,allow
52222,11516,7975,11516,70,70,0,1,5,1,0,allow
60474,443,49891,443,5888,1175,4713,19,76,11,8,allow
35922,443,6231,443,6997,1773,5224,27,17,15,12,allow
50433,443,11749,443,134,60,74,3,10,2,1,allow
33042,443,32323,443,130,70,60,2,14,1,1,allow
59833,443,63196,443,15252,5376,9876,35,154,16,19,allow
52257,6712,42589,6712,70,70,0,2,8,2,0,allow
38716,443,32682,443,90273,3481,86792,96,15,31,65,allow
52226,48784,61623,48784,70,70,0,1,5,1,0,allow
52645,6881,55258,6881,841,535,306,10,14,5,5,allow
64081,59517,43134,59517,504,382,122,8,16,6,2,allow
55806,53,43969,53,200,102,98,2,32,1,1,allow
50057,53,42578,53,177,94,83,2,29,1,1,allow
52149,80,41444,80,1638,1324,314,10,15,5,5,allow
56730,53,39267,53,177,94,83,2,29,1,1,allow
52015,80,59849,80,14830,11044,3786,27,37,15,12,allow
53024,123,1742,123,184,94,90,2,30,1,1,allow
50366,80,48017,80,23852,1662,22190,36,15,19,17,allow
56730,53,28037,53,177,94,83,2,30,1,1,allow
55306,53,18601,53,177,94,83,2,29,1,1,allow
55354,53,28658,53,168,94,74,2,30,1,1,allow
54351,53,59901,53,168,78,90,2,29,1,1,allow
55613,53,25861,53,177,94,83,2,30,1,1,allow
55613,53,1186,53,177,94,83,2,30,1,1,allow
1937,53,32884,53,210,78,132,2,30,1,1,allow
51406,443,19359,443,5360,3775,1585,22,35,13,9,allow
55354,53,24160,53,168,94,74,2,30,1,1,allow
43625,53,13195,53,86,86,0,1,30,1,0,allow
56730,53,28651,53,177,94,83,2,30,1,1,allow
56962,53,33318,53,210,102,108,2,30,1,1,allow
50171,53,22623,53,211,78,133,2,30,1,1,allow
57470,8999,23972,8999,1577,594,983,20,1616,10,10,allow
65062,53,47695,53,229,110,119,2,30,1,1,allow
33065,443,50330,443,6746,2826,3920,19,399,11,8,allow
56528,443,54144,443,8313,3597,4716,16,119,8,8,allow
54391,80,1850,80,1378,808,570,13,361,7,6,allow
50698,80,39680,80,318,192,126,6,27,4,2,allow
60809,40010,63910,40010,316,136,180,6,6,3,3,allow
52255,16087,20036,16087,70,70,0,2,8,2,0,allow
55723,80,48588,80,70,70,0,1,5,1,0,allow
52229,54711,46262,54711,136,136,0,3,14,3,0,allow
45839,80,2983,80,1638,1324,314,10,15,5,5,allow
52048,80,14488,80,41486,20844,20642,64,37,32,32,allow
50961,5222,36046,5222,8318,2850,5468,54,255,27,27,allow
37426,443,35217,443,7477,3305,4172,21,400,12,9,allow
53176,58851,59130,58851,70,70,0,2,8,2,0,allow
59949,80,40471,80,730296,15564,714732,723,57,218,505,allow
41314,80,2894,80,1723,438,1285,10,136,6,4,allow
43225,443,17321,443,3831584,85342,3746242,3246,110,597,2649,allow
55836,53,51304,53,177,94,83,2,30,1,1,allow
39097,443,24428,443,6747,2827,3920,19,399,11,8,allow
46295,443,39789,443,178,118,60,2,15,1,1,allow
54343,443,5667,443,7990,2701,5289,30,61,17,13,allow
50707,80,44331,80,16427,3830,12597,28,25,12,16,allow
52261,48208,15422,48208,70,70,0,2,8,2,0,allow
49335,80,26214,80,1193,703,490,8,18,5,3,allow
43227,443,35933,443,1139403,49178,1090225,1155,108,353,802,allow
123,123,15177,123,184,94,90,2,30,1,1,allow
1938,53,25817,53,210,78,132,2,30,1,1,allow
37427,443,48428,443,10281,4850,5431,23,400,13,10,allow
50584,51413,16088,51413,475,150,325,2,1200,1,1,allow
51221,40624,20030,40624,594,594,0,10,1200,10,0,allow
57470,8999,31471,8999,1577,594,983,20,1614,10,10,allow
55387,443,54944,443,3997,1374,2623,14,136,7,7,allow
19473,45556,7986,45556,469,150,319,2,1200,1,1,allow
30188,12494,61043,12494,502,150,352,2,1200,1,1,allow
57470,24276,41676,24276,132,132,0,3,1200,3,0,allow
21133,51413,43233,51413,460,150,310,2,1200,1,1,allow
55650,53,22960,53,179,94,85,2,31,1,1,allow
53126,53,53126,53,247,98,149,2,32,1,1,allow
58990,53,6423,53,168,78,90,2,30,1,1,allow
21846,53,21846,53,247,98,149,2,33,1,1,allow
5111,53,5111,53,235,90,145,2,33,1,1,allow
53980,36153,43274,36153,164,70,94,2,5,1,1,allow
40785,443,32724,443,646,292,354,10,41,5,5,allow
46271,7700,56460,7700,1440,956,484,15,36,8,7,allow
50253,53,23205,53,167,86,81,2,31,1,1,allow
57449,80,1245,80,4508,2978,1530,13,15,6,7,allow
52194,443,33437,443,9075,3727,5348,38,50,18,20,allow
56841,53,62125,53,177,94,83,2,30,1,1,allow
55494,53,4891,53,255,102,153,2,30,1,1,allow
50920,445,0,0,66,66,0,1,0,1,0,drop
55507,445,0,0,70,70,0,1,0,1,0,drop
53305,50584,0,0,62,62,0,1,0,1,0,deny
50919,445,0,0,66,66,0,1,0,1,0,drop
63495,50584,0,0,66,66,0,1,0,1,0,deny
50915,445,0,0,66,66,0,1,0,1,0,drop
50917,445,0,0,66,66,0,1,0,1,0,drop
50913,445,0,0,66,66,0,1,0,1,0,drop
51114,25174,0,0,66,66,0,1,0,1,0,deny
59549,50584,0,0,66,66,0,1,0,1,0,deny
50822,445,0,0,70,70,0,1,0,1,0,drop
59107,25174,0,0,66,66,0,1,0,1,0,deny
443,49988,0,0,82,82,0,1,0,1,0,deny
45941,23388,0,0,60,60,0,1,0,1,0,deny
55504,445,0,0,70,70,0,1,0,1,0,drop
55310,50584,0,0,66,66,0,1,0,1,0,deny
50813,445,0,0,70,70,0,1,0,1,0,drop
50811,445,0,0,70,70,0,1,0,1,0,drop
50810,445,0,0,70,70,0,1,0,1,0,drop
36992,25174,0,0,62,62,0,1,0,1,0,deny
55498,445,0,0,70,70,0,1,0,1,0,drop
55491,445,0,0,70,70,0,1,0,1,0,drop
993,34205,0,0,66,66,0,1,0,1,0,deny
50807,445,0,0,70,70,0,1,0,1,0,drop
50806,445,0,0,70,70,0,1,0,1,0,drop
50903,445,0,0,66,66,0,1,0,1,0,drop
20112,64147,0,0,62,62,0,1,0,1,0,deny
27507,25174,0,0,62,62,0,1,0,1,0,deny
54539,26467,0,0,62,62,0,1,0,1,0,deny
61583,64147,0,0,66,66,0,1,0,1,0,deny
26420,25174,0,0,66,66,0,1,0,1,0,deny
443,49988,0,0,82,82,0,1,0,1,0,deny
57325,60043,0,0,62,62,0,1,0,1,0,deny
50800,445,0,0,70,70,0,1,0,1,0,drop
50895,445,0,0,66,66,0,1,0,1,0,drop
59497,64097,0,0,66,66,0,1,0,1,0,deny
56576,9000,0,0,60,60,0,1,0,1,0,deny
61932,25174,0,0,66,66,0,1,0,1,0,deny
22029,50584,0,0,66,66,0,1,0,1,0,deny
55481,445,0,0,70,70,0,1,0,1,0,drop
58460,36237,0,0,66,66,0,1,0,1,0,deny
65003,57470,0,0,78,78,0,1,0,1,0,deny
51348,25174,0,0,66,66,0,1,0,1,0,deny
63409,50265,0,0,66,66,0,1,0,1,0,deny
50893,445,0,0,66,66,0,1,0,1,0,drop
443,35385,0,0,161,161,0,1,0,1,0,deny
50792,445,0,0,70,70,0,1,0,1,0,drop
3914,37965,0,0,62,62,0,1,0,1,0,deny
3911,37965,0,0,66,66,0,1,0,1,0,deny
50789,445,0,0,70,70,0,1,0,1,0,drop
32722,25174,0,0,62,62,0,1,0,1,0,deny
50885,445,0,0,66,66,0,1,0,1,0,drop
53353,26467,0,0,62,62,0,1,0,1,0,deny
35616,21247,0,0,146,146,0,1,0,1,0,deny
50882,445,0,0,66,66,0,1,0,1,0,drop
3093,62413,0,0,62,62,0,1,0,1,0,deny
31410,25174,0,0,62,62,0,1,0,1,0,deny
50785,445,0,0,70,70,0,1,0,1,0,drop
50784,445,0,0,70,70,0,1,0,1,0,drop
53194,35440,0,0,66,66,0,1,0,1,0,deny
10652,57470,0,0,66,66,0,1,0,1,0,deny
62838,44847,0,0,66,66,0,1,0,1,0,deny
14578,50584,0,0,66,66,0,1,0,1,0,deny
6546,37965,0,0,62,62,0,1,0,1,0,deny
3667,56205,0,0,146,146,0,1,0,1,0,deny
50780,445,0,0,70,70,0,1,0,1,0,drop
40418,25174,0,0,62,62,0,1,0,1,0,deny
64333,57470,0,0,78,78,0,1,0,1,0,deny
443,49988,0,0,82,82,0,1,0,1,0,deny
55468,445,0,0,70,70,0,1,0,1,0,drop
55469,445,0,0,70,70,0,1,0,1,0,drop
55467,445,0,0,70,70,0,1,0,1,0,drop
50867,445,0,0,66,66,0,1,0,1,0,drop
50863,445,0,0,66,66,0,1,0,1,0,drop
50869,445,0,0,66,66,0,1,0,1,0,drop
50865,445,0,0,66,66,0,1,0,1,0,drop
50870,445,0,0,66,66,0,1,0,1,0,drop
50868,445,0,0,66,66,0,1,0,1,0,drop
50866,445,0,0,66,66,0,1,0,1,0,drop
50864,445,0,0,66,66,0,1,0,1,0,drop
50779,445,0,0,70,70,0,1,0,1,0,drop
58229,50584,0,0,66,66,0,1,0,1,0,deny
60058,11392,0,0,66,66,0,1,0,1,0,deny
8889,63001,0,0,60,60,0,1,0,1,0,deny
11317,61248,0,0,143,143,0,1,0,1,0,reset-both
52044,44847,0,0,146,146,0,1,0,1,0,deny
56075,23,0,0,60,60,0,1,0,1,0,deny
25565,47158,0,0,60,60,0,1,0,1,0,deny
50774,445,0,0,70,70,0,1,0,1,0,drop
55463,445,0,0,70,70,0,1,0,1,0,drop
55567,53,51894,53,184,80,104,2,0,1,1,allow
55458,445,0,0,70,70,0,1,0,1,0,drop
55460,445,0,0,70,70,0,1,0,1,0,drop
55452,445,0,0,70,70,0,1,0,1,0,drop
56098,64147,0,0,66,66,0,1,0,1,0,deny
53120,25174,0,0,146,146,0,1,0,1,0,deny
57607,21247,0,0,66,66,0,1,0,1,0,deny
13168,35440,0,0,62,62,0,1,0,1,0,deny
50850,445,0,0,66,66,0,1,0,1,0,drop
50848,445,0,0,66,66,0,1,0,1,0,drop
50847,445,0,0,66,66,0,1,0,1,0,drop
58463,11392,0,0,66,66,0,1,0,1,0,deny
22981,15503,0,0,62,62,0,1,0,1,0,deny
0,0,0,0,98,98,0,1,0,1,0,deny
0,0,0,0,98,98,0,1,0,1,0,deny
0,0,0,0,98,98,0,1,0,1,0,deny
0,0,0,0,244,244,0,2,0,2,0,allow
0,0,0,0,98,98,0,1,0,1,0,deny
0,0,0,0,82,82,0,1,0,1,0,deny
0,0,0,0,98,98,0,1,0,1,0,deny
0,0,0,0,98,98,0,1,0,1,0,deny
62971,44847,0,0,62,62,0,1,0,1,0,deny
443,9863,0,0,60,60,0,1,0,1,0,deny
55448,445,0,0,70,70,0,1,0,1,0,drop
48706,23393,0,0,60,60,0,1,0,1,0,deny
32983,51221,0,0,66,66,0,1,0,1,0,deny
443,48056,0,0,135,135,0,1,0,1,0,deny
55043,57470,0,0,78,78,0,1,0,1,0,deny
55443,445,0,0,70,70,0,1,0,1,0,drop
55441,445,0,0,70,70,0,1,0,1,0,drop
55440,445,0,0,70,70,0,1,0,1,0,drop
50761,445,0,0,70,70,0,1,0,1,0,drop
5223,32965,0,0,220,220,0,1,0,1,0,deny
23031,22114,0,0,146,146,0,1,0,1,0,deny
53544,21247,0,0,66,66,0,1,0,1,0,deny
58758,22114,0,0,66,66,0,1,0,1,0,deny
26821,57866,0,0,62,62,0,1,0,1,0,deny
38565,51505,0,0,62,62,0,1,0,1,0,deny
50758,445,0,0,70,70,0,1,0,1,0,drop
45064,25174,0,0,62,62,0,1,0,1,0,deny
57793,37807,0,0,66,66,0,1,0,1,0,deny
1730,37965,0,0,145,145,0,1,0,1,0,deny
54131,57866,0,0,66,66,0,1,0,1,0,deny
57779,22114,0,0,146,146,0,1,0,1,0,deny
55430,445,0,0,70,70,0,1,0,1,0,drop
55427,445,0,0,70,70,0,1,0,1,0,drop
55423,445,0,0,70,70,0,1,0,1,0,drop
50754,445,0,0,70,70,0,1,0,1,0,drop
43571,26467,0,0,62,62,0,1,0,1,0,deny
58861,26467,0,0,66,66,0,1,0,1,0,deny
50752,445,0,0,70,70,0,1,0,1,0,drop
993,58185,0,0,129,129,0,1,0,1,0,deny
50837,445,0,0,66,66,0,1,0,1,0,drop
50750,445,0,0,70,70,0,1,0,1,0,drop
10467,25174,0,0,146,146,0,1,0,1,0,deny
7105,25174,0,0,66,66,0,1,0,1,0,deny
10430,22114,0,0,146,146,0,1,0,1,0,deny
18986,44847,0,0,66,66,0,1,0,1,0,deny
63765,51221,0,0,62,62,0,1,0,1,0,deny
39393,22114,0,0,62,62,0,1,0,1,0,deny
443,45788,0,0,332,332,0,1,0,1,0,deny
61637,25174,0,0,66,66,0,1,0,1,0,deny
55422,445,0,0,70,70,0,1,0,1,0,drop
64431,53,52524,53,170,87,83,2,31,1,1,allow
40932,8434,40932,8434,156,156,0,3,8,3,0,allow
49564,443,50036,443,180388,3938,176450,145,161,20,125,allow
64715,53,13561,53,770,102,668,2,30,1,1,allow
53276,80,53276,80,42664,1998,40666,53,27,20,33,allow
36712,53,0,0,138,69,69,2,30,1,1,allow
57171,3389,57171,3389,3428,1714,1714,16,33,8,8,allow
26249,7000,26249,7000,2269,815,1454,14,16,7,7,allow
49484,7000,49484,7000,2958,1567,1391,15,15,8,7,allow
51432,80,51432,80,42247,4067,38180,58,25,23,35,allow
64113,22211,60375,22211,312,132,180,6,7,3,3,allow
52274,443,52274,443,6679,2408,4271,23,20,10,13,allow
61443,443,44561,443,7832,1143,6689,19,26,9,10,allow
56807,443,49269,443,8020,2000,6020,20,16,11,9,allow
45315,80,28283,80,6087687,127446,5960241,5920,28,1981,3939,allow
62333,443,8530,443,4019,2219,1800,33,186,17,16,allow
38400,53,0,0,82,82,0,1,30,1,0,allow
56659,53,59706,53,711,87,624,2,30,1,1,allow
63738,443,63738,443,4349,1442,2907,19,27,11,8,allow
57424,53,35431,53,711,87,624,2,30,1,1,allow
56809,443,9000,443,7929,1909,6020,20,15,11,9,allow
56808,443,31717,443,7981,1961,6020,20,15,11,9,allow
49483,7000,49483,7000,755531,16955,738576,785,16,265,520,allow
8416,8416,61571,8416,66,66,0,1,30,1,0,allow
56838,53,49360,53,170,87,83,2,30,1,1,allow
57436,53,43639,53,733,85,648,2,30,1,1,allow
52246,52840,54967,52840,258,70,188,4,9,2,2,allow
56343,53,26546,53,170,87,83,2,30,1,1,allow
8415,8415,47085,8415,66,66,0,1,30,1,0,allow
52025,80,59666,80,87927,9680,78247,101,37,40,61,allow
52280,443,52280,443,1615,941,674,15,20,7,8,allow
17052,53,17052,53,235,90,145,2,32,1,1,allow
56275,53,11893,53,170,87,83,2,30,1,1,allow
41774,53,0,0,82,82,0,1,30,1,0,allow
8414,8414,6179,8414,66,66,0,1,30,1,0,allow
50190,53,51481,53,754,94,660,2,30,1,1,allow
55650,53,47564,53,174,89,85,2,30,1,1,allow
55797,53,58319,53,170,87,83,2,31,1,1,allow
50972,3544,45034,3544,258,107,151,2,31,1,1,allow
51443,53,51443,53,217,87,130,2,31,1,1,allow
55325,53,64305,53,711,87,624,2,31,1,1,allow
56663,53,34654,53,178,91,87,2,31,1,1,allow
56882,53,4292,53,87,87,0,2,61,2,0,allow
6881,64422,29110,64422,219,111,108,2,1201,1,1,allow
65284,53,18214,53,758,96,662,2,31,1,1,allow
26458,44847,0,0,146,146,0,1,0,1,0,deny
55420,445,0,0,70,70,0,1,0,1,0,drop
23383,64147,0,0,62,62,0,1,0,1,0,deny
50415,64147,0,0,66,66,0,1,0,1,0,deny
50743,445,0,0,70,70,0,1,0,1,0,drop
26906,22114,0,0,62,62,0,1,0,1,0,deny
65507,53,7082,53,229,102,127,2,30,1,1,allow
50822,443,34134,443,89322,8569,80753,102,316,31,71,allow
53197,80,29002,80,748,459,289,8,254,5,3,allow
53195,443,44058,443,2016,1160,856,17,46,9,8,allow
50183,443,52770,443,6348,1071,5277,18,42,10,8,allow
56841,53,54383,53,177,94,83,2,29,1,1,allow
50253,53,52044,53,167,86,81,2,29,1,1,allow
56838,53,18546,53,177,94,83,2,29,1,1,allow
64431,53,6973,53,177,94,83,2,30,1,1,allow
39636,80,39636,80,4774,553,4221,13,20,6,7,allow
62069,443,28586,443,38455,5252,33203,71,60,41,30,allow
51263,443,47905,443,143597,6963,136634,206,439,103,103,allow
55650,53,39411,53,179,94,85,2,29,1,1,allow
38280,80,34023,80,748,459,289,8,254,5,3,allow
50170,53,38281,53,260,86,174,2,29,1,1,allow
56755,443,63082,443,1327,918,409,10,26,6,4,allow
42441,123,34753,123,184,94,90,2,30,1,1,allow
50744,443,51827,443,6811,1923,4888,21,15,11,10,allow
56838,53,39774,53,177,94,83,2,30,1,1,allow
55590,53,49633,53,177,94,83,2,29,1,1,allow
50078,53,55714,53,177,94,83,2,29,1,1,allow
60017,443,62960,443,5291,2624,2667,28,145,15,13,allow
48783,53,0,0,86,86,0,1,30,1,0,allow
56285,443,32543,443,185763,7360,178403,201,120,68,133,allow
37786,443,52361,443,5544,2626,2918,28,145,15,13,allow
40074,443,9837,443,412322,17503,394819,466,140,167,299,allow
64431,53,36891,53,177,94,83,2,30,1,1,allow
51982,80,16574,80,2776,2091,685,9,47,5,4,allow
57038,53,18909,53,194,102,92,2,33,1,1,allow
45315,443,19700,443,56118,3429,52689,77,26,35,42,allow
50187,443,52959,443,6363,1073,5290,18,38,10,8,allow
50186,443,57350,443,6363,1073,5290,18,38,10,8,allow
61361,443,58250,443,7653,1226,6427,24,18,14,10,allow
52053,80,43263,80,27839,14036,13803,46,36,24,22,allow
56092,53,34391,53,177,94,83,2,30,1,1,allow
55594,53,43491,53,167,86,81,2,30,1,1,allow
56343,53,46504,53,177,94,83,2,30,1,1,allow
51684,80,23150,80,1515,481,1034,11,15,6,5,allow
55059,443,19056,443,32852,17447,15405,61,64,32,29,allow
50188,443,57063,443,6357,1079,5278,18,32,10,8,allow
50185,443,5992,443,6350,1071,5279,18,42,10,8,allow
50184,443,37537,443,6349,1071,5278,18,42,10,8,allow
35519,80,60080,80,841,715,126,5,15,3,2,allow
46587,443,46587,443,30701,1538,29163,40,16,14,26,allow
58589,80,4699,80,1360,900,460,10,515,6,4,allow
36535,443,34984,443,3319,2176,1143,21,15,11,10,allow
61362,443,23026,443,7653,1226,6427,24,18,14,10,allow
42117,443,44867,443,9999,4008,5991,33,345,18,15,allow
61364,443,17656,443,7653,1226,6427,24,18,14,10,allow
53168,23074,22420,23074,958,454,504,14,21,8,6,allow
56092,53,54654,53,177,94,83,2,30,1,1,allow
55915,53,47313,53,86,86,0,1,30,1,0,allow
55226,443,25011,443,711879,19394,692485,724,98,238,486,allow
65330,53,32414,53,733,94,639,2,30,1,1,allow
56343,53,54537,53,177,94,83,2,30,1,1,allow
55867,53,45353,53,178,94,84,2,30,1,1,allow
55963,53,19959,53,316,94,222,2,30,1,1,allow
57038,53,31637,53,194,102,92,2,30,1,1,allow
65520,53,2299,53,379,94,285,2,30,1,1,allow
64439,53,36419,53,359,134,225,2,30,1,1,allow
50698,5900,50698,5900,130,66,64,2,5,1,1,allow
8204,53,48850,53,86,86,0,1,30,1,0,allow
60376,443,40016,443,6608,1843,4765,44,120,23,21,allow
52101,443,56883,443,5706850,104758,5602092,5170,41,1379,3791,allow
60407,443,48240,443,308771,8699,300072,322,30,112,210,allow
56757,443,47194,443,6205,986,5219,16,25,10,6,allow
44250,443,49251,443,3374,2106,1268,19,15,10,9,allow
33119,80,62481,80,1638,1324,314,10,14,5,5,allow
32895,443,18670,443,76969,3534,73435,97,34,40,57,allow
53169,44707,23330,44707,1078,518,560,16,21,9,7,allow
53975,40978,50066,40978,1946,1019,927,10,15,6,4,allow
51120,587,51120,587,320,128,192,6,6,3,3,allow
43129,443,48108,443,4579,580,3999,13,22,5,8,allow
64996,53,37849,53,547,91,456,4,35,2,2,allow
52609,18081,52609,18081,66,66,0,1,5,1,0,allow
49250,80,27382,80,1623,629,994,8,75,5,3,allow
51324,465,51324,465,320,128,192,6,5,3,3,allow
50406,443,46416,443,6470,897,5573,24,55,9,15,allow
49485,7080,49485,7080,2960,432,2528,11,15,6,5,allow
50182,443,53780,443,6349,1071,5278,18,42,10,8,allow
52195,443,42007,443,3470,1776,1694,20,48,10,10,allow
55729,63805,38910,63805,70,70,0,2,8,2,0,allow
50181,443,22681,443,6350,1071,5279,18,42,10,8,allow
56407,53,58288,53,216,102,114,2,29,1,1,allow
33539,443,27903,443,3244,2042,1202,17,16,9,8,allow
56275,53,62167,53,177,94,83,2,29,1,1,allow
58174,443,55907,443,11141,2777,8364,33,58,14,19,allow
50078,53,19314,53,185,102,83,2,29,1,1,allow
55329,443,60850,443,18284,2468,15816,42,26,22,20,allow
49778,53,15143,53,255,102,153,2,29,1,1,allow
64067,53,52701,53,329,94,235,2,29,1,1,allow
59343,80,59343,80,32527,13068,19459,56,15,21,35,allow
49674,53,9150,53,211,102,109,2,29,1,1,allow
56343,53,52506,53,177,94,83,2,29,1,1,allow
61363,443,19587,443,7653,1226,6427,24,18,14,10,allow
61360,443,42103,443,7653,1226,6427,24,18,14,10,allow
26900,27017,38585,27017,6466,3520,2946,38,46,21,17,allow
49458,53,15275,53,280,94,186,2,30,1,1,allow
55745,443,5170,443,11503,3691,7812,30,240,14,16,allow
49364,53,17404,53,307,307,0,4,60,4,0,allow
59847,443,26253,443,11950,1590,10360,33,90,16,17,allow
55836,53,33356,53,177,94,83,2,30,1,1,allow
60590,443,17721,443,41114,1554,39560,49,120,18,31,allow
52100,80,3260,80,30068,3203,26865,43,35,19,24,allow
55732,45682,36442,45682,70,70,0,2,8,2,0,allow
49201,80,60094,80,2986,825,2161,10,135,6,4,allow
56492,53,4383,53,212,102,110,2,30,1,1,allow
34750,80,47643,80,111678,5254,106424,150,240,71,79,allow
50180,443,51713,443,6349,1071,5278,18,42,10,8,allow
55542,443,51637,443,58975,3359,55616,78,26,34,44,allow
56905,80,13949,80,78,78,0,2,8,2,0,allow
55731,36432,38455,36432,70,70,0,2,8,2,0,allow
37335,443,14228,443,130,70,60,3,5,2,1,allow
54104,443,3216,443,190,70,120,4,15,2,2,allow
56838,53,31421,53,327,87,240,4,50,2,2,allow
64709,53,11434,53,821,102,719,2,30,1,1,allow
55154,443,34870,443,2251,1098,1153,25,120,12,13,allow
50179,443,33699,443,5419,1080,4339,17,42,10,7,allow
62232,80,47630,80,1511,517,994,8,15,5,3,allow
62918,993,34205,993,8324,3635,4689,76,53,35,41,allow
9521,443,4635,443,7231,1442,5789,21,30,10,11,allow
52107,80,35011,80,9902,8772,1130,18,35,10,8,allow
55594,53,22728,53,167,86,81,2,30,1,1,allow
55066,443,25317,443,12715,3716,8999,28,62,16,12,allow
56515,53,36823,53,177,94,83,2,30,1,1,allow
49988,443,49988,443,2123,1050,1073,23,120,11,12,allow
55420,53,38783,53,177,94,83,2,30,1,1,allow
55053,53,47870,53,216,102,114,2,30,1,1,allow
55867,53,60176,53,178,94,84,2,31,1,1,allow
50641,443,27533,443,1473,890,583,13,140,7,6,allow
43199,5228,42030,5228,10588,2455,8133,46,5724,19,27,allow
56431,53,28557,53,177,94,83,2,31,1,1,allow
56586,53,32780,53,177,94,83,2,31,1,1,allow
64796,53,3205,53,184,94,90,2,31,1,1,allow
64431,53,35945,53,177,94,83,2,31,1,1,allow
64124,443,56676,443,1411,852,559,13,25,7,6,allow
55869,53,8327,53,196,102,94,2,31,1,1,allow
53251,53,53251,53,247,98,149,2,34,1,1,allow
31994,53,31994,53,244,98,146,2,33,1,1,allow
2099,53,2099,53,217,82,135,2,33,1,1,allow
49857,53,15096,53,173,94,79,2,30,1,1,allow
57840,53,57840,53,183,82,101,2,30,1,1,allow
55869,53,64090,53,196,102,94,2,30,1,1,allow
49396,53,60623,53,216,102,114,2,30,1,1,allow
55732,53,29178,53,177,94,83,2,30,1,1,allow
55797,53,36305,53,177,94,83,2,31,1,1,allow
34920,53,40562,53,168,78,90,2,31,1,1,allow
65289,53,7871,53,179,94,85,2,31,1,1,allow
56906,53,55216,53,167,86,81,2,31,1,1,allow
50741,445,0,0,70,70,0,1,0,1,0,drop
50821,445,0,0,66,66,0,1,0,1,0,drop
50818,445,0,0,66,66,0,1,0,1,0,drop
50740,445,0,0,70,70,0,1,0,1,0,drop
17408,8497,0,0,148,148,0,1,0,1,0,deny
57015,25174,0,0,66,66,0,1,0,1,0,deny
50739,445,0,0,70,70,0,1,0,1,0,drop
50738,445,0,0,70,70,0,1,0,1,0,drop
50735,445,0,0,70,70,0,1,0,1,0,drop
50732,445,0,0,70,70,0,1,0,1,0,drop
17002,22114,0,0,62,62,0,1,0,1,0,deny
63677,15503,0,0,66,66,0,1,0,1,0,deny
63508,62413,0,0,66,66,0,1,0,1,0,deny
55409,445,0,0,70,70,0,1,0,1,0,drop
55408,445,0,0,70,70,0,1,0,1,0,drop
55404,445,0,0,70,70,0,1,0,1,0,drop
55402,445,0,0,70,70,0,1,0,1,0,drop
10833,23,0,0,60,60,0,1,0,1,0,deny
50816,445,0,0,66,66,0,1,0,1,0,drop
56679,51505,0,0,62,62,0,1,0,1,0,deny
12645,22114,0,0,146,146,0,1,0,1,0,deny
50720,445,0,0,70,70,0,1,0,1,0,drop
50719,445,0,0,70,70,0,1,0,1,0,drop
18771,35440,0,0,62,62,0,1,0,1,0,deny
50717,445,0,0,70,70,0,1,0,1,0,drop
3976,25174,0,0,62,62,0,1,0,1,0,deny
50809,445,0,0,66,66,0,1,0,1,0,drop
50799,445,0,0,66,66,0,1,0,1,0,drop
50807,445,0,0,66,66,0,1,0,1,0,drop
50800,445,0,0,66,66,0,1,0,1,0,drop
50803,445,0,0,66,66,0,1,0,1,0,drop
50808,445,0,0,66,66,0,1,0,1,0,drop
50801,445,0,0,66,66,0,1,0,1,0,drop
50709,445,0,0,70,70,0,1,0,1,0,drop
50710,445,0,0,70,70,0,1,0,1,0,drop
68,67,0,0,346,346,0,1,0,1,0,deny
57297,51221,0,0,66,66,0,1,0,1,0,deny
10874,25174,0,0,62,62,0,1,0,1,0,deny
55395,445,0,0,70,70,0,1,0,1,0,drop
55392,445,0,0,70,70,0,1,0,1,0,drop
55389,445,0,0,70,70,0,1,0,1,0,drop
55388,445,0,0,70,70,0,1,0,1,0,drop
38959,25174,0,0,62,62,0,1,0,1,0,deny
50698,445,0,0,70,70,0,1,0,1,0,drop
1030,35776,0,0,139,139,0,1,0,1,0,deny
62952,35440,0,0,66,66,0,1,0,1,0,deny
55386,445,0,0,70,70,0,1,0,1,0,drop
55385,445,0,0,70,70,0,1,0,1,0,drop
55384,445,0,0,70,70,0,1,0,1,0,drop
50793,445,0,0,66,66,0,1,0,1,0,drop
55379,445,0,0,70,70,0,1,0,1,0,drop
14263,22114,0,0,62,62,0,1,0,1,0,deny
50790,445,0,0,66,66,0,1,0,1,0,drop
17146,57470,0,0,62,62,0,1,0,1,0,deny
1582,56205,0,0,62,62,0,1,0,1,0,deny
50789,445,0,0,66,66,0,1,0,1,0,drop
80,13987,0,0,66,66,0,1,0,1,0,deny
50787,445,0,0,66,66,0,1,0,1,0,drop
50694,445,0,0,70,70,0,1,0,1,0,drop
50786,445,0,0,66,66,0,1,0,1,0,drop
29719,22114,0,0,146,146,0,1,0,1,0,deny
20457,51185,0,0,72,72,0,1,0,1,0,deny
38852,37965,0,0,62,62,0,1,0,1,0,deny
50683,445,0,0,70,70,0,1,0,1,0,drop
50682,445,0,0,70,70,0,1,0,1,0,drop
50684,445,0,0,70,70,0,1,0,1,0,drop
50681,445,0,0,70,70,0,1,0,1,0,drop
55374,445,0,0,70,70,0,1,0,1,0,drop
50677,445,0,0,70,70,0,1,0,1,0,drop
60714,50584,0,0,66,66,0,1,0,1,0,deny
55370,445,0,0,70,70,0,1,0,1,0,drop
55363,445,0,0,70,70,0,1,0,1,0,drop
41213,25174,0,0,62,62,0,1,0,1,0,deny
28579,64147,0,0,62,62,0,1,0,1,0,deny
63988,22114,0,0,66,66,0,1,0,1,0,deny
57643,28189,0,0,60,60,0,1,0,1,0,deny
62080,54532,0,0,60,60,0,1,0,1,0,deny
50775,445,0,0,66,66,0,1,0,1,0,drop
48706,23393,0,0,60,60,0,1,0,1,0,deny
5610,37965,0,0,66,66,0,1,0,1,0,deny
15635,41182,0,0,66,66,0,1,0,1,0,deny
27419,23,0,0,60,60,0,1,0,1,0,deny
59088,57470,0,0,62,62,0,1,0,1,0,deny
59126,57470,0,0,66,66,0,1,0,1,0,deny
60193,53,20927,53,214,85,129,2,0,1,1,allow
54025,53,41690,53,578,286,292,9,0,5,4,allow
50672,445,0,0,70,70,0,1,0,1,0,drop
6796,50584,0,0,62,62,0,1,0,1,0,deny
45013,50584,0,0,62,62,0,1,0,1,0,deny
46760,50584,0,0,146,146,0,1,0,1,0,deny
25565,2216,0,0,60,60,0,1,0,1,0,deny
33912,25174,0,0,62,62,0,1,0,1,0,deny
993,49276,0,0,129,129,0,1,0,1,0,deny
50767,445,0,0,66,66,0,1,0,1,0,drop
29576,37807,0,0,66,66,0,1,0,1,0,deny
55351,445,0,0,70,70,0,1,0,1,0,drop
50594,25174,0,0,66,66,0,1,0,1,0,deny
6712,123,0,0,90,90,0,1,0,1,0,deny
61288,23,0,0,60,60,0,1,0,1,0,deny
443,35385,0,0,161,161,0,1,0,1,0,deny
50664,445,0,0,70,70,0,1,0,1,0,drop
27621,50584,0,0,62,62,0,1,0,1,0,deny
50661,445,0,0,70,70,0,1,0,1,0,drop
50764,445,0,0,66,66,0,1,0,1,0,drop
40394,67,0,0,60,60,0,1,0,1,0,deny
58593,57470,0,0,62,62,0,1,0,1,0,deny
50756,445,0,0,66,66,0,1,0,1,0,drop
50657,445,0,0,70,70,0,1,0,1,0,drop
50656,445,0,0,70,70,0,1,0,1,0,drop
50749,445,0,0,66,66,0,1,0,1,0,drop
50652,445,0,0,70,70,0,1,0,1,0,drop
28139,22114,0,0,62,62,0,1,0,1,0,deny
58440,22114,0,0,146,146,0,1,0,1,0,deny
5683,44847,0,0,66,66,0,1,0,1,0,deny
54051,28793,0,0,66,66,0,1,0,1,0,deny
64333,57470,0,0,78,78,0,1,0,1,0,deny
50650,445,0,0,70,70,0,1,0,1,0,drop
55341,445,0,0,70,70,0,1,0,1,0,drop
55340,445,0,0,70,70,0,1,0,1,0,drop
55339,445,0,0,70,70,0,1,0,1,0,drop
50738,445,0,0,66,66,0,1,0,1,0,drop
50735,445,0,0,66,66,0,1,0,1,0,drop
50741,445,0,0,66,66,0,1,0,1,0,drop
50742,445,0,0,66,66,0,1,0,1,0,drop
50737,445,0,0,66,66,0,1,0,1,0,drop
50740,445,0,0,66,66,0,1,0,1,0,drop
50736,445,0,0,66,66,0,1,0,1,0,drop
50734,445,0,0,66,66,0,1,0,1,0,drop
0,0,0,0,60,60,0,1,0,1,0,deny
0,0,0,0,98,98,0,1,0,1,0,deny
0,0,0,0,60,60,0,1,0,1,0,deny
0,0,0,0,60,60,0,1,0,1,0,deny
11775,25174,0,0,62,62,0,1,0,1,0,deny
64150,22114,0,0,66,66,0,1,0,1,0,deny
37959,3855,0,0,72,72,0,1,0,1,0,deny
51146,23117,0,0,66,66,0,1,0,1,0,deny
50646,445,0,0,70,70,0,1,0,1,0,drop
55043,57470,0,0,78,78,0,1,0,1,0,deny
14360,64147,0,0,62,62,0,1,0,1,0,deny
55427,64147,0,0,66,66,0,1,0,1,0,deny
55338,445,0,0,70,70,0,1,0,1,0,drop
55335,445,0,0,70,70,0,1,0,1,0,drop
55333,445,0,0,70,70,0,1,0,1,0,drop
55321,445,0,0,70,70,0,1,0,1,0,drop
50721,445,0,0,66,66,0,1,0,1,0,drop
50720,445,0,0,66,66,0,1,0,1,0,drop
50719,445,0,0,66,66,0,1,0,1,0,deny
57546,25174,0,0,66,66,0,1,0,1,0,deny
54502,34729,0,0,66,66,0,1,0,1,0,deny
32554,34729,0,0,62,62,0,1,0,1,0,deny
53626,30317,0,0,66,66,0,1,0,1,0,deny
7539,30317,0,0,62,62,0,1,0,1,0,deny
63640,57866,0,0,66,66,0,1,0,1,0,deny
50633,445,0,0,70,70,0,1,0,1,0,drop
55319,445,0,0,70,70,0,1,0,1,0,drop
58836,51505,0,0,66,66,0,1,0,1,0,deny
44710,25174,0,0,62,62,0,1,0,1,0,deny
55317,445,0,0,70,70,0,1,0,1,0,drop
55314,445,0,0,70,70,0,1,0,1,0,drop
55308,445,0,0,70,70,0,1,0,1,0,drop
50052,65008,0,0,60,60,0,1,0,1,0,deny
50630,445,0,0,70,70,0,1,0,1,0,drop
53260,36237,0,0,62,62,0,1,0,1,0,deny
53324,44847,0,0,66,66,0,1,0,1,0,deny
52564,15503,0,0,74,74,0,1,0,1,0,deny
58638,5900,58638,5900,156,62,94,2,10,1,1,allow
50147,443,13714,443,9915,1833,8082,22,46,13,9,allow
55109,53,12323,53,711,87,624,2,30,1,1,allow
23332,80,23332,80,490,264,226,8,26,5,3,allow
58638,5900,58638,5900,156,62,94,2,10,1,1,allow
59342,80,59342,80,107768,4073,103695,177,15,58,119,allow
8411,8411,36899,8411,66,66,0,1,30,1,0,allow
55869,53,59798,53,192,98,94,2,30,1,1,allow
27302,443,50050,443,9046,1414,7632,25,84,10,15,allow
22321,80,22321,80,490,264,226,8,26,5,3,allow
58957,80,23483,80,13330975,109486,13221489,10177,23,1394,8783,allow
56804,443,56989,443,8074,2054,6020,20,15,11,9,allow
55457,443,34189,443,130,70,60,3,5,2,1,allow
56083,53,60591,53,711,87,624,2,30,1,1,allow
56431,53,62997,53,170,87,83,2,30,1,1,allow
56806,443,15010,443,8072,2052,6020,20,15,11,9,allow
61054,53,61054,53,237,91,146,2,33,1,1,allow
54076,53,54076,53,243,94,149,2,32,1,1,allow
6527,53,6527,53,235,90,145,2,32,1,1,allow
52248,9323,44483,9323,210,70,140,4,8,2,2,allow
52270,443,52270,443,1615,941,674,15,20,7,8,allow
55867,53,58666,53,172,88,84,2,30,1,1,allow
56586,53,6320,53,170,87,83,2,30,1,1,allow
54898,443,54771,443,78537,4022,74515,120,386,55,65,allow
50823,443,50823,443,1210,637,573,14,25,7,7,allow
64796,53,48263,53,184,94,90,2,31,1,1,allow
58638,5900,58638,5900,156,62,94,2,10,1,1,allow
9519,443,34920,443,3910,370,3540,16,34,5,11,allow
9522,443,6233,443,6146,709,5437,18,29,8,10,allow
58638,5900,58638,5900,156,62,94,2,10,1,1,allow
52269,443,52269,443,1615,941,674,15,20,7,8,allow
58638,5900,58638,5900,156,62,94,2,10,1,1,allow
56805,443,33799,443,8022,2002,6020,20,15,11,9,allow
58638,5900,58638,5900,156,62,94,2,10,1,1,allow
65359,53,51803,53,731,91,640,2,30,1,1,allow
8413,8413,11663,8413,66,66,0,1,30,1,0,allow
56504,53,4684,53,196,100,96,2,30,1,1,allow
56919,53,26686,53,170,87,83,2,30,1,1,allow
8412,8412,23033,8412,66,66,0,1,30,1,0,allow
55491,443,47772,443,5123,2651,2472,15,123,8,7,allow
49506,53,26702,53,200,102,98,2,31,1,1,allow
65289,53,55084,53,174,89,85,2,31,1,1,allow
64722,53,22432,53,184,94,90,2,31,1,1,allow
50031,53,53719,53,178,91,87,2,31,1,1,allow
59086,53,59086,53,235,90,145,2,32,1,1,allow
50944,443,50944,443,1210,637,573,14,25,7,7,allow
51073,443,51073,443,1210,637,573,14,25,7,7,allow
64103,38976,24644,38976,66,66,0,2,8,2,0,allow
64105,6363,30786,6363,66,66,0,2,8,2,0,allow
40175,53,40175,53,235,90,145,2,32,1,1,allow
53976,52534,6002,52534,70,70,0,1,5,1,0,allow
28236,53,28236,53,235,90,145,2,32,1,1,allow
58638,5900,58638,5900,156,62,94,2,10,1,1,allow
64729,80,64729,80,40906,1105,39801,45,142,13,32,allow
9516,443,9863,443,3909,369,3540,16,35,5,11,allow
56733,53,47115,53,187,98,89,3,52,2,1,allow
37350,53,37350,53,213,87,126,2,30,1,1,allow
38104,443,51062,443,8884,4067,4817,24,19,11,13,allow
58254,80,49705,80,1151,711,440,10,15,5,5,allow
62160,53,62160,53,205,81,124,2,30,1,1,allow
5588,5588,0,0,3354,1792,1562,46,194,23,23,allow
55735,53,59032,53,256,93,163,2,30,1,1,allow
64171,53,19883,53,174,89,85,2,30,1,1,allow
53338,53,53532,53,168,78,90,2,30,1,1,allow
56262,53,64499,53,170,87,83,2,31,1,1,allow
56906,53,50869,53,166,85,81,2,31,1,1,allow
56322,53,0,0,166,73,93,2,31,1,1,allow
37965,56605,48626,56605,847,152,695,4,1201,2,2,allow
62825,443,8189,443,17772,2595,15177,25,122,12,13,allow
57033,53,60387,53,754,94,660,2,31,1,1,allow
56720,53,57762,53,916,86,830,2,31,1,1,allow
49321,53,16825,53,184,94,90,2,31,1,1,allow
27677,22114,0,0,146,146,0,1,0,1,0,deny
50547,22197,0,0,66,66,0,1,0,1,0,deny
51052,50584,0,0,66,66,0,1,0,1,0,deny
58230,64147,0,0,66,66,0,1,0,1,0,deny
30456,36237,0,0,62,62,0,1,0,1,0,deny
50625,445,0,0,70,70,0,1,0,1,0,drop
50624,445,0,0,70,70,0,1,0,1,0,drop
45269,50584,0,0,62,62,0,1,0,1,0,deny
55300,445,0,0,70,70,0,1,0,1,0,drop
55295,445,0,0,70,70,0,1,0,1,0,drop
35207,22114,0,0,62,62,0,1,0,1,0,deny
50622,445,0,0,70,70,0,1,0,1,0,drop
53127,443,41153,443,13914,7812,6102,52,69,28,24,allow
46568,443,33630,443,6407,984,5423,21,360,11,10,allow
42356,443,3759,443,276,70,206,5,26,2,3,allow
43900,443,13168,443,442,250,192,8,25,5,3,allow
56479,443,37707,443,3041,1995,1046,17,16,8,9,allow
52047,80,55413,80,27784,13980,13804,44,35,22,22,allow
53957,29970,1762,29970,552,366,186,9,17,6,3,allow
53951,80,8930,80,78,78,0,2,7,2,0,allow
38602,80,59364,80,2586,832,1754,14,16,7,7,allow
57410,443,21541,443,7435,2697,4738,23,30,13,10,allow
51136,443,51136,443,1210,637,573,14,25,7,7,allow
65131,53,28562,53,443,98,345,4,57,2,2,allow
4782,443,2792,443,1191,692,499,12,39,7,5,allow
49670,443,5760,443,886,541,345,11,15,6,5,allow
64082,43786,41878,43786,504,382,122,8,14,6,2,allow
21944,53,21944,53,217,82,135,2,32,1,1,allow
65053,53,65053,53,235,90,145,2,31,1,1,allow
53979,26308,29256,26308,70,70,0,1,4,1,0,allow
49188,53,58733,53,621,111,510,4,35,2,2,allow
52272,443,52272,443,1615,941,674,15,20,7,8,allow
39994,80,41282,80,2387,930,1457,14,16,7,7,allow
56515,53,8193,53,177,94,83,2,29,1,1,allow
57448,53,27842,53,177,94,83,2,29,1,1,allow
56906,53,48411,53,167,86,81,2,29,1,1,allow
50063,53,17752,53,173,94,79,2,29,1,1,allow
55650,53,4298,53,179,94,85,2,29,1,1,allow
61119,53,61119,53,217,90,127,2,29,1,1,allow
50063,53,53923,53,173,94,79,2,30,1,1,allow
55732,53,41995,53,177,94,83,2,29,1,1,allow
56176,53,13645,53,177,94,83,2,30,1,1,allow
51606,443,25122,443,5188,1096,4092,21,95,12,9,allow
48285,8080,0,0,184,78,106,3,10,2,1,allow
58638,5900,58638,5900,160,66,94,2,9,1,1,allow
62910,993,51747,993,9108,4045,5063,84,72,39,45,allow
63954,53,6162,53,289,102,187,2,30,1,1,allow
57152,53,57152,53,241,98,143,2,30,1,1,allow
49481,53,5935,53,232,102,130,2,30,1,1,allow
55061,443,38247,443,18682,8068,10614,42,62,22,20,allow
49482,7000,49482,7000,3098,1611,1487,16,15,9,7,allow
49364,443,26461,443,8376,2198,6178,25,81,14,11,allow
50972,3544,40157,3544,409,107,302,4,30,2,2,allow
56504,53,22416,53,198,102,96,2,33,1,1,allow
57035,80,15633,80,953,524,429,11,256,6,5,allow
51605,443,55829,443,8095,3030,5065,27,95,14,13,allow
65094,53,59382,53,630,204,426,6,64,3,3,allow
39892,443,8583,443,2186,1319,867,23,20,13,10,allow
51252,443,8705,443,9600,4628,4972,41,16,24,17,allow
64051,53,63556,53,275,102,173,2,30,1,1,allow
49837,53,3661,53,183,102,81,2,30,1,1,allow
65028,53,37363,53,79,79,0,2,33,2,0,allow
61544,53,18551,53,325,86,239,2,30,1,1,allow
64876,53,58020,53,737,94,643,2,30,1,1,allow
53500,443,64344,443,558,210,348,9,29,4,5,allow
64722,53,7575,53,184,94,90,2,30,1,1,allow
56262,53,63670,53,177,94,83,2,30,1,1,allow
45608,443,58506,443,8487,2231,6256,26,350,12,14,allow
56563,53,53188,53,292,126,166,2,30,1,1,allow
50031,53,15521,53,181,94,87,2,30,1,1,allow
64122,443,27502,443,5121090,119252,5001838,5000,55,1680,3320,allow
56431,53,59476,53,177,94,83,2,30,1,1,allow
21526,53,21526,53,230,90,140,2,30,1,1,allow
64796,53,58063,53,184,94,90,2,30,1,1,allow
49340,53,57846,53,387,134,253,2,30,1,1,allow
44839,443,42515,443,308,84,224,4,120,2,2,allow
40401,80,34965,80,1603,1179,424,10,124,6,4,allow
38135,80,24108,80,111328,4904,106424,145,240,66,79,allow
51377,443,25439,443,2838,944,1894,12,135,7,5,allow
57176,53,43366,53,178,94,84,2,30,1,1,allow
58991,443,64156,443,972647,20727,951920,916,263,245,671,allow
28441,23,28441,23,152,66,86,2,7,1,1,allow
60506,56243,34455,56243,70,70,0,2,8,2,0,allow
52569,80,52569,80,93783,3885,89898,105,167,37,68,allow
54388,53,31456,53,168,78,90,2,30,1,1,allow
64371,443,25379,443,5925,3462,2463,13,120,7,6,allow
51704,443,61850,443,7117,619,6498,19,34,6,13,allow
58975,80,4684,80,214,140,74,4,15,3,1,allow
53956,41578,43631,41578,492,306,186,8,17,5,3,allow
51251,443,24124,443,7950,2502,5448,38,16,22,16,allow
58855,80,59829,80,1601,902,699,8,387,5,3,allow
46201,443,55008,443,16666,4851,11815,58,150,27,31,allow
41249,443,56931,443,2080,1126,954,17,150,10,7,allow
59912,53,38804,53,168,78,90,2,30,1,1,allow
64926,53,0,0,371,77,294,2,30,1,1,allow
64171,53,47261,53,179,94,85,2,30,1,1,allow
46567,443,52746,443,6407,984,5423,21,360,11,10,allow
17750,6992,50842,6992,150,150,0,1,1200,1,0,allow
41325,443,55609,443,6015,4418,1597,38,246,22,16,allow
57356,443,8609,443,7644,3087,4557,26,46,15,11,allow
54030,443,52354,443,249900,26024,223876,450,167,183,267,allow
47152,443,10144,443,11278,2044,9234,32,178,17,15,allow
58856,443,60071,443,2694,1614,1080,14,386,8,6,allow
49224,53,4375,53,199,102,97,2,32,1,1,allow
52218,62004,11964,62004,136,136,0,3,12,3,0,allow
34331,443,11872,443,120,60,60,3,4,2,1,allow
43026,443,33561,443,138,78,60,2,4,1,1,allow
58638,5900,58638,5900,160,66,94,2,9,1,1,allow
58638,5900,58638,5900,160,66,94,2,9,1,1,allow
32515,443,32515,443,34885,6636,28249,74,51,38,36,allow
46822,3389,46822,3389,3457,1568,1889,17,21,10,7,allow
55867,53,49859,53,178,94,84,2,29,1,1,allow
36873,80,37820,80,1115,534,581,12,16,7,5,allow
60502,61473,62296,61473,1628,1037,591,14,16,8,6,allow
56919,53,21784,53,177,94,83,2,29,1,1,allow
50388,53,43330,53,94,94,0,1,29,1,0,allow
55797,53,20315,53,177,94,83,2,29,1,1,allow
56269,53,56636,53,326,126,200,2,30,1,1,allow
43830,443,46012,443,2257,461,1796,9,39,4,5,allow
55420,53,27651,53,177,94,83,2,29,1,1,allow
65290,53,22798,53,181,94,87,2,29,1,1,allow
40204,40017,36316,40017,156,94,62,2,30,1,1,allow
49506,53,12143,53,200,102,98,2,30,1,1,allow
65229,53,65530,53,443,182,261,6,30,3,3,allow
49837,53,9778,53,167,86,81,2,30,1,1,allow
65239,53,57855,53,489,185,304,6,73,3,3,allow
56586,53,54269,53,177,94,83,2,30,1,1,allow
64376,53,21911,53,210,94,116,2,30,1,1,allow
57448,53,10658,53,177,94,83,2,29,1,1,allow
56037,53,8318,53,246,102,144,2,30,1,1,allow
55797,53,21762,53,177,94,83,2,30,1,1,allow
56977,53,6420,53,322,102,220,2,30,1,1,allow
65290,53,6842,53,181,94,87,2,29,1,1,allow
49857,53,44627,53,165,86,79,2,29,1,1,allow
56919,53,40423,53,177,94,83,2,29,1,1,allow
56906,53,34993,53,167,86,81,2,31,1,1,allow
56307,53,55446,53,185,102,83,2,31,1,1,allow
56257,53,40578,53,177,94,83,2,31,1,1,allow
55605,53,12415,53,300,88,212,4,51,2,2,allow
49745,53,63902,53,1472,98,1374,4,54,2,2,allow
49603,53,34411,53,326,126,200,2,30,1,1,allow
55025,53,42219,53,183,94,89,2,30,1,1,allow
50031,53,40045,53,181,94,87,2,30,1,1,allow
56322,53,0,0,629,73,556,2,30,1,1,allow
58839,443,35385,443,8595,2118,6477,40,179,22,18,allow
49669,443,57280,443,6911,897,6014,22,28,10,12,allow
44246,5228,57956,5228,19678,4762,14916,98,9851,54,44,allow
62913,993,11946,993,9122,4055,5067,84,67,39,45,allow
45105,443,12616,443,3607,2257,1350,22,19,12,10,allow
33818,53,62977,53,168,78,90,2,30,1,1,allow
56176,53,54476,53,177,94,83,2,30,1,1,allow
55065,443,23726,443,13236,4421,8815,28,61,16,12,allow
64171,53,17588,53,179,94,85,2,30,1,1,allow
46569,443,56973,443,6409,984,5425,21,360,11,10,allow
59685,443,5373,443,2316,1353,963,17,276,9,8,allow
60508,55998,14688,55998,70,70,0,2,8,2,0,allow
52297,80,4278,80,1061,574,487,13,256,7,6,allow
49462,53,10345,53,86,86,0,1,30,1,0,allow
34484,53,27104,53,86,86,0,1,30,1,0,allow
65402,53,33102,53,297,110,187,2,30,1,1,allow
32185,53,63584,53,86,86,0,1,30,1,0,allow
49506,53,23058,53,200,102,98,2,30,1,1,allow
64722,53,27260,53,184,94,90,2,30,1,1,allow
56262,53,55550,53,177,94,83,2,31,1,1,allow
44191,443,19988,443,7151,1943,5208,30,25,17,13,allow
49231,443,44532,443,474745,13542,461203,502,17,189,313,allow
56663,53,10723,53,181,94,87,2,33,1,1,allow
58176,5223,41893,5223,15152,5747,9405,46,56,20,26,allow
53174,41442,13286,41442,70,70,0,1,5,1,0,allow
39538,80,23642,80,2191,1142,1049,21,370,9,12,allow
58974,80,55839,80,214,140,74,4,15,3,1,allow
65522,443,46739,443,399281,11940,387341,412,16,145,267,allow
45545,53,45545,53,178,82,96,2,30,1,1,allow
49293,53,22414,53,811,94,717,2,30,1,1,allow
64511,53,2785,53,305,102,203,2,30,1,1,allow
55025,53,22515,53,183,94,89,2,30,1,1,allow
65289,53,55210,53,179,94,85,2,30,1,1,allow
56919,53,56265,53,177,94,83,2,30,1,1,allow
56431,53,39797,53,177,94,83,2,30,1,1,allow
56572,53,63633,53,177,94,83,2,31,1,1,allow
56262,53,24636,53,177,94,83,2,30,1,1,allow
64917,53,41071,53,194,94,100,2,30,1,1,allow
51442,443,50943,443,15321,3760,11561,56,170,23,33,allow
49321,53,55835,53,184,94,90,2,31,1,1,allow
64370,443,23826,443,2783,692,2091,10,120,5,5,allow
49126,443,33194,443,3800867,77753,3723114,3263,625,478,2785,allow
60774,443,14767,443,29739,1164,28575,40,120,15,25,allow
49591,5228,57295,5228,18548,2772,15776,41,3957,17,24,allow
47963,443,46762,443,8903,3095,5808,31,121,16,15,allow
61445,443,34767,443,97211,3043,94168,109,121,37,72,allow
37142,443,20503,443,17201,10578,6623,57,145,27,30,allow
49160,33586,34033,33586,1377,300,1077,6,1200,3,3,allow
49506,53,52835,53,200,102,98,2,31,1,1,allow
64722,53,18980,53,384,94,290,4,42,2,2,allow
50740,443,2714,443,3108,1730,1378,16,16,9,7,allow
65066,80,65066,80,874843,22526,852317,878,44,304,574,allow
55053,443,17178,443,6906,1283,5623,29,248,14,15,allow
14446,443,21708,443,2616,1470,1146,18,16,8,10,allow
55869,53,49767,53,196,102,94,2,30,1,1,allow
64694,53,22388,53,289,82,207,4,46,2,2,allow
62922,993,33264,993,9484,4222,5262,86,45,40,46,allow
42354,443,60503,443,4181,998,3183,14,27,7,7,allow
59875,443,3172,443,12357,5182,7175,30,108,13,17,allow
54927,443,30686,443,7148,1924,5224,35,364,19,16,allow
42096,80,4456,80,1711,698,1013,14,17,6,8,allow
60503,53425,43534,53425,504,318,186,8,16,5,3,allow
54892,443,40724,443,602278,26008,576270,748,396,317,431,allow
33041,443,60563,443,12375,6777,5598,28,49,13,15,allow
65200,51050,0,0,62,62,0,1,0,1,0,deny
42417,22114,0,0,62,62,0,1,0,1,0,deny
50708,445,0,0,66,66,0,1,0,1,0,drop
55710,5555,0,0,60,60,0,1,0,1,0,deny
18652,64147,0,0,62,62,0,1,0,1,0,deny
11983,57470,0,0,62,62,0,1,0,1,0,deny
39588,25174,0,0,66,66,0,1,0,1,0,deny
443,35385,0,0,161,161,0,1,0,1,0,deny
55294,445,0,0,70,70,0,1,0,1,0,drop
43269,50584,0,0,66,66,0,1,0,1,0,deny
50615,445,0,0,70,70,0,1,0,1,0,drop
30966,44847,0,0,146,146,0,1,0,1,0,deny
61550,5529,0,0,145,145,0,1,0,1,0,deny
55293,445,0,0,70,70,0,1,0,1,0,drop
9518,1,0,0,100,100,0,1,0,1,0,deny
50613,445,0,0,70,70,0,1,0,1,0,drop
51598,56079,0,0,66,66,0,1,0,1,0,deny
47342,36237,0,0,62,62,0,1,0,1,0,deny
60676,57866,0,0,66,66,0,1,0,1,0,deny
50692,445,0,0,66,66,0,1,0,1,0,drop
50691,445,0,0,66,66,0,1,0,1,0,drop
50612,445,0,0,70,70,0,1,0,1,0,drop
26287,56205,0,0,62,62,0,1,0,1,0,deny
50611,445,0,0,70,70,0,1,0,1,0,drop
50610,445,0,0,70,70,0,1,0,1,0,drop
50606,445,0,0,70,70,0,1,0,1,0,drop
50604,445,0,0,70,70,0,1,0,1,0,drop
63421,44847,0,0,66,66,0,1,0,1,0,deny
58365,5900,0,0,60,60,0,1,0,1,0,deny
12909,47807,0,0,148,148,0,1,0,1,0,deny
6881,6881,0,0,62,62,0,1,0,1,0,deny
55283,445,0,0,70,70,0,1,0,1,0,drop
55280,445,0,0,70,70,0,1,0,1,0,drop
55277,445,0,0,70,70,0,1,0,1,0,drop
55275,445,0,0,70,70,0,1,0,1,0,drop
57539,44847,0,0,62,62,0,1,0,1,0,deny
40847,25174,0,0,146,146,0,1,0,1,0,deny
63346,37965,0,0,66,66,0,1,0,1,0,deny
56119,37965,0,0,62,62,0,1,0,1,0,deny
50592,445,0,0,70,70,0,1,0,1,0,drop
62949,37965,0,0,62,62,0,1,0,1,0,deny
43704,37965,0,0,66,66,0,1,0,1,0,deny
50591,445,0,0,70,70,0,1,0,1,0,drop
50689,445,0,0,66,66,0,1,0,1,0,drop
63050,57470,0,0,74,74,0,1,0,1,0,deny
50586,445,0,0,70,70,0,1,0,1,0,drop
50582,445,0,0,70,70,0,1,0,1,0,drop
50581,445,0,0,70,70,0,1,0,1,0,drop
50680,445,0,0,66,66,0,1,0,1,0,drop
50682,445,0,0,66,66,0,1,0,1,0,drop
50671,445,0,0,66,66,0,1,0,1,0,drop
50676,445,0,0,66,66,0,1,0,1,0,drop
50677,445,0,0,66,66,0,1,0,1,0,drop
50674,445,0,0,66,66,0,1,0,1,0,drop
50675,445,0,0,66,66,0,1,0,1,0,drop
55266,445,0,0,70,70,0,1,0,1,0,drop
48706,23393,0,0,60,60,0,1,0,1,0,deny
49786,25174,0,0,66,66,0,1,0,1,0,deny
55264,445,0,0,70,70,0,1,0,1,0,drop
55262,445,0,0,70,70,0,1,0,1,0,drop
55261,445,0,0,70,70,0,1,0,1,0,drop
36005,22,0,0,60,60,0,1,0,1,0,deny
65417,44847,0,0,66,66,0,1,0,1,0,deny
9231,3389,0,0,66,66,0,1,0,1,0,deny
39213,25174,0,0,62,62,0,1,0,1,0,deny
50570,445,0,0,70,70,0,1,0,1,0,drop
59096,8604,0,0,66,66,0,1,0,1,0,deny
57846,57866,0,0,66,66,0,1,0,1,0,deny
443,35385,0,0,66,66,0,1,0,1,0,deny
443,58101,0,0,60,60,0,1,0,1,0,deny
993,51747,0,0,66,66,0,1,0,1,0,deny
55259,445,0,0,70,70,0,1,0,1,0,drop
55256,445,0,0,70,70,0,1,0,1,0,drop
55253,445,0,0,70,70,0,1,0,1,0,drop
63002,22114,0,0,66,66,0,1,0,1,0,deny
50665,445,0,0,66,66,0,1,0,1,0,drop
55251,445,0,0,70,70,0,1,0,1,0,drop
57643,28189,0,0,60,60,0,1,0,1,0,deny
62080,54532,0,0,60,60,0,1,0,1,0,deny
50662,445,0,0,66,66,0,1,0,1,0,drop
50566,445,0,0,70,70,0,1,0,1,0,drop
443,50238,0,0,331,331,0,1,0,1,0,deny
10754,28793,0,0,62,62,0,1,0,1,0,deny
42973,57470,0,0,62,62,0,1,0,1,0,deny
50660,445,0,0,66,66,0,1,0,1,0,drop
50659,445,0,0,66,66,0,1,0,1,0,drop
3945,35440,0,0,66,66,0,1,0,1,0,deny
56428,30317,0,0,66,66,0,1,0,1,0,deny
50658,445,0,0,66,66,0,1,0,1,0,drop
58511,50584,0,0,146,146,0,1,0,1,0,deny
50557,445,0,0,70,70,0,1,0,1,0,drop
50556,445,0,0,70,70,0,1,0,1,0,drop
50555,445,0,0,70,70,0,1,0,1,0,drop
443,44683,0,0,83,83,0,1,0,1,0,deny
50552,445,0,0,70,70,0,1,0,1,0,drop
50550,445,0,0,70,70,0,1,0,1,0,drop
60861,25174,0,0,66,66,0,1,0,1,0,deny
60883,64147,0,0,70,70,0,1,0,1,0,deny
55246,445,0,0,70,70,0,1,0,1,0,drop
993,11946,0,0,66,66,0,1,0,1,0,deny
40772,15503,0,0,74,74,0,1,0,1,0,deny
443,35385,0,0,66,66,0,1,0,1,0,deny
443,35385,0,0,97,97,0,1,0,1,0,deny
443,35385,0,0,130,130,0,1,0,1,0,deny
55240,445,0,0,70,70,0,1,0,1,0,drop
55233,445,0,0,70,70,0,1,0,1,0,drop
47141,50584,0,0,62,62,0,1,0,1,0,deny
5151,50584,0,0,62,62,0,1,0,1,0,deny
50647,445,0,0,66,66,0,1,0,1,0,drop
50544,445,0,0,70,70,0,1,0,1,0,drop
34212,11392,0,0,62,62,0,1,0,1,0,deny
24127,23,0,0,60,60,0,1,0,1,0,deny
50506,10214,0,0,66,66,0,1,0,1,0,deny
45652,10214,0,0,62,62,0,1,0,1,0,deny
35610,37965,0,0,62,62,0,1,0,1,0,deny
57325,37965,0,0,62,62,0,1,0,1,0,deny
50639,445,0,0,66,66,0,1,0,1,0,drop
55223,445,0,0,70,70,0,1,0,1,0,drop
8889,3808,0,0,60,60,0,1,0,1,0,deny
50536,445,0,0,70,70,0,1,0,1,0,drop
55306,53,23236,53,170,87,83,2,0,1,1,allow
993,33264,0,0,66,66,0,1,0,1,0,deny
6666,2001,0,0,60,60,0,1,0,1,0,deny
50535,445,0,0,70,70,0,1,0,1,0,drop
50637,445,0,0,66,66,0,1,0,1,0,drop
61202,35894,0,0,66,66,0,1,0,1,0,deny
1024,35894,0,0,62,62,0,1,0,1,0,deny
13027,64147,0,0,62,62,0,1,0,1,0,deny
50530,445,0,0,70,70,0,1,0,1,0,drop
26424,27189,0,0,66,66,0,1,0,1,0,deny
53466,25174,0,0,146,146,0,1,0,1,0,deny
50528,445,0,0,70,70,0,1,0,1,0,drop
50360,37965,0,0,62,62,0,1,0,1,0,deny
50629,445,0,0,66,66,0,1,0,1,0,drop
6889,55108,0,0,143,143,0,1,0,1,0,deny
3117,37965,0,0,62,62,0,1,0,1,0,deny
50622,445,0,0,66,66,0,1,0,1,0,drop
50524,445,0,0,70,70,0,1,0,1,0,drop
53318,22114,0,0,66,66,0,1,0,1,0,deny
52033,50584,0,0,66,66,0,1,0,1,0,deny
31675,19473,0,0,62,62,0,1,0,1,0,deny
55043,57470,0,0,78,78,0,1,0,1,0,deny
45144,25174,0,0,146,146,0,1,0,1,0,deny
50523,445,0,0,70,70,0,1,0,1,0,drop
60453,22114,0,0,146,146,0,1,0,1,0,deny
20804,64147,0,0,145,145,0,1,0,1,0,deny
55216,445,0,0,70,70,0,1,0,1,0,drop
55212,445,0,0,70,70,0,1,0,1,0,drop
55211,445,0,0,70,70,0,1,0,1,0,drop
49677,25174,0,0,62,62,0,1,0,1,0,deny
55994,22114,0,0,66,66,0,1,0,1,0,deny
50607,445,0,0,66,66,0,1,0,1,0,drop
50614,445,0,0,66,66,0,1,0,1,0,drop
50609,445,0,0,66,66,0,1,0,1,0,drop
50610,445,0,0,66,66,0,1,0,1,0,drop
50613,445,0,0,66,66,0,1,0,1,0,drop
50608,445,0,0,66,66,0,1,0,1,0,drop
50606,445,0,0,66,66,0,1,0,1,0,drop
50612,445,0,0,66,66,0,1,0,1,0,drop
58055,56205,0,0,146,146,0,1,0,1,0,deny
50518,445,0,0,70,70,0,1,0,1,0,drop
45375,1900,0,0,139,139,0,1,0,1,0,deny
19136,64147,0,0,62,62,0,1,0,1,0,deny
63321,37807,0,0,66,66,0,1,0,1,0,deny
46417,22114,0,0,146,146,0,1,0,1,0,deny
41677,57470,0,0,62,62,0,1,0,1,0,deny
30303,56301,0,0,169,169,0,1,0,1,0,deny
49594,22114,0,0,66,66,0,1,0,1,0,deny
50655,26467,0,0,66,66,0,1,0,1,0,deny
2850,64147,0,0,62,62,0,1,0,1,0,deny
48071,25174,0,0,62,62,0,1,0,1,0,deny
6666,62078,0,0,60,60,0,1,0,1,0,deny
55209,445,0,0,70,70,0,1,0,1,0,drop
55204,445,0,0,70,70,0,1,0,1,0,drop
55203,445,0,0,70,70,0,1,0,1,0,drop
55199,445,0,0,70,70,0,1,0,1,0,drop
50594,445,0,0,66,66,0,1,0,1,0,drop
50593,445,0,0,66,66,0,1,0,1,0,drop
50591,445,0,0,66,66,0,1,0,1,0,drop
28875,51505,0,0,62,62,0,1,0,1,0,deny
50505,445,0,0,70,70,0,1,0,1,0,drop
55903,53,1701,53,170,87,83,2,30,1,1,allow
40204,40018,64999,40018,150,88,62,2,30,1,1,allow
52213,56682,55020,56682,66,66,0,1,5,1,0,allow
9515,443,54612,443,318,192,126,6,34,4,2,allow
55115,53,54899,53,758,96,662,2,31,1,1,allow
50687,443,7518,443,1199,618,581,13,29,6,7,allow
49476,7010,49476,7010,4215,2090,2125,15,16,8,7,allow
56803,443,62661,443,8020,2000,6020,20,15,11,9,allow
53971,18810,57788,18810,70,70,0,1,5,1,0,allow
64080,11801,41031,11801,66,66,0,1,5,1,0,allow
49722,443,18328,443,9698,3026,6672,54,618,27,27,allow
64681,53,5691,53,86,86,0,1,60,1,0,allow
56122,53,50294,53,731,91,640,2,30,1,1,allow
39023,443,14196,443,1017,705,312,9,20,4,5,allow
50686,443,4744,443,1199,618,581,13,29,6,7,allow
65130,80,61798,80,2500,531,1969,11,76,6,5,allow
50722,80,21337,80,3235,555,2680,13,20,6,7,allow
53171,11820,1212,11820,698,320,378,10,16,6,4,allow
50730,53,50730,53,228,97,131,2,30,1,1,allow
57047,53,47290,53,1426,98,1328,4,53,2,2,allow
49315,443,55462,443,160961,7302,153659,171,87,49,122,allow
29979,53,29979,53,215,80,135,2,33,1,1,allow
56801,443,16437,443,8022,2002,6020,20,15,11,9,allow
59799,443,59799,443,4666,1759,2907,19,28,11,8,allow
63431,443,3951,443,3182,1568,1614,8,120,4,4,allow
63217,443,63217,443,11907,1406,10501,25,22,11,14,allow
53964,24389,41775,24389,1473,842,631,12,15,7,5,allow
36103,443,46915,443,130,70,60,2,15,1,1,allow
53998,443,53998,443,4613,1706,2907,19,30,11,8,allow
56802,443,7219,443,8072,2052,6020,20,15,11,9,allow
52215,16937,53036,16937,136,136,0,3,12,3,0,allow
53967,54589,61471,54589,70,70,0,1,5,1,0,allow
9511,443,26929,443,318,192,126,6,34,4,2,allow
49477,7000,49477,7000,5910,4455,1455,19,15,11,8,allow
44884,443,1595,443,309,309,0,1,5,1,0,allow
56756,443,1855,443,7565,2187,5378,27,24,15,12,allow
54973,53,61675,53,711,87,624,2,30,1,1,allow
56265,53,18284,53,733,85,648,2,30,1,1,allow
55897,53,23504,53,770,102,668,2,30,1,1,allow
55975,53,49618,53,711,87,624,2,30,1,1,allow
56257,53,60774,53,170,87,83,2,31,1,1,allow
50134,53,40420,53,733,86,647,2,31,1,1,allow
56216,53,5035,53,170,87,83,2,31,1,1,allow
56272,443,56272,443,4550,1643,2907,19,28,11,8,allow
9514,443,6699,443,318,192,126,6,34,4,2,allow
49480,7000,49480,7000,3050,1659,1391,16,15,9,7,allow
46774,53,46774,53,235,90,145,2,33,1,1,allow
41614,5222,29157,5222,768,510,258,9,21,5,4,allow
59442,53,59442,53,235,90,145,2,33,1,1,allow
38698,443,26967,443,628,250,378,11,39,5,6,allow
56476,443,56476,443,4624,1717,2907,19,30,11,8,allow
54939,443,24418,443,13018,3066,9952,65,361,33,32,allow
55370,53,23288,53,711,87,624,2,30,1,1,allow
56800,443,17462,443,8074,2054,6020,20,16,11,9,allow
57176,53,30899,53,172,88,84,2,30,1,1,allow
55219,53,47738,53,91,91,0,1,30,1,0,allow
55806,53,53227,53,200,102,98,2,30,1,1,allow
55564,53,55564,53,215,88,127,2,30,1,1,allow
55349,53,28852,53,744,89,655,2,30,1,1,allow
55224,53,26209,53,711,87,624,2,31,1,1,allow
45205,443,55089,443,7221,3151,4070,20,162,9,11,allow
61077,443,19799,443,4970,2272,2698,12,121,6,6,allow
56255,53,37256,53,701,88,613,2,31,1,1,allow
49762,53,56822,53,184,94,90,2,31,1,1,allow
59513,53,0,0,82,82,0,1,31,1,0,allow
57237,443,44952,443,3283,1030,2253,16,136,8,8,allow
55647,53,53361,53,250,86,164,4,31,2,2,allow
56480,53,53765,53,755,94,661,2,31,1,1,allow
64124,53,26589,53,182,93,89,2,31,1,1,allow
57052,53,31599,53,711,87,624,2,31,1,1,allow
45154,53,45154,53,236,108,128,2,31,1,1,allow
55288,53,47176,53,192,98,94,2,31,1,1,allow
57374,53,45450,53,733,86,647,2,31,1,1,allow
56397,53,29734,53,174,89,85,2,31,1,1,allow
55082,53,13671,53,755,93,662,2,31,1,1,allow
5578,53,5578,53,288,83,205,2,31,1,1,allow
43056,443,9640,443,31297,21354,9943,55,363,28,27,allow
6881,16869,32052,16869,509,150,359,2,1200,1,1,allow
48706,23393,0,0,60,60,0,1,0,1,0,deny
18204,55160,0,0,146,146,0,1,0,1,0,deny
53189,62413,0,0,62,62,0,1,0,1,0,deny
13406,22114,0,0,62,62,0,1,0,1,0,deny
54256,123,0,0,234,234,0,1,0,1,0,deny
52863,50584,0,0,66,66,0,1,0,1,0,deny
55206,22114,0,0,66,66,0,1,0,1,0,deny
2075,19473,0,0,62,62,0,1,0,1,0,deny
55191,445,0,0,70,70,0,1,0,1,0,drop
23846,22114,0,0,146,146,0,1,0,1,0,deny
64878,26467,0,0,62,62,0,1,0,1,0,deny
50367,37965,0,0,66,66,0,1,0,1,0,deny
50502,445,0,0,70,70,0,1,0,1,0,drop
55190,445,0,0,70,70,0,1,0,1,0,drop
55183,445,0,0,70,70,0,1,0,1,0,drop
55180,445,0,0,70,70,0,1,0,1,0,drop
1638,25174,0,0,146,146,0,1,0,1,0,deny
46619,57470,0,0,62,62,0,1,0,1,0,deny
23353,25174,0,0,62,62,0,1,0,1,0,deny
50498,445,0,0,70,70,0,1,0,1,0,drop
9687,35440,0,0,66,66,0,1,0,1,0,deny
48144,21247,0,0,66,66,0,1,0,1,0,deny
50496,445,0,0,70,70,0,1,0,1,0,drop
43260,41615,0,0,145,145,0,1,0,1,0,deny
43260,41615,0,0,145,145,0,1,0,1,0,deny
51827,56205,0,0,66,66,0,1,0,1,0,deny
16425,15503,0,0,62,62,0,1,0,1,0,deny
25565,28739,0,0,60,60,0,1,0,1,0,deny
50494,445,0,0,70,70,0,1,0,1,0,drop
52819,15503,0,0,66,66,0,1,0,1,0,deny
55172,445,0,0,70,70,0,1,0,1,0,drop
30046,15503,0,0,62,62,0,1,0,1,0,deny
55168,445,0,0,70,70,0,1,0,1,0,drop
55167,445,0,0,70,70,0,1,0,1,0,drop
51954,57470,0,0,66,66,0,1,0,1,0,deny
33351,43890,0,0,146,146,0,1,0,1,0,deny
4862,37965,0,0,66,66,0,1,0,1,0,deny
50581,445,0,0,66,66,0,1,0,1,0,drop
7844,22114,0,0,66,66,0,1,0,1,0,deny
34500,23,0,0,60,60,0,1,0,1,0,deny
61701,15503,0,0,62,62,0,1,0,1,0,deny
993,4264,0,0,66,66,0,1,0,1,0,deny
61455,64147,0,0,66,66,0,1,0,1,0,deny
52745,25174,0,0,66,66,0,1,0,1,0,deny
26623,22114,0,0,146,146,0,1,0,1,0,deny
62721,56205,0,0,66,66,0,1,0,1,0,deny
1025,46776,0,0,62,62,0,1,0,1,0,deny
50487,445,0,0,70,70,0,1,0,1,0,drop
57348,25174,0,0,146,146,0,1,0,1,0,deny
24073,22114,0,0,62,62,0,1,0,1,0,deny
59107,25174,0,0,66,66,0,1,0,1,0,deny
55166,445,0,0,70,70,0,1,0,1,0,drop
59549,50584,0,0,66,66,0,1,0,1,0,deny
62183,57470,0,0,74,74,0,1,0,1,0,deny
34993,15503,0,0,62,62,0,1,0,1,0,deny
993,3979,0,0,129,129,0,1,0,1,0,deny
50485,445,0,0,70,70,0,1,0,1,0,drop
31859,33909,0,0,62,62,0,1,0,1,0,deny
55164,445,0,0,70,70,0,1,0,1,0,drop
60428,25174,0,0,66,66,0,1,0,1,0,deny
63190,35440,0,0,62,62,0,1,0,1,0,deny
50484,445,0,0,70,70,0,1,0,1,0,drop
55310,50584,0,0,66,66,0,1,0,1,0,deny
50483,445,0,0,70,70,0,1,0,1,0,drop
50482,445,0,0,70,70,0,1,0,1,0,drop
50476,445,0,0,70,70,0,1,0,1,0,drop
65216,53,28628,53,218,94,124,2,30,1,1,allow
56216,53,58788,53,177,94,83,2,30,1,1,allow
64592,443,64064,443,24682,1935,22747,36,17,17,19,allow
57607,443,42010,443,2614,1689,925,18,20,10,8,allow
37110,53,37110,53,247,98,149,2,33,1,1,allow
50674,80,2786,80,3325,598,2727,12,15,6,6,allow
55066,443,16494,443,39091,9981,29110,93,208,42,51,allow
53972,59089,19075,59089,70,70,0,1,4,1,0,allow
64078,54561,14823,54561,70,70,0,1,4,1,0,allow
56604,3389,56604,3389,3424,1710,1714,16,31,8,8,allow
42355,443,21738,443,4181,998,3183,14,26,7,7,allow
39890,443,4730,443,21106,2445,18661,45,20,24,21,allow
55051,443,30290,443,6975,1243,5732,29,254,14,15,allow
65523,443,11792,443,92518,4869,87649,109,15,44,65,allow
38783,443,19297,443,584,370,214,9,25,6,3,allow
53969,13156,32626,13156,70,70,0,1,4,1,0,allow
55806,53,52811,53,200,102,98,2,33,1,1,allow
53974,26108,47325,26108,70,70,0,1,4,1,0,allow
64079,20233,52835,20233,70,70,0,1,4,1,0,allow
64083,63666,39336,63666,70,70,0,1,4,1,0,allow
53173,25067,40514,25067,70,70,0,1,5,1,0,allow
56586,53,50469,53,177,94,83,2,29,1,1,allow
64618,53,13340,53,410,102,308,2,29,1,1,allow
49787,53,40556,53,258,110,148,2,29,1,1,allow
65289,53,50124,53,564,193,371,6,51,3,3,allow
56439,53,20721,53,177,94,83,2,29,1,1,allow
57176,53,54360,53,178,94,84,2,29,1,1,allow
64365,53,27467,53,341,110,231,2,29,1,1,allow
65511,53,46791,53,214,102,112,2,30,1,1,allow
50175,53,51711,53,819,102,717,2,30,1,1,allow
53461,443,61462,443,52988,3128,49860,67,48,26,41,allow
49344,53,20668,53,458,188,270,6,29,3,3,allow
57176,53,50437,53,178,94,84,2,29,1,1,allow
55339,53,49453,53,194,94,100,2,30,1,1,allow
55903,53,28482,53,177,94,83,2,30,1,1,allow
64009,53,32252,53,209,110,99,2,30,1,1,allow
40204,40003,21367,40003,156,94,62,2,30,1,1,allow
52212,51343,7428,51343,70,70,0,1,5,1,0,allow
49566,443,65424,443,1394,540,854,24,36,10,14,allow
9323,443,4707,443,26959,1764,25195,42,48,18,24,allow
49550,443,28578,443,2338,1407,931,18,200,10,8,allow
56068,53,60568,53,168,94,74,2,30,1,1,allow
14032,53,14032,53,235,90,145,2,32,1,1,allow
53194,443,6156,443,1478,918,560,12,44,6,6,allow
38002,49152,2185,49152,156,156,0,3,8,3,0,allow
9524,443,1427,443,1313,876,437,11,26,6,5,allow
46486,53,46486,53,414,268,146,3,34,2,1,allow
38785,443,33251,443,5206,3832,1374,23,25,13,10,allow
59131,53,59747,53,70,70,0,1,30,1,0,allow
55015,53,27863,53,733,94,639,2,30,1,1,allow
59899,3389,59899,3389,3624,1910,1714,19,32,11,8,allow
56892,53,40383,53,210,102,108,2,30,1,1,allow
61827,5223,22031,5223,10784,5831,4953,33,521,15,18,allow
55561,53,57871,53,313,102,211,2,30,1,1,allow
52111,53162,33838,53162,1330,706,624,10,33,6,4,allow
52124,443,40698,443,78269,5330,72939,127,313,57,70,allow
57284,53,57366,53,165,86,79,2,30,1,1,allow
58877,443,35023,443,183394,7389,176005,219,108,87,132,allow
49103,443,44063,443,6725,505,6220,20,181,5,15,allow
54658,443,29655,443,40096,3155,36941,50,135,19,31,allow
55288,53,5668,53,196,102,94,2,30,1,1,allow
46310,443,45813,443,10106,2096,8010,24,186,13,11,allow
56939,53,41233,53,322,134,188,2,30,1,1,allow
55845,443,55416,443,505207,16025,489182,464,139,97,367,allow
55138,53,34483,53,173,94,79,2,30,1,1,allow
56257,53,40161,53,177,94,83,2,30,1,1,allow
55219,53,51728,53,181,94,87,2,32,1,1,allow
25778,53,25778,53,235,90,145,2,33,1,1,allow
55774,8060,21425,8060,70,70,0,1,5,1,0,allow
52718,53,15399,53,164,78,86,2,30,1,1,allow
49321,53,46028,53,184,94,90,2,30,1,1,allow
56068,53,7794,53,152,78,74,2,30,1,1,allow
55070,53,15674,53,195,94,101,2,30,1,1,allow
40204,40018,24038,40018,566,86,480,2,30,1,1,allow
52214,27480,63759,27480,70,70,0,1,5,1,0,allow
62506,443,7984,443,1326,876,450,11,32,6,5,allow
40689,443,13371,443,4203,1564,2639,26,470,14,12,allow
35921,443,5709,443,5207,1058,4149,21,150,12,9,allow
55903,53,48648,53,177,94,83,2,30,1,1,allow
40204,40031,12730,40031,245,182,63,2,30,1,1,allow
43568,443,63608,443,9445,6593,2852,43,96,25,18,allow
56743,443,40694,443,7789,2275,5514,30,47,16,14,allow
54934,443,9475,443,11700,3386,8314,63,362,33,30,allow
34752,3389,34752,3389,3910,1805,2105,20,18,12,8,allow
49481,7000,49481,7000,3066,1675,1391,16,14,9,7,allow
57382,443,54714,443,5619,927,4692,17,15,10,7,allow
52046,80,15183,80,27904,14100,13804,46,34,24,22,allow
52113,443,33178,443,17710,1892,15818,37,24,17,20,allow
52216,8848,22408,8848,136,136,0,3,11,3,0,allow
14259,53,14259,53,247,98,149,2,33,1,1,allow
53304,80,56632,80,130,64,66,3,4,2,1,allow
60707,80,12418,80,144,78,66,2,5,1,1,allow
64077,20208,51700,20208,70,70,0,1,4,1,0,allow
62923,993,4264,993,9848,4639,5209,83,41,42,41,allow
37636,443,48056,443,9658,2602,7056,32,66,14,18,allow
36542,443,35325,443,31814,26657,5157,52,212,32,20,allow
56904,80,52022,80,25125,2681,22444,36,318,19,17,allow
123,123,26903,123,826,376,450,10,34,5,5,allow
58730,443,58122,443,5110,950,4160,21,48,10,11,allow
57923,443,34874,443,13736,1702,12034,26,15,12,14,allow
49573,443,25314,443,1820,1101,719,18,16,10,8,allow
56572,53,22035,53,177,94,83,2,29,1,1,allow
56307,53,24670,53,185,102,83,2,29,1,1,allow
50175,53,55281,53,196,102,94,2,30,1,1,allow
64425,53,6282,53,182,86,96,2,29,1,1,allow
64588,443,57526,443,9156,2109,7047,27,32,15,12,allow
56439,53,22707,53,177,94,83,2,29,1,1,allow
55795,53,50908,53,177,94,83,2,30,1,1,allow
40204,40035,37692,40035,156,94,62,2,30,1,1,allow
63847,443,1340,443,1786,172,1614,7,120,3,4,allow
64560,53,45431,53,807,94,713,2,30,1,1,allow
56397,53,62027,53,179,94,85,2,30,1,1,allow
64698,53,15508,53,763,102,661,2,30,1,1,allow
56143,53,11476,53,214,94,120,2,30,1,1,allow
36687,53,34461,53,168,78,90,2,31,1,1,allow
48731,443,18575,443,5959,1709,4250,27,1211,15,12,allow
56991,443,28802,443,20986,10828,10158,35,95,20,15,allow
49479,7000,49479,7000,5200,3745,1455,18,15,10,8,allow
62504,443,1666,443,10385,7051,3334,27,33,15,12,allow
56620,53,8741,53,214,102,112,2,30,1,1,allow
54020,443,45905,443,17529,8138,9391,39,31,17,22,allow
55871,53,54072,53,189,102,87,2,30,1,1,allow
55382,53,39381,53,226,110,116,2,30,1,1,allow
38001,49152,63633,49152,156,156,0,3,8,3,0,allow
62505,443,46992,443,14891,3970,10921,32,33,15,17,allow
60991,443,12084,443,15561,8186,7375,44,47,26,18,allow
56594,53,16703,53,167,86,81,2,30,1,1,allow
50031,53,6210,53,181,94,87,2,30,1,1,allow
56216,53,54561,53,177,94,83,2,30,1,1,allow
30434,53,30434,53,197,90,107,2,30,1,1,allow
56594,53,29488,53,167,86,81,2,30,1,1,allow
37052,53,37052,53,178,82,96,2,30,1,1,allow
56746,80,35139,80,876072,26350,849722,935,27,335,600,allow
50826,443,11870,443,6601,1120,5481,17,115,9,8,allow
60992,443,15020,443,3465,2532,933,20,47,12,8,allow
55795,53,49814,53,177,94,83,2,30,1,1,allow
55064,443,12029,443,12611,3681,8930,26,61,15,11,allow
55138,53,34113,53,165,86,79,2,30,1,1,allow
50478,445,0,0,70,70,0,1,0,1,0,drop
50564,445,0,0,66,66,0,1,0,1,0,drop
50562,445,0,0,66,66,0,1,0,1,0,drop
16518,64147,0,0,145,145,0,1,0,1,0,deny
1865,25174,0,0,146,146,0,1,0,1,0,deny
56152,56205,0,0,62,62,0,1,0,1,0,deny
63848,443,19599,443,3182,1568,1614,8,120,4,4,allow
6881,51413,34368,51413,207,118,89,2,1199,1,1,allow
49762,53,16917,53,184,94,90,2,30,1,1,allow
55107,53,13262,53,184,94,90,2,30,1,1,allow
55647,53,13562,53,168,86,82,2,31,1,1,allow
37322,53,64245,53,168,78,90,2,31,1,1,allow
49369,53,12483,53,168,86,82,2,31,1,1,allow
57470,31566,19027,31566,481,150,331,2,1199,1,1,allow
49369,53,65002,53,168,86,82,2,30,1,1,allow
49383,53,39251,53,758,102,656,2,30,1,1,allow
57431,53,3019,53,181,94,87,2,31,1,1,allow
57470,15564,5143,15564,1577,594,983,20,1624,10,10,allow
57169,53,55765,53,458,188,270,6,31,3,3,allow
56397,53,56445,53,179,94,85,2,31,1,1,allow
52245,53652,1791,53652,70,70,0,2,7,2,0,allow
55288,53,4599,53,196,102,94,2,30,1,1,allow
49760,53,59419,53,183,94,89,2,30,1,1,allow
57006,53,15142,53,819,102,717,2,30,1,1,allow
52210,15604,53741,15604,70,70,0,1,5,1,0,allow
62065,443,18237,443,21959,8954,13005,65,63,33,32,allow
49633,53,11968,53,168,86,82,2,30,1,1,allow
49590,53,5842,53,458,188,270,6,30,3,3,allow
55318,53,12855,53,167,86,81,2,30,1,1,allow
56442,53,53594,53,167,86,81,2,30,1,1,allow
19651,53,19651,53,216,90,126,2,30,1,1,allow
49225,80,23885,80,15343,3240,12103,23,81,9,14,allow
57355,443,46923,443,36265,3519,32746,55,46,27,28,allow
57304,53,49312,53,228,110,118,2,31,1,1,allow
55318,53,32183,53,167,86,81,2,31,1,1,allow
49946,443,3936,443,8725,3341,5384,25,136,12,13,allow
58535,30317,0,0,62,62,0,1,0,1,0,deny
54912,64147,0,0,66,66,0,1,0,1,0,deny
27507,25174,0,0,62,62,0,1,0,1,0,deny
25565,27942,0,0,60,60,0,1,0,1,0,deny
55155,445,0,0,70,70,0,1,0,1,0,drop
55154,445,0,0,70,70,0,1,0,1,0,drop
55151,445,0,0,70,70,0,1,0,1,0,drop
55146,445,0,0,70,70,0,1,0,1,0,drop
50464,445,0,0,70,70,0,1,0,1,0,drop
50463,445,0,0,70,70,0,1,0,1,0,drop
64199,50584,0,0,146,146,0,1,0,1,0,deny
50460,445,0,0,70,70,0,1,0,1,0,drop
26420,25174,0,0,66,66,0,1,0,1,0,deny
61583,64147,0,0,66,66,0,1,0,1,0,deny
20112,64147,0,0,62,62,0,1,0,1,0,deny
50453,445,0,0,70,70,0,1,0,1,0,drop
50454,445,0,0,70,70,0,1,0,1,0,drop
50561,445,0,0,66,66,0,1,0,1,0,drop
4328,7302,0,0,66,66,0,1,0,1,0,deny
50553,445,0,0,66,66,0,1,0,1,0,drop
50552,445,0,0,66,66,0,1,0,1,0,drop
50549,445,0,0,66,66,0,1,0,1,0,drop
50548,445,0,0,66,66,0,1,0,1,0,drop
50545,445,0,0,66,66,0,1,0,1,0,drop
50546,445,0,0,66,66,0,1,0,1,0,drop
50543,445,0,0,66,66,0,1,0,1,0,drop
57239,123,0,0,90,90,0,1,0,1,0,deny
52427,42873,0,0,66,66,0,1,0,1,0,deny
55140,445,0,0,70,70,0,1,0,1,0,drop
51348,25174,0,0,66,66,0,1,0,1,0,deny
57643,28189,0,0,60,60,0,1,0,1,0,deny
51550,11392,0,0,66,66,0,1,0,1,0,deny
62080,54532,0,0,60,60,0,1,0,1,0,deny
55136,445,0,0,70,70,0,1,0,1,0,drop
55133,445,0,0,70,70,0,1,0,1,0,drop
55132,445,0,0,70,70,0,1,0,1,0,drop
60248,46776,0,0,66,66,0,1,0,1,0,deny
53730,37965,0,0,66,66,0,1,0,1,0,deny
14717,64147,0,0,66,66,0,1,0,1,0,deny
50442,445,0,0,70,70,0,1,0,1,0,drop
42030,25,0,0,74,74,0,1,0,1,0,deny
2572,17546,0,0,62,62,0,1,0,1,0,deny
30784,30975,0,0,159,159,0,1,0,1,0,deny
55201,26467,0,0,62,62,0,1,0,1,0,deny
8102,57470,0,0,62,62,0,1,0,1,0,deny
18653,42707,0,0,66,66,0,1,0,1,0,deny
3093,62413,0,0,62,62,0,1,0,1,0,deny
42608,1,0,0,62,62,0,1,0,1,0,deny
62744,62413,0,0,66,66,0,1,0,1,0,deny
55130,445,0,0,70,70,0,1,0,1,0,drop
55131,445,0,0,70,70,0,1,0,1,0,drop
55128,445,0,0,70,70,0,1,0,1,0,drop
53194,35440,0,0,66,66,0,1,0,1,0,deny
50438,445,0,0,70,70,0,1,0,1,0,drop
50537,445,0,0,66,66,0,1,0,1,0,drop
55123,445,0,0,70,70,0,1,0,1,0,drop
50535,445,0,0,66,66,0,1,0,1,0,drop
50532,445,0,0,66,66,0,1,0,1,0,drop
50533,445,0,0,66,66,0,1,0,1,0,drop
50427,445,0,0,70,70,0,1,0,1,0,drop
50429,445,0,0,70,70,0,1,0,1,0,drop
50426,445,0,0,70,70,0,1,0,1,0,drop
8734,56205,0,0,66,66,0,1,0,1,0,deny
50530,445,0,0,66,66,0,1,0,1,0,drop
50423,445,0,0,70,70,0,1,0,1,0,drop
58229,50584,0,0,66,66,0,1,0,1,0,deny
40254,25174,0,0,62,62,0,1,0,1,0,deny
50421,445,0,0,70,70,0,1,0,1,0,drop
6546,37965,0,0,62,62,0,1,0,1,0,deny
44207,44847,0,0,62,62,0,1,0,1,0,deny
58799,30188,0,0,62,62,0,1,0,1,0,deny
35760,11392,0,0,146,146,0,1,0,1,0,deny
56182,53,55538,53,762,98,664,2,0,1,1,allow
22029,50584,0,0,66,66,0,1,0,1,0,deny
55118,445,0,0,70,70,0,1,0,1,0,drop
57762,25174,0,0,146,146,0,1,0,1,0,deny
26566,44847,0,0,66,66,0,1,0,1,0,deny
55817,36829,0,0,66,66,0,1,0,1,0,deny
55114,445,0,0,70,70,0,1,0,1,0,drop
55105,445,0,0,70,70,0,1,0,1,0,drop
26629,56079,0,0,62,62,0,1,0,1,0,deny
50415,445,0,0,70,70,0,1,0,1,0,drop
48025,44847,0,0,62,62,0,1,0,1,0,deny
11317,53563,0,0,143,143,0,1,0,1,0,reset-both
50518,445,0,0,66,66,0,1,0,1,0,drop
50408,445,0,0,70,70,0,1,0,1,0,drop
50511,445,0,0,66,66,0,1,0,1,0,drop
50406,445,0,0,70,70,0,1,0,1,0,drop
49380,21247,0,0,66,66,0,1,0,1,0,deny
55666,35440,0,0,60,60,0,1,0,1,0,deny
55095,445,0,0,70,70,0,1,0,1,0,drop
51575,9694,0,0,62,62,0,1,0,1,0,deny
9748,21247,0,0,66,66,0,1,0,1,0,deny
32983,51221,0,0,66,66,0,1,0,1,0,deny
61916,64097,0,0,62,62,0,1,0,1,0,deny
55043,57470,0,0,78,78,0,1,0,1,0,deny
50508,445,0,0,66,66,0,1,0,1,0,drop
58758,22114,0,0,66,66,0,1,0,1,0,deny
50402,445,0,0,70,70,0,1,0,1,0,drop
44079,10387,0,0,145,145,0,1,0,1,0,deny
50400,445,0,0,70,70,0,1,0,1,0,drop
53995,25174,0,0,66,66,0,1,0,1,0,deny
50502,445,0,0,66,66,0,1,0,1,0,drop
53928,15503,0,0,62,62,0,1,0,1,0,deny
50499,445,0,0,66,66,0,1,0,1,0,drop
50396,445,0,0,70,70,0,1,0,1,0,drop
6881,45378,0,0,146,146,0,1,0,1,0,deny
19875,30170,0,0,145,145,0,1,0,1,0,deny
50394,445,0,0,70,70,0,1,0,1,0,drop
44891,23,0,0,60,60,0,1,0,1,0,deny
52336,64097,0,0,62,62,0,1,0,1,0,deny
3730,17372,0,0,62,62,0,1,0,1,0,deny
55088,445,0,0,70,70,0,1,0,1,0,drop
55084,445,0,0,70,70,0,1,0,1,0,drop
55083,445,0,0,70,70,0,1,0,1,0,drop
36685,35440,0,0,62,62,0,1,0,1,0,deny
58453,50584,0,0,66,66,0,1,0,1,0,deny
36933,23117,0,0,62,62,0,1,0,1,0,deny
50485,445,0,0,66,66,0,1,0,1,0,drop
50486,445,0,0,66,66,0,1,0,1,0,drop
50481,445,0,0,66,66,0,1,0,1,0,drop
49828,53,40540,53,578,286,292,9,15,5,4,allow
45316,80,11125,80,3044854,64416,2980438,2968,19,997,1971,allow
53172,56013,23634,56013,70,70,0,1,5,1,0,allow
52247,49278,31090,49278,316,136,180,6,6,3,3,allow
55318,53,35151,53,166,85,81,2,30,1,1,allow
49552,53,59587,53,188,96,92,2,30,1,1,allow
56797,443,58873,443,8022,2002,6020,20,16,11,9,allow
49475,7000,49475,7000,3546,2043,1503,16,15,9,7,allow
48985,15000,20199,15000,130,70,60,2,5,1,1,allow
55445,53,56296,53,711,87,624,2,30,1,1,allow
49369,53,21699,53,168,86,82,2,30,1,1,allow
56748,53,43623,53,184,94,90,2,31,1,1,allow
56204,53,48985,53,168,86,82,2,30,1,1,allow
45017,443,13860,443,11771,2624,9147,50,20,25,25,allow
56799,443,47229,443,8021,2001,6020,20,15,11,9,allow
63459,443,63459,443,4506,1599,2907,19,28,11,8,allow
56822,53,60516,53,184,94,90,2,30,1,1,allow
53963,6882,6880,6882,70,70,0,1,5,1,0,allow
50295,3389,50295,3389,5936,2690,3246,25,20,15,10,allow
43906,443,43906,443,4792,2767,2025,38,255,20,18,allow
57896,7635,57896,7635,138,78,60,2,5,1,1,allow
56798,443,60246,443,8073,2053,6020,20,15,11,9,allow
64801,53,33594,53,728,96,632,2,30,1,1,allow
49474,7000,49474,7000,3100,783,2317,14,15,7,7,allow
6194,80,6194,80,3058,774,2284,11,16,6,5,allow
55638,53,11091,53,168,86,82,2,30,1,1,allow
49482,80,49482,80,2444,1148,1296,14,48,7,7,allow
42780,53,61676,53,198,93,105,2,30,1,1,allow
55774,53,26343,53,701,88,613,2,30,1,1,allow
57431,53,32621,53,178,91,87,2,31,1,1,allow
55088,53,52692,53,170,87,83,2,31,1,1,allow
57418,443,57418,443,4736,1759,2977,20,26,11,9,allow
56732,53,32710,53,701,88,613,2,30,1,1,allow
52242,3749,25339,3749,70,70,0,2,7,2,0,allow
37905,443,37905,443,4707,1800,2907,19,26,11,8,allow
57038,53,16760,53,188,96,92,2,30,1,1,allow
45287,53,10390,53,198,93,105,2,30,1,1,allow
49633,53,21391,53,168,86,82,2,30,1,1,allow
41317,53,41317,53,217,87,130,2,30,1,1,allow
48906,53,48906,53,217,87,130,2,30,1,1,allow
65336,53,30958,53,771,101,670,2,31,1,1,allow
55702,53,21809,53,761,100,661,2,31,1,1,allow
55469,53,16063,53,817,98,719,2,31,1,1,allow
37510,443,18789,443,8619,2288,6331,41,361,16,25,allow
55107,53,40259,53,184,94,90,2,30,1,1,allow
56677,53,20003,53,200,102,98,2,31,1,1,allow
56765,53,1940,53,188,96,92,2,31,1,1,allow
49332,53,39051,53,740,93,647,2,31,1,1,allow
35141,53,35141,53,288,83,205,2,31,1,1,allow
50793,443,16791,443,9721,3096,6625,30,122,13,17,allow
49870,53,21637,53,188,96,92,2,31,1,1,allow
55317,53,36634,53,711,87,624,2,31,1,1,allow
56439,53,38034,53,196,100,96,2,31,1,1,allow
56942,53,26338,53,170,87,83,2,31,1,1,allow
57269,53,41250,53,182,93,89,2,31,1,1,allow
56030,53,56239,53,815,95,720,2,31,1,1,allow
55478,53,12055,53,170,87,83,2,31,1,1,allow
56079,53,34259,53,740,93,647,2,31,1,1,allow
49480,53,59035,53,184,94,90,2,31,1,1,allow
65442,53,27260,53,760,97,663,2,31,1,1,allow
49540,53,42804,53,754,94,660,2,31,1,1,allow
55752,443,54224,443,11823,4029,7794,25,143,12,13,allow
50285,53,26837,53,760,97,663,2,31,1,1,allow
64941,53,34820,53,295,101,194,4,31,2,2,allow
54887,443,19441,443,4364,2141,2223,15,137,7,8,allow
64763,53,55818,53,212,108,104,2,31,1,1,allow
55877,54210,39473,54210,490,149,341,2,1200,1,1,allow
50479,445,0,0,66,66,0,1,0,1,0,drop
50480,445,0,0,66,66,0,1,0,1,0,drop
50482,445,0,0,66,66,0,1,0,1,0,drop
50484,445,0,0,66,66,0,1,0,1,0,drop
50478,445,0,0,66,66,0,1,0,1,0,drop
32722,25174,0,0,62,62,0,1,0,1,0,deny
28830,37965,0,0,62,62,0,1,0,1,0,deny
44044,23,0,0,60,60,0,1,0,1,0,deny
61250,42873,0,0,66,66,0,1,0,1,0,deny
61637,25174,0,0,66,66,0,1,0,1,0,deny
11112,43890,0,0,66,66,0,1,0,1,0,deny
59883,17637,0,0,66,66,0,1,0,1,0,deny
52363,123,30662,123,184,94,90,2,30,1,1,allow
55288,53,34566,53,196,102,94,2,30,1,1,allow
54996,53,14810,53,168,86,82,2,31,1,1,allow
64709,53,54232,53,338,110,228,2,29,1,1,allow
64683,53,62247,53,198,102,96,2,29,1,1,allow
64124,53,35184,53,183,94,89,2,30,1,1,allow
56442,53,30750,53,167,86,81,2,30,1,1,allow
55183,53,52172,53,177,94,83,2,30,1,1,allow
55107,53,25498,53,184,94,90,2,30,1,1,allow
56658,53,34980,53,458,188,270,6,30,3,3,allow
58036,443,9162,443,12752,5123,7629,39,90,18,21,allow
48935,443,24879,443,12753,6074,6679,44,88,23,21,allow
54136,80,25504,80,1585,863,722,12,15,6,6,allow
60498,55100,54000,55100,164,70,94,2,5,1,1,allow
35104,53,13881,53,168,78,90,2,29,1,1,allow
55903,53,64113,53,177,94,83,2,29,1,1,allow
50210,53,56208,53,756,94,662,2,29,1,1,allow
49321,53,38287,53,184,94,90,2,29,1,1,allow
64683,53,49305,53,821,102,719,2,29,1,1,allow
58961,80,48953,80,5412,4758,654,14,14,8,6,allow
55647,53,31412,53,168,86,82,2,29,1,1,allow
50524,53,52843,53,816,102,714,2,29,1,1,allow
52211,56648,11346,56648,70,70,0,1,4,1,0,allow
56677,53,7912,53,200,102,98,2,30,1,1,allow
49762,53,33292,53,184,94,90,2,30,1,1,allow
57297,53,52793,53,242,102,140,2,30,1,1,allow
49989,53,64218,53,755,94,661,2,29,1,1,allow
57284,53,33476,53,173,94,79,2,29,1,1,allow
54973,53,49914,53,811,94,717,2,29,1,1,allow
56204,53,61458,53,168,86,82,2,30,1,1,allow
57006,53,13462,53,196,102,94,2,29,1,1,allow
50524,53,62327,53,193,102,91,2,30,1,1,allow
63012,443,56934,443,3707,1245,2462,11,119,6,5,allow
64560,53,36010,53,184,94,90,2,29,1,1,allow
56688,53,13604,53,196,102,94,2,29,1,1,allow
49948,53,30662,53,214,94,120,2,30,1,1,allow
56041,53,5205,53,183,94,89,2,30,1,1,allow
55233,53,15536,53,215,102,113,2,30,1,1,allow
60499,51413,63354,51413,70,70,0,1,5,1,0,allow
36515,80,38433,80,51571,48786,2785,74,19,38,36,allow
56822,53,28434,53,184,94,90,2,30,1,1,allow
43564,53,37702,53,199,94,105,2,30,1,1,allow
56041,53,23370,53,183,94,89,2,30,1,1,allow
49368,443,53544,443,14412,3279,11133,33,19,17,16,allow
54382,53,54382,53,414,268,146,3,33,2,1,allow
35699,443,53038,443,2060,1106,954,17,150,10,7,allow
57228,53,50397,53,344,94,250,2,30,1,1,allow
56677,53,47518,53,200,102,98,2,30,1,1,allow
49552,53,25565,53,194,102,92,2,30,1,1,allow
56942,53,38411,53,177,94,83,2,30,1,1,allow
57431,53,54427,53,181,94,87,2,30,1,1,allow
55088,53,34841,53,177,94,83,2,30,1,1,allow
48095,53,40439,53,199,94,105,2,30,1,1,allow
56942,53,55677,53,177,94,83,2,30,1,1,allow
55823,53,52028,53,210,102,108,2,30,1,1,allow
52948,48482,33406,48482,5180,2470,2710,49,339,25,24,allow
60501,40829,17093,40829,70,70,0,1,5,1,0,allow
52209,37241,61696,37241,136,136,0,3,14,3,0,allow
56191,53,1757,53,177,94,83,2,30,1,1,allow
60863,53,60863,53,298,114,184,2,30,1,1,allow
55075,443,61643,443,2459,1608,851,17,25,9,8,allow
64122,53,46704,53,255,102,153,2,30,1,1,allow
56531,53,17376,53,309,94,215,2,30,1,1,allow
10963,53,10963,53,216,90,126,2,30,1,1,allow
56205,53,15763,53,240,110,130,2,30,1,1,allow
10061,443,5696,443,4984,892,4092,18,185,9,9,allow
58330,443,54762,443,7353,2840,4513,33,107,18,15,allow
52207,4637,29875,4637,136,136,0,3,14,3,0,allow
52208,47300,63479,47300,70,70,0,1,5,1,0,allow
55753,53,0,0,82,82,0,2,40,2,0,allow
49563,80,54340,80,1515,481,1034,11,15,6,5,allow
49762,53,65280,53,184,94,90,2,30,1,1,allow
49552,53,34956,53,194,102,92,2,30,1,1,allow
56617,53,38232,53,228,110,118,2,30,1,1,allow
57432,443,22941,443,26468,3325,23143,41,147,16,25,allow
51116,80,26188,80,14873,8100,6773,36,32,19,17,allow
51117,80,26474,80,5040,3914,1126,19,32,12,7,allow
50421,443,23778,443,562,222,340,9,26,4,5,allow
49369,53,34405,53,324,86,238,4,47,2,2,allow
55647,53,8145,53,168,86,82,2,30,1,1,allow
64124,53,4238,53,183,94,89,2,30,1,1,allow
63948,53,52448,53,366,102,264,4,60,2,2,allow
55638,53,63082,53,168,86,82,2,30,1,1,allow
56204,53,36998,53,168,86,82,2,30,1,1,allow
57122,53,58221,53,198,94,104,2,30,1,1,allow
56111,53,27769,53,227,110,117,2,30,1,1,allow
49480,53,58009,53,184,94,90,2,31,1,1,allow
55062,443,36502,443,14701,3640,11061,29,60,16,13,allow
49671,53,50695,53,335,117,218,4,36,2,2,allow
57288,443,50391,443,840,420,420,14,39,7,7,allow
55089,80,46073,80,1558,452,1106,11,15,6,5,allow
14445,443,55284,443,2589,1443,1146,18,15,8,10,allow
58061,80,39603,80,5571,2637,2934,23,75,12,11,allow
44155,53,24482,53,168,78,90,2,29,1,1,allow
43552,443,10231,443,4680,2873,1807,26,53,15,11,allow
56872,53,25005,53,443,182,261,6,29,3,3,allow
52049,80,61901,80,34695,17472,17223,55,33,28,27,allow
56688,53,52079,53,196,102,94,2,31,1,1,allow
60808,40010,35600,40010,316,136,180,6,6,3,3,allow
50672,80,28058,80,1515,481,1034,11,16,6,5,allow
60507,53830,57450,53830,320,140,180,6,6,3,3,allow
56748,53,55168,53,184,94,90,2,30,1,1,allow
52244,58774,22208,58774,70,70,0,2,6,2,0,allow
55056,443,30880,443,5233,3384,1849,21,62,11,10,allow
60213,80,45825,80,70,70,0,1,4,1,0,allow
55088,53,21749,53,177,94,83,2,30,1,1,allow
64124,53,27285,53,294,93,201,4,42,2,2,allow
49272,53,53692,53,198,102,96,2,30,1,1,allow
49366,443,23124,443,14668,3601,11067,34,19,19,15,allow
53959,39097,20337,39097,1450,761,689,14,15,8,6,allow
38715,443,52129,443,403299,12717,390582,439,16,171,268,allow
49743,443,50508,443,2372,1143,1229,21,82,10,11,allow
55871,53,26416,53,181,94,87,2,29,1,1,allow
62170,53,16163,53,234,94,140,2,29,1,1,allow
50279,53,54207,53,749,94,655,2,29,1,1,allow
56216,53,35008,53,177,94,83,2,29,1,1,allow
49760,53,45249,53,183,94,89,2,29,1,1,allow
55183,53,35427,53,177,94,83,2,29,1,1,allow
56257,53,40398,53,177,94,83,2,29,1,1,allow
39556,443,12327,443,7469,2547,4922,18,135,8,10,allow
55836,53,17348,53,177,94,83,2,30,1,1,allow
19366,53,39850,53,300,209,91,3,30,2,1,allow
57422,53,31757,53,821,102,719,2,30,1,1,allow
30188,56962,59522,56962,2746,1487,1259,21,2495,14,7,allow
49272,53,44204,53,198,102,96,2,30,1,1,allow
64072,80,14418,80,314,192,122,6,15,4,2,allow
56252,53,39340,53,228,110,118,2,30,1,1,allow
48443,53,3585,53,168,78,90,2,30,1,1,allow
56191,53,27279,53,177,94,83,2,30,1,1,allow
56748,53,15879,53,184,94,90,2,30,1,1,allow
56765,53,6433,53,194,102,92,2,30,1,1,allow
65240,53,35636,53,755,102,653,2,30,1,1,allow
32871,53,29403,53,199,94,105,2,30,1,1,allow
55556,53,41769,53,224,94,130,2,30,1,1,allow
52071,80,35224,80,1284,780,504,12,360,7,5,allow
43439,443,4737,443,13482,3731,9751,40,500,17,23,allow
49495,53,39798,53,758,102,656,2,31,1,1,allow
55053,80,18063,80,162010,4343,157667,170,98,61,109,allow
20727,53,20727,53,217,82,135,2,32,1,1,allow
49724,53,30037,53,470,131,339,4,32,2,2,allow
60500,44739,7471,44739,70,70,0,1,5,1,0,allow
55097,53,3886,53,324,102,222,4,42,2,2,allow
42947,443,14067,443,11377,7703,3674,26,161,19,7,allow
50548,443,50022,443,9277,2865,6412,31,200,18,13,allow
61920,53,61920,53,298,114,184,2,30,1,1,allow
52686,53,56390,53,199,94,105,2,30,1,1,allow
57409,53,41368,53,232,94,138,2,30,1,1,allow
56982,53,26329,53,193,94,99,2,30,1,1,allow
49264,443,65214,443,2424,258,2166,9,120,4,5,allow
58955,80,51848,80,3037,2276,761,12,28,7,5,allow
39994,80,39994,80,2919,1492,1427,10,15,6,4,allow
51129,80,6520,80,2794,2075,719,15,30,9,6,allow
52243,35643,17676,35643,70,70,0,2,6,2,0,allow
57038,53,63930,53,194,102,92,2,33,1,1,allow
9337,443,53921,443,428,128,300,8,47,3,5,allow
49216,53,56828,53,274,94,180,2,30,1,1,allow
55836,53,6468,53,177,94,83,2,30,1,1,allow
56678,53,49059,53,240,110,130,2,30,1,1,allow
55478,53,56587,53,177,94,83,2,30,1,1,allow
56822,53,60070,53,184,94,90,2,30,1,1,allow
57384,53,57923,53,228,110,118,2,30,1,1,allow
49821,53,3854,53,265,94,171,2,30,1,1,allow
56147,53,61785,53,258,110,148,2,30,1,1,allow
57422,53,42352,53,198,102,96,2,30,1,1,allow
49356,53,31993,53,763,102,661,2,31,1,1,allow
42727,443,63558,443,4813,970,3843,12,135,6,6,allow
57575,443,3355,443,707158,36853,670305,902,148,310,592,allow
57269,53,5905,53,183,94,89,2,30,1,1,allow
64128,53,31311,53,193,102,91,2,31,1,1,allow
49710,443,63933,443,7691,1797,5894,22,137,12,10,allow
56020,53,55046,53,168,86,82,2,30,1,1,allow
56506,53,36137,53,227,102,125,2,30,1,1,allow
55478,53,54641,53,177,94,83,2,30,1,1,allow
49969,53,53673,53,789,102,687,2,30,1,1,allow
56863,53,12002,53,177,94,83,2,31,1,1,allow
56397,53,11047,53,179,94,85,2,30,1,1,allow
51173,443,28678,443,13341,4805,8536,88,378,42,46,allow
6881,6881,38605,6881,502,150,352,2,1199,1,1,allow
48817,27294,48817,27294,150,150,0,1,1200,1,0,allow
56942,53,10682,53,177,94,83,2,31,1,1,allow
34014,80,56105,80,1951,731,1220,11,150,6,5,allow
57470,36670,48397,36670,3570,1126,2444,28,1465,16,12,allow
56020,53,24675,53,168,86,82,2,31,1,1,allow
56439,53,35642,53,198,102,96,2,31,1,1,allow
49224,53,51489,53,199,102,97,2,34,1,1,allow
37672,5223,15708,5223,110,110,0,1,5,1,0,allow
57269,53,43829,53,183,94,89,2,30,1,1,allow
64095,1976,59947,1976,66,66,0,2,8,2,0,allow
64098,10096,39565,10096,66,66,0,2,8,2,0,allow
55058,443,16741,443,12435,4022,8413,27,62,15,12,allow
49245,80,49245,80,378,180,198,7,54,4,3,allow
64094,1024,11634,1024,66,66,0,2,8,2,0,allow
57426,443,14949,443,832,268,564,14,37,5,9,allow
59845,15503,0,0,66,66,0,1,0,1,0,deny
45964,2225,0,0,60,60,0,1,0,1,0,deny
3986,17372,0,0,66,66,0,1,0,1,0,deny
61963,6881,0,0,146,146,0,1,0,1,0,deny
55082,445,0,0,70,70,0,1,0,1,0,drop
55081,445,0,0,70,70,0,1,0,1,0,drop
55075,445,0,0,70,70,0,1,0,1,0,drop
55067,445,0,0,70,70,0,1,0,1,0,drop
25565,1726,0,0,60,60,0,1,0,1,0,deny
45064,25174,0,0,62,62,0,1,0,1,0,deny
443,44683,0,0,83,83,0,1,0,1,0,deny
51922,44847,0,0,62,62,0,1,0,1,0,deny
50466,445,0,0,66,66,0,1,0,1,0,drop
50465,445,0,0,66,66,0,1,0,1,0,drop
50463,445,0,0,66,66,0,1,0,1,0,drop
50377,445,0,0,70,70,0,1,0,1,0,drop
63508,62413,0,0,66,66,0,1,0,1,0,deny
59068,49813,0,0,70,70,0,1,0,1,0,deny
55393,44512,0,0,66,66,0,1,0,1,0,deny
50354,56205,0,0,66,66,0,1,0,1,0,deny
63677,15503,0,0,66,66,0,1,0,1,0,deny
22981,15503,0,0,62,62,0,1,0,1,0,deny
50372,445,0,0,70,70,0,1,0,1,0,drop
55063,445,0,0,70,70,0,1,0,1,0,drop
19718,37965,0,0,66,66,0,1,0,1,0,deny
55059,445,0,0,70,70,0,1,0,1,0,drop
55055,445,0,0,70,70,0,1,0,1,0,drop
55056,445,0,0,70,70,0,1,0,1,0,drop
10874,25174,0,0,62,62,0,1,0,1,0,deny
57297,51221,0,0,66,66,0,1,0,1,0,deny
63765,51221,0,0,62,62,0,1,0,1,0,deny
49220,22,0,0,60,60,0,1,0,1,0,deny
26124,56205,0,0,146,146,0,1,0,1,0,deny
50367,445,0,0,70,70,0,1,0,1,0,drop
65287,36829,0,0,146,146,0,1,0,1,0,deny
1025,57470,0,0,62,62,0,1,0,1,0,deny
50366,445,0,0,70,70,0,1,0,1,0,drop
47632,25174,0,0,146,146,0,1,0,1,0,deny
25679,27189,0,0,62,62,0,1,0,1,0,deny
50364,445,0,0,70,70,0,1,0,1,0,drop
38959,25174,0,0,62,62,0,1,0,1,0,deny
10306,44847,0,0,62,62,0,1,0,1,0,deny
55045,445,0,0,70,70,0,1,0,1,0,drop
55044,445,0,0,70,70,0,1,0,1,0,drop
55039,445,0,0,70,70,0,1,0,1,0,drop
54280,3398,0,0,60,60,0,1,0,1,0,deny
34086,25174,0,0,66,66,0,1,0,1,0,deny
40086,22114,0,0,146,146,0,1,0,1,0,deny
3576,8305,0,0,145,145,0,1,0,1,0,deny
50453,445,0,0,66,66,0,1,0,1,0,drop
1814,62413,0,0,66,66,0,1,0,1,0,deny
26821,57866,0,0,62,62,0,1,0,1,0,deny
48258,37965,0,0,62,62,0,1,0,1,0,deny
51356,22114,0,0,62,62,0,1,0,1,0,deny
45908,33330,0,0,60,60,0,1,0,1,0,deny
50357,445,0,0,70,70,0,1,0,1,0,drop
14263,22114,0,0,62,62,0,1,0,1,0,deny
50355,445,0,0,70,70,0,1,0,1,0,drop
65270,3855,0,0,78,78,0,1,0,1,0,deny
55038,445,0,0,70,70,0,1,0,1,0,drop
50354,445,0,0,70,70,0,1,0,1,0,drop
55037,445,0,0,70,70,0,1,0,1,0,drop
50353,445,0,0,70,70,0,1,0,1,0,drop
50352,445,0,0,70,70,0,1,0,1,0,drop
64605,25174,0,0,66,66,0,1,0,1,0,deny
50346,445,0,0,70,70,0,1,0,1,0,drop
50347,445,0,0,70,70,0,1,0,1,0,drop
57726,37965,0,0,62,62,0,1,0,1,0,deny
60714,50584,0,0,66,66,0,1,0,1,0,deny
61085,37965,0,0,62,62,0,1,0,1,0,deny
56688,25174,0,0,66,66,0,1,0,1,0,deny
50436,445,0,0,66,66,0,1,0,1,0,drop
50437,445,0,0,66,66,0,1,0,1,0,drop
63988,22114,0,0,66,66,0,1,0,1,0,deny
57643,28189,0,0,60,60,0,1,0,1,0,deny
62080,54532,0,0,60,60,0,1,0,1,0,deny
3410,17372,0,0,62,62,0,1,0,1,0,deny
58724,43890,0,0,66,66,0,1,0,1,0,deny
50334,445,0,0,70,70,0,1,0,1,0,drop
59965,36237,0,0,62,62,0,1,0,1,0,deny
50333,445,0,0,70,70,0,1,0,1,0,drop
5610,37965,0,0,66,66,0,1,0,1,0,deny
50331,445,0,0,70,70,0,1,0,1,0,drop
49529,21247,0,0,62,62,0,1,0,1,0,deny
57015,42707,0,0,62,62,0,1,0,1,0,deny
46842,25174,0,0,146,146,0,1,0,1,0,deny
50324,445,0,0,70,70,0,1,0,1,0,drop
50323,445,0,0,70,70,0,1,0,1,0,drop
15635,41182,0,0,66,66,0,1,0,1,0,deny
55027,445,0,0,70,70,0,1,0,1,0,drop
55026,445,0,0,70,70,0,1,0,1,0,drop
55024,445,0,0,70,70,0,1,0,1,0,drop
55020,445,0,0,70,70,0,1,0,1,0,drop
3406,17372,0,0,62,62,0,1,0,1,0,deny
31410,25174,0,0,146,146,0,1,0,1,0,deny
4545,1900,0,0,136,136,0,1,0,1,0,deny
45013,50584,0,0,62,62,0,1,0,1,0,deny
44774,22114,0,0,146,146,0,1,0,1,0,deny
50432,445,0,0,66,66,0,1,0,1,0,drop
44774,22114,0,0,62,62,0,1,0,1,0,deny
39586,22114,0,0,66,66,0,1,0,1,0,deny
29576,37807,0,0,66,66,0,1,0,1,0,deny
4323,64147,0,0,66,66,0,1,0,1,0,deny
50426,445,0,0,66,66,0,1,0,1,0,drop
50427,445,0,0,66,66,0,1,0,1,0,drop
50425,445,0,0,66,66,0,1,0,1,0,drop
50422,445,0,0,66,66,0,1,0,1,0,drop
50421,445,0,0,66,66,0,1,0,1,0,drop
50418,445,0,0,66,66,0,1,0,1,0,drop
50415,445,0,0,66,66,0,1,0,1,0,drop
40772,15503,0,0,74,74,0,1,0,1,0,deny
63593,22114,0,0,62,62,0,1,0,1,0,deny
58129,26467,0,0,62,62,0,1,0,1,0,deny
55010,445,0,0,70,70,0,1,0,1,0,drop
50312,445,0,0,70,70,0,1,0,1,0,drop
55008,445,0,0,70,70,0,1,0,1,0,drop
55006,445,0,0,70,70,0,1,0,1,0,drop
55004,445,0,0,70,70,0,1,0,1,0,drop
53771,57470,0,0,66,66,0,1,0,1,0,deny
56679,51505,0,0,62,62,0,1,0,1,0,deny
50308,445,0,0,70,70,0,1,0,1,0,drop
60416,37965,0,0,66,66,0,1,0,1,0,deny
45941,23386,0,0,60,60,0,1,0,1,0,deny
3976,25174,0,0,62,62,0,1,0,1,0,deny
55003,445,0,0,70,70,0,1,0,1,0,drop
54997,445,0,0,70,70,0,1,0,1,0,drop
54996,445,0,0,70,70,0,1,0,1,0,drop
64808,62413,0,0,66,66,0,1,0,1,0,deny
61802,23,0,0,60,60,0,1,0,1,0,deny
50409,445,0,0,66,66,0,1,0,1,0,drop
43155,35440,0,0,62,62,0,1,0,1,0,deny
54995,445,0,0,70,70,0,1,0,1,0,drop
34335,23,0,0,60,60,0,1,0,1,0,deny
17171,22114,0,0,66,66,0,1,0,1,0,deny
50298,445,0,0,70,70,0,1,0,1,0,drop
50297,445,0,0,70,70,0,1,0,1,0,drop
50299,445,0,0,70,70,0,1,0,1,0,drop
50407,445,0,0,66,66,0,1,0,1,0,drop
5683,44847,0,0,66,66,0,1,0,1,0,deny
50293,445,0,0,70,70,0,1,0,1,0,drop
64150,22114,0,0,66,66,0,1,0,1,0,deny
24160,37807,0,0,62,62,0,1,0,1,0,deny
50405,445,0,0,66,66,0,1,0,1,0,drop
50403,445,0,0,66,66,0,1,0,1,0,drop
64737,53,51522,53,757,98,659,2,0,1,1,allow
50291,445,0,0,70,70,0,1,0,1,0,drop
11101,22114,0,0,146,146,0,1,0,1,0,deny
44528,5900,0,0,60,60,0,1,0,1,0,deny
58925,25174,0,0,66,66,0,1,0,1,0,deny
50402,445,0,0,66,66,0,1,0,1,0,drop
30129,37965,0,0,72,72,0,1,0,1,0,deny
0,0,0,0,124,64,60,2,0,1,1,allow
11775,25174,0,0,62,62,0,1,0,1,0,deny
56906,50584,0,0,62,62,0,1,0,1,0,deny
59031,25174,0,0,62,62,0,1,0,1,0,deny
51146,23117,0,0,66,66,0,1,0,1,0,deny
6778,50584,0,0,66,66,0,1,0,1,0,deny
12632,25174,0,0,146,146,0,1,0,1,0,deny
54990,445,0,0,70,70,0,1,0,1,0,drop
35507,15503,0,0,62,62,0,1,0,1,0,deny
25363,22114,0,0,66,66,0,1,0,1,0,deny
54981,445,0,0,70,70,0,1,0,1,0,drop
54977,445,0,0,70,70,0,1,0,1,0,drop
28579,64147,0,0,62,62,0,1,0,1,0,deny
50285,445,0,0,70,70,0,1,0,1,0,drop
8040,44847,0,0,66,66,0,1,0,1,0,deny
55427,64147,0,0,66,66,0,1,0,1,0,deny
52838,37965,0,0,66,66,0,1,0,1,0,deny
17146,57470,0,0,62,62,0,1,0,1,0,deny
55043,57470,0,0,78,78,0,1,0,1,0,deny
50391,445,0,0,66,66,0,1,0,1,0,drop
45269,50584,0,0,62,62,0,1,0,1,0,deny
57546,25174,0,0,66,66,0,1,0,1,0,deny
50277,445,0,0,70,70,0,1,0,1,0,drop
50407,62413,0,0,62,62,0,1,0,1,0,deny
59822,56205,0,0,62,62,0,1,0,1,0,deny
50274,445,0,0,70,70,0,1,0,1,0,drop
57613,42707,0,0,66,66,0,1,0,1,0,deny
53985,30188,0,0,66,66,0,1,0,1,0,deny
59345,25174,0,0,62,62,0,1,0,1,0,deny
58836,51505,0,0,66,66,0,1,0,1,0,deny
63640,57866,0,0,66,66,0,1,0,1,0,deny
50383,445,0,0,66,66,0,1,0,1,0,drop
7539,30317,0,0,62,62,0,1,0,1,0,deny
443,44683,0,0,83,83,0,1,0,1,0,deny
54967,445,0,0,70,70,0,1,0,1,0,drop
8080,37965,0,0,62,62,0,1,0,1,0,deny
44710,25174,0,0,62,62,0,1,0,1,0,deny
50270,445,0,0,70,70,0,1,0,1,0,drop
6999,2310,0,0,143,143,0,1,0,1,0,deny
50269,445,0,0,70,70,0,1,0,1,0,drop
59076,25174,0,0,62,62,0,1,0,1,0,deny
50381,445,0,0,66,66,0,1,0,1,0,drop
18398,21247,0,0,66,66,0,1,0,1,0,deny
23310,22114,0,0,62,62,0,1,0,1,0,deny
52564,15503,0,0,74,74,0,1,0,1,0,deny
7561,43890,0,0,62,62,0,1,0,1,0,deny
50265,445,0,0,70,70,0,1,0,1,0,drop
50372,445,0,0,66,66,0,1,0,1,0,drop
51052,50584,0,0,66,66,0,1,0,1,0,deny
58230,64147,0,0,66,66,0,1,0,1,0,deny
64797,53,54337,53,182,93,89,2,30,1,1,allow
52892,443,17240,443,41925,30922,11003,68,186,38,30,allow
49685,80,12171,80,1548,847,701,10,16,5,5,allow
49240,8080,49240,8080,22799,6835,15964,35,56,20,15,allow
57571,443,57571,443,881747,19604,862143,728,175,144,584,allow
55727,43736,4643,43736,70,70,0,2,8,2,0,allow
49243,80,49243,80,378,180,198,7,53,4,3,allow
49238,8080,49238,8080,378,180,198,7,53,4,3,allow
49242,80,49242,80,378,180,198,7,53,4,3,allow
57572,443,57572,443,181333,21870,159463,187,175,65,122,allow
49272,53,7753,53,196,100,96,2,30,1,1,allow
55095,53,54084,53,783,96,687,2,30,1,1,allow
50630,53,37346,53,754,94,660,2,30,1,1,allow
56368,53,19580,53,711,87,624,2,30,1,1,allow
60494,33709,52651,33709,504,318,186,8,16,5,3,allow
52240,52893,59916,52893,70,70,0,2,6,2,0,allow
52194,22674,61715,22674,66,66,0,1,5,1,0,allow
1380,53,1380,53,235,90,145,2,32,1,1,allow
64099,55470,5838,55470,66,66,0,2,8,2,0,allow
27296,443,26053,443,10243,1659,8584,29,83,13,16,allow
56795,443,62237,443,8021,2001,6020,20,15,11,9,allow
55893,53,33227,53,267,94,173,4,56,2,2,allow
55072,53,45639,53,170,87,83,2,31,1,1,allow
57134,53,30351,53,190,97,93,2,30,1,1,allow
3755,443,3755,443,12079,1344,10735,24,17,10,14,allow
31925,53,31925,53,237,91,146,2,33,1,1,allow
56794,443,16368,443,8073,2053,6020,20,15,11,9,allow
55526,53,26801,53,749,94,655,2,30,1,1,allow
64128,53,32109,53,186,95,91,2,30,1,1,allow
43212,443,25002,443,7476,2192,5284,27,316,13,14,allow
26831,443,14363,443,7283,2586,4697,22,19,11,11,allow
49239,8080,49239,8080,378,180,198,7,53,4,3,allow
53984,57077,13402,57077,70,70,0,2,8,2,0,allow
57436,53,31842,53,182,93,89,2,30,1,1,allow
50600,53,50600,53,257,101,156,2,34,1,1,allow
26742,53,26742,53,237,91,146,2,33,1,1,allow
57120,53,16635,53,761,100,661,2,30,1,1,allow
5643,53,5643,53,237,91,146,2,33,1,1,allow
47042,443,19544,443,2809,1884,925,19,25,11,8,allow
57139,53,57139,53,235,90,145,2,32,1,1,allow
55642,53,4187,53,711,87,624,2,30,1,1,allow
55633,53,54670,53,816,97,719,2,30,1,1,allow
60860,443,28548,443,11687,2565,9122,46,66,25,21,allow
49686,80,54142,80,2611,1811,800,13,15,7,6,allow
56688,53,38230,53,192,98,94,2,30,1,1,allow
56796,443,60351,443,8074,2054,6020,20,15,11,9,allow
58035,53,58035,53,237,91,146,2,32,1,1,allow
64092,14447,3904,14447,66,66,0,2,8,2,0,allow
50819,443,24202,443,11217,3882,7335,42,164,19,23,allow
52203,1024,52908,1024,136,136,0,3,14,3,0,allow
43032,443,42506,443,2940,1721,1219,17,361,9,8,allow
64779,53,1103,53,810,108,702,2,30,1,1,allow
56793,443,4192,443,8022,2002,6020,20,16,11,9,allow
39683,443,12229,443,101895,6430,95465,152,175,66,86,allow
56487,53,25181,53,788,108,680,2,31,1,1,allow
32299,40019,6627,40019,261,175,86,2,31,1,1,allow
49364,53,25963,53,307,307,0,4,61,4,0,allow
51848,443,16596,443,5788,3446,2342,22,135,11,11,allow
57470,1500,26703,1500,528,528,0,9,1200,9,0,allow
55025,53,8549,53,93,93,0,1,31,1,0,allow
56424,53,11596,53,170,87,83,2,31,1,1,allow
56163,53,27486,53,188,96,92,2,31,1,1,allow
56020,53,48606,53,168,86,82,2,31,1,1,allow
55617,53,30754,53,212,108,104,2,31,1,1,allow
49929,53,57396,53,212,108,104,2,31,1,1,allow
6882,30499,61301,30499,150,150,0,1,1200,1,0,allow
64712,53,32542,53,181,98,83,2,31,1,1,allow
123,123,4169,123,184,94,90,2,31,1,1,allow
57144,53,3454,53,172,88,84,2,31,1,1,allow
54998,53,2972,53,196,100,96,2,31,1,1,allow
50375,1,0,0,74,74,0,1,91,1,0,allow
56603,53,10898,53,174,89,85,2,31,1,1,allow
53124,443,9153,443,64407,55712,8695,92,364,58,34,allow
51414,22,0,0,60,60,0,1,0,1,0,deny
51414,22,0,0,60,60,0,1,0,1,0,deny
4162,21532,0,0,146,146,0,1,0,1,0,deny
52128,37807,0,0,66,66,0,1,0,1,0,deny
50367,445,0,0,66,66,0,1,0,1,0,drop
33912,25174,0,0,62,62,0,1,0,1,0,deny
50264,445,0,0,70,70,0,1,0,1,0,drop
65228,53,0,0,88,88,0,1,0,1,0,deny
62208,37965,0,0,66,66,0,1,0,1,0,deny
42417,22114,0,0,62,62,0,1,0,1,0,deny
45964,2225,0,0,60,60,0,1,0,1,0,deny
50259,445,0,0,70,70,0,1,0,1,0,drop
55725,14704,2998,14704,70,70,0,2,8,2,0,allow
35422,443,43455,443,154,94,60,2,5,1,1,allow
9487,443,35248,443,5179,2934,2245,25,32,13,12,allow
53496,443,54389,443,3155,2234,921,15,16,8,7,allow
58481,15503,0,0,146,146,0,1,0,1,0,deny
54955,445,0,0,70,70,0,1,0,1,0,drop
54957,445,0,0,70,70,0,1,0,1,0,drop
54956,445,0,0,70,70,0,1,0,1,0,drop
1025,50584,0,0,62,62,0,1,0,1,0,deny
50350,445,0,0,66,66,0,1,0,1,0,drop
50357,445,0,0,66,66,0,1,0,1,0,drop
50352,445,0,0,66,66,0,1,0,1,0,drop
50356,445,0,0,66,66,0,1,0,1,0,drop
50354,445,0,0,66,66,0,1,0,1,0,drop
50358,445,0,0,66,66,0,1,0,1,0,drop
50353,445,0,0,66,66,0,1,0,1,0,drop
50351,445,0,0,66,66,0,1,0,1,0,drop
443,4512,0,0,60,60,0,1,0,1,0,deny
11337,25773,0,0,159,159,0,1,0,1,0,reset-both
60676,57866,0,0,66,66,0,1,0,1,0,deny
5685,35440,0,0,66,66,0,1,0,1,0,deny
29742,50584,0,0,62,62,0,1,0,1,0,deny
63627,26296,0,0,159,159,0,1,0,1,0,deny
19427,23,0,0,60,60,0,1,0,1,0,deny
49607,25174,0,0,62,62,0,1,0,1,0,deny
3456,11392,0,0,66,66,0,1,0,1,0,deny
54951,445,0,0,70,70,0,1,0,1,0,drop
54947,445,0,0,70,70,0,1,0,1,0,drop
54942,445,0,0,70,70,0,1,0,1,0,drop
54940,445,0,0,70,70,0,1,0,1,0,drop
51993,25174,0,0,62,62,0,1,0,1,0,deny
50246,445,0,0,70,70,0,1,0,1,0,drop
37609,15503,0,0,146,146,0,1,0,1,0,deny
14656,36237,0,0,62,62,0,1,0,1,0,deny
50337,445,0,0,66,66,0,1,0,1,0,drop
50338,445,0,0,66,66,0,1,0,1,0,drop
50335,445,0,0,66,66,0,1,0,1,0,drop
61273,25174,0,0,146,146,0,1,0,1,0,deny
50243,445,0,0,70,70,0,1,0,1,0,drop
6892,36949,0,0,159,159,0,1,0,1,0,deny
62183,57470,0,0,74,74,0,1,0,1,0,deny
56039,50584,0,0,66,66,0,1,0,1,0,deny
58357,62413,0,0,146,146,0,1,0,1,0,deny
54936,445,0,0,70,70,0,1,0,1,0,drop
57236,53733,0,0,62,62,0,1,0,1,0,deny
54934,445,0,0,70,70,0,1,0,1,0,drop
54930,445,0,0,70,70,0,1,0,1,0,drop
54926,445,0,0,70,70,0,1,0,1,0,drop
33453,64147,0,0,62,62,0,1,0,1,0,deny
443,44683,0,0,83,83,0,1,0,1,0,deny
59977,30188,0,0,66,66,0,1,0,1,0,deny
50238,445,0,0,70,70,0,1,0,1,0,drop
58873,443,27496,443,1855088,42017,1813071,1821,49,531,1290,allow
49323,53,12095,53,790,110,680,2,30,1,1,allow
56652,53,23903,53,821,102,719,2,30,1,1,allow
64941,53,8617,53,199,102,97,2,30,1,1,allow
64797,53,56821,53,183,94,89,2,30,1,1,allow
49742,53,44369,53,199,94,105,2,30,1,1,allow
64763,53,53321,53,214,110,104,2,30,1,1,allow
56526,443,31407,443,5082,973,4109,18,60,9,9,allow
49247,80,49247,80,378,180,198,7,53,4,3,allow
64075,1026,24378,1026,70,70,0,1,4,1,0,allow
55893,53,24260,53,267,94,173,4,55,2,2,allow
55318,53,26417,53,167,86,81,2,29,1,1,allow
55465,443,38707,443,12399,3942,8457,83,615,42,41,allow
63433,443,29608,443,1950,1231,719,20,15,12,8,allow
51433,80,51433,80,12796,1635,11161,21,15,8,13,allow
56525,443,34500,443,5022,973,4049,17,60,9,8,allow
65234,53,35438,53,193,102,91,2,30,1,1,allow
38714,443,54689,443,90043,3609,86434,97,15,33,64,allow
50080,443,5025,443,15595,3264,12331,26,35,14,12,allow
49272,53,2689,53,198,102,96,2,29,1,1,allow
53960,61038,13704,61038,552,306,246,9,14,5,4,allow
53985,26515,51989,26515,70,70,0,2,7,2,0,allow
57431,53,12541,53,181,94,87,2,29,1,1,allow
46719,443,39379,443,7261,3272,3989,22,45,13,9,allow
52227,27904,24192,27904,316,136,180,6,9,3,3,allow
56971,53,24481,53,195,102,93,2,30,1,1,allow
53983,40500,52248,40500,70,70,0,2,7,2,0,allow
52205,24416,50314,24416,136,136,0,3,13,3,0,allow
49714,53,19961,53,490,101,389,4,45,2,2,allow
58785,53,54759,53,211,86,125,2,30,1,1,allow
50332,53,15195,53,193,102,91,2,29,1,1,allow
49402,53,62978,53,214,110,104,2,30,1,1,allow
52200,42430,15926,42430,66,66,0,2,10,2,0,allow
57631,443,64255,443,154,94,60,2,5,1,1,allow
53273,443,62514,443,17169,6566,10603,52,37,24,28,allow
43829,443,59022,443,368,160,208,6,33,3,3,allow
50544,53,6922,53,193,102,91,2,30,1,1,allow
57269,53,63044,53,183,94,89,2,30,1,1,allow
49480,53,47457,53,184,94,90,2,30,1,1,allow
64750,53,43856,53,193,102,91,2,30,1,1,allow
49003,53,49003,53,262,106,156,2,32,1,1,allow
56750,80,10595,80,194,128,66,4,25,3,1,allow
65294,53,7465,53,184,102,82,2,30,1,1,allow
44724,443,7111,443,4383,2829,1554,27,80,14,13,allow
55049,443,10286,443,12851,3808,9043,30,61,16,14,allow
9463,443,40374,443,8952,5576,3376,35,38,21,14,allow
39915,443,9924,443,15058,8409,6649,40,271,21,19,allow
50544,53,48893,53,816,102,714,2,30,1,1,allow
42947,53,42947,53,260,106,154,2,33,1,1,allow
64640,53,17711,53,249,94,155,2,30,1,1,allow
37653,5223,53311,5223,70,70,0,1,5,1,0,allow
55726,32463,13679,32463,70,70,0,2,8,2,0,allow
52050,80,59091,80,20868,10484,10384,34,32,17,17,allow
65389,53,2887,53,215,102,113,2,30,1,1,allow
9334,443,58101,443,674,128,546,12,46,3,9,allow
51506,443,39609,443,4869,699,4170,14,15,8,6,allow
56652,53,12784,53,198,102,96,2,30,1,1,allow
55053,443,38835,443,23234,3906,19328,40,61,19,21,allow
65294,53,37568,53,168,86,82,2,30,1,1,allow
64268,53,55887,53,679,179,500,6,69,3,3,allow
65461,53,60419,53,226,94,132,2,30,1,1,allow
56688,53,20462,53,196,102,94,2,30,1,1,allow
64685,53,55702,53,193,102,91,2,30,1,1,allow
55490,443,55467,443,3080,1018,2062,10,120,5,5,allow
50241,53,51739,53,184,102,82,2,30,1,1,allow
52204,36387,46788,36387,136,136,0,3,13,3,0,allow
51995,443,36323,443,9966,5049,4917,41,15,25,16,allow
51121,443,8150,443,5553,2844,2709,21,30,11,10,allow
57134,53,41374,53,195,102,93,2,30,1,1,allow
55478,53,55747,53,177,94,83,2,30,1,1,allow
55072,53,59629,53,177,94,83,2,30,1,1,allow
19573,53,49198,53,183,78,105,2,30,1,1,allow
49480,53,12824,53,184,94,90,2,30,1,1,allow
57436,53,46375,53,183,94,89,2,30,1,1,allow
55958,53,32998,53,177,94,83,2,30,1,1,allow
64128,53,26433,53,193,102,91,2,30,1,1,allow
57436,53,1607,53,183,94,89,2,30,1,1,allow
49402,53,18505,53,214,110,104,2,30,1,1,allow
57063,53,34748,53,177,94,83,2,30,1,1,allow
52202,64241,19062,64241,250,66,184,4,9,2,2,allow
52195,50930,54222,50930,70,70,0,1,5,1,0,allow
57512,443,32314,443,4265,2639,1626,34,31,16,18,allow
9464,443,61543,443,9340,5582,3758,36,38,21,15,allow
9477,443,41654,443,7461,1448,6013,22,35,11,11,allow
52930,443,25439,443,4596,1029,3567,15,26,9,6,allow
49701,53,45217,53,523,92,431,4,48,2,2,allow
55050,443,4346,443,7372,2875,4497,23,61,13,10,allow
55958,53,17152,53,177,94,83,2,30,1,1,allow
58306,443,35402,443,5995,3536,2459,31,20,17,14,allow
52432,443,37828,443,330,190,140,6,15,4,2,allow
36433,80,4245,80,1585,863,722,12,15,6,6,allow
49237,8080,49237,8080,4451,1329,3122,13,53,7,6,allow
55062,53,27959,53,194,94,100,2,31,1,1,allow
57574,443,57574,443,164451,18310,146141,163,175,52,111,allow
50425,443,27749,443,4600,667,3933,14,17,7,7,allow
39550,80,36745,80,1598,731,867,17,362,8,9,allow
56747,80,7383,80,194,128,66,4,25,3,1,allow
53953,34661,36111,34661,552,306,246,9,15,5,4,allow
56748,80,43315,80,194,128,66,4,25,3,1,allow
53986,54070,21018,54070,70,70,0,2,7,2,0,allow
50420,443,27192,443,648,210,438,10,27,4,6,allow
49236,8080,49236,8080,4458,1336,3122,13,53,7,6,allow
49246,80,49246,80,378,180,198,7,53,4,3,allow
52241,51717,30281,51717,70,70,0,2,5,2,0,allow
49241,8080,49241,8080,12477,3635,8842,23,55,13,10,allow
55893,53,45153,53,267,94,173,4,56,2,2,allow
52239,1172,16970,1172,256,136,120,5,5,3,2,allow
56204,53,64652,53,168,86,82,2,29,1,1,allow
64093,64828,28561,64828,66,66,0,2,7,2,0,allow
3470,53,3470,53,217,82,135,2,32,1,1,allow
56822,53,57328,53,184,94,90,2,29,1,1,allow
52160,443,26040,443,956,420,536,15,26,7,8,allow
53982,24226,50334,24226,70,70,0,2,7,2,0,allow
55107,53,60741,53,184,94,90,2,29,1,1,allow
52198,12727,50505,12727,66,66,0,2,10,2,0,allow
55724,45682,40719,45682,70,70,0,2,8,2,0,allow
65070,53,12563,53,198,102,96,2,30,1,1,allow
64044,21989,15782,21989,816,508,308,12,27,7,5,allow
53987,16571,41017,16571,70,70,0,2,7,2,0,allow
52398,443,30861,443,323437,18923,304514,544,252,276,268,allow
58755,53,43262,53,277,102,175,2,30,1,1,allow
64815,53,31191,53,214,110,104,2,30,1,1,allow
52199,35549,28334,35549,66,66,0,2,10,2,0,allow
56765,53,25229,53,194,102,92,2,29,1,1,allow
59897,443,39118,443,9919,4495,5424,53,118,30,23,allow
55088,53,51001,53,177,94,83,2,29,1,1,allow
52931,443,64191,443,416,210,206,7,26,4,3,allow
50332,53,12740,53,193,102,91,2,29,1,1,allow
56748,53,37401,53,184,94,90,2,30,1,1,allow
49775,80,50741,80,254,128,126,5,16,3,2,allow
56439,53,49648,53,198,102,96,2,29,1,1,allow
65258,53,18646,53,763,102,661,2,30,1,1,allow
56677,53,61027,53,200,102,98,2,30,1,1,allow
56863,53,37391,53,177,94,83,2,30,1,1,allow
64797,53,6795,53,183,94,89,2,30,1,1,allow
49870,53,17515,53,194,102,92,2,30,1,1,allow
57436,53,48007,53,183,94,89,2,30,1,1,allow
49418,53,2882,53,165,86,79,2,30,1,1,allow
65229,53,28081,53,195,102,93,2,30,1,1,allow
50369,53,47601,53,166,86,80,2,30,1,1,allow
37574,123,51434,123,184,94,90,2,30,1,1,allow
49308,53,30302,53,195,102,93,2,31,1,1,allow
64941,53,17276,53,199,102,97,2,30,1,1,allow
55072,53,7801,53,177,94,83,2,30,1,1,allow
49254,53,47857,53,173,94,79,2,30,1,1,allow
55072,53,28531,53,177,94,83,2,30,1,1,allow
57398,53,40796,53,196,94,102,2,31,1,1,allow
32299,40021,3069,40021,148,86,62,2,31,1,1,allow
53259,443,6892,443,5513,929,4584,20,360,10,10,allow
52434,80,48898,80,1647,481,1166,13,15,6,7,allow
52193,33027,51097,33027,70,70,0,1,5,1,0,allow
56971,53,47465,53,195,102,93,2,30,1,1,allow
64763,53,14685,53,214,110,104,2,30,1,1,allow
56765,53,28041,53,194,102,92,2,30,1,1,allow
64797,53,38007,53,183,94,89,2,30,1,1,allow
65465,53,62433,53,372,126,246,2,30,1,1,allow
57063,53,54503,53,177,94,83,2,30,1,1,allow
57134,53,42837,53,195,102,93,2,30,1,1,allow
49402,53,34826,53,214,110,104,2,30,1,1,allow
57396,53,7718,53,184,94,90,2,30,1,1,allow
51714,123,49877,123,184,94,90,2,30,1,1,allow
55879,53,59038,53,184,94,90,2,30,1,1,allow
51391,443,62057,443,9973,1941,8032,38,121,19,19,allow
15503,63093,6070,63093,481,150,331,2,1200,1,1,allow
56163,53,47774,53,194,102,92,2,30,1,1,allow
57588,443,14769,443,7629,3270,4359,34,337,17,17,allow
56749,80,24129,80,194,128,66,4,25,3,1,allow
52201,44054,12966,44054,66,66,0,2,9,2,0,allow
55722,26192,51333,26192,70,70,0,1,5,1,0,allow
35516,80,25484,80,841,715,126,5,15,3,2,allow
64815,53,51366,53,214,110,104,2,30,1,1,allow
49870,53,59356,53,194,102,92,2,30,1,1,allow
64599,53,27573,53,398,102,296,2,30,1,1,allow
56439,53,18376,53,198,102,96,2,30,1,1,allow
34107,443,34100,443,11976,5066,6910,83,2475,43,40,allow
65181,53,41975,53,421,96,325,4,42,2,2,allow
9444,443,26906,443,7353,1570,5783,22,39,11,11,allow
9443,443,55182,443,7398,1480,5918,24,39,12,12,allow
60990,443,42071,443,212824,12881,199943,244,49,101,143,allow
52425,443,14303,443,64135,3588,60547,88,40,38,50,allow
65070,53,45301,53,821,102,719,2,30,1,1,allow
64748,53,54658,53,212,102,110,2,30,1,1,allow
64941,53,15219,53,199,102,97,2,30,1,1,allow
50241,53,32622,53,184,102,82,2,30,1,1,allow
56341,53,11727,53,243,94,149,2,30,1,1,allow
65229,53,50271,53,195,102,93,2,30,1,1,allow
57396,53,20662,53,807,94,713,2,30,1,1,allow
64685,53,47182,53,193,102,91,2,30,1,1,allow
49308,53,4514,53,195,102,93,2,30,1,1,allow
49703,53,62145,53,228,110,118,2,30,1,1,allow
64980,53,1256,53,199,102,97,2,31,1,1,allow
54998,53,21655,53,198,102,96,2,31,1,1,allow
44889,443,7395,443,9982,2062,7920,37,120,19,18,allow
49499,443,1804,443,5541,2623,2918,28,144,15,13,allow
57470,40794,36042,40794,132,132,0,3,1199,3,0,allow
57072,53,34434,53,193,102,91,2,30,1,1,allow
56332,53,17265,53,193,102,91,2,30,1,1,allow
55025,53,14358,53,183,94,89,2,31,1,1,allow
56332,53,36197,53,193,102,91,2,31,1,1,allow
65234,53,58797,53,193,102,91,2,31,1,1,allow
64710,53,45310,53,195,102,93,2,31,1,1,allow
37334,443,47156,443,6592,1735,4857,23,360,11,12,allow
44847,37005,6154,37005,150,150,0,1,1200,1,0,allow
50584,6881,26330,6881,502,150,352,2,1200,1,1,allow
56226,53,55576,53,512,187,325,6,58,3,3,allow
52189,24190,59596,24190,70,70,0,1,5,1,0,allow
52236,15313,56383,15313,70,70,0,2,5,2,0,allow
37673,443,65454,443,3226,2225,1001,18,47,11,7,allow
52217,36746,31872,36746,316,136,180,6,9,3,3,allow
53955,3290,25446,3290,70,70,0,1,5,1,0,allow
52054,80,38291,80,41406,4176,37230,57,32,25,32,allow
51992,443,50696,443,1083,596,487,11,16,7,4,allow
57914,80,49885,80,6527,1210,5317,15,18,8,7,allow
49998,443,24613,443,24410,6698,17712,32,16,13,19,allow
52223,11979,36766,11979,70,70,0,2,9,2,0,allow
51993,443,1370,443,1209,656,553,13,16,8,5,allow
6897,48817,0,0,139,139,0,1,0,1,0,deny
50237,445,0,0,70,70,0,1,0,1,0,drop
32424,25174,0,0,146,146,0,1,0,1,0,deny
26762,22114,0,0,62,62,0,1,0,1,0,deny
60141,30188,0,0,66,66,0,1,0,1,0,deny
65417,44847,0,0,66,66,0,1,0,1,0,deny
50235,445,0,0,70,70,0,1,0,1,0,drop
52812,25174,0,0,66,66,0,1,0,1,0,deny
63050,57470,0,0,74,74,0,1,0,1,0,deny
11983,57470,0,0,62,62,0,1,0,1,0,deny
59096,8604,0,0,66,66,0,1,0,1,0,deny
57846,57866,0,0,66,66,0,1,0,1,0,deny
32484,2323,0,0,60,60,0,1,0,1,0,deny
54916,445,0,0,70,70,0,1,0,1,0,drop
54913,445,0,0,70,70,0,1,0,1,0,drop
54911,445,0,0,70,70,0,1,0,1,0,drop
50325,445,0,0,66,66,0,1,0,1,0,drop
50228,445,0,0,70,70,0,1,0,1,0,drop
53260,36237,0,0,62,62,0,1,0,1,0,deny
50226,445,0,0,70,70,0,1,0,1,0,drop
58148,43890,0,0,62,62,0,1,0,1,0,deny
50225,445,0,0,70,70,0,1,0,1,0,drop
36357,25174,0,0,66,66,0,1,0,1,0,deny
50224,445,0,0,70,70,0,1,0,1,0,drop
54910,445,0,0,70,70,0,1,0,1,0,drop
50223,445,0,0,70,70,0,1,0,1,0,drop
443,44683,0,0,83,83,0,1,0,1,0,deny
50219,445,0,0,70,70,0,1,0,1,0,drop
50217,445,0,0,70,70,0,1,0,1,0,drop
60861,25174,0,0,66,66,0,1,0,1,0,deny
56876,11392,0,0,66,66,0,1,0,1,0,deny
54909,445,0,0,70,70,0,1,0,1,0,drop
40772,15503,0,0,74,74,0,1,0,1,0,deny
52340,22114,0,0,66,66,0,1,0,1,0,deny
50310,445,0,0,66,66,0,1,0,1,0,drop
50308,445,0,0,66,66,0,1,0,1,0,drop
62919,9694,0,0,146,146,0,1,0,1,0,deny
50198,445,0,0,70,70,0,1,0,1,0,drop
50205,445,0,0,70,70,0,1,0,1,0,drop
50204,445,0,0,70,70,0,1,0,1,0,drop
30303,22530,0,0,169,169,0,1,0,1,0,deny
50195,445,0,0,70,70,0,1,0,1,0,drop
50194,445,0,0,70,70,0,1,0,1,0,drop
52518,35440,0,0,62,62,0,1,0,1,0,deny
54898,445,0,0,70,70,0,1,0,1,0,drop
54899,445,0,0,70,70,0,1,0,1,0,drop
54895,445,0,0,70,70,0,1,0,1,0,drop
54892,445,0,0,70,70,0,1,0,1,0,drop
53721,62413,0,0,62,62,0,1,0,1,0,deny
6889,34962,0,0,143,143,0,1,0,1,0,deny
52969,44847,0,0,62,62,0,1,0,1,0,deny
50303,445,0,0,66,66,0,1,0,1,0,drop
11494,51505,0,0,146,146,0,1,0,1,0,deny
443,44683,0,0,83,83,0,1,0,1,0,deny
64406,25174,0,0,66,66,0,1,0,1,0,deny
50291,445,0,0,66,66,0,1,0,1,0,drop
50296,445,0,0,66,66,0,1,0,1,0,drop
50293,445,0,0,66,66,0,1,0,1,0,drop
50288,445,0,0,66,66,0,1,0,1,0,drop
50295,445,0,0,66,66,0,1,0,1,0,drop
50297,445,0,0,66,66,0,1,0,1,0,drop
50287,445,0,0,66,66,0,1,0,1,0,drop
50183,445,0,0,70,70,0,1,0,1,0,drop
443,62514,0,0,66,66,0,1,0,1,0,deny
54882,445,0,0,70,70,0,1,0,1,0,drop
54598,37965,0,0,62,62,0,1,0,1,0,deny
54880,445,0,0,70,70,0,1,0,1,0,drop
54879,445,0,0,70,70,0,1,0,1,0,drop
54876,445,0,0,70,70,0,1,0,1,0,drop
56067,25174,0,0,62,62,0,1,0,1,0,deny
50990,23884,0,0,62,62,0,1,0,1,0,deny
50127,64147,0,0,66,66,0,1,0,1,0,deny
0,0,0,0,480,244,236,4,0,2,2,allow
62902,32468,0,0,66,66,0,1,0,1,0,deny
50179,445,0,0,70,70,0,1,0,1,0,drop
54874,445,0,0,70,70,0,1,0,1,0,drop
54869,445,0,0,70,70,0,1,0,1,0,drop
54868,445,0,0,70,70,0,1,0,1,0,drop
443,50238,0,0,331,331,0,1,0,1,0,deny
50169,445,0,0,70,70,0,1,0,1,0,drop
50167,445,0,0,70,70,0,1,0,1,0,drop
50170,445,0,0,70,70,0,1,0,1,0,drop
50280,445,0,0,66,66,0,1,0,1,0,drop
50164,445,0,0,70,70,0,1,0,1,0,drop
54867,445,0,0,70,70,0,1,0,1,0,drop
52033,50584,0,0,66,66,0,1,0,1,0,deny
443,45788,0,0,332,332,0,1,0,1,0,deny
50162,445,0,0,70,70,0,1,0,1,0,drop
50279,445,0,0,66,66,0,1,0,1,0,drop
58253,25174,0,0,146,146,0,1,0,1,0,deny
7701,23,0,0,60,60,0,1,0,1,0,deny
50277,445,0,0,66,66,0,1,0,1,0,drop
50276,445,0,0,66,66,0,1,0,1,0,drop
35610,37965,0,0,62,62,0,1,0,1,0,deny
443,44683,0,0,83,83,0,1,0,1,0,deny
50274,445,0,0,66,66,0,1,0,1,0,drop
53318,22114,0,0,66,66,0,1,0,1,0,deny
33132,123,0,0,234,234,0,1,0,1,0,deny
34993,15503,0,0,62,62,0,1,0,1,0,deny
43671,17372,0,0,62,62,0,1,0,1,0,deny
50156,445,0,0,70,70,0,1,0,1,0,drop
49594,22114,0,0,66,66,0,1,0,1,0,deny
54857,445,0,0,70,70,0,1,0,1,0,drop
27745,50584,0,0,62,62,0,1,0,1,0,deny
54849,445,0,0,70,70,0,1,0,1,0,drop
27448,22114,0,0,62,62,0,1,0,1,0,deny
443,9986,0,0,669,669,0,1,0,1,0,deny
50263,445,0,0,66,66,0,1,0,1,0,drop
50149,445,0,0,70,70,0,1,0,1,0,drop
30270,37965,0,0,62,62,0,1,0,1,0,deny
50146,445,0,0,70,70,0,1,0,1,0,drop
44784,443,49876,443,12834,7868,4966,60,463,38,22,allow
56790,443,12015,443,8073,2053,6020,20,16,11,9,allow
52221,33166,34754,33166,70,70,0,2,8,2,0,allow
57468,2258,57468,2258,156,156,0,3,8,3,0,allow
53961,13067,4497,13067,70,70,0,1,5,1,0,allow
59339,80,59339,80,107838,4143,103695,178,15,59,119,allow
50337,53,56473,53,762,97,665,2,30,1,1,allow
64710,53,31226,53,190,97,93,2,30,1,1,allow
47598,443,10751,443,22048,16451,5597,47,18,21,26,allow
38537,443,38537,443,4662,1755,2907,19,30,11,8,allow
60884,443,1605,443,6505,2038,4467,26,46,15,11,allow
5588,5588,0,0,3354,1792,1562,46,194,23,23,allow
65234,53,64779,53,186,95,91,2,31,1,1,allow
49459,53,24594,53,198,101,97,2,30,1,1,allow
49308,53,20210,53,190,97,93,2,30,1,1,allow
7968,53,7968,53,407,261,146,3,32,2,1,allow
8082,53,8082,53,237,91,146,2,33,1,1,allow
64883,53,13274,53,184,94,90,2,31,1,1,allow
59340,80,59340,80,24437,12718,11719,41,15,16,25,allow
52186,57609,42161,57609,66,66,0,1,5,1,0,allow
56792,443,43093,443,8074,2054,6020,20,15,11,9,allow
56791,443,55063,443,8021,2001,6020,20,15,11,9,allow
36551,443,34195,443,8674,2101,6573,25,15,13,12,allow
51754,7000,51754,7000,4727,2346,2381,19,16,12,7,allow
10436,53,10436,53,237,91,146,2,32,1,1,allow
56247,53,34021,53,751,95,656,2,30,1,1,allow
64089,20260,49240,20260,66,66,0,2,8,2,0,allow
52225,31985,22878,31985,70,70,0,2,8,2,0,allow
55879,53,40028,53,184,94,90,2,30,1,1,allow
48471,443,48471,443,4381,1474,2907,19,26,11,8,allow
5588,5588,0,0,3354,1792,1562,46,193,23,23,allow
57115,53,47701,53,172,88,84,2,30,1,1,allow
36499,53,58408,53,302,208,94,3,30,2,1,allow
42982,443,14998,443,7467,1522,5945,26,16,14,12,allow
49941,53,34590,53,186,95,91,2,31,1,1,allow
64242,53,44715,53,176,90,86,2,31,1,1,allow
43718,53,43718,53,209,77,132,2,34,1,1,allow
7975,53,7975,53,237,91,146,2,33,1,1,allow
64684,53,19854,53,184,94,90,2,31,1,1,allow
58077,36653,28921,36653,268,128,140,5,10,3,2,allow
52184,57262,17429,57262,66,66,0,1,5,1,0,allow
64685,53,52958,53,186,95,91,2,30,1,1,allow
58653,53,0,0,82,82,0,1,30,1,0,allow
57288,53,62463,53,770,101,669,2,30,1,1,allow
56332,53,50254,53,186,95,91,2,30,1,1,allow
65408,53,61605,53,764,99,665,2,30,1,1,allow
56606,53,17065,53,762,97,665,2,31,1,1,allow
49370,443,17640,443,350,210,140,6,16,4,2,allow
65206,53,9006,53,762,98,664,2,30,1,1,allow
55161,53,9497,53,732,89,643,2,30,1,1,allow
55579,53,14828,53,172,88,84,2,30,1,1,allow
51808,443,64378,443,3871,1166,2705,13,136,6,7,allow
39895,443,43258,443,10727,3308,7419,33,503,15,18,allow
53625,53,53625,53,643,88,555,2,31,1,1,allow
55273,53,3281,53,764,99,665,2,31,1,1,allow
64770,53,63194,53,93,93,0,1,31,1,0,allow
64639,53,5053,53,198,101,97,2,31,1,1,allow
57181,53,16955,53,753,96,657,2,31,1,1,allow
50334,443,29587,443,3193,346,2847,12,121,5,7,allow
5588,5588,0,0,3354,1792,1562,46,194,23,23,allow
50455,53,22933,53,756,95,661,2,30,1,1,allow
57378,53,2616,53,756,95,661,2,31,1,1,allow
55799,53,31223,53,752,93,659,2,31,1,1,allow
64283,53,28343,53,186,95,91,2,31,1,1,allow
59777,443,22920,443,19311,2432,16879,55,417,24,31,allow
56864,53,65006,53,200,102,98,2,31,1,1,allow
55265,53,47317,53,198,101,97,2,31,1,1,allow
10151,27949,13472,27949,469,149,320,2,1200,1,1,allow
54596,443,49824,443,4510,2210,2300,14,136,7,7,allow
59537,443,51089,443,3351,841,2510,13,136,6,7,allow
56622,53,51149,53,757,98,659,2,31,1,1,allow
56446,443,1598,443,16401,10833,5568,32,362,18,14,allow
53125,443,24442,443,3358,1952,1406,16,360,8,8,allow
18574,56205,0,0,62,62,0,1,0,1,0,deny
53089,24211,0,0,66,66,0,1,0,1,0,deny
50255,445,0,0,66,66,0,1,0,1,0,drop
52863,50584,0,0,66,66,0,1,0,1,0,deny
50143,445,0,0,70,70,0,1,0,1,0,drop
54839,445,0,0,70,70,0,1,0,1,0,drop
50141,445,0,0,70,70,0,1,0,1,0,drop
57325,37965,0,0,62,62,0,1,0,1,0,deny
50367,37965,0,0,66,66,0,1,0,1,0,deny
18745,64147,0,0,66,66,0,1,0,1,0,deny
28999,37807,0,0,62,62,0,1,0,1,0,deny
64949,44847,0,0,62,62,0,1,0,1,0,deny
56775,9200,31796,9200,8223,3066,5157,30,33,15,15,allow
55879,53,11765,53,184,94,90,2,30,1,1,allow
38690,443,27226,443,8871,3470,5401,24,123,13,11,allow
56603,53,24241,53,179,94,85,2,30,1,1,allow
51848,443,58021,443,68198,5503,62695,102,40,43,59,allow
51596,443,63040,443,4638384,61757,4576627,3641,280,309,3332,allow
52190,29765,59554,29765,70,70,0,1,4,1,0,allow
52187,38153,27552,38153,70,70,0,1,4,1,0,allow
64041,53,28808,53,380,92,288,4,37,2,2,allow
57354,53,64428,53,198,94,104,2,29,1,1,allow
49929,53,44359,53,214,110,104,2,29,1,1,allow
57134,53,24003,53,195,102,93,2,29,1,1,allow
60473,22170,57823,22170,1599,743,856,13,36,7,6,allow
53944,23280,32203,23280,1740,834,906,16,16,10,6,allow
52188,13182,17024,13182,70,70,0,1,4,1,0,allow
51994,443,26093,443,330,190,140,6,15,4,2,allow
64685,53,12212,53,534,193,341,6,78,3,3,allow
64997,53,32660,53,771,102,669,2,29,1,1,allow
64856,53,25050,53,451,124,327,4,45,2,2,allow
49459,53,5838,53,199,102,97,2,29,1,1,allow
49254,53,63665,53,173,94,79,2,29,1,1,allow
60914,53,60914,53,180,82,98,2,29,1,1,allow
52219,37398,8768,37398,316,136,180,6,8,3,3,allow
52185,13269,13389,13269,70,70,0,1,4,1,0,allow
57072,53,31261,53,816,102,714,2,29,1,1,allow
53962,16251,51780,16251,70,70,0,1,4,1,0,allow
49586,53,25001,53,212,94,118,2,29,1,1,allow
52226,48784,24421,48784,70,70,0,2,8,2,0,allow
54998,53,23774,53,198,102,96,2,29,1,1,allow
64088,39650,57206,39650,66,66,0,2,7,2,0,allow
52237,16801,36529,16801,70,70,0,2,4,2,0,allow
64883,53,48996,53,184,94,90,2,30,1,1,allow
55255,53,4437,53,282,94,188,2,29,1,1,allow
50369,53,17923,53,166,86,80,2,29,1,1,allow
56424,53,45965,53,177,94,83,2,29,1,1,allow
64885,53,14280,53,261,102,159,2,29,1,1,allow
48982,53,28037,53,306,212,94,3,29,2,1,allow
55462,53,64670,53,214,110,104,2,29,1,1,allow
64980,53,27979,53,199,102,97,2,29,1,1,allow
123,123,40397,123,184,94,90,2,30,1,1,allow
44945,80,24197,80,1729,1287,442,7,15,5,2,allow
51911,443,51829,443,4456,2972,1484,38,211,20,18,allow
47831,443,18559,443,180582,6020,174562,196,200,70,126,allow
64641,53,5011,53,260,102,158,2,30,1,1,allow
64968,53,62769,53,767,102,665,2,30,1,1,allow
55372,53,44494,53,199,102,97,2,30,1,1,allow
49907,53,22787,53,199,102,97,2,30,1,1,allow
49342,53,2621,53,200,102,98,2,30,1,1,allow
47665,443,4370,443,214,140,74,4,15,3,1,allow
64490,53,23595,53,280,118,162,2,30,1,1,allow
64175,53,22231,53,453,100,353,4,57,2,2,allow
50700,80,7989,80,142,142,0,1,5,1,0,allow
64495,53,28201,53,243,94,149,2,30,1,1,allow
64988,53,6131,53,360,110,250,2,30,1,1,allow
55723,80,12672,80,70,70,0,2,8,2,0,allow
50709,80,40115,80,1658,1247,411,8,15,5,3,allow
65344,53,6284,53,211,102,109,2,30,1,1,allow
57381,443,25601,443,4645,700,3945,12,15,8,4,allow
65366,53,65366,53,244,98,146,2,33,1,1,allow
49853,53,4793,53,291,102,189,2,30,1,1,allow
41741,443,63716,443,20594,4629,15965,46,317,29,17,allow
50755,80,64278,80,1783,1346,437,7,15,5,2,allow
56424,53,21857,53,177,94,83,2,30,1,1,allow
62054,443,20146,443,10596,3874,6722,30,62,17,13,allow
56163,53,9366,53,194,102,92,2,30,1,1,allow
55617,53,46139,53,214,110,104,2,30,1,1,allow
64883,53,2709,53,184,94,90,2,30,1,1,allow
49437,53,49111,53,498,204,294,6,30,3,3,allow
64712,53,1546,53,177,94,83,2,30,1,1,allow
51812,443,55280,443,10741,7368,3373,32,135,16,16,allow
57144,53,45834,53,178,94,84,2,30,1,1,allow
57411,443,31872,443,214,140,74,4,15,3,1,allow
64096,1127,15786,1127,312,132,180,6,6,3,3,allow
47832,443,4961,443,130090,7064,123026,184,200,92,92,allow
41298,443,14805,443,2974,1378,1596,28,34,15,13,allow
49764,443,46462,443,114197,7285,106912,177,77,85,92,allow
55516,53,62536,53,211,102,109,2,30,1,1,allow
28280,53,52004,53,168,78,90,2,30,1,1,allow
50079,443,34341,443,7274,2208,5066,26,255,14,12,allow
49326,53,31358,53,193,102,91,2,31,1,1,allow
60805,20010,5973,20010,70,70,0,1,5,1,0,allow
39537,8245,49028,8245,280,214,66,2,30,1,1,allow
55579,53,62219,53,178,94,84,2,30,1,1,allow
49941,53,13341,53,193,102,91,2,30,1,1,allow
48994,443,64205,443,46452,6817,39635,103,299,45,58,allow
51001,443,45191,443,5841,1986,3855,19,18,11,8,allow
53949,42301,56593,42301,1396,719,677,15,15,8,7,allow
52222,11516,64024,11516,70,70,0,2,8,2,0,allow
60496,56871,22838,56871,504,318,186,8,15,5,3,allow
52191,32843,31336,32843,70,70,0,1,4,1,0,allow
50699,80,24288,80,7292,3171,4121,19,21,11,8,allow
37694,80,28033,80,1190,591,599,8,15,5,3,allow
52220,65128,43562,65128,70,70,0,2,8,2,0,allow
52238,48996,6858,48996,70,70,0,2,4,2,0,allow
43586,443,62166,443,2328,1429,899,18,33,10,8,allow
43701,3389,43701,3389,3910,1805,2105,20,19,12,8,allow
55893,53,44273,53,267,94,173,4,55,2,2,allow
44320,443,32394,443,154,94,60,2,4,1,1,allow
64750,53,24687,53,193,102,91,2,29,1,1,allow
52701,443,13239,443,130,70,60,3,5,2,1,allow
49352,53,51513,53,216,102,114,2,29,1,1,allow
55071,53,30463,53,356,118,238,2,29,1,1,allow
46593,28678,34181,28678,1806,1806,0,22,224,22,0,allow
56424,53,8677,53,177,94,83,2,29,1,1,allow
57409,443,54706,443,1054,567,487,10,15,6,4,allow
55462,53,19938,53,214,110,104,2,29,1,1,allow
51688,123,9497,123,184,94,90,2,29,1,1,allow
64242,53,3579,53,180,94,86,2,30,1,1,allow
55144,53,13694,53,316,94,222,2,29,1,1,allow
57115,53,18402,53,178,94,84,2,30,1,1,allow
44517,53,22276,53,306,212,94,3,29,2,1,allow
55879,53,9895,53,184,94,90,2,29,1,1,allow
49418,53,32330,53,165,86,79,2,29,1,1,allow
57115,53,57243,53,178,94,84,2,29,1,1,allow
32299,40019,4671,40019,148,86,62,2,30,1,1,allow
49929,53,53934,53,214,110,104,2,30,1,1,allow
64710,53,1727,53,195,102,93,2,29,1,1,allow
64684,53,47246,53,184,94,90,2,30,1,1,allow
55617,53,20605,53,214,110,104,2,30,1,1,allow
64684,53,48311,53,184,94,90,2,30,1,1,allow
64171,53,30410,53,94,94,0,1,30,1,0,allow
49459,53,33594,53,199,102,97,2,30,1,1,allow
123,123,12424,123,184,94,90,2,30,1,1,allow
57144,53,55905,53,178,94,84,2,30,1,1,allow
65236,53,5620,53,758,102,656,2,30,1,1,allow
55372,53,36344,53,199,102,97,2,30,1,1,allow
49342,53,62127,53,200,102,98,2,30,1,1,allow
64522,53,42718,53,230,102,128,2,31,1,1,allow
55786,53,43858,53,177,94,83,2,31,1,1,allow
37965,48167,49022,48167,490,149,341,3,1199,2,1,allow
49941,53,58431,53,193,102,91,2,30,1,1,allow
49469,53,2393,53,185,102,83,2,30,1,1,allow
56603,53,17293,53,179,94,85,2,30,1,1,allow
65075,53,5602,53,164,86,78,2,31,1,1,allow
49459,53,35212,53,199,102,97,2,31,1,1,allow
53723,443,51817,443,70,70,0,1,5,1,0,allow
51910,443,32865,443,308,188,120,4,15,2,2,allow
45109,443,9498,443,190,70,120,4,15,2,2,allow
51051,443,1978,443,7712,2203,5509,24,516,14,10,allow
50627,443,54044,443,5427,3497,1930,23,141,13,10,allow
64568,53,24682,53,388,134,254,2,30,1,1,allow
54815,3389,54815,3389,3424,1710,1714,16,31,8,8,allow
50316,53,18070,53,816,102,714,2,30,1,1,allow
65518,53,59686,53,211,102,109,2,30,1,1,allow
49277,53,14856,53,230,102,128,2,30,1,1,allow
32914,80,9670,80,1542,831,711,7,15,5,2,allow
47663,443,61725,443,214,140,74,4,15,3,1,allow
44228,443,32223,443,7352,1790,5562,24,263,12,12,allow
49374,53,26527,53,199,94,105,2,30,1,1,allow
55617,53,11638,53,214,110,104,2,30,1,1,allow
64242,53,41761,53,180,94,86,2,30,1,1,allow
65028,53,13338,53,763,102,661,2,30,1,1,allow
55579,53,12007,53,178,94,84,2,30,1,1,allow
50316,53,39379,53,193,102,91,2,30,1,1,allow
56008,53,22150,53,230,86,144,2,30,1,1,allow
56603,53,28698,53,179,94,85,2,30,1,1,allow
49342,53,56835,53,200,102,98,2,30,1,1,allow
51913,443,51764,443,190,70,120,4,15,2,2,allow
58959,80,58892,80,5481,4758,723,15,15,8,7,allow
52174,43106,3385,43106,160,70,90,2,8,1,1,allow
9335,443,4512,443,674,128,546,12,45,3,9,allow
64046,18318,32519,18318,3197,1526,1671,19,26,12,7,allow
37952,80,16690,80,1372,868,504,13,35,8,5,allow
63464,443,19526,443,8543,1114,7429,26,93,11,15,allow
44227,443,19248,443,7491,1930,5561,26,263,14,12,allow
57115,53,1229,53,178,94,84,2,30,1,1,allow
65154,53,12899,53,196,94,102,2,30,1,1,allow
42315,443,13240,443,13090,9437,3653,43,188,14,29,allow
55820,53,19644,53,194,102,92,2,30,1,1,allow
49941,53,57941,53,193,102,91,2,31,1,1,allow
64283,53,30888,53,193,102,91,2,31,1,1,allow
40672,443,9807,443,9150,2155,6995,38,295,15,23,allow
56882,53,12251,53,87,87,0,2,60,2,0,allow
50992,443,14898,443,49212,42366,6846,109,147,59,50,allow
54526,443,1853,443,33625519,489773,33135746,29877,243,6803,23074,allow
65322,53,59723,53,235,94,141,2,30,1,1,allow
55866,443,45291,443,53845,7300,46545,80,31,38,42,allow
42121,53,52822,53,199,94,105,2,31,1,1,allow
65090,53,63161,53,230,102,128,2,31,1,1,allow
50294,53,23372,53,178,94,84,2,30,1,1,allow
65515,53,18245,53,195,102,93,2,31,1,1,allow
49469,53,45496,53,177,94,83,2,30,1,1,allow
64639,53,49663,53,199,102,97,2,31,1,1,allow
58381,53,27908,53,199,94,105,2,31,1,1,allow
57793,53,34542,53,168,78,90,2,31,1,1,allow
64684,53,15819,53,184,94,90,2,31,1,1,allow
64724,53,50975,53,195,102,93,2,31,1,1,allow
56332,53,61425,53,193,102,91,2,31,1,1,allow
54998,53,27657,53,198,102,96,2,31,1,1,allow
46899,443,58934,443,9085,2222,6863,39,125,19,20,allow
65234,53,47492,53,193,102,91,2,31,1,1,allow
51638,443,56586,443,8176,2082,6094,26,360,12,14,allow
56079,53,14640,53,199,102,97,2,31,1,1,allow
52334,443,32129,443,96091,8340,87751,159,205,75,84,allow
62241,443,33164,443,7205,2250,4955,16,120,7,9,allow
50191,53,52829,53,182,102,80,2,30,1,1,allow
54889,443,50379,443,4600,2214,2386,13,134,7,6,allow
30188,33365,39784,33365,42329,18517,23812,241,2378,116,125,allow
51221,51413,53021,51413,460,150,310,2,1200,1,1,allow
49512,53,60222,53,195,102,93,2,31,1,1,allow
37912,443,31339,443,130,70,60,3,5,2,1,allow
49913,53,48535,53,493,94,399,4,40,2,2,allow
38914,443,38914,443,4644,1737,2907,19,28,11,8,allow
49982,53,15818,53,322,94,228,4,49,2,2,allow
55820,53,60004,53,194,102,92,2,31,1,1,allow
51880,8000,15502,8000,750,360,390,10,60,5,5,allow
53122,443,25117,443,23067,5901,17166,43,73,21,22,allow
58638,5900,58638,5900,130,66,64,2,5,1,1,allow
58638,5900,58638,5900,66,66,0,1,5,1,0,allow
58638,5900,58638,5900,130,66,64,2,5,1,1,allow
58638,5900,58638,5900,130,66,64,2,5,1,1,allow
45732,443,54582,443,6558,2131,4427,26,262,10,16,allow
50730,443,7850,443,1323,738,585,10,16,6,4,allow
50252,445,0,0,66,66,0,1,0,1,0,drop
50137,445,0,0,70,70,0,1,0,1,0,drop
53750,25174,0,0,66,66,0,1,0,1,0,deny
53275,21247,0,0,66,66,0,1,0,1,0,deny
58835,17372,0,0,66,66,0,1,0,1,0,deny
64622,36829,0,0,62,62,0,1,0,1,0,deny
53667,22114,0,0,66,66,0,1,0,1,0,deny
50246,445,0,0,66,66,0,1,0,1,0,drop
50136,445,0,0,70,70,0,1,0,1,0,drop
48144,21247,0,0,66,66,0,1,0,1,0,deny
5223,32965,0,0,220,220,0,1,0,1,0,deny
21294,21247,0,0,146,146,0,1,0,1,0,deny
50239,445,0,0,66,66,0,1,0,1,0,drop
53376,22114,0,0,146,146,0,1,0,1,0,deny
46619,57470,0,0,62,62,0,1,0,1,0,deny
51954,57470,0,0,66,66,0,1,0,1,0,deny
11585,56205,0,0,62,62,0,1,0,1,0,deny
54633,36237,0,0,66,66,0,1,0,1,0,deny
32679,37965,0,0,62,62,0,1,0,1,0,deny
3117,37965,0,0,62,62,0,1,0,1,0,deny
4862,37965,0,0,66,66,0,1,0,1,0,deny
18739,23,0,0,60,60,0,1,0,1,0,deny
56818,60043,0,0,66,66,0,1,0,1,0,deny
50131,445,0,0,70,70,0,1,0,1,0,drop
7844,22114,0,0,66,66,0,1,0,1,0,deny
61455,64147,0,0,66,66,0,1,0,1,0,deny
13027,64147,0,0,62,62,0,1,0,1,0,deny
53305,50584,0,0,66,66,0,1,0,1,0,deny
63495,50584,0,0,66,66,0,1,0,1,0,deny
52745,25174,0,0,66,66,0,1,0,1,0,deny
54830,445,0,0,70,70,0,1,0,1,0,drop
54828,445,0,0,70,70,0,1,0,1,0,drop
54827,445,0,0,70,70,0,1,0,1,0,drop
62721,56205,0,0,66,66,0,1,0,1,0,deny
48706,23393,0,0,60,60,0,1,0,1,0,deny
49590,57470,0,0,78,78,0,1,0,1,0,deny
50229,445,0,0,66,66,0,1,0,1,0,drop
50230,445,0,0,66,66,0,1,0,1,0,drop
50226,445,0,0,66,66,0,1,0,1,0,drop
50225,445,0,0,66,66,0,1,0,1,0,drop
50228,445,0,0,66,66,0,1,0,1,0,drop
50222,445,0,0,66,66,0,1,0,1,0,drop
50224,445,0,0,66,66,0,1,0,1,0,drop
50223,445,0,0,66,66,0,1,0,1,0,drop
24073,22114,0,0,62,62,0,1,0,1,0,deny
61550,5529,0,0,145,145,0,1,0,1,0,deny
62183,57470,0,0,74,74,0,1,0,1,0,deny
60428,25174,0,0,66,66,0,1,0,1,0,deny
12531,22114,0,0,146,146,0,1,0,1,0,deny
50828,23,0,0,60,60,0,1,0,1,0,deny
63488,22114,0,0,62,62,0,1,0,1,0,deny
50118,445,0,0,70,70,0,1,0,1,0,drop
52018,22114,0,0,146,146,0,1,0,1,0,deny
54821,445,0,0,70,70,0,1,0,1,0,drop
54816,445,0,0,70,70,0,1,0,1,0,drop
54814,445,0,0,70,70,0,1,0,1,0,drop
54811,445,0,0,70,70,0,1,0,1,0,drop
4752,30188,0,0,62,62,0,1,0,1,0,deny
32796,37965,0,0,62,62,0,1,0,1,0,deny
51474,14914,0,0,139,139,0,1,0,1,0,deny
58535,30317,0,0,62,62,0,1,0,1,0,deny
54912,64147,0,0,66,66,0,1,0,1,0,deny
19136,64147,0,0,62,62,0,1,0,1,0,deny
50115,445,0,0,70,70,0,1,0,1,0,drop
50210,445,0,0,66,66,0,1,0,1,0,drop
50208,445,0,0,66,66,0,1,0,1,0,drop
50207,445,0,0,66,66,0,1,0,1,0,drop
19623,25174,0,0,62,62,0,1,0,1,0,deny
20741,64147,0,0,62,62,0,1,0,1,0,deny
1027,57866,0,0,62,62,0,1,0,1,0,deny
57523,25174,0,0,146,146,0,1,0,1,0,deny
54808,445,0,0,70,70,0,1,0,1,0,drop
443,4205,0,0,320,320,0,1,0,1,0,deny
57325,60043,0,0,66,66,0,1,0,1,0,deny
59497,64097,0,0,66,66,0,1,0,1,0,deny
50111,445,0,0,70,70,0,1,0,1,0,drop
54803,445,0,0,70,70,0,1,0,1,0,drop
54797,445,0,0,70,70,0,1,0,1,0,drop
54795,445,0,0,70,70,0,1,0,1,0,drop
29177,44847,0,0,62,62,0,1,0,1,0,deny
50109,445,0,0,70,70,0,1,0,1,0,drop
61711,35440,0,0,62,62,0,1,0,1,0,deny
16979,56205,0,0,62,62,0,1,0,1,0,deny
36419,50584,0,0,146,146,0,1,0,1,0,deny
36120,57470,0,0,145,145,0,1,0,1,0,deny
50107,445,0,0,70,70,0,1,0,1,0,drop
19068,37965,0,0,62,62,0,1,0,1,0,deny
51550,11392,0,0,66,66,0,1,0,1,0,deny
4328,7302,0,0,66,66,0,1,0,1,0,deny
65270,3855,0,0,78,78,0,1,0,1,0,deny
17038,36829,0,0,146,146,0,1,0,1,0,deny
52459,33890,0,0,60,60,0,1,0,1,0,deny
56719,37807,0,0,62,62,0,1,0,1,0,deny
43747,22114,0,0,62,62,0,1,0,1,0,deny
62838,44847,0,0,66,66,0,1,0,1,0,deny
12503,25174,0,0,146,146,0,1,0,1,0,deny
56102,53,3387,53,757,98,659,2,0,1,1,allow
54788,445,0,0,70,70,0,1,0,1,0,drop
54787,445,0,0,70,70,0,1,0,1,0,drop
54783,445,0,0,70,70,0,1,0,1,0,drop
8889,2117,0,0,60,60,0,1,0,1,0,deny
50100,445,0,0,70,70,0,1,0,1,0,drop
62744,62413,0,0,66,66,0,1,0,1,0,deny
24560,51050,0,0,146,146,0,1,0,1,0,deny
24376,50584,0,0,62,62,0,1,0,1,0,deny
50198,445,0,0,66,66,0,1,0,1,0,drop
50098,445,0,0,70,70,0,1,0,1,0,drop
23353,25174,0,0,62,62,0,1,0,1,0,deny
8734,56205,0,0,66,66,0,1,0,1,0,deny
23353,25174,0,0,146,146,0,1,0,1,0,deny
31660,35440,0,0,62,62,0,1,0,1,0,deny
50097,445,0,0,70,70,0,1,0,1,0,drop
50096,445,0,0,70,70,0,1,0,1,0,drop
11692,25174,0,0,62,62,0,1,0,1,0,deny
50095,445,0,0,70,70,0,1,0,1,0,drop
50089,445,0,0,70,70,0,1,0,1,0,drop
50092,445,0,0,70,70,0,1,0,1,0,drop
40254,25174,0,0,62,62,0,1,0,1,0,deny
54782,445,0,0,70,70,0,1,0,1,0,drop
54781,445,0,0,70,70,0,1,0,1,0,drop
55817,36829,0,0,66,66,0,1,0,1,0,deny
52596,17372,0,0,62,62,0,1,0,1,0,deny
26566,44847,0,0,66,66,0,1,0,1,0,deny
50076,445,0,0,70,70,0,1,0,1,0,drop
50075,445,0,0,70,70,0,1,0,1,0,drop
40418,25174,0,0,66,66,0,1,0,1,0,deny
50070,445,0,0,70,70,0,1,0,1,0,drop
50065,445,0,0,70,70,0,1,0,1,0,drop
50066,445,0,0,70,70,0,1,0,1,0,drop
50182,445,0,0,66,66,0,1,0,1,0,drop
50180,445,0,0,66,66,0,1,0,1,0,drop
52745,57866,0,0,62,62,0,1,0,1,0,deny
30181,61689,0,0,62,62,0,1,0,1,0,deny
64923,25174,0,0,66,66,0,1,0,1,0,deny
48025,44847,0,0,62,62,0,1,0,1,0,deny
56098,64147,0,0,66,66,0,1,0,1,0,deny
57607,21247,0,0,66,66,0,1,0,1,0,deny
42542,25174,0,0,146,146,0,1,0,1,0,deny
54768,445,0,0,70,70,0,1,0,1,0,deny
54767,445,0,0,70,70,0,1,0,1,0,drop
54766,445,0,0,70,70,0,1,0,1,0,drop
54760,445,0,0,70,70,0,1,0,1,0,drop
53844,22114,0,0,62,62,0,1,0,1,0,deny
47179,53733,0,0,146,146,0,1,0,1,0,deny
58463,11392,0,0,66,66,0,1,0,1,0,deny
0,0,0,0,134,64,70,2,0,1,1,allow
58543,6881,0,0,146,146,0,1,0,1,0,deny
50174,445,0,0,66,66,0,1,0,1,0,drop
50054,445,0,0,70,70,0,1,0,1,0,drop
54539,26467,0,0,62,62,0,1,0,1,0,deny
49380,21247,0,0,66,66,0,1,0,1,0,deny
46640,9002,0,0,60,60,0,1,0,1,0,deny
50164,445,0,0,66,66,0,1,0,1,0,drop
50169,445,0,0,66,66,0,1,0,1,0,drop
50171,445,0,0,66,66,0,1,0,1,0,drop
50168,445,0,0,66,66,0,1,0,1,0,drop
50162,445,0,0,66,66,0,1,0,1,0,drop
50161,445,0,0,66,66,0,1,0,1,0,drop
50159,445,0,0,66,66,0,1,0,1,0,drop
62971,44847,0,0,66,66,0,1,0,1,0,deny
53353,26467,0,0,62,62,0,1,0,1,0,deny
443,14315,0,0,158,158,0,1,0,1,0,deny
54757,445,0,0,70,70,0,1,0,1,0,drop
13168,35440,0,0,66,66,0,1,0,1,0,deny
443,59890,0,0,60,60,0,1,0,1,0,deny
54752,445,0,0,70,70,0,1,0,1,0,drop
54749,445,0,0,70,70,0,1,0,1,0,drop
54748,445,0,0,70,70,0,1,0,1,0,drop
38565,51505,0,0,66,66,0,1,0,1,0,deny
46180,1433,0,0,60,60,0,1,0,1,0,deny
50050,445,0,0,70,70,0,1,0,1,0,drop
53995,25174,0,0,66,66,0,1,0,1,0,deny
57793,37807,0,0,66,66,0,1,0,1,0,deny
50041,445,0,0,70,70,0,1,0,1,0,drop
50040,445,0,0,70,70,0,1,0,1,0,drop
50039,445,0,0,70,70,0,1,0,1,0,drop
23379,57866,0,0,62,62,0,1,0,1,0,deny
50035,445,0,0,70,70,0,1,0,1,0,drop
28064,36237,0,0,62,62,0,1,0,1,0,deny
54740,445,0,0,70,70,0,1,0,1,0,drop
54745,445,0,0,70,70,0,1,0,1,0,drop
54743,445,0,0,70,70,0,1,0,1,0,drop
50033,445,0,0,70,70,0,1,0,1,0,drop
50153,445,0,0,66,66,0,1,0,1,0,drop
54739,445,0,0,70,70,0,1,0,1,0,drop
50151,445,0,0,66,66,0,1,0,1,0,drop
7105,25174,0,0,66,66,0,1,0,1,0,deny
50149,445,0,0,66,66,0,1,0,1,0,drop
50148,445,0,0,66,66,0,1,0,1,0,drop
50146,445,0,0,66,66,0,1,0,1,0,drop
59845,15503,0,0,66,66,0,1,0,1,0,deny
3381,44847,0,0,78,78,0,1,0,1,0,deny
56258,53,45112,53,166,85,81,2,31,1,1,allow
37669,443,48889,443,24415,3924,20491,45,48,22,23,allow
37152,443,20347,443,7794,2670,5124,27,316,14,13,allow
58638,5900,58638,5900,126,62,64,2,5,1,1,allow
58638,5900,58638,5900,126,62,64,2,5,1,1,allow
58638,5900,58638,5900,126,62,64,2,5,1,1,allow
58638,5900,58638,5900,62,62,0,1,5,1,0,allow
58638,5900,58638,5900,62,62,0,1,5,1,0,allow
58638,5900,58638,5900,62,62,0,1,5,1,0,allow
57002,53,38861,53,731,85,646,2,30,1,1,allow
47643,443,8942,443,11108,3774,7334,28,230,13,15,allow
58638,5900,58638,5900,62,62,0,1,5,1,0,allow
53954,57868,29520,57868,70,70,0,1,5,1,0,allow
49514,53,50895,53,780,93,687,2,30,1,1,allow
40159,443,53282,443,5360,4048,1312,22,265,11,11,allow
50624,443,1028,443,12712,3662,9050,32,140,17,15,allow
30945,53,30945,53,237,91,146,2,32,1,1,allow
55325,53,12048,53,762,101,661,2,30,1,1,allow
57265,53,26246,53,762,98,664,2,30,1,1,allow
48171,443,3704,443,10420,3506,6914,33,274,18,15,allow
47276,443,9154,443,9503,5267,4236,56,218,31,25,allow
56079,53,63600,53,198,101,97,2,31,1,1,allow
64724,53,10875,53,190,97,93,2,31,1,1,allow
64789,53,3910,53,198,101,97,2,30,1,1,allow
64454,3389,64454,3389,4350,2261,2089,21,18,11,10,allow
9189,80,9189,80,13456,880,12576,21,16,9,12,allow
56786,443,23041,443,7929,1940,5989,20,16,11,9,allow
51969,443,9113,443,15609,5649,9960,58,76,31,27,allow
53134,443,53110,443,8361,2182,6179,26,40,15,11,allow
58638,5900,58638,5900,62,62,0,1,5,1,0,allow
58638,5900,58638,5900,62,62,0,1,5,1,0,allow
58638,5900,58638,5900,126,62,64,2,5,1,1,allow
51880,8000,29097,8000,270,270,0,4,33,4,0,allow
58638,5900,58638,5900,126,62,64,2,5,1,1,allow
49882,80,49056,80,2560,599,1961,13,75,7,6,allow
58638,5900,58638,5900,62,62,0,1,5,1,0,allow
58638,5900,58638,5900,62,62,0,1,5,1,0,allow
55048,443,61796,443,12799,3662,9137,40,50,22,18,allow
65006,53,31072,53,793,101,692,2,30,1,1,allow
39462,80,39462,80,1058,497,561,10,16,6,4,allow
50935,80,12497,80,40645,6133,34512,66,274,33,33,allow
58638,5900,58638,5900,62,62,0,1,5,1,0,allow
56788,443,39724,443,7929,1940,5989,20,15,11,9,allow
58638,5900,58638,5900,62,62,0,1,5,1,0,allow
58638,5900,58638,5900,62,62,0,1,5,1,0,allow
54234,53,54234,53,237,91,146,2,33,1,1,allow
58638,5900,58638,5900,126,62,64,2,5,1,1,allow
49512,53,53127,53,190,97,93,2,31,1,1,allow
58638,5900,58638,5900,126,62,64,2,5,1,1,allow
38520,53,38520,53,231,88,143,2,34,1,1,allow
64149,53,35596,53,301,108,193,4,50,2,2,allow
56789,443,8502,443,7877,1888,5989,20,15,11,9,allow
63607,53,63607,53,643,88,555,2,30,1,1,allow
56787,443,7195,443,7877,1888,5989,20,15,11,9,allow
60495,6882,21325,6882,70,70,0,1,5,1,0,allow
49342,53,37970,53,200,102,98,2,30,1,1,allow
56812,53,46886,53,767,102,665,2,30,1,1,allow
58725,443,25110,443,9279,5062,4217,56,259,25,31,allow
51179,443,22561,443,13708,1734,11974,25,31,12,13,allow
64937,53,10087,53,182,93,89,2,31,1,1,allow
64937,53,22410,53,182,93,89,2,31,1,1,allow
64332,53,28123,53,166,85,81,2,31,1,1,allow
57470,867,17411,867,330,330,0,6,1200,6,0,allow
57470,1024,34451,1024,132,132,0,3,1200,3,0,allow
49160,6881,22368,6881,490,150,340,2,1200,1,1,allow
55711,53,33941,53,733,93,640,2,31,1,1,allow
64217,53,58721,53,186,95,91,2,31,1,1,allow
57411,53,22912,53,192,98,94,2,31,1,1,allow
48229,53,48229,53,213,87,126,2,31,1,1,allow
57470,53380,4441,53380,330,330,0,6,1200,6,0,allow
55820,53,24388,53,188,96,92,2,31,1,1,allow
64815,123,8798,123,184,94,90,2,31,1,1,allow
50636,53,31294,53,772,100,672,2,31,1,1,allow
49907,53,44048,53,198,101,97,2,31,1,1,allow
55646,53,23408,53,182,93,89,2,31,1,1,allow
56724,53,16788,53,190,97,93,2,31,1,1,allow
64723,443,61032,443,7978900,79979,7898921,6464,210,644,5820,allow
55615,53,23565,53,772,100,672,2,31,1,1,allow
19473,51413,49212,51413,459,149,310,2,1200,1,1,allow
57131,35776,0,0,145,145,0,1,0,1,0,deny
16490,25174,0,0,62,62,0,1,0,1,0,deny
50591,22114,0,0,146,146,0,1,0,1,0,deny
55973,25174,0,0,62,62,0,1,0,1,0,deny
50027,445,0,0,70,70,0,1,0,1,0,drop
443,56513,0,0,78,78,0,1,0,1,0,deny
18130,25174,0,0,62,62,0,1,0,1,0,deny
63136,42873,0,0,66,66,0,1,0,1,0,deny
61250,42873,0,0,66,66,0,1,0,1,0,deny
49308,22114,0,0,62,62,0,1,0,1,0,deny
54735,445,0,0,70,70,0,1,0,1,0,drop
54727,445,0,0,70,70,0,1,0,1,0,drop
54721,445,0,0,70,70,0,1,0,1,0,drop
13718,23,0,0,60,60,0,1,0,1,0,deny
26906,22114,0,0,66,66,0,1,0,1,0,deny
50020,445,0,0,70,70,0,1,0,1,0,drop
11112,43890,0,0,66,66,0,1,0,1,0,deny
50018,445,0,0,70,70,0,1,0,1,0,drop
56258,53,19240,53,167,86,81,2,30,1,1,allow
56745,80,35194,80,214,140,74,4,25,3,1,allow
58769,22114,0,0,146,146,0,1,0,1,0,deny
50135,445,0,0,66,66,0,1,0,1,0,drop
25565,50263,0,0,60,60,0,1,0,1,0,deny
63469,64147,0,0,62,62,0,1,0,1,0,deny
57015,25174,0,0,66,66,0,1,0,1,0,deny
50014,445,0,0,70,70,0,1,0,1,0,drop
50012,445,0,0,70,70,0,1,0,1,0,drop
50354,56205,0,0,66,66,0,1,0,1,0,deny
50127,445,0,0,66,66,0,1,0,1,0,drop
54711,445,0,0,70,70,0,1,0,1,0,drop
10425,23,0,0,60,60,0,1,0,1,0,deny
18771,35440,0,0,66,66,0,1,0,1,0,deny
26629,56079,0,0,62,62,0,1,0,1,0,deny
50008,445,0,0,70,70,0,1,0,1,0,drop
33352,50584,0,0,146,146,0,1,0,1,0,deny
51865,61689,0,0,62,62,0,1,0,1,0,deny
50125,445,0,0,66,66,0,1,0,1,0,drop
50007,445,0,0,70,70,0,1,0,1,0,drop
64322,53,60744,53,273,90,183,4,33,2,2,allow
46987,443,53868,443,8688,3211,5477,24,343,11,13,allow
64307,53,35303,53,241,94,147,2,30,1,1,allow
49880,53,5726,53,194,102,92,2,30,1,1,allow
55265,53,4151,53,199,102,97,2,30,1,1,allow
56115,53,60323,53,167,86,81,2,30,1,1,allow
56115,53,18486,53,167,86,81,2,30,1,1,allow
65452,53,19191,53,196,102,94,2,30,1,1,allow
34732,53,8209,53,86,86,0,1,30,1,0,allow
64789,53,27915,53,199,102,97,2,30,1,1,allow
63773,443,33011,443,9693,2010,7683,18,130,9,9,allow
64116,443,49764,443,7439,1156,6283,19,75,11,8,allow
51880,8000,24485,8000,582,270,312,8,32,4,4,allow
123,123,14772,123,184,94,90,2,29,1,1,allow
65515,53,18334,53,195,102,93,2,29,1,1,allow
64882,53,29551,53,230,102,128,2,29,1,1,allow
65076,53,51472,53,215,94,121,2,29,1,1,allow
57054,53,52774,53,241,94,147,2,29,1,1,allow
56131,53,35553,53,199,94,105,2,29,1,1,allow
49939,53,35198,53,231,102,129,2,29,1,1,allow
49166,53,17612,53,322,102,220,2,30,1,1,allow
64789,53,49397,53,199,102,97,2,30,1,1,allow
57884,443,11734,443,7668,2540,5128,22,155,12,10,allow
56400,53,1687,53,196,102,94,2,30,1,1,allow
56538,53,20855,53,401,95,306,4,57,2,2,allow
64149,53,6477,53,301,108,193,4,49,2,2,allow
36660,443,25642,443,25051,3368,21683,50,313,26,24,allow
53136,80,42745,80,23974,12718,11256,37,36,19,18,allow
64930,53,11667,53,317,96,221,4,32,2,2,allow
58638,5900,58638,5900,130,66,64,2,4,1,1,allow
49279,53,50429,53,199,102,97,2,29,1,1,allow
53951,8999,52530,8999,70,70,0,1,4,1,0,allow
58638,5900,58638,5900,66,66,0,1,4,1,0,allow
49929,53,22603,53,214,110,104,2,29,1,1,allow
64283,53,44589,53,193,102,91,2,29,1,1,allow
49177,443,40595,443,840,700,140,13,59,11,2,allow
64710,53,5594,53,195,102,93,2,29,1,1,allow
49836,53,26222,53,889,404,485,10,29,5,5,allow
64935,53,15324,53,193,102,91,2,31,1,1,allow
65199,53,15810,53,215,94,121,2,30,1,1,allow
64606,53,12951,53,290,102,188,2,30,1,1,allow
37672,443,48728,443,3338,2337,1001,18,45,11,7,allow
38320,53,38320,53,260,106,154,2,32,1,1,allow
61343,443,57856,443,1784740,34746,1749994,1769,331,357,1412,allow
55598,53,62889,53,186,102,84,2,30,1,1,allow
65220,53,21177,53,184,94,90,2,30,1,1,allow
57137,53,46999,53,279,96,183,4,32,2,2,allow
52101,64162,42746,64162,1200,576,624,8,31,4,4,allow
64404,53,7876,53,251,110,141,2,30,1,1,allow
49965,53,10762,53,226,110,116,2,30,1,1,allow
49280,53,63122,53,167,86,81,2,30,1,1,allow
55273,53,48247,53,197,94,103,2,30,1,1,allow
55265,53,44071,53,199,102,97,2,30,1,1,allow
49448,53,38995,53,195,94,101,2,30,1,1,allow
64789,53,51641,53,199,102,97,2,30,1,1,allow
49280,53,8666,53,167,86,81,2,30,1,1,allow
50011,53,47474,53,1398,98,1300,4,31,2,2,allow
49291,53,30701,53,759,102,657,2,30,1,1,allow
64217,53,23995,53,193,102,91,2,30,1,1,allow
50622,443,10440,443,9215,1795,7420,32,140,16,16,allow
37586,443,60764,443,19675,10416,9259,53,81,30,23,allow
64283,53,27743,53,193,102,91,2,30,1,1,allow
55040,443,51805,443,36648,3634,33014,51,62,23,28,allow
52075,443,32298,443,18579,9266,9313,49,198,25,24,allow
50681,80,59849,80,318,192,126,6,26,4,2,allow
64639,53,21872,53,199,102,97,2,30,1,1,allow
64719,53,55102,53,263,118,145,2,30,1,1,allow
64149,53,17311,53,301,108,193,4,49,2,2,allow
55797,53,43104,53,194,102,92,2,30,1,1,allow
64724,53,43750,53,195,102,93,2,30,1,1,allow
33892,53,0,0,86,86,0,1,30,1,0,allow
55797,53,58246,53,817,102,715,2,30,1,1,allow
56258,53,24780,53,167,86,81,2,30,1,1,allow
57255,443,53541,443,4769,2622,2147,14,135,7,7,allow
57309,53,4070,53,197,102,95,2,30,1,1,allow
64603,53,49089,53,269,110,159,2,30,1,1,allow
49228,443,55799,443,842887,22143,820744,866,19,314,552,allow
53101,443,16538,443,27964,15805,12159,204,904,120,84,allow
42686,53,42686,53,262,106,156,2,32,1,1,allow
40826,443,36041,443,4125,2847,1278,18,255,10,8,allow
64854,53,54158,53,260,102,158,2,30,1,1,allow
63965,53,1139,53,214,102,112,2,30,1,1,allow
55100,53,15692,53,182,102,80,2,30,1,1,allow
55094,53,35029,53,244,94,150,2,30,1,1,allow
65452,53,12771,53,819,102,717,2,30,1,1,allow
56864,53,28207,53,200,102,98,2,30,1,1,allow
65260,53,63253,53,184,94,90,2,30,1,1,allow
49512,53,36100,53,195,102,93,2,30,1,1,allow
53028,443,47549,443,12081,2070,10011,33,620,12,21,allow
49326,53,56607,53,193,102,91,2,31,1,1,allow
57883,443,38550,443,5932,1264,4668,21,155,11,10,allow
38639,443,56279,443,10556,3559,6997,38,82,21,17,allow
49554,53,46723,53,541,201,340,6,64,3,3,allow
50682,80,30834,80,5036,4332,704,11,25,6,5,allow
56754,443,40687,443,9868,2027,7841,24,20,12,12,allow
63985,53,11526,53,351,103,248,4,46,2,2,allow
55044,443,65434,443,14427,4574,9853,34,61,18,16,allow
55254,53,23493,53,195,102,93,2,30,1,1,allow
65075,53,61185,53,172,94,78,2,30,1,1,allow
7536,53,7536,53,198,90,108,2,30,1,1,allow
55254,53,12306,53,195,102,93,2,30,1,1,allow
55026,53,51536,53,164,86,78,2,30,1,1,allow
53946,27426,37838,27426,612,306,306,10,14,5,5,allow
51880,8000,42444,8000,582,270,312,8,32,4,4,allow
51880,4000,30933,4000,270,270,0,4,32,4,0,allow
58020,80,26488,80,2312,1094,1218,25,89,13,12,allow
51880,51880,39901,51880,582,270,312,8,32,4,4,allow
53980,36153,5182,36153,258,70,188,4,7,2,2,allow
48495,443,14805,443,3108,1711,1397,24,813,11,13,allow
53950,32057,54034,32057,70,70,0,1,4,1,0,allow
65176,53,19712,53,299,99,200,4,45,2,2,allow
58638,5900,58638,5900,130,66,64,2,4,1,1,allow
58638,5900,58638,5900,66,66,0,1,4,1,0,allow
58638,5900,58638,5900,66,66,0,1,4,1,0,allow
58638,5900,58638,5900,66,66,0,1,4,1,0,allow
58638,5900,58638,5900,66,66,0,1,4,1,0,allow
58638,5900,58638,5900,130,66,64,2,4,1,1,allow
58638,5900,58638,5900,66,66,0,1,4,1,0,allow
64883,53,45539,53,292,94,198,4,57,2,2,allow
58638,5900,58638,5900,66,66,0,1,4,1,0,allow
58638,5900,58638,5900,66,66,0,1,4,1,0,allow
58638,5900,58638,5900,66,66,0,1,4,1,0,allow
58638,5900,58638,5900,130,66,64,2,4,1,1,allow
58638,5900,58638,5900,130,66,64,2,4,1,1,allow
58638,5900,58638,5900,66,66,0,1,4,1,0,allow
58638,5900,58638,5900,66,66,0,1,4,1,0,allow
55579,53,24866,53,178,94,84,2,29,1,1,allow
58638,5900,58638,5900,130,66,64,2,4,1,1,allow
10059,443,58839,443,70553,6471,64082,141,182,69,72,allow
58638,5900,58638,5900,66,66,0,1,4,1,0,allow
49308,53,35422,53,320,97,223,4,50,2,2,allow
53952,26973,7961,26973,70,70,0,1,4,1,0,allow
50191,53,41237,53,182,102,80,2,29,1,1,allow
56775,53,62594,53,200,94,106,2,29,1,1,allow
64550,53,62266,53,221,94,127,2,29,1,1,allow
33161,80,27979,80,604,530,74,7,15,6,1,allow
47935,443,5335,443,12403,2139,10264,38,22,19,19,allow
50294,53,34116,53,178,94,84,2,29,1,1,allow
55754,53,55090,53,199,102,97,2,30,1,1,allow
56079,53,40631,53,199,102,97,2,29,1,1,allow
56864,53,5721,53,200,102,98,2,30,1,1,allow
57144,53,1605,53,178,94,84,2,29,1,1,allow
55348,53,24176,53,498,204,294,6,30,3,3,allow
56864,53,8861,53,200,102,98,2,30,1,1,allow
56020,53,56318,53,168,86,82,2,29,1,1,allow
55598,53,46757,53,186,102,84,2,30,1,1,allow
56332,53,33283,53,199,102,97,2,29,1,1,allow
50316,53,38175,53,753,94,659,2,29,1,1,allow
64895,53,61625,53,199,102,97,2,30,1,1,allow
49407,53,19099,53,209,102,107,2,30,1,1,allow
49248,53,8891,53,211,102,109,2,30,1,1,allow
65063,53,59913,53,340,94,246,2,30,1,1,allow
49697,53,43942,53,195,94,101,2,30,1,1,allow
55087,53,1147,53,183,94,89,2,31,1,1,allow
49337,443,47623,443,5483,2770,2713,30,361,15,15,allow
59103,443,44683,443,2192,1049,1143,24,119,11,13,allow
56127,443,17365,443,6103,2710,3393,58,212,28,30,allow
57262,443,38202,443,43771,18333,25438,105,126,49,56,allow
42484,443,62904,443,79507,72433,7074,96,415,60,36,allow
65377,53,44573,53,193,102,91,2,31,1,1,allow
49223,2710,26016,2710,3492,3432,60,12,36,11,1,allow
35515,80,62151,80,841,715,126,5,15,3,2,allow
49880,53,16831,53,817,102,715,2,30,1,1,allow
59119,53,4964,53,168,78,90,2,30,1,1,allow
57411,53,7355,53,196,102,94,2,30,1,1,allow
37833,53,37833,53,222,90,132,2,30,1,1,allow
38633,443,28633,443,4393,1151,3242,22,165,13,9,allow
38640,443,50053,443,6171,1091,5080,22,82,12,10,allow
36841,443,46092,443,7293,1544,5749,22,256,11,11,allow
49585,53,39603,53,732,86,646,2,30,1,1,allow
64639,53,46471,53,199,102,97,2,30,1,1,allow
55786,53,44397,53,177,94,83,2,30,1,1,allow
45899,53,19119,53,168,78,90,2,30,1,1,allow
65201,53,5254,53,288,94,194,2,30,1,1,allow
49974,53,0,0,86,86,0,1,30,1,0,allow
49907,53,32516,53,199,102,97,2,30,1,1,allow
55265,53,65356,53,199,102,97,2,30,1,1,allow
55044,53,38715,53,196,102,94,2,30,1,1,allow
38634,443,59310,443,9741,4687,5054,36,165,21,15,allow
53170,20259,55641,20259,70,70,0,1,5,1,0,allow
53165,18504,40263,18504,444,192,252,8,17,4,4,allow
49840,443,49840,443,4645,1738,2907,19,30,11,8,allow
49314,53,60410,53,214,94,120,2,30,1,1,allow
54816,53,4342,53,168,78,90,2,30,1,1,allow
36245,53,44289,53,168,78,90,2,30,1,1,allow
55100,53,34612,53,182,102,80,2,30,1,1,allow
44505,53,44505,53,216,90,126,2,30,1,1,allow
56400,53,12520,53,819,102,717,2,30,1,1,allow
65377,53,29691,53,193,102,91,2,30,1,1,allow
45676,123,45676,123,184,94,90,2,30,1,1,allow
50290,443,41228,443,6662,3336,3326,37,142,17,20,allow
56660,53,55953,53,183,94,89,2,31,1,1,allow
49198,53,18910,53,164,78,86,2,31,1,1,allow
55044,53,10792,53,196,102,94,2,31,1,1,allow
43463,443,25009,443,6919,1449,5470,21,186,12,9,allow
6881,56867,6114,56867,150,150,0,1,1199,1,0,allow
53497,443,53212,443,17187157,553524,16633633,18453,352,6098,12355,allow
52160,443,34670,443,6679,3424,3255,19,138,10,9,allow
57470,80,24424,80,230,82,148,4,1199,2,2,allow
64724,53,63918,53,319,97,222,4,31,2,2,allow
56079,53,1064,53,199,102,97,2,31,1,1,allow
57137,53,9212,53,279,96,183,4,32,2,2,allow
53281,80,26227,80,124,64,60,3,5,2,1,allow
49217,53,30696,53,282,93,189,4,45,2,2,allow
49260,53,23458,53,199,86,113,2,30,1,1,allow
65496,53,1852,53,198,94,104,2,31,1,1,allow
61829,443,61829,443,280243,73972,206271,309,206,142,167,allow
40072,80,29014,80,1298,370,928,12,15,6,6,allow
49217,53,45409,53,282,93,189,4,45,2,2,allow
49217,53,50933,53,282,93,189,4,45,2,2,allow
49420,80,13977,80,1985,657,1328,11,21,6,5,allow
64149,53,19971,53,301,108,193,4,49,2,2,allow
64961,53,7551,53,243,110,133,2,30,1,1,allow
64758,53,8387,53,734,94,640,2,30,1,1,allow
65260,53,12231,53,184,94,90,2,30,1,1,allow
64332,53,6045,53,167,86,81,2,30,1,1,allow
59883,17637,0,0,66,66,0,1,0,1,0,deny
25679,27189,0,0,62,62,0,1,0,1,0,deny
10333,22114,0,0,146,146,0,1,0,1,0,deny
50116,445,0,0,66,66,0,1,0,1,0,drop
52791,25174,0,0,66,66,0,1,0,1,0,deny
50113,445,0,0,66,66,0,1,0,1,0,drop
54280,3398,0,0,60,60,0,1,0,1,0,deny
56381,51505,0,0,146,146,0,1,0,1,0,deny
50002,445,0,0,70,70,0,1,0,1,0,drop
54976,10387,0,0,159,159,0,1,0,1,0,deny
1814,62413,0,0,66,66,0,1,0,1,0,deny
25583,2323,0,0,60,60,0,1,0,1,0,deny
54701,445,0,0,70,70,0,1,0,1,0,drop
54702,445,0,0,70,70,0,1,0,1,0,drop
54699,445,0,0,70,70,0,1,0,1,0,drop
50102,445,0,0,66,66,0,1,0,1,0,drop
50098,445,0,0,66,66,0,1,0,1,0,drop
50101,445,0,0,66,66,0,1,0,1,0,drop
50100,445,0,0,66,66,0,1,0,1,0,drop
50095,445,0,0,66,66,0,1,0,1,0,drop
50099,445,0,0,66,66,0,1,0,1,0,drop
50097,445,0,0,66,66,0,1,0,1,0,drop
50094,445,0,0,66,66,0,1,0,1,0,drop
20706,23718,0,0,62,62,0,1,0,1,0,deny
9696,16010,0,0,60,60,0,1,0,1,0,deny
50326,46824,0,0,66,66,0,1,0,1,0,deny
34086,25174,0,0,66,66,0,1,0,1,0,deny
64605,25174,0,0,66,66,0,1,0,1,0,deny
45952,22114,0,0,62,62,0,1,0,1,0,deny
49989,445,0,0,70,70,0,1,0,1,0,drop
55666,35440,0,0,66,66,0,1,0,1,0,deny
38852,37965,0,0,62,62,0,1,0,1,0,deny
12980,26296,0,0,145,145,0,1,0,1,0,deny
63690,64147,0,0,62,62,0,1,0,1,0,deny
20487,50584,0,0,62,62,0,1,0,1,0,deny
32381,50584,0,0,66,66,0,1,0,1,0,deny
49986,445,0,0,70,70,0,1,0,1,0,drop
54695,445,0,0,70,70,0,1,0,1,0,drop
54689,445,0,0,70,70,0,1,0,1,0,drop
54688,445,0,0,70,70,0,1,0,1,0,drop
54683,445,0,0,70,70,0,1,0,1,0,drop
59326,57470,0,0,74,74,0,1,0,1,0,deny
56688,25174,0,0,66,66,0,1,0,1,0,deny
36685,35440,0,0,62,62,0,1,0,1,0,deny
50080,445,0,0,66,66,0,1,0,1,0,drop
50082,445,0,0,66,66,0,1,0,1,0,drop
50079,445,0,0,66,66,0,1,0,1,0,drop
65216,35440,0,0,66,66,0,1,0,1,0,deny
65270,3855,0,0,78,78,0,1,0,1,0,deny
44913,36866,0,0,148,148,0,1,0,1,0,deny
49981,445,0,0,70,70,0,1,0,1,0,drop
44774,22114,0,0,62,62,0,1,0,1,0,deny
35974,23,0,0,60,60,0,1,0,1,0,deny
39586,22114,0,0,66,66,0,1,0,1,0,deny
54679,445,0,0,70,70,0,1,0,1,0,drop
49980,445,0,0,70,70,0,1,0,1,0,drop
1687,25174,0,0,146,146,0,1,0,1,0,deny
4323,64147,0,0,66,66,0,1,0,1,0,deny
54678,445,0,0,70,70,0,1,0,1,0,drop
54675,445,0,0,70,70,0,1,0,1,0,drop
54667,445,0,0,70,70,0,1,0,1,0,drop
49978,445,0,0,70,70,0,1,0,1,0,drop
443,50238,0,0,331,331,0,1,0,1,0,deny
41653,21247,0,0,62,62,0,1,0,1,0,deny
49590,57470,0,0,78,78,0,1,0,1,0,deny
49971,445,0,0,70,70,0,1,0,1,0,drop
63010,57470,0,0,145,145,0,1,0,1,0,deny
56039,50584,0,0,66,66,0,1,0,1,0,deny
54660,445,0,0,70,70,0,1,0,1,0,drop
54657,445,0,0,70,70,0,1,0,1,0,drop
54655,445,0,0,70,70,0,1,0,1,0,drop
49969,445,0,0,70,70,0,1,0,1,0,drop
58593,57470,0,0,62,62,0,1,0,1,0,deny
29009,25174,0,0,146,146,0,1,0,1,0,deny
59223,17500,0,0,66,66,0,1,0,1,0,deny
64808,62413,0,0,66,66,0,1,0,1,0,deny
61280,26467,0,0,62,62,0,1,0,1,0,deny
50068,445,0,0,66,66,0,1,0,1,0,drop
59225,57587,0,0,66,66,0,1,0,1,0,deny
8889,29421,0,0,60,60,0,1,0,1,0,deny
54555,25174,0,0,62,62,0,1,0,1,0,deny
2064,22114,0,0,62,62,0,1,0,1,0,deny
49968,445,0,0,70,70,0,1,0,1,0,drop
17171,22114,0,0,66,66,0,1,0,1,0,deny
49967,445,0,0,70,70,0,1,0,1,0,drop
49966,445,0,0,70,70,0,1,0,1,0,drop
54051,28793,0,0,66,66,0,1,0,1,0,deny
49961,445,0,0,70,70,0,1,0,1,0,drop
49960,445,0,0,70,70,0,1,0,1,0,drop
9327,57470,0,0,62,62,0,1,0,1,0,deny
49908,56205,0,0,62,62,0,1,0,1,0,deny
56713,25174,0,0,62,62,0,1,0,1,0,deny
56909,50584,0,0,62,62,0,1,0,1,0,deny
10004,57470,0,0,145,145,0,1,0,1,0,deny
58925,25174,0,0,66,66,0,1,0,1,0,deny
30129,37965,0,0,72,72,0,1,0,1,0,deny
54654,445,0,0,70,70,0,1,0,1,0,drop
59031,25174,0,0,62,62,0,1,0,1,0,deny
54650,445,0,0,70,70,0,1,0,1,0,drop
56906,50584,0,0,62,62,0,1,0,1,0,deny
27321,25174,0,0,62,62,0,1,0,1,0,deny
49948,445,0,0,70,70,0,1,0,1,0,drop
25363,22114,0,0,66,66,0,1,0,1,0,deny
49945,445,0,0,70,70,0,1,0,1,0,drop
1024,48817,0,0,145,145,0,1,0,1,0,deny
49938,445,0,0,70,70,0,1,0,1,0,drop
49937,445,0,0,70,70,0,1,0,1,0,drop
6778,50584,0,0,66,66,0,1,0,1,0,deny
49529,21247,0,0,62,62,0,1,0,1,0,deny
5787,44847,0,0,66,66,0,1,0,1,0,deny
50055,445,0,0,66,66,0,1,0,1,0,drop
50050,445,0,0,66,66,0,1,0,1,0,drop
9745,26467,0,0,62,62,0,1,0,1,0,deny
52838,37965,0,0,66,66,0,1,0,1,0,deny
52929,43890,0,0,62,62,0,1,0,1,0,deny
64882,43890,0,0,66,66,0,1,0,1,0,deny
49531,26467,0,0,62,62,0,1,0,1,0,deny
52604,25174,0,0,62,62,0,1,0,1,0,deny
50974,11392,0,0,66,66,0,1,0,1,0,deny
52318,22114,0,0,146,146,0,1,0,1,0,deny
54642,445,0,0,70,70,0,1,0,1,0,drop
54640,445,0,0,70,70,0,1,0,1,0,drop
54639,445,0,0,70,70,0,1,0,1,0,drop
54633,445,0,0,70,70,0,1,0,1,0,drop
51414,22,0,0,60,60,0,1,0,1,0,deny
49926,445,0,0,70,70,0,1,0,1,0,drop
50047,445,0,0,66,66,0,1,0,1,0,drop
53985,30188,0,0,66,66,0,1,0,1,0,deny
57015,42707,0,0,62,62,0,1,0,1,0,deny
57613,42707,0,0,66,66,0,1,0,1,0,deny
50033,445,0,0,66,66,0,1,0,1,0,drop
50043,445,0,0,66,66,0,1,0,1,0,drop
50031,445,0,0,66,66,0,1,0,1,0,drop
50036,445,0,0,66,66,0,1,0,1,0,drop
50040,445,0,0,66,66,0,1,0,1,0,drop
50038,445,0,0,66,66,0,1,0,1,0,drop
50035,445,0,0,66,66,0,1,0,1,0,drop
51544,44847,0,0,146,146,0,1,0,1,0,deny
58129,26467,0,0,62,62,0,1,0,1,0,deny
44414,23718,0,0,62,62,0,1,0,1,0,deny
54629,445,0,0,70,70,0,1,0,1,0,drop
19875,30170,0,0,145,145,0,1,0,1,0,deny
24160,37807,0,0,62,62,0,1,0,1,0,deny
54624,445,0,0,70,70,0,1,0,1,0,drop
54621,445,0,0,70,70,0,1,0,1,0,drop
54620,445,0,0,70,70,0,1,0,1,0,deny
59076,25174,0,0,62,62,0,1,0,1,0,deny
23122,26296,0,0,159,159,0,1,0,1,0,deny
49922,445,0,0,70,70,0,1,0,1,0,drop
45461,25174,0,0,146,146,0,1,0,1,0,deny
47063,15503,0,0,62,62,0,1,0,1,0,deny
49911,445,0,0,70,70,0,1,0,1,0,drop
49910,445,0,0,70,70,0,1,0,1,0,drop
49913,445,0,0,70,70,0,1,0,1,0,drop
32496,48817,0,0,148,148,0,1,0,1,0,deny
49476,443,31371,443,7254,1183,6071,19,152,9,10,allow
59336,80,59336,80,24437,12718,11719,41,15,16,25,allow
53981,29500,46111,29500,320,140,180,6,7,3,3,allow
58932,80,50607,80,2424,529,1895,11,75,6,5,allow
56785,443,49634,443,7905,1916,5989,20,15,11,9,allow
49774,80,42910,80,254,128,126,5,15,3,2,allow
64818,53,5282,53,174,89,85,2,30,1,1,allow
57309,53,11380,53,194,99,95,2,30,1,1,allow
59335,80,59335,80,107776,4213,103563,177,16,60,117,allow
26882,443,64713,443,10633,2672,7961,31,20,16,15,allow
55646,53,12583,53,780,93,687,2,30,1,1,allow
52025,443,47252,443,8034,2692,5342,15,16,8,7,allow
64322,53,46348,53,273,90,183,4,32,2,2,allow
54610,443,15531,443,19810,7047,12763,54,438,28,26,allow
56664,80,24275,80,1056,682,374,10,15,6,4,allow
43518,443,43518,443,4691,1784,2907,19,29,11,8,allow
64944,53,44996,53,749,89,660,2,30,1,1,allow
54601,443,45945,443,28386,15864,12522,59,471,31,28,allow
53976,52534,48449,52534,70,70,0,2,7,2,0,allow
44503,1433,44503,1433,150,60,90,2,9,1,1,allow
64701,53,64701,53,265,111,154,2,30,1,1,allow
53978,27091,3798,27091,320,140,180,6,7,3,3,allow
47904,443,37875,443,2766,1907,859,17,24,10,7,allow
53948,7370,62549,7370,70,70,0,1,5,1,0,allow
55856,53,9134,53,1410,93,1317,4,59,2,2,allow
49477,443,62857,443,8416,1247,7169,21,152,10,11,allow
61401,443,65147,443,33774,1880,31894,58,195,19,39,allow
49326,53,16602,53,186,95,91,2,30,1,1,allow
49224,53,33872,53,198,101,97,2,30,1,1,allow
55564,53,50276,53,775,103,672,2,30,1,1,allow
49582,53,42965,53,775,103,672,2,30,1,1,allow
60247,443,21929,443,12256,5443,6813,33,437,18,15,allow
56784,443,32848,443,7957,1968,5989,20,15,11,9,allow
62218,53,62218,53,253,99,154,2,33,1,1,allow
63855,80,40243,80,4529,1221,3308,14,75,8,6,allow
53947,867,6908,867,70,70,0,1,5,1,0,allow
56783,443,28364,443,7904,1915,5989,20,16,11,9,allow
49478,443,45550,443,4241,1161,3080,17,152,9,8,allow
5588,5588,0,0,3354,1792,1562,46,195,23,23,allow
48204,443,48204,443,4743,1836,2907,19,26,11,8,allow
41803,53,41803,53,243,104,139,2,30,1,1,allow
50497,53,25431,53,747,93,654,2,30,1,1,allow
55044,53,9273,53,192,98,94,2,30,1,1,allow
44125,53,44125,53,209,79,130,2,30,1,1,allow
64895,53,11867,53,198,101,97,2,30,1,1,allow
65220,53,41846,53,184,94,90,2,30,1,1,allow
63560,53,63560,53,209,79,130,2,30,1,1,allow
52487,443,29392,443,13734,3206,10528,26,150,13,13,allow
55257,53,9976,53,749,89,660,2,30,1,1,allow
65260,53,38236,53,184,94,90,2,30,1,1,allow
49901,53,54026,53,776,102,674,2,30,1,1,allow
65224,53,48832,53,758,93,665,2,30,1,1,allow
55087,53,55975,53,182,93,89,2,31,1,1,allow
64935,53,11961,53,186,95,91,2,31,1,1,allow
17119,53,17119,53,217,87,130,2,30,1,1,allow
55646,53,54569,53,182,93,89,2,30,1,1,allow
57188,53,44023,53,186,95,91,2,30,1,1,allow
57130,53,10466,53,778,103,675,2,31,1,1,allow
55530,53,3862,53,758,93,665,2,31,1,1,allow
36017,53,46700,53,198,93,105,2,31,1,1,allow
45459,53,25942,53,198,93,105,2,31,1,1,allow
54994,53,24459,53,202,103,99,2,31,1,1,allow
57956,443,29445,443,7842,2164,5678,48,5441,20,28,allow
21133,11342,54289,11342,478,149,329,2,1200,1,1,allow
55627,53,20054,53,174,89,85,2,31,1,1,allow
64930,53,64696,53,186,95,91,2,31,1,1,allow
65377,53,42499,53,186,95,91,2,31,1,1,allow
55377,53,47893,53,190,97,93,2,31,1,1,allow
55654,53,20360,53,726,85,641,2,31,1,1,allow
55932,53,16236,53,202,103,99,2,31,1,1,allow
56389,53,11725,53,774,101,673,2,31,1,1,allow
49237,53,49766,53,735,88,647,2,31,1,1,allow
49629,53,36000,53,196,100,96,2,31,1,1,allow
51444,443,39755,443,3283,951,2332,13,135,6,7,allow
56790,53,5516,53,747,92,655,2,31,1,1,allow
57577,443,27380,443,39421,4980,34441,57,144,23,34,allow
35722,443,40129,443,13035,2590,10445,27,125,14,13,allow
56180,53,32734,53,200,102,98,2,31,1,1,allow
49343,53,32839,53,202,103,99,2,31,1,1,allow
6881,6882,26617,6882,231,111,120,2,1200,1,1,allow
44290,53,27070,53,240,76,164,2,31,1,1,allow
19037,53,19037,53,227,89,138,2,31,1,1,allow
55005,53,54882,53,182,93,89,2,31,1,1,allow
55637,53,24847,53,202,103,99,2,31,1,1,allow
55675,53,42703,53,196,100,96,2,31,1,1,allow
56002,53,4276,53,771,101,670,2,31,1,1,allow
55014,53,9068,53,716,95,621,2,31,1,1,allow
57051,53,27315,53,170,87,83,2,31,1,1,allow
64752,53,55237,53,190,97,93,2,31,1,1,allow
56317,53,55686,53,182,93,89,2,31,1,1,allow
56569,53,23106,53,182,93,89,2,31,1,1,allow
57137,53,2649,53,279,96,183,4,31,2,2,allow
65373,53,60314,53,194,99,95,2,31,1,1,allow
57401,53,41706,53,174,89,85,2,31,1,1,allow
65257,443,11599,443,4019,708,3311,16,137,7,9,allow
49909,445,0,0,70,70,0,1,0,1,0,deny
52128,37807,0,0,66,66,0,1,0,1,0,deny
48016,57470,0,0,62,62,0,1,0,1,0,deny
49905,445,0,0,70,70,0,1,0,1,0,drop
60645,35440,0,0,62,62,0,1,0,1,0,deny
1712,23,0,0,60,60,0,1,0,1,0,deny
4545,1900,0,0,136,136,0,1,0,1,0,deny
4545,1900,0,0,136,136,0,1,0,1,0,deny
14360,64147,0,0,62,62,0,1,0,1,0,deny
9226,57470,0,0,66,66,0,1,0,1,0,deny
54619,445,0,0,70,70,0,1,0,1,0,drop
54615,445,0,0,70,70,0,1,0,1,0,drop
54612,445,0,0,70,70,0,1,0,1,0,drop
65200,51050,0,0,66,66,0,1,0,1,0,deny
54611,445,0,0,70,70,0,1,0,1,0,drop
13020,26467,0,0,62,62,0,1,0,1,0,deny
59347,57470,0,0,62,62,0,1,0,1,0,deny
50023,445,0,0,66,66,0,1,0,1,0,drop
65530,53,49295,53,381,88,293,4,31,2,2,allow
42753,443,38036,443,10114,3154,6960,27,20,16,11,allow
56660,53,34940,53,183,94,89,2,30,1,1,allow
64712,53,32713,53,210,102,108,2,30,1,1,allow
53871,443,15841,443,7797,1807,5990,15,135,7,8,allow
64469,53,32950,53,342,97,245,4,42,2,2,allow
53935,42874,31408,42874,1973,1021,952,10,15,6,4,allow
49907,53,54297,53,199,102,97,2,29,1,1,allow
55044,53,52145,53,196,102,94,2,29,1,1,allow
64146,53,19064,53,212,102,110,2,29,1,1,allow
57188,53,20332,53,193,102,91,2,30,1,1,allow
64332,53,46508,53,167,86,81,2,30,1,1,allow
56724,53,52473,53,195,102,93,2,30,1,1,allow
53938,15926,50841,15926,492,306,186,8,15,5,3,allow
34687,443,63653,443,3120,1862,1258,18,15,11,7,allow
49504,7275,25597,7275,8962,1625,7337,28,16,15,13,allow
45195,80,65375,80,1115,534,581,12,15,7,5,allow
64322,53,46298,53,273,90,183,4,32,2,2,allow
49430,53,28668,53,332,99,233,4,45,2,2,allow
49548,443,63354,443,8912,2297,6615,43,255,20,23,allow
65186,53,51165,53,521,90,431,4,43,2,2,allow
57188,53,35661,53,193,102,91,2,29,1,1,allow
60807,40010,25177,40010,316,136,180,6,5,3,3,allow
64217,53,31853,53,193,102,91,2,29,1,1,allow
51418,443,51418,443,4742,1835,2907,19,30,11,8,allow
63957,53,44993,53,214,94,120,2,29,1,1,allow
56258,53,14638,53,167,86,81,2,29,1,1,allow
123,123,46819,123,184,94,90,2,29,1,1,allow
64930,53,29648,53,193,102,91,2,29,1,1,allow
57411,53,32246,53,196,102,94,2,29,1,1,allow
49512,53,26273,53,195,102,93,2,30,1,1,allow
56724,53,34585,53,308,97,211,4,45,2,2,allow
36897,443,23482,443,6351,4202,2149,35,94,18,17,allow
49472,443,5541,443,3897,1306,2591,17,158,9,8,allow
55122,443,57128,443,17936,14273,3663,59,122,33,26,allow
17824,53,17824,53,244,98,146,2,32,1,1,allow
46102,80,6915,80,70,70,0,2,5,2,0,allow
38524,443,15396,443,5846879,177697,5669182,6043,41,2261,3782,allow
64846,53,55957,53,785,110,675,2,30,1,1,allow
64895,53,65185,53,199,102,97,2,30,1,1,allow
49475,443,44120,443,10402,1945,8457,24,158,11,13,allow
49655,53,33441,53,209,110,99,2,30,1,1,allow
51443,443,11818,443,4773,2454,2319,14,135,7,7,allow
55005,53,64520,53,183,94,89,2,30,1,1,allow
43357,443,61952,443,146374,13143,133231,238,131,116,122,allow
38143,443,25496,443,84884,5896,78988,128,36,66,62,allow
49256,443,30277,443,10619,3257,7362,29,361,13,16,allow
64978,53,11316,53,198,102,96,2,30,1,1,allow
36022,443,7743,443,7257,1619,5638,22,275,11,11,allow
64816,123,36690,123,184,94,90,2,30,1,1,allow
57309,53,8457,53,197,102,95,2,30,1,1,allow
9166,53,9166,53,244,98,146,2,32,1,1,allow
65220,53,17734,53,303,94,209,4,32,2,2,allow
52165,80,35107,80,1945,1002,943,11,19,7,4,allow
10014,40026,21058,40026,156,94,62,2,30,1,1,allow
55087,53,26632,53,183,94,89,2,30,1,1,allow
64685,53,47486,53,785,110,675,2,30,1,1,allow
52082,80,6337,80,4560,3934,626,11,29,6,5,allow
53931,55300,33330,55300,492,306,186,8,15,5,3,allow
51651,80,41220,80,8100,4781,3319,23,166,12,11,allow
49872,443,65245,443,3120,1862,1258,18,15,11,7,allow
49950,443,56465,443,6770,2219,4551,21,89,11,10,allow
10008,40004,11500,40004,156,94,62,2,30,1,1,allow
64978,53,20864,53,198,102,96,2,30,1,1,allow
64818,53,60686,53,179,94,85,2,30,1,1,allow
49520,53,1147,53,209,110,99,2,30,1,1,allow
55043,443,10001,443,36707,3750,32957,54,60,24,30,allow
53937,28506,44986,28506,492,306,186,8,15,5,3,allow
65144,53,32702,53,653,86,567,4,46,2,2,allow
51329,443,55771,443,2019,1219,800,15,17,8,7,allow
65521,443,8234,443,92427,4519,87908,105,15,39,66,allow
57137,53,36481,53,279,96,183,4,31,2,2,allow
60803,80,16464,80,254,128,126,5,15,3,2,allow
46101,80,15092,80,70,70,0,2,5,2,0,allow
53939,9504,53453,9504,492,306,186,8,15,5,3,allow
49491,53,15104,53,492,94,398,4,45,2,2,allow
65520,443,22541,443,438102,12780,425322,449,15,157,292,allow
49196,53,15790,53,181,94,87,2,33,1,1,allow
53979,26308,39677,26308,70,70,0,2,7,2,0,allow
49888,53,58972,53,363,97,266,4,34,2,2,allow
43495,5223,36493,5223,142,142,0,1,4,1,0,allow
38474,28678,45201,28678,1806,1806,0,22,224,22,0,allow
49443,443,17566,443,70988,47020,23968,152,652,79,73,allow
49474,443,32026,443,10315,2018,8297,24,158,12,12,allow
50132,443,60688,443,8162,1364,6798,22,16,11,11,allow
49480,443,58193,443,1160,638,522,13,113,7,6,allow
65220,53,7048,53,184,94,90,2,29,1,1,allow
49473,443,31044,443,3990,1296,2694,17,158,9,8,allow
56724,53,41138,53,195,102,93,2,29,1,1,allow
49629,53,2341,53,198,102,96,2,29,1,1,allow
59005,443,56215,443,6306,1780,4526,28,33,14,14,allow
64895,53,23891,53,199,102,97,2,29,1,1,allow
55026,53,39957,53,164,86,78,2,29,1,1,allow
49483,53,61034,53,319,94,225,2,29,1,1,allow
57309,53,6657,53,197,102,95,2,29,1,1,allow
65496,53,50374,53,183,94,89,2,30,1,1,allow
64937,53,43310,53,183,94,89,2,29,1,1,allow
55646,53,3427,53,183,94,89,2,30,1,1,allow
10013,40024,56811,40024,156,94,62,2,30,1,1,allow
58868,443,58939,443,239435,36478,202957,319,111,133,186,allow
64355,53,3739,53,213,102,111,2,30,1,1,allow
65496,53,50300,53,183,94,89,2,30,1,1,allow
39886,443,46428,443,315567,15410,300157,404,46,189,215,allow
55600,53,4581,53,209,110,99,2,30,1,1,allow
55939,53,57194,53,193,102,91,2,31,1,1,allow
50137,53,53286,53,448,184,264,6,31,3,3,allow
54979,53,64417,53,183,94,89,2,30,1,1,allow
33264,53,24560,53,164,78,86,2,30,1,1,allow
57375,53,3463,53,198,102,96,2,30,1,1,allow
55637,53,12301,53,209,110,99,2,30,1,1,allow
65373,53,2835,53,197,102,95,2,30,1,1,allow
57270,53,64569,53,200,102,98,2,30,1,1,allow
64930,53,28381,53,193,102,91,2,31,1,1,allow
55477,53,61973,53,183,94,89,2,31,1,1,allow
55087,53,19901,53,183,94,89,2,31,1,1,allow
64578,53,31792,53,193,102,91,2,31,1,1,allow
57067,53,21723,53,183,94,89,2,31,1,1,allow
55675,53,21127,53,198,102,96,2,30,1,1,allow
50522,443,12346,443,13347,4662,8685,40,202,24,16,allow
39343,443,19498,443,8562,1634,6928,27,26,13,14,allow
46103,80,5613,80,70,70,0,2,5,2,0,allow
65260,53,28900,53,184,94,90,2,30,1,1,allow
54979,53,11444,53,183,94,89,2,30,1,1,allow
55060,53,22947,53,195,102,93,2,30,1,1,allow
56317,53,35779,53,183,94,89,2,31,1,1,allow
49326,53,62713,53,193,102,91,2,30,1,1,allow
61226,443,29248,443,3135,1603,1532,22,632,7,15,allow
49224,53,25602,53,199,102,97,2,30,1,1,allow
64332,53,40499,53,167,86,81,2,30,1,1,allow
55224,53,5980,53,209,110,99,2,30,1,1,allow
35550,53,45606,53,164,78,86,2,30,1,1,allow
55224,53,33137,53,209,110,99,2,30,1,1,allow
49376,53,19245,53,209,110,99,2,30,1,1,allow
55346,443,44978,443,13181,6041,7140,60,410,27,33,allow
57401,53,56934,53,179,94,85,2,31,1,1,allow
36926,53,54098,53,164,78,86,2,30,1,1,allow
52092,80,65314,80,3163,716,2447,12,28,7,5,allow
21432,53,21432,53,244,98,146,2,32,1,1,allow
14950,53,14950,53,414,268,146,3,32,2,1,allow
65462,53,20337,53,196,102,94,2,33,1,1,allow
53174,41442,6472,41442,70,70,0,2,8,2,0,allow
46099,80,56104,80,70,70,0,2,5,2,0,allow
65350,53,8382,53,390,105,285,4,42,2,2,allow
49479,443,58848,443,4591,2492,2099,20,113,11,9,allow
43151,443,30299,443,9462,4488,4974,28,96,13,15,allow
49949,443,7206,443,4712,908,3804,18,89,9,9,allow
50676,80,23134,80,13054,6885,6169,27,26,13,14,allow
56660,53,40707,53,183,94,89,2,30,1,1,allow
10009,40008,62477,40008,156,94,62,2,30,1,1,allow
49782,53,28643,53,228,86,142,2,30,1,1,allow
49269,53,11598,53,254,102,152,2,30,1,1,allow
49655,53,32746,53,209,110,99,2,30,1,1,allow
64911,53,65363,53,232,86,146,2,30,1,1,allow
46902,123,43333,123,184,94,90,2,30,1,1,allow
57411,53,35330,53,196,102,94,2,30,1,1,allow
64217,53,33943,53,193,102,91,2,30,1,1,allow
55820,53,49367,53,194,102,92,2,30,1,1,allow
56317,53,26526,53,183,94,89,2,30,1,1,allow
55377,53,41334,53,195,102,93,2,30,1,1,allow
49734,53,51597,53,259,110,149,2,30,1,1,allow
52859,53,16412,53,164,78,86,2,30,1,1,allow
55477,53,62006,53,183,94,89,2,30,1,1,allow
64637,53,39523,53,194,102,92,2,31,1,1,allow
46273,5228,19288,5228,5239,1558,3681,27,4020,9,18,allow
49277,53,15554,53,199,102,97,2,31,1,1,allow
49488,53,28678,53,194,102,92,2,31,1,1,allow
62547,443,41349,443,54095,6413,47682,151,450,61,90,allow
40590,443,36504,443,2965,1650,1315,24,275,12,12,allow
49376,53,53542,53,209,110,99,2,30,1,1,allow
65519,443,19659,443,436359,12780,423579,448,16,157,291,allow
50296,53,13683,53,183,94,89,2,30,1,1,allow
57037,443,39402,443,6847,1658,5189,21,25,12,9,allow
42060,53,44916,53,164,78,86,2,30,1,1,allow
55675,53,47376,53,198,102,96,2,30,1,1,allow
57375,53,63119,53,198,102,96,2,30,1,1,allow
49546,53,30362,53,193,102,91,2,30,1,1,allow
55060,53,16844,53,195,102,93,2,30,1,1,allow
57270,53,53677,53,200,102,98,2,31,1,1,allow
43093,53,41079,53,242,78,164,2,30,1,1,allow
65385,53,41370,53,259,110,149,2,30,1,1,allow
64869,53,31516,53,195,94,101,2,30,1,1,allow
65373,53,50644,53,197,102,95,2,31,1,1,allow
56754,53,50250,53,209,110,99,2,30,1,1,allow
2321,53,2321,53,216,98,118,2,30,1,1,allow
65356,53,60802,53,197,94,103,2,31,1,1,allow
54994,53,25626,53,209,110,99,2,31,1,1,allow
65106,53,25747,53,772,102,670,2,30,1,1,allow
64899,53,5067,53,199,102,97,2,31,1,1,allow
6881,6881,40398,6881,238,118,120,2,1199,1,1,allow
41459,80,32156,80,1866,1032,834,11,150,6,5,allow
37965,61085,23932,61085,132,132,0,3,1199,3,0,allow
37475,443,1375,443,4403,2160,2243,14,136,7,7,allow
55627,53,32877,53,179,94,85,2,30,1,1,allow
65336,53,55246,53,200,102,98,2,30,1,1,allow
56754,53,42272,53,209,110,99,2,30,1,1,allow
64899,53,16096,53,199,102,97,2,30,1,1,allow
59366,53,31679,53,242,78,164,2,30,1,1,allow
59951,53,55881,53,237,86,151,2,30,1,1,allow
50437,53,50192,53,413,170,243,6,30,3,3,allow
55377,53,45027,53,195,102,93,2,30,1,1,allow
49907,53,52196,53,199,102,97,2,30,1,1,allow
55763,53,36537,53,197,94,103,2,31,1,1,allow
64957,53,39699,53,196,102,94,2,30,1,1,allow
49294,53,26484,53,723,102,621,2,30,1,1,allow
49680,53,31932,53,749,94,655,2,30,1,1,allow
65403,53,11897,53,199,102,97,2,31,1,1,allow
49629,53,65217,53,198,102,96,2,31,1,1,allow
38149,53,54452,53,199,94,105,2,31,1,1,allow
55932,53,30562,53,209,110,99,2,31,1,1,allow
49539,53,54919,53,198,94,104,2,31,1,1,allow
64957,53,56586,53,196,102,94,2,31,1,1,allow
63465,443,3023,443,3942,1406,2536,18,135,8,10,allow
53974,26108,3464,26108,70,70,0,2,8,2,0,allow
64083,63666,21856,63666,66,66,0,2,8,2,0,allow
10007,40005,19403,40005,148,86,62,2,31,1,1,allow
64322,53,37052,53,273,90,183,4,32,2,2,allow
64077,20208,16294,20208,66,66,0,2,8,2,0,allow
50711,443,37437,443,2952,1548,1404,18,16,9,9,allow
65377,53,64134,53,404,95,309,4,49,2,2,allow
50021,445,0,0,66,66,0,1,0,1,0,drop
50019,445,0,0,66,66,0,1,0,1,0,drop
31130,30188,0,0,62,62,0,1,0,1,0,deny
50018,445,0,0,66,66,0,1,0,1,0,drop
1025,50584,0,0,62,62,0,1,0,1,0,deny
49900,445,0,0,70,70,0,1,0,1,0,drop
64035,25174,0,0,146,146,0,1,0,1,0,deny
15998,36829,0,0,62,62,0,1,0,1,0,deny
54610,445,0,0,70,70,0,1,0,1,0,drop
29742,50584,0,0,62,62,0,1,0,1,0,deny
54602,445,0,0,70,70,0,1,0,1,0,drop
54594,445,0,0,70,70,0,1,0,1,0,drop
49892,445,0,0,70,70,0,1,0,1,0,drop
5685,35440,0,0,66,66,0,1,0,1,0,deny
59018,22114,0,0,146,146,0,1,0,1,0,deny
47342,36237,0,0,66,66,0,1,0,1,0,deny
49890,445,0,0,70,70,0,1,0,1,0,drop
26287,56205,0,0,66,66,0,1,0,1,0,deny
50007,445,0,0,66,66,0,1,0,1,0,drop
443,45788,0,0,332,332,0,1,0,1,0,deny
49885,445,0,0,70,70,0,1,0,1,0,drop
52236,25174,0,0,62,62,0,1,0,1,0,deny
49884,445,0,0,70,70,0,1,0,1,0,drop
17306,25174,0,0,66,66,0,1,0,1,0,deny
49999,445,0,0,66,66,0,1,0,1,0,drop
54583,445,0,0,70,70,0,1,0,1,0,drop
3456,11392,0,0,66,66,0,1,0,1,0,deny
49880,445,0,0,70,70,0,1,0,1,0,drop
62642,25174,0,0,62,62,0,1,0,1,0,deny
11136,19910,0,0,62,62,0,1,0,1,0,deny
59977,30188,0,0,66,66,0,1,0,1,0,deny
49997,445,0,0,66,66,0,1,0,1,0,drop
49879,445,0,0,70,70,0,1,0,1,0,drop
37008,42707,0,0,62,62,0,1,0,1,0,deny
26762,22114,0,0,62,62,0,1,0,1,0,deny
60141,30188,0,0,66,66,0,1,0,1,0,deny
57539,44847,0,0,62,62,0,1,0,1,0,deny
52812,25174,0,0,66,66,0,1,0,1,0,deny
22263,30188,0,0,66,66,0,1,0,1,0,deny
37959,3855,0,0,72,72,0,1,0,1,0,deny
46516,80,0,0,60,60,0,1,0,1,0,deny
49990,445,0,0,66,66,0,1,0,1,0,drop
57410,25174,0,0,62,62,0,1,0,1,0,deny
49982,445,0,0,66,66,0,1,0,1,0,drop
9231,3389,0,0,66,66,0,1,0,1,0,deny
40054,62413,0,0,62,62,0,1,0,1,0,deny
59345,25174,0,0,62,62,0,1,0,1,0,deny
49874,445,0,0,70,70,0,1,0,1,0,drop
18173,25174,0,0,62,62,0,1,0,1,0,deny
63208,30975,0,0,148,148,0,1,0,1,0,deny
45941,23386,0,0,60,60,0,1,0,1,0,deny
63002,22114,0,0,66,66,0,1,0,1,0,deny
49786,25174,0,0,66,66,0,1,0,1,0,deny
5611,25174,0,0,146,146,0,1,0,1,0,deny
18652,64147,0,0,62,62,0,1,0,1,0,deny
10754,28793,0,0,66,66,0,1,0,1,0,deny
27824,51505,0,0,146,146,0,1,0,1,0,deny
39617,50584,0,0,146,146,0,1,0,1,0,deny
54573,445,0,0,70,70,0,1,0,1,0,drop
54572,445,0,0,70,70,0,1,0,1,0,drop
54571,445,0,0,70,70,0,1,0,1,0,drop
49966,445,0,0,66,66,0,1,0,1,0,drop
49973,445,0,0,66,66,0,1,0,1,0,drop
49971,445,0,0,66,66,0,1,0,1,0,drop
49972,445,0,0,66,66,0,1,0,1,0,drop
49968,445,0,0,66,66,0,1,0,1,0,drop
49974,445,0,0,66,66,0,1,0,1,0,drop
49970,445,0,0,66,66,0,1,0,1,0,drop
49969,445,0,0,66,66,0,1,0,1,0,drop
42973,57470,0,0,62,62,0,1,0,1,0,deny
36357,25174,0,0,66,66,0,1,0,1,0,deny
53579,42707,0,0,66,66,0,1,0,1,0,deny
56876,11392,0,0,66,66,0,1,0,1,0,deny
49861,445,0,0,70,70,0,1,0,1,0,drop
60883,64147,0,0,74,74,0,1,0,1,0,deny
9731,64147,0,0,62,62,0,1,0,1,0,deny
30046,15503,0,0,62,62,0,1,0,1,0,deny
49858,445,0,0,70,70,0,1,0,1,0,drop
52340,22114,0,0,66,66,0,1,0,1,0,deny
48706,23393,0,0,60,60,0,1,0,1,0,deny
48706,23393,0,0,60,60,0,1,0,1,0,deny
65270,3855,0,0,78,78,0,1,0,1,0,deny
49182,21247,0,0,62,62,0,1,0,1,0,deny
54569,445,0,0,70,70,0,1,0,1,0,drop
54567,445,0,0,70,70,0,1,0,1,0,drop
54563,445,0,0,70,70,0,1,0,1,0,drop
54559,445,0,0,70,70,0,1,0,1,0,drop
43645,39004,0,0,145,145,0,1,0,1,0,deny
49954,445,0,0,66,66,0,1,0,1,0,drop
49952,445,0,0,66,66,0,1,0,1,0,drop
49953,445,0,0,66,66,0,1,0,1,0,drop
49853,445,0,0,70,70,0,1,0,1,0,drop
49852,445,0,0,70,70,0,1,0,1,0,drop
34212,11392,0,0,66,66,0,1,0,1,0,deny
49850,445,0,0,70,70,0,1,0,1,0,drop
36770,56205,0,0,62,62,0,1,0,1,0,deny
54551,445,0,0,70,70,0,1,0,1,0,drop
64406,25174,0,0,66,66,0,1,0,1,0,deny
54550,445,0,0,70,70,0,1,0,1,0,drop
54547,445,0,0,70,70,0,1,0,1,0,drop
54539,445,0,0,70,70,0,1,0,1,0,drop
49356,50584,0,0,62,62,0,1,0,1,0,deny
34993,15503,0,0,62,62,0,1,0,1,0,deny
50360,37965,0,0,66,66,0,1,0,1,0,deny
49590,57470,0,0,78,78,0,1,0,1,0,deny
7342,22114,0,0,62,62,0,1,0,1,0,deny
12785,2323,0,0,60,60,0,1,0,1,0,deny
49843,445,0,0,70,70,0,1,0,1,0,drop
50127,64147,0,0,66,66,0,1,0,1,0,deny
33453,64147,0,0,62,62,0,1,0,1,0,deny
35589,25174,0,0,66,66,0,1,0,1,0,deny
49841,445,0,0,70,70,0,1,0,1,0,drop
54531,445,0,0,70,70,0,1,0,1,0,drop
54529,445,0,0,70,70,0,1,0,1,0,drop
54530,445,0,0,70,70,0,1,0,1,0,drop
37749,15503,0,0,62,62,0,1,0,1,0,deny
5223,32965,0,0,66,66,0,1,0,1,0,deny
49840,445,0,0,70,70,0,1,0,1,0,drop
19933,35440,0,0,62,62,0,1,0,1,0,deny
52819,15503,0,0,66,66,0,1,0,1,0,deny
23578,2323,0,0,60,60,0,1,0,1,0,deny
49839,445,0,0,70,70,0,1,0,1,0,deny
49940,445,0,0,66,66,0,1,0,1,0,drop
49838,445,0,0,70,70,0,1,0,1,0,drop
10248,21247,0,0,146,146,0,1,0,1,0,deny
49832,445,0,0,70,70,0,1,0,1,0,drop
49834,445,0,0,70,70,0,1,0,1,0,drop
56067,25174,0,0,62,62,0,1,0,1,0,deny
12290,22114,0,0,62,62,0,1,0,1,0,deny
55994,22114,0,0,66,66,0,1,0,1,0,deny
49677,25174,0,0,66,66,0,1,0,1,0,deny
49820,445,0,0,70,70,0,1,0,1,0,drop
49818,445,0,0,70,70,0,1,0,1,0,drop
49164,25174,0,0,146,146,0,1,0,1,0,deny
54526,445,0,0,70,70,0,1,0,1,0,drop
49813,445,0,0,70,70,0,1,0,1,0,drop
49809,445,0,0,70,70,0,1,0,1,0,drop
49808,445,0,0,70,70,0,1,0,1,0,drop
35949,31573,0,0,146,146,0,1,0,1,0,deny
54525,445,0,0,70,70,0,1,0,1,0,drop
41677,57470,0,0,66,66,0,1,0,1,0,deny
31675,19473,0,0,62,62,0,1,0,1,0,deny
21322,25174,0,0,62,62,0,1,0,1,0,deny
60245,25174,0,0,62,62,0,1,0,1,0,deny
27745,50584,0,0,62,62,0,1,0,1,0,deny
25565,62979,0,0,60,60,0,1,0,1,0,deny
49927,445,0,0,66,66,0,1,0,1,0,drop
49924,445,0,0,66,66,0,1,0,1,0,drop
6889,65473,0,0,143,143,0,1,0,1,0,deny
2850,64147,0,0,66,66,0,1,0,1,0,deny
60571,26467,0,0,62,62,0,1,0,1,0,deny
27448,22114,0,0,62,62,0,1,0,1,0,deny
57677,57470,0,0,62,62,0,1,0,1,0,deny
49797,445,0,0,70,70,0,1,0,1,0,drop
54516,445,0,0,70,70,0,1,0,1,0,drop
54510,445,0,0,70,70,0,1,0,1,0,drop
54506,445,0,0,70,70,0,1,0,1,0,drop
54508,445,0,0,70,70,0,1,0,1,0,drop
58399,56205,0,0,62,62,0,1,0,1,0,deny
49920,445,0,0,66,66,0,1,0,1,0,drop
23873,30188,0,0,62,62,0,1,0,1,0,deny
40780,80,6352,80,1155,781,374,10,16,6,4,allow
38753,443,17390,443,29887852,586245,29301607,27419,299,7975,19444,allow
50038,443,53552,443,2652,1566,1086,15,86,9,6,allow
52370,443,22287,443,7058,2421,4637,21,17,11,10,allow
64080,11801,22050,11801,66,66,0,2,8,2,0,allow
54280,3396,54280,3396,60,60,0,1,5,1,0,allow
64117,80,61513,80,5827,773,5054,16,73,9,7,allow
56781,443,59501,443,7870,1881,5989,20,15,11,9,allow
55999,53,41388,53,774,101,673,2,30,1,1,allow
53751,53,53289,53,578,286,292,9,16,5,4,allow
45123,15000,48758,15000,130,70,60,2,6,1,1,allow
34079,443,61674,443,14068,7909,6159,37,82,23,14,allow
55046,443,8809,443,23425,10763,12662,57,48,31,26,allow
52172,80,27126,80,362,240,122,7,17,5,2,allow
64957,53,47584,53,192,98,94,2,30,1,1,allow
57067,53,57189,53,182,93,89,2,30,1,1,allow
56780,443,59581,443,7922,1933,5989,20,16,11,9,allow
40039,80,57862,80,1155,781,374,10,15,6,4,allow
41620,53,41620,53,257,101,156,2,32,1,1,allow
59924,443,2445,443,682,310,372,12,68,6,6,allow
47169,15000,52806,15000,130,70,60,2,5,1,1,allow
63993,17866,56109,17866,4607,2045,2562,24,45,14,10,allow
52169,80,44471,80,362,240,122,7,17,5,2,allow
34964,80,34964,80,2889,1482,1407,10,15,6,4,allow
50014,443,7099,443,5644,3210,2434,22,86,13,9,allow
52213,56682,21348,56682,70,70,0,2,6,2,0,allow
48276,15000,65405,15000,130,70,60,2,5,1,1,allow
58288,443,58288,443,4661,1754,2907,19,26,11,8,allow
55555,53,19089,53,778,103,675,2,30,1,1,allow
50336,53,11367,53,240,76,164,2,30,1,1,allow
49618,53,25113,53,774,101,673,2,30,1,1,allow
56330,53,9857,53,271,95,176,4,48,2,2,allow
64899,53,35861,53,198,101,97,2,30,1,1,allow
10005,40022,7541,40022,151,89,62,2,30,1,1,allow
56715,53,5613,53,1384,88,1296,4,32,2,2,allow
53971,18810,62225,18810,70,70,0,2,8,2,0,allow
57750,15000,45543,15000,130,70,60,2,5,1,1,allow
52181,1038,36423,1038,66,66,0,1,5,1,0,allow
52169,59681,49857,59681,66,66,0,1,5,1,0,allow
51619,15000,21734,15000,130,70,60,2,6,1,1,allow
49248,80,49248,80,163556,12140,151416,207,22,97,110,allow
49996,443,63041,443,19523,5346,14177,37,87,17,20,allow
52170,45144,10407,45144,66,66,0,1,5,1,0,allow
57452,53,53868,53,776,102,674,2,30,1,1,allow
56385,53,50019,53,249,85,164,4,56,2,2,allow
64559,53,6054,53,196,100,96,2,31,1,1,allow
64578,53,53350,53,186,95,91,2,31,1,1,allow
49246,80,49246,80,133699,9415,124284,169,23,77,92,allow
52170,80,60754,80,362,240,122,7,17,5,2,allow
41958,5222,34545,5222,2380,1500,880,24,130,13,11,allow
52173,80,40738,80,362,240,122,7,17,5,2,allow
55652,443,55652,443,141647,19296,122351,203,55,102,101,allow
44048,443,44048,443,4401,1494,2907,19,29,11,8,allow
56782,443,26053,443,7956,1967,5989,20,15,11,9,allow
49323,443,62942,443,9802,2846,6956,33,79,15,18,allow
64340,53,64340,53,237,91,146,2,33,1,1,allow
53967,54589,5598,54589,70,70,0,2,8,2,0,allow
49247,80,49247,80,135755,6750,129005,160,22,68,92,allow
36586,3142,36586,3142,138,78,60,2,6,1,1,allow
53839,15000,61295,15000,130,70,60,2,5,1,1,allow
47276,443,53172,443,190,70,120,4,15,2,2,allow
20689,53,20689,53,237,91,146,2,33,1,1,allow
61822,53,61822,53,237,91,146,2,33,1,1,allow
49249,80,49249,80,265842,14126,251716,311,22,136,175,allow
11295,40002,55023,40002,209,85,124,4,54,2,2,allow
60252,443,61357,443,5169,790,4379,16,72,8,8,allow
52173,44632,6542,44632,156,66,90,2,5,1,1,allow
50040,443,40234,443,1097,654,443,12,86,7,5,allow
50041,443,57357,443,1097,654,443,12,86,7,5,allow
57356,53,60821,53,198,101,97,2,30,1,1,allow
53417,443,8874,443,9193,6294,2899,27,121,14,13,allow
57727,443,62460,443,54944,4374,50570,88,361,44,44,allow
65370,53,60115,53,186,95,91,2,31,1,1,allow
65346,53,45745,53,182,93,89,2,31,1,1,allow
64204,53,3889,53,186,95,91,2,31,1,1,allow
55933,53,2538,53,180,92,88,2,30,1,1,allow
51052,53,0,0,82,82,0,1,30,1,0,allow
50356,53,7944,53,176,90,86,2,31,1,1,allow
49382,53,52485,53,200,102,98,2,31,1,1,allow
49671,53,37210,53,182,93,89,2,31,1,1,allow
65127,53,25987,53,780,104,676,2,31,1,1,allow
55436,53,43899,53,774,101,673,2,30,1,1,allow
56672,53,28355,53,198,101,97,2,31,1,1,allow
64569,53,10194,53,182,93,89,2,31,1,1,allow
57035,53,19895,53,198,101,97,2,31,1,1,allow
49798,53,59206,53,192,98,94,2,31,1,1,allow
50265,44822,26867,44822,149,149,0,1,1200,1,0,allow
64048,53,43444,53,202,103,99,2,31,1,1,allow
49869,53,53726,53,202,103,99,2,31,1,1,allow
55951,53,2710,53,780,104,676,2,31,1,1,allow
56951,53,25007,53,198,101,97,2,31,1,1,allow
63278,443,14519,443,11570,3553,8017,24,134,10,14,allow
57574,443,28846,443,3595,1957,1638,17,361,9,8,allow
59012,443,51105,443,6278,3531,2747,23,122,12,11,allow
56941,53,4680,53,192,98,94,2,31,1,1,allow
65292,53,23690,53,190,97,93,2,31,1,1,allow
49380,53,10250,53,198,101,97,2,31,1,1,allow
65526,53,17062,53,198,101,97,2,31,1,1,allow
64288,53,10803,53,182,93,89,2,31,1,1,allow
49331,53,64999,53,180,92,88,2,31,1,1,allow
53089,24211,0,0,66,66,0,1,0,1,0,deny
40787,57470,0,0,62,62,0,1,0,1,0,deny
17232,22114,0,0,62,62,0,1,0,1,0,deny
65228,53,0,0,88,88,0,1,0,1,0,deny
2075,19473,0,0,66,66,0,1,0,1,0,deny
49911,445,0,0,66,66,0,1,0,1,0,drop
49909,445,0,0,66,66,0,1,0,1,0,drop
49914,445,0,0,66,66,0,1,0,1,0,drop
49910,445,0,0,66,66,0,1,0,1,0,drop
49905,445,0,0,66,66,0,1,0,1,0,drop
49908,445,0,0,66,66,0,1,0,1,0,drop
49903,445,0,0,66,66,0,1,0,1,0,drop
18745,64147,0,0,66,66,0,1,0,1,0,deny
38503,25,0,0,60,60,0,1,0,1,0,deny
57484,30317,0,0,62,62,0,1,0,1,0,deny
54501,445,0,0,70,70,0,1,0,1,0,drop
53256,5900,0,0,60,60,0,1,0,1,0,deny
49793,445,0,0,70,70,0,1,0,1,0,drop
65530,53,21720,53,167,86,81,2,30,1,1,allow
10004,40014,64871,40014,156,94,62,2,30,1,1,allow
56569,53,13010,53,183,94,89,2,30,1,1,allow
44062,443,52650,443,8998,1684,7314,24,170,12,12,allow
58958,80,41174,80,6969,6315,654,15,15,9,6,allow
50594,443,48288,443,4337,3026,1311,21,141,12,9,allow
34783,5222,34830,5222,482,210,272,8,15,4,4,allow
5588,5588,0,0,3498,1872,1626,48,204,24,24,allow
56385,53,3618,53,249,85,164,4,55,2,2,allow
49277,53,20518,53,199,102,97,2,30,1,1,allow
64752,53,29277,53,195,102,93,2,30,1,1,allow
64276,53,2363,53,354,102,252,2,30,1,1,allow
55933,53,42992,53,182,94,88,2,30,1,1,allow
54994,53,3788,53,209,110,99,2,30,1,1,allow
49437,53,23949,53,199,102,97,2,30,1,1,allow
57356,53,19968,53,199,102,97,2,30,1,1,allow
55004,443,35617,443,27629,9041,18588,88,271,46,42,allow
52175,1101,27107,1101,70,70,0,1,5,1,0,allow
55600,53,6191,53,209,110,99,2,29,1,1,allow
53373,53,58629,53,242,78,164,2,29,1,1,allow
57067,53,18004,53,183,94,89,2,29,1,1,allow
65403,53,40925,53,199,102,97,2,29,1,1,allow
49546,53,27218,53,193,102,91,2,30,1,1,allow
64238,53,6347,53,215,102,113,2,30,1,1,allow
56330,53,48374,53,271,95,176,4,47,2,2,allow
49437,53,10171,53,199,102,97,2,30,1,1,allow
52128,80,31768,80,366,240,126,7,26,5,2,allow
54139,80,14592,80,1515,481,1034,11,15,6,5,allow
33970,443,28633,443,2586,832,1754,14,15,7,7,allow
52124,80,5847,80,366,240,126,7,26,5,2,allow
35514,80,18032,80,841,715,126,5,14,3,2,allow
64078,54561,7261,54561,66,66,0,2,7,2,0,allow
52206,59077,23195,59077,316,136,180,6,9,3,3,allow
50043,443,32430,443,6551,2085,4466,25,85,14,11,allow
36145,443,14544,443,1439,878,561,15,17,10,5,allow
53969,13156,38324,13156,70,70,0,2,7,2,0,allow
53972,59089,65256,59089,70,70,0,2,7,2,0,allow
64079,20233,31225,20233,66,66,0,2,7,2,0,allow
38011,443,55120,443,6732,885,5847,24,368,7,17,allow
49176,443,57308,443,10225,3155,7070,28,57,19,9,allow
49479,53,55939,53,213,94,119,2,29,1,1,allow
54207,443,5893,443,4788,785,4003,15,70,8,7,allow
55005,53,24549,53,183,94,89,2,30,1,1,allow
65339,53,4097,53,775,102,673,2,30,1,1,allow
64559,53,8772,53,198,102,96,2,30,1,1,allow
64048,53,38443,53,209,110,99,2,30,1,1,allow
52102,80,29370,80,22495,1895,20600,33,27,15,18,allow
51880,8001,9632,8001,86,86,0,1,30,1,0,allow
52176,17572,9912,17572,70,70,0,1,5,1,0,allow
52171,63033,25728,63033,70,70,0,1,5,1,0,allow
49382,53,23594,53,200,102,98,2,30,1,1,allow
49552,53,39720,53,102,102,0,1,30,1,0,allow
49869,53,64308,53,209,110,99,2,30,1,1,allow
50708,80,26997,80,1658,1247,411,8,15,5,3,allow
41157,443,35776,443,78535,3648,74887,94,30,41,53,allow
58737,443,61229,443,16417,13221,3196,50,74,31,19,allow
37602,53,37602,53,260,106,154,2,32,1,1,allow
10019,443,53412,443,1497912,26236,1471676,1321,121,299,1022,allow
58739,443,43331,443,22751,17995,4756,67,73,42,25,allow
35985,443,7017,443,6250,1312,4938,23,28,12,11,allow
55939,53,43027,53,193,102,91,2,30,1,1,allow
56330,53,40178,53,271,95,176,4,48,2,2,allow
36101,53,61383,53,168,78,90,2,30,1,1,allow
55749,53,21707,53,413,170,243,6,30,3,3,allow
55637,53,58251,53,209,110,99,2,30,1,1,allow
56569,53,53689,53,183,94,89,2,30,1,1,allow
55932,53,22197,53,209,110,99,2,30,1,1,allow
55653,53,34737,53,199,102,97,2,30,1,1,allow
64559,53,63710,53,198,102,96,2,30,1,1,allow
49629,53,5781,53,198,102,96,2,30,1,1,allow
57295,53,34997,53,448,184,264,6,30,3,3,allow
56941,53,63824,53,196,102,94,2,30,1,1,allow
56941,53,56569,53,193,102,91,2,30,1,1,allow
55675,53,48589,53,198,102,96,2,30,1,1,allow
55182,53,17791,53,199,102,97,2,30,1,1,allow
65292,53,4110,53,195,102,93,2,30,1,1,allow
55182,53,55293,53,199,102,97,2,30,1,1,allow
56941,53,44223,53,196,102,94,2,30,1,1,allow
65260,53,8952,53,199,102,97,2,30,1,1,allow
64976,53,35202,53,229,102,127,2,30,1,1,allow
56672,53,28150,53,199,102,97,2,30,1,1,allow
52168,62118,28732,62118,70,70,0,1,5,1,0,allow
41322,53,41322,53,244,98,146,2,32,1,1,allow
58902,5223,20774,5223,308,86,222,4,13,1,3,allow
49229,8112,22492,8112,2049,1276,773,15,15,8,7,allow
33098,443,57667,443,6044,780,5264,16,66,8,8,allow
48286,443,48286,443,4621,1714,2907,19,26,11,8,allow
47310,443,33854,443,3541,616,2925,19,165,8,11,allow
56180,53,31487,53,200,102,98,2,30,1,1,allow
54106,53,53865,53,164,78,86,2,30,1,1,allow
55933,53,60713,53,182,94,88,2,30,1,1,allow
57401,53,48123,53,179,94,85,2,30,1,1,allow
57356,53,26396,53,199,102,97,2,30,1,1,allow
55932,53,3248,53,209,110,99,2,30,1,1,allow
65260,53,3983,53,199,102,97,2,30,1,1,allow
55764,53,63898,53,250,94,156,2,30,1,1,allow
49666,443,64744,443,14531,7971,6560,36,190,20,16,allow
52212,51343,6977,51343,70,70,0,2,6,2,0,allow
52179,14354,22942,14354,70,70,0,1,5,1,0,allow
52172,7353,21812,7353,70,70,0,1,5,1,0,allow
50934,443,28821,443,9989,3003,6986,30,46,17,13,allow
32962,443,9560,443,3935,1010,2925,20,165,9,11,allow
54994,53,62711,53,209,110,99,2,30,1,1,allow
55377,53,33641,53,195,102,93,2,30,1,1,allow
56180,53,37696,53,200,102,98,2,30,1,1,allow
49343,53,1518,53,209,110,99,2,30,1,1,allow
65513,53,51212,53,216,102,114,2,30,1,1,allow
49284,53,41000,53,195,86,109,2,30,1,1,allow
56180,53,15802,53,200,102,98,2,30,1,1,allow
49650,53,58699,53,539,97,442,4,58,2,2,allow
55948,5223,3545,5223,10038,5272,4766,36,196,20,16,allow
50045,443,55393,443,5661,1526,4135,22,85,12,10,allow
56330,53,41814,53,271,95,176,4,47,2,2,allow
50047,443,14680,443,4612,947,3665,18,85,10,8,allow
50658,443,64697,443,4876,2522,2354,22,83,13,9,allow
6881,6881,3673,6881,237,118,119,2,1200,1,1,allow
50608,443,24048,443,4758,2811,1947,22,140,12,10,allow
50578,80,35081,80,367162,17367,349795,470,143,214,256,allow
39194,53,39194,53,414,268,146,3,32,2,1,allow
52211,56648,57880,56648,70,70,0,2,8,2,0,allow
52232,35126,34717,35126,70,70,0,1,5,1,0,allow
65518,443,8967,443,92157,4519,87638,105,15,39,66,allow
50612,443,9041,443,6782,3367,3415,25,139,15,10,allow
60729,443,20106,443,5737,1929,3808,19,201,11,8,allow
52208,47300,20128,47300,70,70,0,2,9,2,0,allow
38977,53,0,0,82,82,0,2,40,2,0,allow
64132,53,20663,53,381,102,279,4,42,2,2,allow
44060,443,59243,443,9734,1614,8120,24,170,11,13,allow
55774,8060,26633,8060,70,70,0,2,8,2,0,allow
52178,30922,2429,30922,70,70,0,1,5,1,0,allow
43304,443,10226,443,4389,797,3592,15,70,8,7,allow
52180,20121,7972,20121,70,70,0,1,5,1,0,allow
57188,53,28885,53,193,102,91,2,29,1,1,allow
49520,53,8068,53,209,110,99,2,29,1,1,allow
55637,53,5558,53,209,110,99,2,29,1,1,allow
64935,53,54508,53,193,102,91,2,29,1,1,allow
50296,53,43204,53,183,94,89,2,29,1,1,allow
38608,80,62728,80,1289,303,986,12,16,5,7,allow
55005,53,53050,53,183,94,89,2,29,1,1,allow
49662,53,29879,53,211,102,109,2,29,1,1,allow
60591,80,30981,80,1364,860,504,13,17,8,5,allow
65336,53,9283,53,200,102,98,2,29,1,1,allow
64686,53,47974,53,214,102,112,2,29,1,1,allow
65196,53,54719,53,392,90,302,4,55,2,2,allow
38948,53,19233,53,242,78,164,2,29,1,1,allow
56385,53,22600,53,249,85,164,4,55,2,2,allow
64752,53,50636,53,195,102,93,2,30,1,1,allow
51880,51881,42143,51881,86,86,0,1,30,1,0,allow
57258,53,33746,53,215,102,113,2,30,1,1,allow
51880,8001,32545,8001,86,86,0,1,30,1,0,allow
65370,53,23524,53,193,102,91,2,30,1,1,allow
50401,53,50401,53,200,90,110,2,30,1,1,allow
56544,53,54094,53,224,102,122,2,30,1,1,allow
64637,53,52362,53,194,102,92,2,30,1,1,allow
56951,53,9479,53,199,102,97,2,30,1,1,allow
56805,53,39519,53,178,94,84,2,30,1,1,allow
49331,53,5900,53,182,94,88,2,31,1,1,allow
56884,53,35715,53,199,102,97,2,30,1,1,allow
49382,53,23586,53,200,102,98,2,30,1,1,allow
65292,53,3636,53,195,102,93,2,30,1,1,allow
56186,53,56186,53,233,98,135,2,30,1,1,allow
56739,443,22996,443,795,795,0,2,169,2,0,allow
54367,443,60704,443,5892088,193411,5698677,6287,213,2098,4189,allow
54438,443,22711,443,8198,1975,6223,24,361,11,13,allow
17750,18866,37630,18866,150,150,0,1,1200,1,0,allow
45860,443,61779,443,12852,3554,9298,35,24,19,16,allow
36146,443,34524,443,1147,660,487,11,17,7,4,allow
5011,53,5011,53,244,98,146,2,32,1,1,allow
53173,25067,13422,25067,70,70,0,2,8,2,0,allow
52183,13503,58173,13503,70,70,0,1,5,1,0,allow
55933,53,55116,53,330,92,238,4,43,2,2,allow
38713,443,14389,443,90241,3033,87208,89,16,24,65,allow
49543,53,24051,53,880,189,691,6,75,3,3,allow
56941,53,56687,53,193,102,91,2,30,1,1,allow
55653,53,53327,53,199,102,97,2,30,1,1,allow
64569,53,17459,53,183,94,89,2,30,1,1,allow
51446,53,21490,53,168,78,90,2,30,1,1,allow
64066,80,28023,80,314,192,122,6,15,4,2,allow
53101,443,12106,443,1287,800,487,13,16,9,4,allow
52210,15604,53868,15604,70,70,0,2,8,2,0,allow
52182,60769,21483,60769,70,70,0,1,5,1,0,allow
38712,443,31171,443,382972,9177,373795,378,16,120,258,allow
44061,443,59659,443,8551,1685,6866,24,170,12,12,allow
56385,53,50438,53,249,85,164,4,56,2,2,allow
55201,53,9810,53,168,78,90,2,30,1,1,allow
49343,53,21551,53,209,110,99,2,30,1,1,allow
57051,53,56096,53,185,102,83,2,30,1,1,allow
64821,53,30415,53,775,102,673,2,30,1,1,allow
50234,53,63121,53,720,94,626,2,30,1,1,allow
49488,53,56220,53,194,102,92,2,31,1,1,allow
60661,53,54714,53,278,102,176,2,31,1,1,allow
65526,53,37729,53,199,102,97,2,30,1,1,allow
52056,80,64858,80,4562,3936,626,11,28,6,5,allow
53102,443,27329,443,983,496,487,9,16,5,4,allow
52214,27480,12479,27480,70,70,0,2,6,2,0,allow
44065,443,13980,443,6114,862,5252,17,71,9,8,allow
44059,443,60027,443,9730,1613,8117,24,170,11,13,allow
44893,53,32339,53,199,94,105,2,30,1,1,allow
56569,53,42369,53,183,94,89,2,30,1,1,allow
64578,53,30124,53,193,102,91,2,30,1,1,allow
56672,53,60163,53,199,102,97,2,30,1,1,allow
64055,53,3603,53,233,94,139,2,30,1,1,allow
65258,53,62928,53,178,94,84,2,30,1,1,allow
64569,53,45660,53,183,94,89,2,30,1,1,allow
50356,53,30610,53,180,94,86,2,30,1,1,allow
57067,53,11799,53,183,94,89,2,30,1,1,allow
64288,53,3103,53,183,94,89,2,31,1,1,allow
56725,53,48111,53,180,94,86,2,31,1,1,allow
49869,53,29655,53,209,110,99,2,30,1,1,allow
56317,53,15827,53,183,94,89,2,30,1,1,allow
65258,53,21767,53,178,94,84,2,30,1,1,allow
65370,53,10592,53,193,102,91,2,30,1,1,allow
56005,53,10080,53,199,102,97,2,30,1,1,allow
64935,53,65195,53,193,102,91,2,30,1,1,allow
55078,53,15054,53,246,94,152,2,30,1,1,allow
49610,53,51833,53,212,102,110,2,30,1,1,allow
49380,53,58826,53,199,102,97,2,31,1,1,allow
65346,53,19469,53,183,94,89,2,30,1,1,allow
49671,53,47128,53,183,94,89,2,30,1,1,allow
57401,53,55696,53,179,94,85,2,31,1,1,allow
64957,53,58925,53,196,102,94,2,30,1,1,allow
57035,53,3817,53,199,102,97,2,30,1,1,allow
49838,53,52067,53,183,94,89,2,31,1,1,allow
64204,53,35802,53,193,102,91,2,30,1,1,allow
64204,53,37090,53,193,102,91,2,31,1,1,allow
51325,443,32371,443,2959,793,2166,10,120,5,5,allow
57035,53,5245,53,199,102,97,2,30,1,1,allow
49382,53,52583,53,200,102,98,2,31,1,1,allow
56805,53,61616,53,178,94,84,2,31,1,1,allow
65370,53,21172,53,193,102,91,2,30,1,1,allow
50694,443,18706,443,3097,1708,1389,15,19,9,6,allow
50018,53,63073,53,350,91,259,4,41,2,2,allow
49869,53,17507,53,414,103,311,4,31,2,2,allow
53923,25267,60857,25267,1724,1157,567,14,17,9,5,allow
52525,80,56526,80,3951,3437,514,13,15,8,5,allow
57446,443,49278,443,9642,3343,6299,37,16,17,20,allow
49364,53,13056,53,307,307,0,4,60,4,0,allow
62112,443,29747,443,505589,13504,492085,462,345,91,371,allow
50607,443,33073,443,3947,2271,1676,22,140,13,9,allow
37898,53,37898,53,244,98,146,2,33,1,1,allow
5480,53,5480,53,244,98,146,2,33,1,1,allow
52167,61948,3341,61948,70,70,0,1,5,1,0,allow
49991,80,28668,80,2095,1010,1085,11,87,6,5,allow
62149,22114,0,0,66,66,0,1,0,1,0,deny
13589,22114,0,0,146,146,0,1,0,1,0,deny
54496,445,0,0,70,70,0,1,0,1,0,drop
54492,445,0,0,70,70,0,1,0,1,0,drop
54493,445,0,0,70,70,0,1,0,1,0,drop
443,36576,0,0,60,60,0,1,0,1,0,deny
53275,21247,0,0,66,66,0,1,0,1,0,deny
63487,129,0,0,60,60,0,1,0,1,0,deny
53750,25174,0,0,66,66,0,1,0,1,0,deny
49781,445,0,0,70,70,0,1,0,1,0,drop
49784,445,0,0,70,70,0,1,0,1,0,drop
49782,445,0,0,70,70,0,1,0,1,0,drop
53667,22114,0,0,66,66,0,1,0,1,0,deny
20544,5223,0,0,148,148,0,1,0,1,0,deny
49780,445,0,0,70,70,0,1,0,1,0,drop
53721,62413,0,0,62,62,0,1,0,1,0,deny
64005,26467,0,0,66,66,0,1,0,1,0,deny
49777,445,0,0,70,70,0,1,0,1,0,drop
9687,35440,0,0,66,66,0,1,0,1,0,deny
16425,15503,0,0,62,62,0,1,0,1,0,deny
51414,22,0,0,60,60,0,1,0,1,0,deny
43671,17372,0,0,62,62,0,1,0,1,0,deny
58835,17372,0,0,66,66,0,1,0,1,0,deny
54491,445,0,0,70,70,0,1,0,1,0,drop
54488,445,0,0,70,70,0,1,0,1,0,drop
54485,445,0,0,70,70,0,1,0,1,0,drop
63495,50584,0,0,66,66,0,1,0,1,0,deny
49897,445,0,0,66,66,0,1,0,1,0,drop
54483,445,0,0,70,70,0,1,0,1,0,drop
49894,445,0,0,66,66,0,1,0,1,0,drop
12164,22114,0,0,146,146,0,1,0,1,0,deny
12338,64147,0,0,66,66,0,1,0,1,0,deny
17213,22114,0,0,62,62,0,1,0,1,0,deny
61701,15503,0,0,66,66,0,1,0,1,0,deny
49893,445,0,0,66,66,0,1,0,1,0,drop
49891,445,0,0,66,66,0,1,0,1,0,drop
49769,445,0,0,70,70,0,1,0,1,0,drop
53305,50584,0,0,66,66,0,1,0,1,0,deny
62348,50584,0,0,62,62,0,1,0,1,0,deny
64878,26467,0,0,62,62,0,1,0,1,0,deny
49889,445,0,0,66,66,0,1,0,1,0,drop
49938,57470,0,0,62,62,0,1,0,1,0,deny
23753,25174,0,0,62,62,0,1,0,1,0,deny
64013,57470,0,0,74,74,0,1,0,1,0,deny
49761,445,0,0,70,70,0,1,0,1,0,drop
40821,41615,0,0,157,157,0,1,0,1,0,deny
31859,33909,0,0,66,66,0,1,0,1,0,deny
54478,445,0,0,70,70,0,1,0,1,0,drop
49760,445,0,0,70,70,0,1,0,1,0,drop
31691,50584,0,0,62,62,0,1,0,1,0,deny
58751,51221,0,0,62,62,0,1,0,1,0,deny
50488,22114,0,0,62,62,0,1,0,1,0,deny
1025,46776,0,0,62,62,0,1,0,1,0,deny
54471,445,0,0,70,70,0,1,0,1,0,drop
54465,445,0,0,70,70,0,1,0,1,0,drop
29064,23,0,0,60,60,0,1,0,1,0,deny
9552,22114,0,0,146,146,0,1,0,1,0,deny
49196,25174,0,0,62,62,0,1,0,1,0,deny
49754,445,0,0,70,70,0,1,0,1,0,drop
49878,445,0,0,66,66,0,1,0,1,0,drop
56152,56205,0,0,66,66,0,1,0,1,0,deny
49753,445,0,0,70,70,0,1,0,1,0,drop
6899,48817,0,0,139,139,0,1,0,1,0,deny
1048,25174,0,0,62,62,0,1,0,1,0,deny
48478,49903,0,0,62,62,0,1,0,1,0,deny
53194,26467,0,0,66,66,0,1,0,1,0,deny
49749,445,0,0,70,70,0,1,0,1,0,drop
49871,445,0,0,66,66,0,1,0,1,0,drop
59497,64097,0,0,66,66,0,1,0,1,0,deny
54455,445,0,0,70,70,0,1,0,1,0,drop
57325,60043,0,0,66,66,0,1,0,1,0,deny
443,50238,0,0,331,331,0,1,0,1,0,deny
443,23220,0,0,100,100,0,1,0,1,0,deny
51046,25174,0,0,62,62,0,1,0,1,0,deny
49748,445,0,0,70,70,0,1,0,1,0,drop
443,45788,0,0,332,332,0,1,0,1,0,deny
49869,445,0,0,66,66,0,1,0,1,0,drop
62838,44847,0,0,66,66,0,1,0,1,0,deny
61784,49903,0,0,66,66,0,1,0,1,0,deny
22350,25174,0,0,62,62,0,1,0,1,0,deny
14717,64147,0,0,66,66,0,1,0,1,0,deny
18642,42707,0,0,62,62,0,1,0,1,0,deny
53730,37965,0,0,66,66,0,1,0,1,0,deny
60248,46776,0,0,66,66,0,1,0,1,0,deny
49862,445,0,0,66,66,0,1,0,1,0,drop
49743,445,0,0,70,70,0,1,0,1,0,drop
55201,26467,0,0,66,66,0,1,0,1,0,deny
49853,445,0,0,66,66,0,1,0,1,0,drop
22240,22114,0,0,146,146,0,1,0,1,0,deny
2572,17546,0,0,66,66,0,1,0,1,0,deny
18653,42707,0,0,66,66,0,1,0,1,0,deny
15899,37807,0,0,62,62,0,1,0,1,0,deny
28999,37807,0,0,62,62,0,1,0,1,0,deny
34360,25174,0,0,62,62,0,1,0,1,0,deny
58118,22114,0,0,62,62,0,1,0,1,0,deny
64811,51221,0,0,62,62,0,1,0,1,0,deny
54446,445,0,0,70,70,0,1,0,1,0,drop
54443,445,0,0,70,70,0,1,0,1,0,drop
54444,445,0,0,70,70,0,1,0,1,0,drop
50784,50584,0,0,146,146,0,1,0,1,0,deny
49844,445,0,0,66,66,0,1,0,1,0,drop
49842,445,0,0,66,66,0,1,0,1,0,drop
49846,445,0,0,66,66,0,1,0,1,0,drop
49845,445,0,0,66,66,0,1,0,1,0,drop
49840,445,0,0,66,66,0,1,0,1,0,drop
49843,445,0,0,66,66,0,1,0,1,0,drop
49841,445,0,0,66,66,0,1,0,1,0,drop
49838,445,0,0,66,66,0,1,0,1,0,drop
58799,30188,0,0,66,66,0,1,0,1,0,deny
49730,445,0,0,70,70,0,1,0,1,0,drop
17230,25174,0,0,146,146,0,1,0,1,0,deny
11006,23117,0,0,146,146,0,1,0,1,0,deny
65270,3855,0,0,78,78,0,1,0,1,0,deny
44207,44847,0,0,66,66,0,1,0,1,0,deny
55893,45711,0,0,78,78,0,1,0,1,0,deny
49727,445,0,0,70,70,0,1,0,1,0,drop
42608,1,0,0,62,62,0,1,0,1,0,deny
40418,25174,0,0,66,66,0,1,0,1,0,deny
63488,22114,0,0,62,62,0,1,0,1,0,deny
52745,57866,0,0,62,62,0,1,0,1,0,deny
11676,25174,0,0,146,146,0,1,0,1,0,deny
38629,25174,0,0,62,62,0,1,0,1,0,deny
54441,445,0,0,70,70,0,1,0,1,0,drop
54434,445,0,0,70,70,0,1,0,1,0,drop
54432,445,0,0,70,70,0,1,0,1,0,drop
54428,445,0,0,70,70,0,1,0,1,0,drop
64334,25174,0,0,62,62,0,1,0,1,0,deny
51430,25174,0,0,146,146,0,1,0,1,0,deny
5222,7493,0,0,66,66,0,1,0,1,0,deny
56098,64147,0,0,66,66,0,1,0,1,0,deny
1594,44847,0,0,62,62,0,1,0,1,0,deny
57607,21247,0,0,66,66,0,1,0,1,0,deny
60485,22114,0,0,62,62,0,1,0,1,0,deny
49723,445,0,0,70,70,0,1,0,1,0,drop
49826,445,0,0,66,66,0,1,0,1,0,drop
49825,445,0,0,66,66,0,1,0,1,0,drop
49824,445,0,0,66,66,0,1,0,1,0,drop
6666,5000,0,0,60,60,0,1,0,1,0,deny
3765,64147,0,0,62,62,0,1,0,1,0,deny
49721,445,0,0,70,70,0,1,0,1,0,drop
51313,25174,0,0,62,62,0,1,0,1,0,deny
13285,29892,0,0,145,145,0,1,0,1,0,deny
58463,11392,0,0,66,66,0,1,0,1,0,deny
62716,23,0,0,60,60,0,1,0,1,0,deny
49719,445,0,0,70,70,0,1,0,1,0,drop
56377,51505,0,0,66,66,0,1,0,1,0,deny
12457,57866,0,0,62,62,0,1,0,1,0,deny
51456,45680,0,0,139,139,0,1,0,1,0,deny
28792,22,0,0,60,60,0,1,0,1,0,deny
54423,445,0,0,70,70,0,1,0,1,0,drop
51575,9694,0,0,66,66,0,1,0,1,0,deny
44398,50584,0,0,146,146,0,1,0,1,0,deny
54418,445,0,0,70,70,0,1,0,1,0,drop
54419,445,0,0,70,70,0,1,0,1,0,drop
54415,445,0,0,70,70,0,1,0,1,0,drop
54043,36237,0,0,62,62,0,1,0,1,0,deny
60830,50584,0,0,62,62,0,1,0,1,0,deny
62971,44847,0,0,66,66,0,1,0,1,0,deny
9748,21247,0,0,66,66,0,1,0,1,0,deny
38565,51505,0,0,66,66,0,1,0,1,0,deny
61916,64097,0,0,66,66,0,1,0,1,0,deny
3580,25174,0,0,62,62,0,1,0,1,0,deny
34262,23,0,0,60,60,0,1,0,1,0,deny
49712,445,0,0,70,70,0,1,0,1,0,drop
57761,15503,0,0,62,62,0,1,0,1,0,deny
13168,35440,0,0,66,66,0,1,0,1,0,deny
22916,25174,0,0,62,62,0,1,0,1,0,deny
49710,445,0,0,70,70,0,1,0,1,0,drop
19623,25174,0,0,62,62,0,1,0,1,0,deny
57793,37807,0,0,66,66,0,1,0,1,0,deny
22528,25174,0,0,146,146,0,1,0,1,0,deny
49709,445,0,0,70,70,0,1,0,1,0,drop
1027,57866,0,0,62,62,0,1,0,1,0,deny
54404,445,0,0,70,70,0,1,0,1,0,drop
54403,445,0,0,70,70,0,1,0,1,0,drop
54399,445,0,0,70,70,0,1,0,1,0,drop
49708,445,0,0,70,70,0,1,0,1,0,drop
10627,23117,0,0,62,62,0,1,0,1,0,deny
49707,445,0,0,70,70,0,1,0,1,0,drop
23379,57866,0,0,62,62,0,1,0,1,0,deny
49701,445,0,0,70,70,0,1,0,1,0,drop
49702,445,0,0,70,70,0,1,0,1,0,drop
49812,445,0,0,66,66,0,1,0,1,0,drop
52336,64097,0,0,66,66,0,1,0,1,0,deny
58453,50584,0,0,66,66,0,1,0,1,0,deny
37075,48817,0,0,62,62,0,1,0,1,0,deny
49689,445,0,0,70,70,0,1,0,1,0,drop
49687,445,0,0,70,70,0,1,0,1,0,drop
49686,445,0,0,70,70,0,1,0,1,0,drop
7105,25174,0,0,66,66,0,1,0,1,0,deny
49678,445,0,0,70,70,0,1,0,1,0,drop
49679,445,0,0,70,70,0,1,0,1,0,drop
49488,53,14006,53,188,96,92,2,30,1,1,allow
56805,53,35322,53,172,88,84,2,30,1,1,allow
65448,443,34387,443,3224,2373,851,17,23,9,8,allow
55043,443,34590,443,37068,4085,32983,66,48,33,33,allow
49703,443,4967,443,421435,16499,404936,388,210,95,293,allow
64637,53,50285,53,188,96,92,2,30,1,1,allow
49931,443,64224,443,92352,5699,86653,105,134,35,70,allow
49984,53,41486,53,172,88,84,2,30,1,1,allow
41545,443,41545,443,4719,1812,2907,19,29,11,8,allow
50005,80,43332,80,2088,1160,928,10,86,6,4,allow
57470,24409,44348,24409,870,330,540,12,1501,6,6,allow
40033,80,40033,80,424,198,226,7,142,4,3,allow
40080,80,40080,80,424,198,226,7,142,4,3,allow
39943,80,39943,80,424,198,226,7,142,4,3,allow
50749,443,38979,443,4749,1897,2852,16,124,8,8,allow
49035,443,36911,443,4299,2327,1972,23,315,11,12,allow
49709,443,24927,443,523518,15431,508087,466,210,109,357,allow
18381,53,18381,53,237,91,146,2,32,1,1,allow
51260,80,28140,80,2339,1680,659,11,17,6,5,allow
50015,443,26548,443,59858,24345,35513,148,612,78,70,allow
49319,53,3849,53,198,101,97,2,30,1,1,allow
58036,443,28433,443,10454,1724,8730,28,525,12,16,allow
49242,443,58883,443,638,70,568,10,203,2,8,allow
38536,443,1919,443,33980,7386,26594,51,121,22,29,allow
53927,37828,58314,37828,552,306,246,9,16,5,4,allow
50006,80,59669,80,2087,1159,928,10,86,6,4,allow
49707,443,44929,443,593578,18531,575047,531,210,128,403,allow
53172,56013,19244,56013,70,70,0,2,8,2,0,allow
53936,5915,56119,5915,70,70,0,1,5,1,0,allow
52166,57975,20041,57975,66,66,0,1,5,1,0,allow
53932,27258,53010,27258,70,70,0,1,5,1,0,allow
58178,443,51468,443,8000,1760,6240,32,43,16,16,allow
57451,443,58507,443,19175423,168230,19007193,15129,313,2298,12831,allow
42956,53,20926,53,168,78,90,2,30,1,1,allow
56725,53,37417,53,176,90,86,3,55,2,1,allow
48290,443,64782,443,7920,2731,5189,27,82,15,12,allow
49838,53,8093,53,182,93,89,2,31,1,1,allow
41936,443,58038,443,7118,2386,4732,18,133,10,8,allow
50007,80,25590,80,2089,1161,928,10,86,6,4,allow
49704,443,41533,443,513839,16341,497498,453,210,104,349,allow
57570,443,12758,443,21267,5407,15860,36,361,17,19,allow
49930,443,24713,443,16631,7072,9559,50,134,29,21,allow
57447,443,62052,443,7847,1377,6470,27,15,12,15,allow
55796,53,55796,53,253,99,154,2,32,1,1,allow
58179,443,33593,443,7883,1768,6115,30,36,14,16,allow
58666,53,58666,53,235,90,145,2,32,1,1,allow
53963,6882,44227,6882,70,70,0,2,8,2,0,allow
53968,17904,18186,17904,320,140,180,6,7,3,3,allow
47092,15000,12405,15000,138,78,60,2,5,1,1,allow
50017,443,54344,443,51055,17321,33734,147,612,77,70,allow
53245,80,62504,80,2071,1305,766,10,256,6,4,allow
65530,53,20818,53,166,85,81,2,30,1,1,allow
43934,53,43934,53,310,94,216,2,30,1,1,allow
57319,53,22543,53,176,90,86,2,30,1,1,allow
56100,53,56100,53,265,111,154,2,30,1,1,allow
65189,53,20195,53,176,90,86,2,31,1,1,allow
64143,53,9554,53,174,89,85,2,31,1,1,allow
32843,443,63526,443,6444,2640,3804,18,122,9,9,allow
64727,443,24002,443,18620,15824,2796,31,129,18,13,allow
39802,80,39802,80,424,198,226,7,142,4,3,allow
6882,46440,39998,46440,324,150,174,2,1200,1,1,allow
55704,53,48604,53,186,95,91,2,31,1,1,allow
39852,80,39852,80,576,272,304,9,142,5,4,allow
54440,26467,0,0,62,62,0,1,0,1,0,deny
3730,17372,0,0,62,62,0,1,0,1,0,deny
54539,26467,0,0,62,62,0,1,0,1,0,deny
36933,23117,0,0,66,66,0,1,0,1,0,deny
54398,445,0,0,70,70,0,1,0,1,0,drop
9504,25174,0,0,62,62,0,1,0,1,0,deny
53928,15503,0,0,62,62,0,1,0,1,0,deny
54397,445,0,0,70,70,0,1,0,1,0,drop
48706,23393,0,0,60,60,0,1,0,1,0,deny
57557,64147,0,0,62,62,0,1,0,1,0,deny
31780,11392,0,0,62,62,0,1,0,1,0,deny
443,14591,0,0,131,131,0,1,0,1,0,deny
46275,23,0,0,60,60,0,1,0,1,0,deny
443,45788,0,0,332,332,0,1,0,1,0,deny
49797,445,0,0,66,66,0,1,0,1,0,drop
49795,445,0,0,66,66,0,1,0,1,0,drop
3986,17372,0,0,66,66,0,1,0,1,0,deny
443,18177,0,0,66,66,0,1,0,1,0,deny
65442,80,64392,80,366,180,186,7,28,4,3,allow
42318,443,52319,443,10723,2046,8677,29,116,10,19,allow
49380,53,47715,53,199,102,97,2,30,1,1,allow
56805,53,60553,53,178,94,84,2,30,1,1,allow
26906,22114,0,0,66,66,0,1,0,1,0,deny
49001,22114,0,0,62,62,0,1,0,1,0,deny
49667,445,0,0,70,70,0,1,0,1,0,drop
53838,36829,0,0,62,62,0,1,0,1,0,deny
28830,37965,0,0,62,62,0,1,0,1,0,deny
57015,25174,0,0,66,66,0,1,0,1,0,deny
54387,445,0,0,70,70,0,1,0,1,0,drop
54383,445,0,0,70,70,0,1,0,1,0,drop
54376,445,0,0,70,70,0,1,0,1,0,drop
26239,25174,0,0,62,62,0,1,0,1,0,deny
36484,67,0,0,60,60,0,1,0,1,0,deny
49790,445,0,0,66,66,0,1,0,1,0,drop
55246,31573,0,0,62,62,0,1,0,1,0,deny
59068,49813,0,0,74,74,0,1,0,1,0,deny
55393,44512,0,0,66,66,0,1,0,1,0,deny
15018,37965,0,0,62,62,0,1,0,1,0,deny
46162,25174,0,0,62,62,0,1,0,1,0,deny
61550,5529,0,0,145,145,0,1,0,1,0,deny
49785,445,0,0,66,66,0,1,0,1,0,drop
49784,445,0,0,66,66,0,1,0,1,0,drop
49783,445,0,0,66,66,0,1,0,1,0,drop
49776,445,0,0,66,66,0,1,0,1,0,drop
49779,445,0,0,66,66,0,1,0,1,0,drop
49777,445,0,0,66,66,0,1,0,1,0,drop
49778,445,0,0,66,66,0,1,0,1,0,drop
49662,445,0,0,70,70,0,1,0,1,0,drop
18771,35440,0,0,66,66,0,1,0,1,0,deny
51922,44847,0,0,66,66,0,1,0,1,0,deny
15981,23117,0,0,146,146,0,1,0,1,0,deny
54371,445,0,0,70,70,0,1,0,1,0,drop
54367,445,0,0,70,70,0,1,0,1,0,drop
54365,445,0,0,70,70,0,1,0,1,0,drop
54364,445,0,0,70,70,0,1,0,1,0,drop
49652,445,0,0,70,70,0,1,0,1,0,drop
49653,445,0,0,70,70,0,1,0,1,0,drop
49654,445,0,0,70,70,0,1,0,1,0,drop
63593,22114,0,0,66,66,0,1,0,1,0,deny
48706,23393,0,0,60,60,0,1,0,1,0,deny
42558,64147,0,0,62,62,0,1,0,1,0,deny
49650,445,0,0,70,70,0,1,0,1,0,drop
54189,64147,0,0,66,66,0,1,0,1,0,deny
49646,445,0,0,70,70,0,1,0,1,0,drop
49984,53,22558,53,178,94,84,2,30,1,1,allow
30188,51403,44357,51403,502,150,352,2,1200,1,1,allow
64637,53,26983,53,194,102,92,2,31,1,1,allow
53933,20801,53397,20801,70,70,0,1,4,1,0,allow
50927,80,64147,80,876,519,357,10,75,6,4,allow
52524,80,48631,80,3224,2776,448,11,15,7,4,allow
50688,80,9336,80,27391,3550,23841,36,20,15,21,allow
50599,443,63618,443,11301,5604,5697,29,139,17,12,allow
56403,53,56403,53,244,98,146,2,32,1,1,allow
53399,53,53399,53,414,268,146,3,32,2,1,allow
33017,443,34545,443,130,70,60,3,4,2,1,allow
51986,443,52647,443,7567,3038,4529,35,15,21,14,allow
49772,53,51587,53,531,188,343,6,58,3,3,allow
65222,53,38822,53,197,94,103,2,29,1,1,allow
56078,53,50373,53,178,94,84,2,29,1,1,allow
56884,53,20649,53,199,102,97,2,29,1,1,allow
64048,53,43496,53,209,110,99,2,29,1,1,allow
49671,53,11585,53,183,94,89,2,29,1,1,allow
65346,53,42988,53,183,94,89,2,29,1,1,allow
55485,53,55524,53,720,94,626,2,29,1,1,allow
65373,53,10645,53,197,102,95,2,29,1,1,allow
64288,53,49667,53,183,94,89,2,29,1,1,allow
57319,53,20750,53,180,94,86,2,29,1,1,allow
64107,53,23798,53,212,102,110,2,29,1,1,allow
35585,53,60283,53,168,78,90,2,29,1,1,allow
56951,53,31350,53,199,102,97,2,30,1,1,allow
52163,14181,27565,14181,70,70,0,1,5,1,0,allow
52522,80,14593,80,3290,2776,514,12,15,7,5,allow
65443,80,29432,80,366,180,186,7,28,4,3,allow
56725,53,45081,53,262,90,172,4,53,2,2,allow
60290,53,35403,53,213,86,127,2,30,1,1,allow
49433,53,51324,53,278,94,184,2,30,1,1,allow
52237,53,52237,53,220,90,130,2,30,1,1,allow
49380,53,64533,53,199,102,97,2,30,1,1,allow
38911,443,33015,443,13187,2075,11112,35,420,11,24,allow
53572,443,49621,443,5935,342,5593,12,120,5,7,allow
40368,123,25473,123,184,94,90,2,30,1,1,allow
65189,53,27284,53,180,94,86,2,30,1,1,allow
64266,53,14538,53,255,102,153,2,30,1,1,allow
52520,80,54295,80,3224,2776,448,11,15,7,4,allow
49838,53,33413,53,183,94,89,2,30,1,1,allow
47886,80,46758,80,1767,751,1016,10,15,6,4,allow
49798,53,8655,53,196,102,94,2,30,1,1,allow
50928,80,36754,80,875,518,357,10,75,6,4,allow
60499,51413,3005,51413,70,70,0,2,8,2,0,allow
60500,44739,45783,44739,70,70,0,2,8,2,0,allow
65430,80,47649,80,306,180,126,6,29,4,2,allow
52093,80,65106,80,366,240,126,7,26,5,2,allow
44962,8802,46440,8802,4014,2342,1672,42,386,21,21,allow
65441,80,26203,80,366,180,186,7,28,4,3,allow
49331,53,35223,53,182,94,88,2,30,1,1,allow
56440,80,38855,80,17008,1379,15629,22,25,7,15,allow
60384,80,50302,80,1420,715,705,12,16,7,5,allow
49174,53,10035,53,264,110,154,2,30,1,1,allow
56941,53,42543,53,196,102,94,2,30,1,1,allow
56725,53,46910,53,262,90,172,4,59,2,2,allow
56951,53,23495,53,199,102,97,2,30,1,1,allow
50547,53,45838,53,210,110,100,2,30,1,1,allow
41950,53,0,0,86,86,0,1,30,1,0,allow
58771,53,46484,53,168,78,90,2,30,1,1,allow
49798,53,43543,53,196,102,94,2,30,1,1,allow
64569,53,30065,53,183,94,89,2,30,1,1,allow
64143,53,33110,53,179,94,85,2,30,1,1,allow
32966,53,20380,53,199,94,105,2,30,1,1,allow
65346,53,64945,53,183,94,89,2,30,1,1,allow
54402,53,53139,53,291,86,205,2,30,1,1,allow
49184,53,41219,53,199,94,105,2,30,1,1,allow
52165,49740,12957,49740,70,70,0,1,5,1,0,allow
65440,80,8468,80,366,180,186,7,28,4,3,allow
52521,80,12951,80,3676,3228,448,11,15,7,4,allow
46532,3389,46532,3389,4145,1976,2169,22,20,13,9,allow
35337,443,49436,443,6550678,172191,6378487,6426,82,2117,4309,allow
16403,16385,45121,16385,182,62,120,4,30,2,2,allow
49798,53,23227,53,196,102,94,2,30,1,1,allow
57035,53,29329,53,199,102,97,2,30,1,1,allow
49984,53,7504,53,178,94,84,2,30,1,1,allow
65428,80,59063,80,366,180,186,7,29,4,3,allow
50547,53,5293,53,210,110,100,2,30,1,1,allow
49319,53,62578,53,199,102,97,2,30,1,1,allow
65189,53,45878,53,180,94,86,2,30,1,1,allow
63759,443,31179,443,7995,2096,5899,18,120,8,10,allow
49672,443,34216,443,10080,2728,7352,28,188,14,14,allow
34155,443,22614,443,11294,2234,9060,23,139,12,11,allow
52644,6881,4484,6881,719,413,306,10,14,5,5,allow
58172,80,64584,80,12618,1038,11580,28,50,13,15,allow
53970,1024,11868,1024,260,140,120,5,6,3,2,allow
53941,53739,17149,53739,70,70,0,1,4,1,0,allow
60498,55100,34970,55100,258,70,188,4,8,2,2,allow
56661,443,57675,443,334,70,264,5,17,1,4,allow
65432,80,46367,80,486,240,246,9,28,5,4,allow
56005,53,33914,53,199,102,97,2,29,1,1,allow
65530,53,20918,53,167,86,81,2,29,1,1,allow
53724,53,53724,53,268,114,154,2,29,1,1,allow
65526,53,17627,53,199,102,97,2,29,1,1,allow
61291,53,61291,53,261,106,155,2,29,1,1,allow
37639,53,37639,53,245,106,139,2,29,1,1,allow
64578,53,11531,53,193,102,91,2,30,1,1,allow
51726,3389,51726,3389,3444,1730,1714,16,33,8,8,allow
57356,53,7268,53,199,102,97,2,29,1,1,allow
56078,53,48093,53,178,94,84,2,29,1,1,allow
64048,53,15990,53,209,110,99,2,30,1,1,allow
65526,53,9344,53,199,102,97,2,30,1,1,allow
56672,53,24787,53,199,102,97,2,29,1,1,allow
16403,16386,51369,16386,122,62,60,2,29,1,1,allow
54835,443,32514,443,15578,7071,8507,69,140,33,36,allow
64899,53,12836,53,199,102,97,2,29,1,1,allow
49488,53,29306,53,194,102,92,2,30,1,1,allow
49554,53,40462,53,210,110,100,2,31,1,1,allow
65425,80,38267,80,366,180,186,7,29,4,3,allow
52158,443,56576,443,2149,1549,600,14,45,8,6,allow
51988,443,46112,443,10492,3167,7325,40,15,24,16,allow
52110,80,18812,80,422,240,182,8,26,5,3,allow
52106,80,35207,80,422,240,182,8,26,5,3,allow
50013,53,57171,53,258,102,156,2,30,1,1,allow
57001,53,34470,53,210,110,100,2,30,1,1,allow
64143,53,3333,53,179,94,85,2,30,1,1,allow
65292,53,37185,53,195,102,93,2,30,1,1,allow
58755,443,6984,443,4827,2244,2583,16,135,8,8,allow
65429,80,58851,80,366,180,186,7,29,4,3,allow
60501,40829,11084,40829,70,70,0,2,8,2,0,allow
65444,80,16519,80,486,240,246,9,28,5,4,allow
65433,80,53822,80,486,240,246,9,28,5,4,allow
52116,80,18216,80,422,240,182,8,26,5,3,allow
49242,443,26105,443,4528,803,3725,14,15,8,6,allow
52120,80,3357,80,366,240,126,7,26,5,2,allow
52109,80,35580,80,422,240,182,8,26,5,3,allow
52105,80,43976,80,422,240,182,8,26,5,3,allow
63143,16884,9026,16884,618,318,300,10,16,5,5,allow
16403,16384,41860,16384,122,62,60,2,30,1,1,allow
58087,53,39920,53,168,78,90,2,30,1,1,allow
49319,53,9038,53,199,102,97,2,30,1,1,allow
57001,53,50963,53,210,110,100,2,30,1,1,allow
65438,443,60459,443,572,320,252,10,28,6,4,allow
52523,80,47280,80,4302,3722,580,14,15,8,6,allow
64770,53,5158,53,360,93,267,3,37,2,1,allow
52802,80,4743,80,1465,729,736,12,16,7,5,allow
49414,443,6061,443,3427,2159,1268,20,17,11,9,allow
51125,80,6897,80,2880,815,2065,12,25,7,5,allow
64950,53,37238,53,725,277,448,8,61,4,4,allow
49331,53,37708,53,182,94,88,2,30,1,1,allow
49806,53,64642,53,331,102,229,2,30,1,1,allow
57452,443,52384,443,6990,2193,4797,15,120,7,8,allow
58614,53,27670,53,218,78,140,2,31,1,1,allow
58661,443,49876,443,2956,790,2166,10,120,5,5,allow
40364,443,43021,443,20594,14251,6343,40,361,22,18,allow
60731,443,42232,443,12669,5297,7372,31,188,18,13,allow
37965,51413,49792,51413,789,152,637,4,1199,2,2,allow
6881,51184,15075,51184,324,150,174,2,1203,1,1,allow
43464,443,26785,443,8198,656,7542,19,327,5,14,allow
49447,443,57996,443,11281,5398,5883,21,125,11,10,allow
57470,53250,48963,53250,491,150,341,2,1199,1,1,allow
50584,29040,20008,29040,509,150,359,2,1200,1,1,allow
44847,58839,4824,58839,501,150,351,2,1200,1,1,allow
56549,443,22340,443,13979,2593,11386,29,114,11,18,allow
49838,53,31499,53,183,94,89,2,31,1,1,allow
47809,53,47809,53,260,106,154,2,32,1,1,allow
64652,443,64652,443,6792,1521,5271,18,26,11,7,allow
61740,443,6060,443,92202,65396,26806,193,3454,68,125,allow
36535,443,64497,443,6805,1662,5143,25,17,13,12,allow
46326,443,42575,443,430,152,278,7,32,3,4,allow
51134,3389,51134,3389,4213,2429,1784,18,32,9,9,allow
49690,443,64449,443,9107,2174,6933,29,187,14,15,allow
45964,2225,0,0,60,60,0,1,0,1,0,deny
9969,2323,0,0,60,60,0,1,0,1,0,deny
52934,35776,0,0,159,159,0,1,0,1,0,deny
11030,17372,0,0,62,62,0,1,0,1,0,deny
42939,48817,0,0,156,156,0,1,0,1,0,deny
10306,44847,0,0,66,66,0,1,0,1,0,deny
54361,445,0,0,70,70,0,1,0,1,0,drop
54360,445,0,0,70,70,0,1,0,1,0,drop
54358,445,0,0,70,70,0,1,0,1,0,drop
53353,26467,0,0,62,62,0,1,0,1,0,deny
52459,33890,0,0,60,60,0,1,0,1,0,deny
16824,11119,0,0,148,148,0,1,0,1,0,deny
49769,445,0,0,66,66,0,1,0,1,0,drop
54355,445,0,0,70,70,0,1,0,1,0,drop
49641,445,0,0,70,70,0,1,0,1,0,drop
54011,22114,0,0,62,62,0,1,0,1,0,deny
49767,445,0,0,66,66,0,1,0,1,0,drop
5223,14446,0,0,220,220,0,1,0,1,0,deny
41577,53,41577,53,265,111,154,2,0,1,1,allow
51356,22114,0,0,66,66,0,1,0,1,0,deny
22150,6881,0,0,62,62,0,1,0,1,0,deny
443,7387,0,0,60,60,0,1,0,1,0,deny
49765,445,0,0,66,66,0,1,0,1,0,drop
49764,445,0,0,66,66,0,1,0,1,0,drop
48258,37965,0,0,62,62,0,1,0,1,0,deny
49761,445,0,0,66,66,0,1,0,1,0,drop
443,45788,0,0,332,332,0,1,0,1,0,deny
49633,445,0,0,70,70,0,1,0,1,0,drop
59535,25174,0,0,146,146,0,1,0,1,0,deny
49631,445,0,0,70,70,0,1,0,1,0,drop
54351,445,0,0,70,70,0,1,0,1,0,drop
45952,22114,0,0,62,62,0,1,0,1,0,deny
55666,35440,0,0,66,66,0,1,0,1,0,deny
54343,445,0,0,70,70,0,1,0,1,0,drop
54339,445,0,0,70,70,0,1,0,1,0,drop
57726,37965,0,0,62,62,0,1,0,1,0,deny
443,50238,0,0,331,331,0,1,0,1,0,deny
57131,35776,0,0,145,145,0,1,0,1,0,deny
49627,445,0,0,70,70,0,1,0,1,0,drop
14185,48637,0,0,60,60,0,1,0,1,0,deny
49625,445,0,0,70,70,0,1,0,1,0,drop
58724,43890,0,0,66,66,0,1,0,1,0,deny
53692,44512,0,0,66,66,0,1,0,1,0,deny
56604,17372,0,0,66,66,0,1,0,1,0,deny
49750,445,0,0,66,66,0,1,0,1,0,drop
3410,17372,0,0,62,62,0,1,0,1,0,deny
59965,36237,0,0,66,66,0,1,0,1,0,deny
10532,26672,0,0,60,60,0,1,0,1,0,deny
63873,44847,0,0,62,62,0,1,0,1,0,deny
59508,65348,0,0,148,148,0,1,0,1,0,deny
3406,17372,0,0,66,66,0,1,0,1,0,deny
56219,22114,0,0,62,62,0,1,0,1,0,deny
49621,445,0,0,70,70,0,1,0,1,0,drop
42973,57470,0,0,62,62,0,1,0,1,0,deny
18130,25174,0,0,62,62,0,1,0,1,0,deny
49743,445,0,0,66,66,0,1,0,1,0,drop
49620,445,0,0,70,70,0,1,0,1,0,drop
443,45788,0,0,199,199,0,1,0,1,0,deny
54327,445,0,0,70,70,0,1,0,1,0,drop
49741,445,0,0,66,66,0,1,0,1,0,drop
50708,22114,0,0,146,146,0,1,0,1,0,deny
49615,445,0,0,70,70,0,1,0,1,0,drop
45837,25174,0,0,62,62,0,1,0,1,0,deny
40845,64147,0,0,62,62,0,1,0,1,0,deny
43155,35440,0,0,66,66,0,1,0,1,0,deny
49734,445,0,0,66,66,0,1,0,1,0,drop
62197,22114,0,0,62,62,0,1,0,1,0,deny
41653,21247,0,0,62,62,0,1,0,1,0,deny
49726,445,0,0,66,66,0,1,0,1,0,drop
61085,37965,0,0,62,62,0,1,0,1,0,deny
443,45788,0,0,199,199,0,1,0,1,0,deny
14869,44847,0,0,62,62,0,1,0,1,0,deny
59155,39004,0,0,74,74,0,1,0,1,0,deny
51558,37965,0,0,72,72,0,1,0,1,0,deny
2064,22114,0,0,62,62,0,1,0,1,0,deny
54051,28793,0,0,66,66,0,1,0,1,0,deny
49602,445,0,0,70,70,0,1,0,1,0,drop
54319,445,0,0,70,70,0,1,0,1,0,drop
54315,445,0,0,70,70,0,1,0,1,0,drop
54316,445,0,0,70,70,0,1,0,1,0,drop
18843,25174,0,0,146,146,0,1,0,1,0,deny
49716,445,0,0,66,66,0,1,0,1,0,drop
49714,445,0,0,66,66,0,1,0,1,0,drop
49718,445,0,0,66,66,0,1,0,1,0,drop
49715,445,0,0,66,66,0,1,0,1,0,drop
49713,445,0,0,66,66,0,1,0,1,0,drop
49712,445,0,0,66,66,0,1,0,1,0,drop
49711,445,0,0,66,66,0,1,0,1,0,drop
49710,445,0,0,66,66,0,1,0,1,0,drop
49908,56205,0,0,62,62,0,1,0,1,0,deny
38852,37965,0,0,62,62,0,1,0,1,0,deny
65270,3855,0,0,78,78,0,1,0,1,0,deny
58421,30188,0,0,66,66,0,1,0,1,0,deny
50334,64147,0,0,66,66,0,1,0,1,0,deny
8560,50584,0,0,62,62,0,1,0,1,0,deny
41885,25174,0,0,62,62,0,1,0,1,0,deny
55998,15503,0,0,146,146,0,1,0,1,0,deny
0,0,0,0,244,244,0,2,0,2,0,allow
49599,445,0,0,70,70,0,1,0,1,0,drop
5826,26467,0,0,62,62,0,1,0,1,0,deny
27321,25174,0,0,62,62,0,1,0,1,0,deny
14333,51050,0,0,62,62,0,1,0,1,0,deny
54314,445,0,0,70,70,0,1,0,1,0,drop
54306,445,0,0,70,70,0,1,0,1,0,drop
54307,445,0,0,70,70,0,1,0,1,0,drop
54302,445,0,0,70,70,0,1,0,1,0,drop
8116,25773,0,0,157,157,0,1,0,1,0,reset-both
49594,445,0,0,70,70,0,1,0,1,0,drop
49593,445,0,0,70,70,0,1,0,1,0,drop
49695,445,0,0,66,66,0,1,0,1,0,drop
49698,445,0,0,66,66,0,1,0,1,0,drop
49696,445,0,0,66,66,0,1,0,1,0,drop
49591,445,0,0,70,70,0,1,0,1,0,drop
39646,44847,0,0,146,146,0,1,0,1,0,deny
51533,44847,0,0,62,62,0,1,0,1,0,deny
20682,57470,0,0,62,62,0,1,0,1,0,deny
6666,138,0,0,60,60,0,1,0,1,0,deny
48706,23393,0,0,60,60,0,1,0,1,0,deny
50396,62413,0,0,66,66,0,1,0,1,0,deny
59822,56205,0,0,66,66,0,1,0,1,0,deny
60416,37965,0,0,66,66,0,1,0,1,0,deny
52280,44847,0,0,62,62,0,1,0,1,0,deny
54295,445,0,0,70,70,0,1,0,1,0,drop
1101,11119,0,0,146,146,0,1,0,1,0,deny
54293,445,0,0,70,70,0,1,0,1,0,drop
54289,445,0,0,70,70,0,1,0,1,0,drop
54288,445,0,0,70,70,0,1,0,1,0,drop
5223,32965,0,0,66,66,0,1,0,1,0,deny
5223,32965,0,0,119,119,0,1,0,1,0,deny
5223,32965,0,0,167,167,0,1,0,1,0,deny
49584,445,0,0,70,70,0,1,0,1,0,drop
18398,21247,0,0,66,66,0,1,0,1,0,deny
8080,37965,0,0,62,62,0,1,0,1,0,deny
49582,445,0,0,70,70,0,1,0,1,0,drop
23310,22114,0,0,66,66,0,1,0,1,0,deny
12567,23,0,0,60,60,0,1,0,1,0,deny
7561,43890,0,0,66,66,0,1,0,1,0,deny
49581,445,0,0,70,70,0,1,0,1,0,drop
50272,53,9644,53,744,95,649,2,30,1,1,allow
35526,443,57074,443,4566,3317,1249,21,23,12,9,allow
9431,443,45231,443,8693,2545,6148,26,34,13,13,allow
62627,7000,62627,7000,2990,1599,1391,15,15,8,7,allow
52096,80,38227,80,366,240,126,7,25,5,2,allow
56238,80,56238,80,44951,1019,43932,48,15,15,33,allow
56246,80,56246,80,101654,1739,99915,95,15,25,70,allow
56241,80,56241,80,101607,1692,99915,94,15,24,70,allow
51422,80,51422,80,9962,3379,6583,26,26,13,13,allow
51427,80,51427,80,22364,4125,18239,41,26,19,22,allow
56778,443,16345,443,8654,2150,6504,20,15,11,9,allow
27164,53,27164,53,208,94,114,2,30,1,1,allow
52076,80,2859,80,366,240,126,7,26,5,2,allow
52077,80,35958,80,366,240,126,7,26,5,2,allow
55047,443,3031,443,7069,2512,4557,25,46,14,11,allow
21187,53,21187,53,208,94,114,2,30,1,1,allow
64670,53,38301,53,186,95,91,2,31,1,1,allow
54865,443,54865,443,125282,21435,103847,162,20,80,82,allow
9440,443,42891,443,7573,1528,6045,22,33,11,11,allow
56507,80,59986,80,1583,712,871,10,136,6,4,allow
58836,443,33212,443,383990,15580,368410,490,212,192,298,allow
52167,80,36480,80,1734,800,934,10,16,6,4,allow
56242,80,56242,80,101354,1343,100011,89,15,19,70,allow
53532,8569,14217,8569,546,306,240,9,143,5,4,allow
56777,443,21273,443,8654,2150,6504,20,16,11,9,allow
60415,53,0,0,82,82,0,1,30,1,0,allow
56245,80,56245,80,101179,1296,99883,88,15,18,70,allow
49023,5223,46497,5223,70,70,0,2,5,2,0,allow
123,123,44084,123,184,94,90,2,30,1,1,allow
56244,80,56244,80,101473,1494,99979,91,15,21,70,allow
44013,53,44013,53,197,76,121,2,30,1,1,allow
58255,123,13070,123,184,94,90,2,30,1,1,allow
52876,443,52876,443,5045,2187,2858,16,136,8,8,allow
46508,80,61419,80,1056,682,374,10,15,6,4,allow
52193,443,39804,443,8868,4111,4757,24,16,12,12,allow
51424,80,51424,80,4995,3443,1552,23,26,13,10,allow
49325,443,26750,443,5749,3401,2348,29,76,15,14,allow
60490,62336,7987,62336,504,318,186,8,15,5,3,allow
9478,443,35302,443,6092,775,5317,17,28,9,8,allow
49326,443,59214,443,5514,3341,2173,31,75,15,16,allow
41753,443,5130,443,11570,3005,8565,43,255,20,23,allow
38961,443,38961,443,4425,1518,2907,19,29,11,8,allow
56239,80,56239,80,101707,1824,99883,96,15,26,70,allow
55609,443,14768,443,13039,4388,8651,93,1191,47,46,allow
56240,80,56240,80,101524,1673,99851,94,15,24,70,allow
44675,53,44675,53,197,76,121,2,30,1,1,allow
49554,53,13063,53,204,104,100,2,30,1,1,allow
56739,53,56739,53,825,99,726,2,30,1,1,allow
63318,443,32091,443,8451,2698,5753,21,129,9,12,allow
57487,443,7890,443,17065,11570,5495,76,218,39,37,allow
50265,41198,60886,41198,330,330,0,6,1200,6,0,allow
34230,53,34230,53,823,98,725,2,31,1,1,allow
40471,53,40471,53,194,87,107,2,31,1,1,allow
32161,53,32161,53,823,98,725,2,31,1,1,allow
3229,53,3229,53,244,98,146,2,31,1,1,allow
29791,53,29791,53,213,87,126,2,31,1,1,allow
27888,53,27888,53,240,96,144,2,31,1,1,allow
54595,443,41142,443,5692,2502,3190,24,131,12,12,allow
55516,5228,12835,5228,2769,1694,1075,20,3600,10,10,allow
38891,443,20514,443,3489,636,2853,16,143,7,9,allow
50265,63104,28604,63104,330,330,0,6,1200,6,0,allow
56400,35440,0,0,66,66,0,1,0,1,0,deny
49580,445,0,0,70,70,0,1,0,1,0,drop
49579,445,0,0,70,70,0,1,0,1,0,drop
49577,445,0,0,70,70,0,1,0,1,0,drop
49576,445,0,0,70,70,0,1,0,1,0,drop
43642,48817,0,0,134,134,0,1,0,1,0,deny
54278,445,0,0,70,70,0,1,0,1,0,drop
54275,445,0,0,70,70,0,1,0,1,0,drop
54277,445,0,0,70,70,0,1,0,1,0,drop
443,50238,0,0,331,331,0,1,0,1,0,deny
65228,53,0,0,88,88,0,1,0,1,0,deny
62208,37965,0,0,66,66,0,1,0,1,0,deny
54677,443,30863,443,72676,12694,59982,144,127,64,80,allow
9420,443,29951,443,9308,2125,7183,27,34,13,14,allow
53928,47287,32055,47287,612,306,306,10,14,5,5,allow
49683,443,27198,443,11301,2219,9082,29,187,14,15,allow
38568,443,10055,443,11418,1999,9419,28,22,13,15,allow
41581,443,9229,443,6816,1197,5619,24,269,12,12,allow
49984,53,11243,53,373,88,285,4,58,2,2,allow
49986,443,64470,443,11626,1206,10420,31,74,13,18,allow
37666,443,8330,443,3354,2353,1001,18,45,11,7,allow
52518,80,48144,80,3290,2776,514,12,15,7,5,allow
55722,26192,12187,26192,70,70,0,2,8,2,0,allow
39648,443,15824,443,5663,4227,1436,27,47,16,11,allow
9471,443,58396,443,8533,1544,6989,22,30,11,11,allow
60806,40010,25471,40010,316,136,180,6,6,3,3,allow
65045,53,38314,53,339,105,234,4,53,2,2,allow
60219,53,60219,53,414,268,146,3,32,2,1,allow
7532,53,7532,53,228,90,138,2,31,1,1,allow
65189,53,46273,53,328,93,235,4,29,2,2,allow
49319,53,39564,53,199,102,97,2,29,1,1,allow
33768,53,59037,53,168,78,90,2,29,1,1,allow
56174,443,38355,443,18931,4924,14007,46,139,20,26,allow
49681,443,29652,443,7074,2016,5058,26,187,13,13,allow
48817,51414,48817,51414,150,150,0,1,1200,1,0,allow
64670,53,60367,53,193,102,91,2,30,1,1,allow
51423,80,51423,80,7610,2737,4873,23,26,12,11,allow
49684,445,0,0,66,66,0,1,0,1,0,drop
18415,37965,0,0,62,62,0,1,0,1,0,deny
65200,51050,0,0,66,66,0,1,0,1,0,deny
49561,445,0,0,70,70,0,1,0,1,0,drop
61785,64147,0,0,62,62,0,1,0,1,0,deny
49560,445,0,0,70,70,0,1,0,1,0,drop
54268,443,64525,443,10173,1548,8625,25,41,14,11,allow
51135,80,13103,80,366,240,126,7,21,5,2,allow
59808,53,0,0,86,86,0,1,30,1,0,allow
49719,53,33096,53,209,110,99,2,30,1,1,allow
55036,443,33915,443,36364,9639,26725,62,53,31,31,allow
51426,80,51426,80,114697,3049,111648,114,26,35,79,allow
55717,13517,54958,13517,70,70,0,1,5,1,0,allow
55049,443,34090,443,13661,4451,9210,32,46,18,14,allow
49519,443,20384,443,7086,1913,5173,29,270,16,13,allow
64670,53,24174,53,193,102,91,2,30,1,1,allow
63142,443,9605,443,4994,379,4615,9,15,4,5,allow
49554,53,50726,53,210,110,100,2,30,1,1,allow
52164,42271,32377,42271,70,70,0,1,5,1,0,allow
53136,5228,42128,5228,26821,4295,22526,95,5045,40,55,allow
55877,55153,7894,55153,481,150,331,2,1200,1,1,allow
49603,443,57719,443,11841,1700,10141,37,195,16,21,allow
34980,443,26995,443,8211,2165,6046,25,361,13,12,allow
52514,80,2585,80,3224,2776,448,11,15,7,4,allow
52517,80,63047,80,4297,3719,578,14,15,8,6,allow
56251,80,56251,80,101529,1646,99883,94,15,24,70,allow
56243,80,56243,80,101477,1626,99851,93,15,23,70,allow
65253,53,35458,53,321,150,171,2,30,1,1,allow
57619,443,40662,443,9315,2153,7162,23,127,6,17,allow
35570,443,64379,443,3221,705,2516,15,135,7,8,allow
52062,80,7748,80,366,240,126,7,26,5,2,allow
51136,80,1499,80,366,240,126,7,21,5,2,allow
34572,443,63392,443,52330,13948,38382,131,129,71,60,allow
54115,443,7544,443,6840,1394,5446,29,270,14,15,allow
53231,443,26059,443,11825,4129,7696,39,40,21,18,allow
56607,443,33013,443,21604,12969,8635,49,112,28,21,allow
56681,443,64351,443,19154,11130,8024,40,102,24,16,allow
52063,80,12503,80,366,240,126,7,26,5,2,allow
51972,5222,10197,5222,5410,2343,3067,42,53,24,18,allow
55711,10480,9991,10480,564,318,246,9,18,5,4,allow
52043,80,36469,80,4185,3462,723,14,15,7,7,allow
52519,80,46745,80,3771,3257,514,12,14,7,5,allow
57270,443,35956,443,9415,3482,5933,57,16,29,28,allow
65534,53,65534,53,414,268,146,3,31,2,1,allow
40932,443,14613,443,4435,2949,1486,25,80,14,11,allow
64075,1026,16814,1026,66,66,0,2,7,2,0,allow
41399,443,26251,443,8512,2563,5949,27,24,15,12,allow
52336,443,7480,443,134,60,74,3,10,2,1,allow
55720,51610,5460,51610,70,70,0,1,5,1,0,allow
52108,80,27420,80,182,60,122,4,25,2,2,allow
46093,443,55794,443,14746,3097,11649,34,19,19,15,allow
52516,80,41641,80,3224,2776,448,11,15,7,4,allow
55718,16805,50581,16805,70,70,0,1,5,1,0,allow
52515,80,55752,80,4183,3603,580,14,15,8,6,allow
57606,443,30554,443,2614,1689,925,18,22,10,8,allow
52085,80,49733,80,360,240,120,7,25,5,2,allow
37508,443,44640,443,8586,1714,6872,25,43,14,11,allow
57863,443,39260,443,2342,1341,1001,15,19,8,7,allow
52073,80,46138,80,482,300,182,9,26,6,3,allow
36828,53,40804,53,168,78,90,2,30,1,1,allow
64714,53,41976,53,212,102,110,2,30,1,1,allow
57061,53,24920,53,197,94,103,2,29,1,1,allow
64143,53,3615,53,179,94,85,2,30,1,1,allow
49357,53,3200,53,211,102,109,2,30,1,1,allow
39297,443,49533,443,9320,3888,5432,21,119,10,11,allow
50265,45589,64355,45589,132,132,0,3,1200,3,0,allow
50265,54145,30228,54145,858,858,0,14,1200,14,0,allow
52016,80,20046,80,8551,5933,2618,18,26,12,6,allow
123,123,41547,123,184,94,90,2,30,1,1,allow
58734,443,17024,443,8758,3850,4908,26,330,14,12,allow
52092,80,44323,80,426,240,186,8,25,5,3,allow
51973,5222,53843,5222,9184,4142,5042,72,53,40,32,allow
51425,80,51425,80,11369,3404,7965,28,26,14,14,allow
60290,443,20487,443,6753,2052,4701,25,15,13,12,allow
53272,443,50136,443,5544,1703,3841,19,31,11,8,allow
52190,443,60064,443,570322,21029,549293,569,46,181,388,allow
55704,53,57746,53,193,102,91,2,30,1,1,allow
61353,443,57410,443,4401,1654,2747,10,120,5,5,allow
55719,13302,2915,13302,70,70,0,1,5,1,0,allow
52072,80,26468,80,482,300,182,9,26,6,3,allow
123,123,58588,123,184,94,90,2,30,1,1,allow
55704,53,41998,53,193,102,91,2,30,1,1,allow
55704,53,62671,53,193,102,91,2,30,1,1,allow
64596,53,7572,53,237,110,127,2,30,1,1,allow
56687,53,1087,53,225,110,115,2,30,1,1,allow
35140,123,7443,123,184,94,90,2,30,1,1,allow
59787,443,23637,443,276238,23971,252267,482,138,188,294,allow
33939,443,3295,443,3191,1047,2144,13,135,6,7,allow
39536,80,4904,80,2749,1732,1017,21,361,12,9,allow
50265,18183,50480,18183,966,464,502,14,1200,7,7,allow
57470,31373,26422,31373,1386,1386,0,22,1798,22,0,allow
45706,443,50703,443,512213,34626,477587,741,147,283,458,allow
56906,443,9378,443,1712418,88847,1623571,2014,149,715,1299,allow
58956,80,51257,80,2493,1830,663,12,15,6,6,allow
49518,443,29100,443,6602,1573,5029,25,271,11,14,allow
52875,443,52875,443,3133,814,2319,13,136,6,7,allow
52065,80,44925,80,692,300,392,9,26,6,3,allow
52066,80,29968,80,692,300,392,9,26,6,3,allow
52074,80,8248,80,422,240,182,8,26,5,3,allow
33043,443,21466,443,11414,6355,5059,30,40,15,15,allow
53930,19831,55247,19831,70,70,0,1,5,1,0,allow
57910,80,25307,80,6453,1210,5243,14,24,8,6,allow
49554,445,0,0,70,70,0,1,0,1,0,drop
49551,445,0,0,70,70,0,1,0,1,0,drop
49550,445,0,0,70,70,0,1,0,1,0,drop
54270,445,0,0,70,70,0,1,0,1,0,drop
41176,64147,0,0,145,145,0,1,0,1,0,deny
21522,80,0,0,60,60,0,1,0,1,0,deny
65332,56205,0,0,62,62,0,1,0,1,0,deny
54268,445,0,0,70,70,0,1,0,1,0,drop
45286,62413,0,0,146,146,0,1,0,1,0,deny
45981,51505,0,0,146,146,0,1,0,1,0,deny
14409,7363,0,0,145,145,0,1,0,1,0,deny
47342,36237,0,0,66,66,0,1,0,1,0,deny
49671,445,0,0,66,66,0,1,0,1,0,drop
49670,445,0,0,66,66,0,1,0,1,0,drop
56713,25174,0,0,62,62,0,1,0,1,0,deny
49539,445,0,0,70,70,0,1,0,1,0,drop
6881,57470,0,0,146,146,0,1,0,1,0,deny
26287,56205,0,0,66,66,0,1,0,1,0,deny
51993,25174,0,0,66,66,0,1,0,1,0,deny
16862,21247,0,0,62,62,0,1,0,1,0,deny
443,4205,0,0,320,320,0,1,0,1,0,deny
14656,36237,0,0,66,66,0,1,0,1,0,deny
10390,26467,0,0,62,62,0,1,0,1,0,deny
54259,445,0,0,70,70,0,1,0,1,0,drop
54252,445,0,0,70,70,0,1,0,1,0,drop
54251,445,0,0,70,70,0,1,0,1,0,drop
54249,445,0,0,70,70,0,1,0,1,0,drop
59874,22114,0,0,66,66,0,1,0,1,0,deny
17306,25174,0,0,66,66,0,1,0,1,0,deny
59587,25174,0,0,146,146,0,1,0,1,0,deny
64013,57470,0,0,74,74,0,1,0,1,0,deny
49664,445,0,0,66,66,0,1,0,1,0,drop
50169,25174,0,0,62,62,0,1,0,1,0,deny
49534,445,0,0,70,70,0,1,0,1,0,drop
53108,22114,0,0,146,146,0,1,0,1,0,deny
6881,6881,0,0,62,62,0,1,0,1,0,deny
32090,43890,0,0,146,146,0,1,0,1,0,deny
49648,445,0,0,66,66,0,1,0,1,0,drop
49656,445,0,0,66,66,0,1,0,1,0,drop
49654,445,0,0,66,66,0,1,0,1,0,drop
49653,445,0,0,66,66,0,1,0,1,0,drop
49652,445,0,0,66,66,0,1,0,1,0,drop
49659,445,0,0,66,66,0,1,0,1,0,drop
49649,445,0,0,66,66,0,1,0,1,0,drop
57236,53733,0,0,66,66,0,1,0,1,0,deny
49525,445,0,0,70,70,0,1,0,1,0,drop
49524,445,0,0,70,70,0,1,0,1,0,drop
49523,445,0,0,70,70,0,1,0,1,0,drop
54243,445,0,0,70,70,0,1,0,1,0,drop
49520,445,0,0,70,70,0,1,0,1,0,drop
54240,445,0,0,70,70,0,1,0,1,0,drop
54238,445,0,0,70,70,0,1,0,1,0,drop
54236,445,0,0,70,70,0,1,0,1,0,drop
49518,445,0,0,70,70,0,1,0,1,0,drop
38565,51505,0,0,62,62,0,1,0,1,0,deny
57410,25174,0,0,62,62,0,1,0,1,0,deny
29512,30188,0,0,62,62,0,1,0,1,0,deny
44674,25174,0,0,146,146,0,1,0,1,0,deny
50637,36237,0,0,62,62,0,1,0,1,0,deny
54598,37965,0,0,66,66,0,1,0,1,0,deny
57539,44847,0,0,62,62,0,1,0,1,0,deny
49512,445,0,0,70,70,0,1,0,1,0,drop
54234,445,0,0,70,70,0,1,0,1,0,drop
54231,445,0,0,70,70,0,1,0,1,0,drop
54228,445,0,0,70,70,0,1,0,1,0,drop
49640,445,0,0,66,66,0,1,0,1,0,drop
49607,25174,0,0,66,66,0,1,0,1,0,deny
54227,445,0,0,70,70,0,1,0,1,0,drop
63002,22114,0,0,66,66,0,1,0,1,0,deny
443,50238,0,0,331,331,0,1,0,1,0,deny
14185,48637,0,0,60,60,0,1,0,1,0,deny
49639,445,0,0,66,66,0,1,0,1,0,drop
9231,3389,0,0,66,66,0,1,0,1,0,deny
49637,445,0,0,66,66,0,1,0,1,0,drop
49635,445,0,0,66,66,0,1,0,1,0,drop
13840,37965,0,0,146,146,0,1,0,1,0,deny
10754,28793,0,0,66,66,0,1,0,1,0,deny
49505,445,0,0,70,70,0,1,0,1,0,drop
49634,445,0,0,66,66,0,1,0,1,0,drop
10532,26672,0,0,60,60,0,1,0,1,0,deny
7686,25174,0,0,62,62,0,1,0,1,0,deny
49502,445,0,0,70,70,0,1,0,1,0,drop
14023,37965,0,0,62,62,0,1,0,1,0,deny
58148,43890,0,0,66,66,0,1,0,1,0,deny
25031,25174,0,0,146,146,0,1,0,1,0,deny
52819,15503,0,0,66,66,0,1,0,1,0,deny
49786,25174,0,0,66,66,0,1,0,1,0,deny
30046,15503,0,0,62,62,0,1,0,1,0,deny
60883,64147,0,0,74,74,0,1,0,1,0,deny
14360,64147,0,0,62,62,0,1,0,1,0,deny
54225,445,0,0,70,70,0,1,0,1,0,drop
49499,445,0,0,70,70,0,1,0,1,0,drop
54216,445,0,0,70,70,0,1,0,1,0,drop
54210,445,0,0,70,70,0,1,0,1,0,drop
49497,445,0,0,70,70,0,1,0,1,0,drop
56213,26467,0,0,62,62,0,1,0,1,0,deny
1038,37965,0,0,62,62,0,1,0,1,0,deny
17842,22114,0,0,62,62,0,1,0,1,0,deny
49622,445,0,0,66,66,0,1,0,1,0,drop
18652,64147,0,0,62,62,0,1,0,1,0,deny
49493,445,0,0,70,70,0,1,0,1,0,drop
52518,35440,0,0,66,66,0,1,0,1,0,deny
24931,25174,0,0,62,62,0,1,0,1,0,deny
49491,445,0,0,70,70,0,1,0,1,0,drop
61762,44847,0,0,62,62,0,1,0,1,0,deny
40054,62413,0,0,62,62,0,1,0,1,0,deny
13285,29892,0,0,145,145,0,1,0,1,0,deny
1190,25174,0,0,146,146,0,1,0,1,0,deny
15998,36829,0,0,62,62,0,1,0,1,0,deny
52969,44847,0,0,66,66,0,1,0,1,0,deny
49615,445,0,0,66,66,0,1,0,1,0,drop
34212,11392,0,0,66,66,0,1,0,1,0,deny
54201,445,0,0,70,70,0,1,0,1,0,drop
41315,11392,0,0,146,146,0,1,0,1,0,deny
36770,56205,0,0,62,62,0,1,0,1,0,deny
2932,44847,0,0,62,62,0,1,0,1,0,deny
18725,35440,0,0,62,62,0,1,0,1,0,deny
49613,445,0,0,66,66,0,1,0,1,0,drop
49487,445,0,0,70,70,0,1,0,1,0,drop
8889,16164,0,0,60,60,0,1,0,1,0,deny
50360,37965,0,0,66,66,0,1,0,1,0,deny
443,50238,0,0,60,60,0,1,0,1,0,deny
50990,23884,0,0,66,66,0,1,0,1,0,deny
49606,445,0,0,66,66,0,1,0,1,0,drop
443,50238,0,0,99,99,0,1,0,1,0,deny
443,50238,0,0,286,286,0,1,0,1,0,deny
0,0,0,0,94,94,0,1,0,1,0,deny
49598,445,0,0,66,66,0,1,0,1,0,drop
62902,32468,0,0,66,66,0,1,0,1,0,deny
17232,22114,0,0,62,62,0,1,0,1,0,deny
52462,25174,0,0,62,62,0,1,0,1,0,deny
19933,35440,0,0,62,62,0,1,0,1,0,deny
40479,35993,0,0,62,62,0,1,0,1,0,deny
37959,3855,0,0,72,72,0,1,0,1,0,deny
65270,3855,0,0,78,78,0,1,0,1,0,deny
49474,445,0,0,70,70,0,1,0,1,0,drop
54192,445,0,0,70,70,0,1,0,1,0,drop
54189,445,0,0,70,70,0,1,0,1,0,drop
54187,445,0,0,70,70,0,1,0,1,0,drop
49584,445,0,0,66,66,0,1,0,1,0,drop
49589,445,0,0,66,66,0,1,0,1,0,drop
49590,445,0,0,66,66,0,1,0,1,0,drop
49588,445,0,0,66,66,0,1,0,1,0,drop
49585,445,0,0,66,66,0,1,0,1,0,drop
49583,445,0,0,66,66,0,1,0,1,0,drop
49586,445,0,0,66,66,0,1,0,1,0,drop
49582,445,0,0,66,66,0,1,0,1,0,drop
41677,57470,0,0,66,66,0,1,0,1,0,deny
49471,445,0,0,70,70,0,1,0,1,0,drop
55994,22114,0,0,66,66,0,1,0,1,0,deny
49677,25174,0,0,66,66,0,1,0,1,0,deny
26697,37965,0,0,66,66,0,1,0,1,0,deny
44378,995,0,0,60,60,0,1,0,1,0,deny
56451,995,0,0,60,60,0,1,0,1,0,deny
35201,25174,0,0,62,62,0,1,0,1,0,deny
25197,1433,0,0,60,60,0,1,0,1,0,deny
10462,25174,0,0,146,146,0,1,0,1,0,deny
60245,25174,0,0,62,62,0,1,0,1,0,deny
19875,30170,0,0,145,145,0,1,0,1,0,deny
49467,445,0,0,70,70,0,1,0,1,0,drop
1058,36866,0,0,136,136,0,1,0,1,0,deny
49465,445,0,0,70,70,0,1,0,1,0,drop
2850,64147,0,0,66,66,0,1,0,1,0,deny
54184,445,0,0,70,70,0,1,0,1,0,drop
54178,445,0,0,70,70,0,1,0,1,0,drop
54179,445,0,0,70,70,0,1,0,1,0,drop
54172,445,0,0,70,70,0,1,0,1,0,drop
22547,48817,0,0,72,72,0,1,0,1,0,deny
49463,445,0,0,70,70,0,1,0,1,0,drop
63398,25174,0,0,66,66,0,1,0,1,0,deny
49568,445,0,0,66,66,0,1,0,1,0,drop
49570,445,0,0,66,66,0,1,0,1,0,drop
49567,445,0,0,66,66,0,1,0,1,0,drop
18574,56205,0,0,66,66,0,1,0,1,0,deny
51143,443,51143,443,33565,5938,27627,60,128,24,36,allow
49288,80,52653,80,1056,682,374,10,15,6,4,allow
57490,443,55071,443,1778,1219,559,13,26,8,5,allow
6666,3493,6666,3493,60,60,0,1,5,1,0,allow
52070,80,7371,80,362,240,122,7,25,5,2,allow
51077,443,51077,443,32010,3207,28803,52,128,20,32,allow
58895,443,55555,443,148,82,66,2,10,1,1,allow
56233,80,56233,80,44955,1023,43932,48,15,15,33,allow
9381,53,9381,53,200,90,110,2,30,1,1,allow
33733,443,7805,443,6998,2361,4637,20,17,10,10,allow
50693,443,50693,443,19125,2345,16780,37,128,15,22,allow
60106,443,61992,443,7243,4797,2446,42,136,23,19,allow
56230,80,56230,80,44881,949,43932,47,15,14,33,allow
56234,80,56234,80,44817,885,43932,46,15,13,33,allow
52071,80,35794,80,362,240,122,7,25,5,2,allow
38663,15000,54810,15000,138,78,60,2,5,1,1,allow
52067,80,33886,80,362,240,122,7,25,5,2,allow
60524,443,60524,443,1088,641,447,10,26,6,4,allow
44714,443,14525,443,7389,2124,5265,26,316,12,14,allow
13084,53,13084,53,224,88,136,2,30,1,1,allow
57493,443,46334,443,1778,1219,559,13,27,8,5,allow
56928,53,56928,53,823,98,725,2,30,1,1,allow
52078,80,58261,80,366,240,126,7,25,5,2,allow
56231,80,56231,80,44747,815,43932,45,15,12,33,allow
56236,80,56236,80,44755,823,43932,45,15,12,33,allow
49324,443,63452,443,6586,3686,2900,35,75,17,18,allow
52079,80,61511,80,366,240,126,7,25,5,2,allow
52069,80,30929,80,362,240,122,7,25,5,2,allow
52068,80,54676,80,362,240,122,7,25,5,2,allow
49886,7000,49886,7000,1236,676,560,13,15,7,6,allow
61488,443,29110,443,7036,2247,4789,39,141,19,20,allow
49509,443,10156,443,8248,2508,5740,31,271,13,18,allow
32317,53,32317,53,823,98,725,2,30,1,1,allow
56232,80,56232,80,44752,820,43932,45,15,12,33,allow
56235,80,56235,80,44756,824,43932,45,15,12,33,allow
53961,13067,41847,13067,70,70,0,2,8,2,0,allow
64064,29856,32936,29856,66,66,0,1,5,1,0,allow
56237,80,56237,80,44949,1017,43932,48,15,15,33,allow
51544,4545,51544,4545,156,156,0,3,8,3,0,allow
51142,443,51142,443,261206,9686,251520,308,128,121,187,allow
60525,443,60525,443,1088,641,447,10,26,6,4,allow
28549,53,28549,53,194,87,107,2,30,1,1,allow
36672,53,36672,53,234,93,141,2,30,1,1,allow
47674,53,47674,53,200,90,110,2,30,1,1,allow
50313,53,50313,53,202,91,111,2,30,1,1,allow
41389,443,45580,443,280,140,140,5,131,3,2,allow
51414,22,0,0,60,60,0,1,0,1,0,deny
30456,36237,0,0,146,146,0,1,0,1,0,deny
54167,445,0,0,70,70,0,1,0,1,0,drop
5222,21212,0,0,66,66,0,1,0,1,0,deny
2075,19473,0,0,66,66,0,1,0,1,0,deny
31675,19473,0,0,62,62,0,1,0,1,0,deny
16429,56205,0,0,146,146,0,1,0,1,0,deny
65228,53,0,0,88,88,0,1,0,1,0,deny
54166,445,0,0,70,70,0,1,0,1,0,drop
54162,445,0,0,70,70,0,1,0,1,0,drop
54157,445,0,0,70,70,0,1,0,1,0,drop
49456,445,0,0,70,70,0,1,0,1,0,drop
12465,9823,0,0,146,146,0,1,0,1,0,deny
61550,5529,0,0,145,145,0,1,0,1,0,deny
31675,19473,0,0,145,145,0,1,0,1,0,deny
65228,53,0,0,88,88,0,1,0,1,0,deny
59068,57470,0,0,74,74,0,1,0,1,0,deny
49454,445,0,0,70,70,0,1,0,1,0,drop
60805,20010,40863,20010,70,70,0,2,8,2,0,allow
52030,443,43838,443,9090,1914,7176,24,25,13,11,allow
39442,443,24613,443,6420,1513,4907,25,26,14,11,allow
52001,80,20376,80,8117874,148550,7969324,7318,25,2033,5285,allow
55020,443,57548,443,3533,1045,2488,17,147,8,9,allow
55457,53,65037,53,372,126,246,2,29,1,1,allow
62717,443,23146,443,3129,782,2347,17,134,8,9,allow
49440,443,48823,443,3721809,103604,3618205,3808,156,1281,2527,allow
52060,80,41226,80,366,240,126,7,25,5,2,allow
62349,443,37822,443,3942042,47512,3894530,3167,53,526,2641,allow
40122,443,13389,443,8235,2076,6159,24,330,11,13,allow
64560,53,40808,53,578,179,399,6,56,3,3,allow
52059,80,19994,80,426,240,186,8,25,5,3,allow
52166,80,3955,80,2110,1066,1044,12,15,7,5,allow
13554,53,13554,53,404,259,145,3,33,2,1,allow
53955,3290,40369,3290,70,70,0,2,7,2,0,allow
52061,80,7969,80,366,240,126,7,25,5,2,allow
64381,53,4400,53,168,86,82,2,32,1,1,allow
36628,80,34664,80,78,78,0,1,4,1,0,allow
44907,5900,44907,5900,130,66,64,2,4,1,1,allow
55267,53,45498,53,168,78,90,2,29,1,1,allow
65084,53,19424,53,215,102,113,2,29,1,1,allow
1100,27540,42086,27540,132,70,62,2,29,1,1,allow
51156,53,46247,53,168,78,90,2,29,1,1,allow
52043,80,5658,80,1484,805,679,11,25,7,4,allow
52100,443,42530,443,14433889,278906,14154983,13633,66,4079,9554,allow
56750,53,18998,53,279,118,161,2,30,1,1,allow
20850,53,20850,53,245,98,147,2,30,1,1,allow
56102,53,33083,53,199,94,105,2,30,1,1,allow
20826,53,20826,53,228,90,138,2,32,1,1,allow
64074,34067,2832,34067,312,132,180,6,6,3,3,allow
53723,443,52693,443,70,70,0,2,8,2,0,allow
61526,443,1145,443,13977,5303,8674,48,152,20,28,allow
60522,443,60522,443,1088,641,447,10,25,6,4,allow
60523,443,60523,443,1088,641,447,10,25,6,4,allow
52005,443,38700,443,4802,866,3936,19,26,10,9,allow
48163,53,27599,53,199,94,105,2,30,1,1,allow
34352,53,34352,53,240,98,142,2,30,1,1,allow
50680,80,61821,80,23386,2375,21011,30,21,12,18,allow
39537,80,22901,80,903,482,421,10,360,5,5,allow
49378,53,26888,53,210,94,116,2,30,1,1,allow
65066,53,65066,53,240,98,142,2,30,1,1,allow
52039,80,39126,80,366,240,126,7,25,5,2,allow
41207,80,55374,80,79441,3092,76349,103,16,48,55,allow
51132,80,62444,80,426,240,186,8,21,5,3,allow
57509,443,8553,443,5150,3987,1163,18,38,11,7,allow
35797,53,35797,53,217,90,127,2,30,1,1,allow
17734,53,17734,53,217,90,127,2,30,1,1,allow
49488,53,49488,53,823,98,725,2,30,1,1,allow
49171,53,63019,53,301,102,199,2,30,1,1,allow
57445,66,60334,66,70,70,0,1,5,1,0,allow
52000,80,36562,80,416,210,206,7,26,4,3,allow
58921,443,58921,443,4627,1720,2907,19,28,11,8,allow
50884,443,50884,443,187790,7733,180057,229,128,90,139,allow
46370,443,36990,443,11035,8438,2597,39,95,23,16,allow
51671,53,51671,53,200,90,110,2,30,1,1,allow
43303,443,47473,443,6448,1982,4466,22,16,11,11,allow
52064,80,33091,80,692,300,392,9,25,6,3,allow
52075,80,29185,80,422,240,182,8,25,5,3,allow
49927,80,6147,80,1141,636,505,10,45,6,4,allow
43834,443,19453,443,4824,671,4153,13,29,7,6,allow
52057,80,6987,80,422,240,182,8,25,5,3,allow
52058,80,14075,80,362,240,122,7,25,5,2,allow
62640,53,62640,53,414,268,146,3,32,2,1,allow
64063,37832,22712,37832,70,70,0,1,4,1,0,allow
53962,16251,40390,16251,70,70,0,2,7,2,0,allow
55182,443,46108,443,2970,1689,1281,24,18,13,11,allow
47311,443,49307,443,3398,2096,1302,19,16,10,9,allow
52042,443,63896,443,8740,1799,6941,25,25,13,12,allow
51078,443,51078,443,71902,4007,67895,98,127,40,58,allow
56363,53,60359,53,269,94,175,2,30,1,1,allow
64670,53,61851,53,193,102,91,2,29,1,1,allow
36665,443,51014,443,5814771,76275,5738496,4959,154,976,3983,allow
64849,53,44145,53,216,102,114,2,29,1,1,allow
2077,53,2077,53,212,98,114,2,30,1,1,allow
57492,53,57492,53,218,90,128,2,30,1,1,allow
40711,53,40711,53,200,90,110,2,30,1,1,allow
55155,53,55155,53,240,98,142,2,30,1,1,allow
49346,53,28098,53,212,102,110,2,30,1,1,allow
48424,53,48424,53,220,90,130,2,30,1,1,allow
53477,443,34084,443,21476,1330,20146,32,137,12,20,allow
10461,53,10461,53,220,90,130,2,30,1,1,allow
56644,53,3506,53,199,94,105,2,30,1,1,allow
27988,40011,54890,40011,253,190,63,2,30,1,1,allow
13871,53,13871,53,240,98,142,2,30,1,1,allow
58045,443,63795,443,3296,1329,1967,14,135,7,7,allow
1725,80,3568,80,254,128,126,5,16,3,2,allow
38384,443,38384,443,4609,1702,2907,19,29,11,8,allow
1666,53,1666,53,217,90,127,2,30,1,1,allow
64049,53,41804,53,209,102,107,2,30,1,1,allow
38784,443,14395,443,9185,3854,5331,23,16,13,10,allow
55657,443,55657,443,30650,11103,19547,66,51,40,26,allow
36536,53,36536,53,414,268,146,3,32,2,1,allow
60492,11339,45509,11339,70,70,0,1,5,1,0,allow
60489,53151,11462,53151,70,70,0,1,5,1,0,allow
56808,53,42088,53,180,94,86,2,35,1,1,allow
56662,443,10328,443,318,192,126,6,15,4,2,allow
52090,64823,30736,64823,634,568,66,8,29,7,1,allow
55812,443,35991,443,9398,2478,6920,26,82,14,12,allow
52003,80,22055,80,16479,1820,14659,31,26,17,14,allow
52490,53,52490,53,240,98,142,2,30,1,1,allow
52004,443,64314,443,4804,866,3938,19,26,10,9,allow
47518,53,47518,53,414,268,146,3,32,2,1,allow
56645,443,24912,443,37030,24937,12093,83,1286,30,53,allow
51615,53,53355,53,207,86,121,2,30,1,1,allow
63139,53,41966,53,78,78,0,1,30,1,0,allow
55628,53,53766,53,199,94,105,2,30,1,1,allow
28998,53,28998,53,220,90,130,2,30,1,1,allow
38905,53,58412,53,86,86,0,1,30,1,0,allow
63384,53,63384,53,198,90,108,2,30,1,1,allow
65172,53,3984,53,211,102,109,2,30,1,1,allow
34441,53,34441,53,314,98,216,2,30,1,1,allow
54118,443,16400,443,3182,1568,1614,8,120,4,4,allow
49445,443,22095,443,462587,17396,445191,527,130,198,329,allow
6881,51719,22526,51719,324,150,174,2,1199,1,1,allow
65498,443,58734,443,3874,1587,2287,17,143,9,8,allow
15503,57141,65001,57141,481,150,331,2,1200,1,1,allow
49539,443,38043,443,5106,1861,3245,21,143,10,11,allow
61187,443,13311,443,4862,1820,3042,14,120,7,7,allow
53952,26973,12520,26973,70,70,0,2,8,2,0,allow
52021,80,35964,80,422,240,182,8,25,5,3,allow
33507,443,18740,443,194174,11657,182517,258,31,124,134,allow
52162,15104,24399,15104,70,70,0,1,5,1,0,allow
50678,80,52506,80,1549,1097,452,9,21,5,4,allow
52034,80,60212,80,366,240,126,7,25,5,2,allow
52479,443,31867,443,9326,1833,7493,24,131,12,12,allow
53924,45212,17906,45212,70,70,0,1,5,1,0,allow
30629,46783,0,0,145,145,0,1,0,1,0,deny
49453,445,0,0,70,70,0,1,0,1,0,drop
10126,57470,0,0,62,62,0,1,0,1,0,deny
64622,36829,0,0,66,66,0,1,0,1,0,deny
49452,445,0,0,70,70,0,1,0,1,0,drop
49451,445,0,0,70,70,0,1,0,1,0,drop
64949,44847,0,0,66,66,0,1,0,1,0,deny
49445,445,0,0,70,70,0,1,0,1,0,drop
9687,35440,0,0,66,66,0,1,0,1,0,deny
59966,37965,0,0,66,66,0,1,0,1,0,deny
1138,57470,0,0,146,146,0,1,0,1,0,deny
54148,445,0,0,70,70,0,1,0,1,0,drop
54146,445,0,0,70,70,0,1,0,1,0,drop
54144,445,0,0,70,70,0,1,0,1,0,drop
27078,25174,0,0,146,146,0,1,0,1,0,deny
49433,445,0,0,70,70,0,1,0,1,0,drop
49432,445,0,0,70,70,0,1,0,1,0,drop
54633,36237,0,0,66,66,0,1,0,1,0,deny
49427,445,0,0,70,70,0,1,0,1,0,drop
49558,445,0,0,66,66,0,1,0,1,0,drop
49423,445,0,0,70,70,0,1,0,1,0,drop
49422,445,0,0,70,70,0,1,0,1,0,drop
11585,56205,0,0,66,66,0,1,0,1,0,deny
17213,22114,0,0,62,62,0,1,0,1,0,deny
16862,21247,0,0,146,146,0,1,0,1,0,deny
16425,15503,0,0,62,62,0,1,0,1,0,deny
61701,15503,0,0,66,66,0,1,0,1,0,deny
54142,445,0,0,70,70,0,1,0,1,0,drop
9212,51505,0,0,146,146,0,1,0,1,0,deny
64013,57470,0,0,74,74,0,1,0,1,0,deny
54141,445,0,0,70,70,0,1,0,1,0,drop
12881,20082,0,0,146,146,0,1,0,1,0,deny
31859,33909,0,0,66,66,0,1,0,1,0,deny
23753,25174,0,0,62,62,0,1,0,1,0,deny
8760,22114,0,0,62,62,0,1,0,1,0,deny
49411,445,0,0,70,70,0,1,0,1,0,drop
31691,50584,0,0,62,62,0,1,0,1,0,deny
31691,50584,0,0,146,146,0,1,0,1,0,deny
49543,445,0,0,66,66,0,1,0,1,0,drop
49542,445,0,0,66,66,0,1,0,1,0,drop
63380,23,0,0,60,60,0,1,0,1,0,deny
32796,37965,0,0,66,66,0,1,0,1,0,deny
27502,50584,0,0,62,62,0,1,0,1,0,deny
56152,56205,0,0,66,66,0,1,0,1,0,deny
54132,445,0,0,70,70,0,1,0,1,0,drop
54129,445,0,0,70,70,0,1,0,1,0,drop
54127,445,0,0,70,70,0,1,0,1,0,drop
54120,445,0,0,70,70,0,1,0,1,0,drop
49407,445,0,0,70,70,0,1,0,1,0,drop
4752,30188,0,0,62,62,0,1,0,1,0,deny
61392,50584,0,0,146,146,0,1,0,1,0,deny
49535,445,0,0,66,66,0,1,0,1,0,drop
21322,25174,0,0,62,62,0,1,0,1,0,deny
42228,51050,0,0,66,66,0,1,0,1,0,deny
58435,64631,0,0,74,74,0,1,0,1,0,deny
49398,445,0,0,70,70,0,1,0,1,0,drop
49395,445,0,0,70,70,0,1,0,1,0,drop
49396,445,0,0,70,70,0,1,0,1,0,drop
49522,445,0,0,66,66,0,1,0,1,0,drop
49520,445,0,0,66,66,0,1,0,1,0,drop
49530,445,0,0,66,66,0,1,0,1,0,drop
49531,445,0,0,66,66,0,1,0,1,0,drop
49527,445,0,0,66,66,0,1,0,1,0,drop
49524,445,0,0,66,66,0,1,0,1,0,drop
52640,64147,0,0,62,62,0,1,0,1,0,deny
49393,445,0,0,70,70,0,1,0,1,0,drop
49391,445,0,0,70,70,0,1,0,1,0,drop
63334,37807,0,0,66,66,0,1,0,1,0,deny
29177,44847,0,0,66,66,0,1,0,1,0,deny
54115,445,0,0,70,70,0,1,0,1,0,drop
14185,48637,0,0,60,60,0,1,0,1,0,deny
61711,35440,0,0,66,66,0,1,0,1,0,deny
57782,57470,0,0,66,66,0,1,0,1,0,deny
16979,56205,0,0,66,66,0,1,0,1,0,deny
54112,445,0,0,70,70,0,1,0,1,0,drop
54108,445,0,0,70,70,0,1,0,1,0,drop
54110,445,0,0,70,70,0,1,0,1,0,drop
60248,46776,0,0,66,66,0,1,0,1,0,deny
14717,64147,0,0,66,66,0,1,0,1,0,deny
53730,37965,0,0,66,66,0,1,0,1,0,deny
10532,26672,0,0,60,60,0,1,0,1,0,deny
1025,46776,0,0,62,62,0,1,0,1,0,deny
18642,42707,0,0,62,62,0,1,0,1,0,deny
56719,37807,0,0,66,66,0,1,0,1,0,deny
18653,42707,0,0,66,66,0,1,0,1,0,deny
56562,44847,0,0,62,62,0,1,0,1,0,deny
55201,26467,0,0,66,66,0,1,0,1,0,deny
43747,22114,0,0,66,66,0,1,0,1,0,deny
49384,445,0,0,70,70,0,1,0,1,0,drop
64878,26467,0,0,62,62,0,1,0,1,0,deny
2572,17546,0,0,66,66,0,1,0,1,0,deny
54104,445,0,0,70,70,0,1,0,1,0,drop
54106,445,0,0,70,70,0,1,0,1,0,drop
54101,445,0,0,70,70,0,1,0,1,0,drop
19068,37965,0,0,62,62,0,1,0,1,0,deny
49513,445,0,0,66,66,0,1,0,1,0,drop
24376,50584,0,0,66,66,0,1,0,1,0,deny
54099,445,0,0,70,70,0,1,0,1,0,drop
25457,25604,0,0,62,62,0,1,0,1,0,deny
49511,445,0,0,66,66,0,1,0,1,0,drop
8884,2323,0,0,60,60,0,1,0,1,0,deny
49377,445,0,0,70,70,0,1,0,1,0,drop
49508,445,0,0,66,66,0,1,0,1,0,drop
49507,445,0,0,66,66,0,1,0,1,0,drop
49375,445,0,0,70,70,0,1,0,1,0,drop
31660,35440,0,0,66,66,0,1,0,1,0,deny
49505,445,0,0,66,66,0,1,0,1,0,drop
11692,25174,0,0,66,66,0,1,0,1,0,deny
64847,22114,0,0,66,66,0,1,0,1,0,deny
443,54507,0,0,82,82,0,1,0,1,0,deny
52596,17372,0,0,66,66,0,1,0,1,0,deny
40078,44847,0,0,146,146,0,1,0,1,0,deny
49371,445,0,0,70,70,0,1,0,1,0,drop
44207,44847,0,0,66,66,0,1,0,1,0,deny
49369,445,0,0,70,70,0,1,0,1,0,drop
54094,445,0,0,70,70,0,1,0,1,0,drop
56639,48817,0,0,62,62,0,1,0,1,0,deny
54088,445,0,0,70,70,0,1,0,1,0,drop
54084,445,0,0,70,70,0,1,0,1,0,drop
58799,30188,0,0,66,66,0,1,0,1,0,deny
49365,445,0,0,70,70,0,1,0,1,0,drop
20741,64147,0,0,62,62,0,1,0,1,0,deny
13035,25174,0,0,146,146,0,1,0,1,0,deny
49494,445,0,0,66,66,0,1,0,1,0,drop
64923,25174,0,0,66,66,0,1,0,1,0,deny
44453,1433,0,0,60,60,0,1,0,1,0,deny
49363,445,0,0,70,70,0,1,0,1,0,drop
60337,30188,0,0,66,66,0,1,0,1,0,deny
11951,45026,0,0,60,60,0,1,0,1,0,deny
53844,22114,0,0,66,66,0,1,0,1,0,deny
58163,20005,0,0,60,60,0,1,0,1,0,deny
7619,50584,0,0,146,146,0,1,0,1,0,deny
3875,25174,0,0,62,62,0,1,0,1,0,deny
60049,25174,0,0,66,66,0,1,0,1,0,deny
49487,445,0,0,66,66,0,1,0,1,0,drop
54071,445,0,0,70,70,0,1,0,1,0,drop
25543,22114,0,0,62,62,0,1,0,1,0,deny
51575,9694,0,0,66,66,0,1,0,1,0,deny
49359,445,0,0,70,70,0,1,0,1,0,drop
60830,50584,0,0,62,62,0,1,0,1,0,deny
9748,21247,0,0,66,66,0,1,0,1,0,deny
49484,445,0,0,66,66,0,1,0,1,0,drop
56309,22114,0,0,146,146,0,1,0,1,0,deny
5228,3434,0,0,345,345,0,1,0,1,0,deny
25009,35440,0,0,62,62,0,1,0,1,0,deny
49476,445,0,0,66,66,0,1,0,1,0,drop
6121,51505,0,0,62,62,0,1,0,1,0,deny
49470,445,0,0,66,66,0,1,0,1,0,drop
61916,64097,0,0,66,66,0,1,0,1,0,deny
1048,25174,0,0,62,62,0,1,0,1,0,deny
30181,61689,0,0,62,62,0,1,0,1,0,deny
54011,22114,0,0,62,62,0,1,0,1,0,deny
6486,64147,0,0,62,62,0,1,0,1,0,deny
52336,64097,0,0,66,66,0,1,0,1,0,deny
49346,445,0,0,70,70,0,1,0,1,0,drop
54189,22114,0,0,66,66,0,1,0,1,0,deny
58101,46314,0,0,72,72,0,1,0,1,0,deny
39839,22114,0,0,62,62,0,1,0,1,0,deny
49343,445,0,0,70,70,0,1,0,1,0,drop
58079,50584,0,0,62,62,0,1,0,1,0,deny
54063,445,0,0,70,70,0,1,0,1,0,drop
2310,8305,0,0,145,145,0,1,0,1,0,deny
54059,445,0,0,70,70,0,1,0,1,0,drop
58453,50584,0,0,66,66,0,1,0,1,0,deny
54060,445,0,0,70,70,0,1,0,1,0,drop
49454,445,0,0,66,66,0,1,0,1,0,drop
49461,445,0,0,66,66,0,1,0,1,0,drop
49462,445,0,0,66,66,0,1,0,1,0,drop
49457,445,0,0,66,66,0,1,0,1,0,drop
49458,445,0,0,66,66,0,1,0,1,0,drop
49455,445,0,0,66,66,0,1,0,1,0,drop
49456,445,0,0,66,66,0,1,0,1,0,drop
49460,445,0,0,66,66,0,1,0,1,0,drop
54542,25604,0,0,62,62,0,1,0,1,0,deny
36933,23117,0,0,66,66,0,1,0,1,0,deny
31780,11392,0,0,62,62,0,1,0,1,0,deny
9504,25174,0,0,62,62,0,1,0,1,0,deny
30583,25174,0,0,62,62,0,1,0,1,0,deny
55973,25174,0,0,62,62,0,1,0,1,0,deny
54420,80,23681,80,1596,511,1085,10,15,5,5,allow
34671,443,52492,443,8904,1058,7846,18,31,9,9,allow
54014,5228,26717,5228,2493,1541,952,16,3601,8,8,allow
55181,53,13217,53,711,87,624,2,30,1,1,allow
52012,80,40658,80,366,240,126,7,25,5,2,allow
56232,443,31381,443,9920,3980,5940,24,40,12,12,allow
60068,443,30976,443,2227,1018,1209,17,16,8,9,allow
22,51051,22,51051,109,109,0,1,5,1,0,allow
52037,80,5136,80,366,240,126,7,25,5,2,allow
52194,22674,46846,22674,70,70,0,2,8,2,0,allow
52186,57609,20882,57609,70,70,0,2,9,2,0,allow
63107,443,39326,443,3272,800,2472,10,120,5,5,allow
63108,443,56013,443,4609,2177,2432,11,120,6,5,allow
64338,443,59182,443,1786,172,1614,7,120,3,4,allow
61828,443,61828,443,317388,25904,291484,338,200,128,210,allow
26922,443,5779,443,7647,2890,4757,23,20,11,12,allow
40200,5222,30344,5222,8250,3928,4322,80,296,44,36,allow
52038,80,27418,80,366,240,126,7,25,5,2,allow
53954,57868,45044,57868,70,70,0,2,8,2,0,allow
48788,443,25045,443,6254,1075,5179,22,34,10,12,allow
55963,443,55963,443,8882,1866,7016,24,148,13,11,allow
60435,80,13780,80,5518,527,4991,13,75,6,7,allow
40626,443,40626,443,7772,2569,5203,23,148,13,10,allow
56178,443,35008,443,12283477,390003,11893474,13073,164,4327,8746,allow
52024,80,44508,80,422,240,182,8,25,5,3,allow
58192,443,58192,443,4381,1474,2907,19,29,11,8,allow
40217,443,61607,443,5377,857,4520,21,88,8,13,allow
52026,80,21940,80,422,240,182,8,25,5,3,allow
60495,6882,55669,6882,70,70,0,2,8,2,0,allow
60816,443,60816,443,1320,685,635,14,182,7,7,allow
37965,58043,10741,58043,6029,3652,2377,79,3221,45,34,allow
57665,5228,43757,5228,2391,1434,957,16,3601,8,8,allow
49878,24855,0,0,66,66,0,1,91,1,0,allow
52607,443,23239,443,2860,258,2602,9,121,4,5,allow
60813,443,60813,443,1386,751,635,15,182,8,7,allow
16490,25174,0,0,66,66,0,1,0,1,0,deny
46116,57470,0,0,74,74,0,1,0,1,0,deny
49339,445,0,0,70,70,0,1,0,1,0,drop
15899,37807,0,0,62,62,0,1,0,1,0,deny
49308,22114,0,0,66,66,0,1,0,1,0,deny
10467,25174,0,0,62,62,0,1,0,1,0,deny
3381,44847,0,0,78,78,0,1,0,1,0,deny
49337,445,0,0,70,70,0,1,0,1,0,drop
61616,23,0,0,60,60,0,1,0,1,0,deny
47730,22,0,0,60,60,0,1,0,1,0,deny
49335,445,0,0,70,70,0,1,0,1,0,drop
28064,36237,0,0,62,62,0,1,0,1,0,deny
52749,443,45343,443,148418,107579,40839,315,6090,107,208,allow
55713,47783,26233,47783,70,70,0,1,5,1,0,allow
46014,53,46014,53,414,268,146,3,33,2,1,allow
52188,13182,48724,13182,70,70,0,2,9,2,0,allow
52191,32843,25090,32843,70,70,0,2,8,2,0,allow
46975,443,49913,443,70,70,0,1,5,1,0,allow
49505,443,25913,443,6318,2030,4288,25,270,12,13,allow
57808,53,57808,53,222,90,132,2,30,1,1,allow
60814,443,60814,443,1386,751,635,15,181,8,7,allow
52036,80,8626,80,366,240,126,7,24,5,2,allow
55039,443,11955,443,62,62,0,1,4,1,0,allow
65436,53,8668,53,234,94,140,2,29,1,1,allow
60758,53,57238,53,199,94,105,2,30,1,1,allow
52035,80,21577,80,426,240,186,8,24,5,3,allow
52028,80,63717,80,422,240,182,8,24,5,3,allow
53951,8999,2950,8999,70,70,0,2,7,2,0,allow
51555,443,44960,443,876,390,486,12,39,4,8,allow
53922,42285,1496,42285,70,70,0,1,4,1,0,allow
49572,443,43054,443,1820,1101,719,18,18,10,8,allow
54924,443,37000,443,62,62,0,1,4,1,0,allow
52040,80,54028,80,366,240,126,7,24,5,2,allow
35797,443,35797,443,4378,1471,2907,19,27,11,8,allow
55040,443,46427,443,62,62,0,1,4,1,0,allow
52022,80,47623,80,422,240,182,8,24,5,3,allow
52023,80,55578,80,366,240,126,7,24,5,2,allow
43215,443,60115,443,9781,3108,6673,28,15,15,13,allow
52161,19897,37234,19897,70,70,0,1,4,1,0,allow
42166,443,27279,443,4057,966,3091,14,31,8,6,allow
52197,19845,30024,19845,70,70,0,2,7,2,0,allow
59581,53,59581,53,823,98,725,2,29,1,1,allow
53925,61701,1063,61701,70,70,0,1,4,1,0,allow
52012,443,5821,443,126,60,66,3,10,2,1,allow
49440,53,37784,53,210,102,108,2,29,1,1,allow
51805,443,60178,443,6339,1901,4438,16,120,8,8,allow
59779,443,64471,443,70,70,0,1,5,1,0,allow
27988,40037,18791,40037,568,78,490,2,29,1,1,allow
34113,443,8238,443,70,70,0,1,5,1,0,allow
38117,443,59236,443,8598,3880,4718,23,200,13,10,allow
53170,20259,44123,20259,70,70,0,2,8,2,0,allow
65485,53,20874,53,718,94,624,2,30,1,1,allow
52190,29765,3143,29765,70,70,0,2,8,2,0,allow
55204,53,55204,53,239,98,141,2,30,1,1,allow
56753,80,58241,80,1462,703,759,8,16,5,3,allow
38568,53,38568,53,247,98,149,2,33,1,1,allow
54987,443,54987,443,3154,2012,1142,16,18,10,6,allow
65223,443,38564,443,5012,4134,878,17,98,10,7,allow
52159,16297,42997,16297,70,70,0,1,5,1,0,allow
52157,23002,50044,23002,70,70,0,1,5,1,0,allow
40633,53,51896,53,168,78,90,2,30,1,1,allow
34741,53,34741,53,414,268,146,3,33,2,1,allow
52155,63867,61917,63867,70,70,0,1,5,1,0,allow
65165,53,5142,53,177,94,83,2,30,1,1,allow
50519,443,63602,443,16215,1368,14847,36,77,12,24,allow
36838,443,43654,443,9381,1457,7924,21,31,11,10,allow
49507,443,28948,443,9536,2399,7137,32,270,17,15,allow
45309,443,7993,443,3094,2048,1046,18,16,9,9,allow
65383,443,27965,443,839325,38439,800886,1027,94,451,576,allow
54356,443,29580,443,18744,10266,8478,44,35,21,23,allow
51221,44710,11229,44710,481,150,331,2,1200,1,1,allow
49504,443,29645,443,26816,2982,23834,50,270,23,27,allow
52189,24190,3693,24190,70,70,0,2,9,2,0,allow
60675,443,27643,443,1871,1235,636,13,31,8,5,allow
52998,443,34422,443,57778,2562,55216,73,200,29,44,allow
42012,443,37519,443,14271,2106,12165,42,227,17,25,allow
50679,80,31176,80,2139,1167,972,10,20,6,4,allow
49152,514,0,0,142,142,0,2,30,2,0,allow
55152,53,56189,53,177,94,83,2,30,1,1,allow
56748,80,11482,80,946,531,415,11,296,6,5,allow
64898,53,12662,53,487,201,286,6,42,3,3,allow
65435,80,40330,80,11239,7307,3932,19,25,10,9,allow
46266,53,15636,53,308,118,190,2,30,1,1,allow
36834,443,42042,443,8975,1129,7846,19,31,10,9,allow
48656,80,8880,80,1114,534,580,12,15,7,5,allow
36835,443,45000,443,9115,1269,7846,21,31,12,9,allow
37087,80,29544,80,946,531,415,11,296,6,5,allow
50212,1688,47539,1688,70,70,0,1,5,1,0,allow
42167,443,27521,443,4117,1026,3091,15,31,9,6,allow
56431,443,60135,443,55149,7806,47343,134,108,61,73,allow
52093,80,7625,80,3019,716,2303,12,23,7,5,allow
60779,80,5237,80,1248,516,732,9,15,4,5,allow
52020,80,57766,80,426,240,186,8,24,5,3,allow
50265,80,26557,80,2100,1146,954,13,46,6,7,allow
60705,443,45671,443,24145,5933,18212,55,549,27,28,allow
48038,5222,35034,5222,49279,23110,26169,459,384,239,220,allow
49319,53,4413,53,199,94,105,2,30,1,1,allow
36837,443,3546,443,9311,1387,7924,20,31,10,10,allow
40680,5228,59129,5228,234,174,60,2,4,1,1,allow
46112,53,33823,53,168,78,90,2,30,1,1,allow
44228,443,22389,443,2754856,125760,2629096,3115,32,1340,1775,allow
52019,80,54297,80,426,240,186,8,24,5,3,allow
56658,443,35998,443,18959,1799,17160,35,110,15,20,allow
50419,443,44835,443,4590,575,4015,14,28,6,8,allow
50695,80,16857,80,1426,865,561,9,15,5,4,allow
47638,53,47638,53,212,98,114,2,30,1,1,allow
53950,32057,38888,32057,70,70,0,2,7,2,0,allow
55712,27816,8971,27816,316,190,126,5,16,3,2,allow
32645,53,32645,53,404,259,145,3,33,2,1,allow
65516,443,35348,443,451899,13130,438769,463,16,162,301,allow
64613,53,11249,53,212,102,110,2,30,1,1,allow
49570,443,47382,443,162268,121343,40925,316,6101,108,208,allow
64956,53,40414,53,402,118,284,2,29,1,1,allow
49949,53,8662,53,307,110,197,2,30,1,1,allow
54928,8245,11083,8245,280,214,66,2,30,1,1,allow
49506,443,13324,443,6002,1965,4037,23,270,11,12,allow
52831,53,52831,53,200,90,110,2,30,1,1,allow
57243,443,49244,443,27444,3840,23604,58,161,28,30,allow
65411,53,12985,53,194,94,100,2,30,1,1,allow
65114,53,42555,53,380,86,294,2,30,1,1,allow
49797,53,51758,53,718,94,624,2,30,1,1,allow
55152,53,31927,53,177,94,83,2,30,1,1,allow
60068,443,63784,443,10192,5090,5102,43,15,24,19,allow
52193,33027,31412,33027,70,70,0,2,8,2,0,allow
52195,50930,43224,50930,70,70,0,2,8,2,0,allow
52187,38153,15114,38153,70,70,0,2,9,2,0,allow
52158,3841,53385,3841,70,70,0,1,5,1,0,allow
40781,443,27911,443,362,302,60,2,5,1,1,allow
51130,80,19465,80,366,240,126,7,21,5,2,allow
59982,443,64265,443,7693,1284,6409,24,81,12,12,allow
56629,443,11922,443,23887293,546911,23340382,23137,108,7700,15437,allow
65165,53,64230,53,177,94,83,2,30,1,1,allow
51574,443,25990,443,3021,960,2061,14,135,7,7,allow
55027,443,27203,443,17167,5192,11975,32,121,17,15,allow
50560,443,20442,443,17710,10880,6830,44,271,25,19,allow
36836,443,26019,443,9381,1457,7924,21,31,11,10,allow
46899,443,24525,443,70,70,0,1,5,1,0,allow
52156,18238,30723,18238,70,70,0,1,5,1,0,allow
64590,443,12398,443,24686,1935,22751,36,17,17,19,allow
62956,443,13888,443,829275,26662,802613,884,129,295,589,allow
39375,443,57783,443,36154,9709,26445,60,161,27,33,allow
47444,443,24955,443,13920,5009,8911,34,30,18,16,allow
64070,53,27144,53,258,110,148,2,30,1,1,allow
53872,53,43483,53,70,70,0,1,30,1,0,allow
49153,53,53527,53,280,94,186,2,30,1,1,allow
46824,53,42441,53,326,78,248,2,30,1,1,allow
6881,6882,61481,6882,238,118,120,2,1199,1,1,allow
57470,1930,53151,1930,858,858,0,14,1199,14,0,allow
59830,443,56581,443,82533,15815,66718,124,131,50,74,allow
44959,443,64557,443,373033,19903,353130,469,143,180,289,allow
10151,38030,53424,38030,481,150,331,2,1200,1,1,allow
50210,443,12154,443,6444,1320,5124,31,727,10,21,allow
52001,80,13411,80,546,300,246,10,25,6,4,allow
63806,443,63806,443,4651,1744,2907,19,30,11,8,allow
52903,443,59181,443,3478,1580,1898,21,31,12,9,allow
50865,53,50865,53,242,98,144,2,30,1,1,allow
56120,53,62724,53,168,78,90,2,30,1,1,allow
35072,53,51638,53,168,78,90,2,30,1,1,allow
53920,34914,18938,34914,1781,1103,678,15,17,9,6,allow
51270,443,53083,443,190,70,120,4,15,2,2,allow
50673,80,12286,80,20265,5748,14517,34,23,16,18,allow
53226,80,34049,80,1054,602,452,10,20,5,5,allow
60368,443,19000,443,10387,2575,7812,26,108,13,13,allow
49948,53,31917,53,177,94,83,2,30,1,1,allow
49948,53,46968,53,177,94,83,2,30,1,1,allow
20388,53,20388,53,217,90,127,2,30,1,1,allow
55817,53,51311,53,177,94,83,2,30,1,1,allow
56141,53,48700,53,277,134,143,2,30,1,1,allow
65533,53,35566,53,277,134,143,2,30,1,1,allow
42608,1,0,0,62,62,0,1,0,1,0,deny
3986,17372,0,0,66,66,0,1,0,1,0,deny
54053,445,0,0,70,70,0,1,0,1,0,drop
54056,445,0,0,70,70,0,1,0,1,0,drop
54054,445,0,0,70,70,0,1,0,1,0,drop
3730,17372,0,0,62,62,0,1,0,1,0,deny
54048,445,0,0,70,70,0,1,0,1,0,drop
2919,37965,0,0,62,62,0,1,0,1,0,deny
49442,445,0,0,66,66,0,1,0,1,0,drop
49440,445,0,0,66,66,0,1,0,1,0,drop
49439,445,0,0,66,66,0,1,0,1,0,drop
53759,42873,0,0,74,74,0,1,0,1,0,deny
27841,35894,0,0,62,62,0,1,0,1,0,deny
55393,44512,0,0,66,66,0,1,0,1,0,deny
64808,27098,0,0,66,66,0,1,0,1,0,deny
49328,445,0,0,70,70,0,1,0,1,0,drop
54040,445,0,0,70,70,0,1,0,1,0,drop
54280,3385,0,0,60,60,0,1,0,1,0,deny
35100,11392,0,0,62,62,0,1,0,1,0,deny
46162,25174,0,0,62,62,0,1,0,1,0,deny
54034,445,0,0,70,70,0,1,0,1,0,drop
54033,445,0,0,70,70,0,1,0,1,0,drop
59068,49813,0,0,74,74,0,1,0,1,0,deny
54028,445,0,0,70,70,0,1,0,1,0,drop
49326,445,0,0,70,70,0,1,0,1,0,drop
31845,55777,0,0,62,62,0,1,0,1,0,deny
52026,26467,0,0,60,60,0,1,0,1,0,deny
3290,57470,0,0,145,145,0,1,0,1,0,deny
49325,445,0,0,70,70,0,1,0,1,0,drop
51865,61689,0,0,66,66,0,1,0,1,0,deny
11235,30188,0,0,62,62,0,1,0,1,0,deny
49324,445,0,0,70,70,0,1,0,1,0,drop
49323,445,0,0,70,70,0,1,0,1,0,drop
49318,445,0,0,70,70,0,1,0,1,0,drop
49321,445,0,0,70,70,0,1,0,1,0,drop
51922,44847,0,0,66,66,0,1,0,1,0,deny
33814,22114,0,0,146,146,0,1,0,1,0,deny
53928,15503,0,0,62,62,0,1,0,1,0,deny
51414,22,0,0,60,60,0,1,0,1,0,deny
51414,22,0,0,60,60,0,1,0,1,0,deny
52791,25174,0,0,66,66,0,1,0,1,0,deny
62339,25174,0,0,62,62,0,1,0,1,0,deny
49305,445,0,0,70,70,0,1,0,1,0,drop
49304,445,0,0,70,70,0,1,0,1,0,drop
54022,445,0,0,70,70,0,1,0,1,0,drop
54021,445,0,0,70,70,0,1,0,1,0,drop
54015,445,0,0,70,70,0,1,0,1,0,drop
49302,445,0,0,70,70,0,1,0,1,0,drop
53928,15503,0,0,145,145,0,1,0,1,0,deny
10306,44847,0,0,66,66,0,1,0,1,0,deny
48996,22114,0,0,146,146,0,1,0,1,0,deny
49294,445,0,0,70,70,0,1,0,1,0,drop
49295,445,0,0,70,70,0,1,0,1,0,drop
41003,5000,0,0,60,60,0,1,0,1,0,deny
49428,445,0,0,66,66,0,1,0,1,0,drop
41004,5000,0,0,60,60,0,1,0,1,0,deny
33948,1375,0,0,146,146,0,1,0,1,0,deny
63469,64147,0,0,62,62,0,1,0,1,0,deny
46275,64147,0,0,62,62,0,1,0,1,0,deny
51356,22114,0,0,66,66,0,1,0,1,0,deny
22916,25174,0,0,62,62,0,1,0,1,0,deny
53532,22114,0,0,62,62,0,1,0,1,0,deny
54014,445,0,0,70,70,0,1,0,1,0,drop
30542,25174,0,0,62,62,0,1,0,1,0,deny
59153,35440,0,0,62,62,0,1,0,1,0,deny
49283,445,0,0,70,70,0,1,0,1,0,drop
54013,445,0,0,70,70,0,1,0,1,0,drop
7891,25174,0,0,66,66,0,1,0,1,0,deny
50326,46824,0,0,66,66,0,1,0,1,0,deny
49414,445,0,0,66,66,0,1,0,1,0,drop
49411,445,0,0,66,66,0,1,0,1,0,drop
57726,37965,0,0,62,62,0,1,0,1,0,deny
50946,44847,0,0,62,62,0,1,0,1,0,deny
28830,37965,0,0,62,62,0,1,0,1,0,deny
20487,50584,0,0,66,66,0,1,0,1,0,deny
63690,64147,0,0,66,66,0,1,0,1,0,deny
14185,48637,0,0,60,60,0,1,0,1,0,deny
47682,20541,0,0,62,62,0,1,0,1,0,deny
32381,50584,0,0,66,66,0,1,0,1,0,deny
40903,5900,0,0,60,60,0,1,0,1,0,deny
58724,43890,0,0,66,66,0,1,0,1,0,deny
59965,36237,0,0,66,66,0,1,0,1,0,deny
49279,445,0,0,70,70,0,1,0,1,0,drop
3410,17372,0,0,62,62,0,1,0,1,0,deny
53929,443,27958,443,499,425,74,4,0,3,1,allow
53928,443,61918,443,499,425,74,4,0,3,1,allow
10532,26672,0,0,60,60,0,1,0,1,0,deny
3410,17372,0,0,145,145,0,1,0,1,0,deny
3406,17372,0,0,66,66,0,1,0,1,0,deny
54002,445,0,0,70,70,0,1,0,1,0,drop
54001,445,0,0,70,70,0,1,0,1,0,drop
53995,445,0,0,70,70,0,1,0,1,0,drop
53993,445,0,0,70,70,0,1,0,1,0,drop
3090,1,0,0,62,62,0,1,0,1,0,deny
1024,25174,0,0,146,146,0,1,0,1,0,deny
49408,445,0,0,66,66,0,1,0,1,0,drop
49267,445,0,0,70,70,0,1,0,1,0,drop
49269,445,0,0,70,70,0,1,0,1,0,drop
49268,445,0,0,70,70,0,1,0,1,0,drop
12604,80,0,0,60,60,0,1,0,1,0,deny
65216,35440,0,0,66,66,0,1,0,1,0,deny
49265,445,0,0,70,70,0,1,0,1,0,drop
40301,8696,0,0,60,60,0,1,0,1,0,deny
1955,35974,0,0,60,60,0,1,0,1,0,deny
49262,445,0,0,70,70,0,1,0,1,0,drop
49401,445,0,0,66,66,0,1,0,1,0,drop
49396,445,0,0,66,66,0,1,0,1,0,drop
49403,445,0,0,66,66,0,1,0,1,0,drop
49392,445,0,0,66,66,0,1,0,1,0,drop
49402,445,0,0,66,66,0,1,0,1,0,drop
49393,445,0,0,66,66,0,1,0,1,0,drop
49395,445,0,0,66,66,0,1,0,1,0,drop
64772,64147,0,0,62,62,0,1,0,1,0,deny
20706,23718,0,0,66,66,0,1,0,1,0,deny
60308,37965,0,0,66,66,0,1,0,1,0,deny
49001,22114,0,0,62,62,0,1,0,1,0,deny
53987,445,0,0,70,70,0,1,0,1,0,drop
55069,44847,0,0,62,62,0,1,0,1,0,deny
61730,25320,0,0,62,62,0,1,0,1,0,deny
51558,37965,0,0,72,72,0,1,0,1,0,deny
53984,445,0,0,70,70,0,1,0,1,0,drop
53981,445,0,0,70,70,0,1,0,1,0,drop
53980,445,0,0,70,70,0,1,0,1,0,drop
45837,25174,0,0,62,62,0,1,0,1,0,deny
346,23,0,0,60,60,0,1,0,1,0,deny
49257,445,0,0,70,70,0,1,0,1,0,drop
53103,8497,0,0,148,148,0,1,0,1,0,deny
443,4205,0,0,320,320,0,1,0,1,0,deny
4138,55777,0,0,66,66,0,1,0,1,0,deny
43155,35440,0,0,66,66,0,1,0,1,0,deny
54816,35440,0,0,62,62,0,1,0,1,0,deny
55893,45711,0,0,78,78,0,1,0,1,0,deny
45941,23388,0,0,60,60,0,1,0,1,0,deny
53979,445,0,0,70,70,0,1,0,1,0,drop
53972,445,0,0,70,70,0,1,0,1,0,drop
53973,445,0,0,70,70,0,1,0,1,0,drop
61911,50432,0,0,146,146,0,1,0,1,0,deny
59155,39004,0,0,74,74,0,1,0,1,0,deny
49384,445,0,0,66,66,0,1,0,1,0,drop
59223,17500,0,0,66,66,0,1,0,1,0,deny
49249,445,0,0,70,70,0,1,0,1,0,drop
53971,445,0,0,70,70,0,1,0,1,0,drop
49248,445,0,0,70,70,0,1,0,1,0,drop
59225,57587,0,0,66,66,0,1,0,1,0,deny
44408,57470,0,0,62,62,0,1,0,1,0,deny
54555,25174,0,0,66,66,0,1,0,1,0,deny
54976,2273,0,0,60,60,0,1,0,1,0,deny
61280,26467,0,0,66,66,0,1,0,1,0,deny
49383,445,0,0,66,66,0,1,0,1,0,drop
49379,445,0,0,66,66,0,1,0,1,0,drop
49381,445,0,0,66,66,0,1,0,1,0,drop
48258,37965,0,0,62,62,0,1,0,1,0,deny
49378,445,0,0,66,66,0,1,0,1,0,drop
63593,22114,0,0,66,66,0,1,0,1,0,deny
49242,445,0,0,70,70,0,1,0,1,0,drop
56909,50584,0,0,66,66,0,1,0,1,0,deny
49241,445,0,0,70,70,0,1,0,1,0,drop
61143,8080,0,0,60,60,0,1,0,1,0,deny
53964,445,0,0,70,70,0,1,0,1,0,drop
53962,445,0,0,70,70,0,1,0,1,0,drop
53956,445,0,0,70,70,0,1,0,1,0,drop
49237,445,0,0,70,70,0,1,0,1,0,drop
35507,15503,0,0,62,62,0,1,0,1,0,deny
46286,21247,0,0,146,146,0,1,0,1,0,deny
9327,57470,0,0,62,62,0,1,0,1,0,deny
46460,36237,0,0,146,146,0,1,0,1,0,deny
49236,445,0,0,70,70,0,1,0,1,0,drop
13528,51221,0,0,62,62,0,1,0,1,0,deny
49367,445,0,0,66,66,0,1,0,1,0,drop
64882,43890,0,0,66,66,0,1,0,1,0,deny
59214,57866,0,0,66,66,0,1,0,1,0,deny
52604,25174,0,0,66,66,0,1,0,1,0,deny
49531,26467,0,0,66,66,0,1,0,1,0,deny
50974,11392,0,0,66,66,0,1,0,1,0,deny
45964,3111,0,0,60,60,0,1,0,1,0,deny
45964,3111,0,0,60,60,0,1,0,1,0,deny
14208,51221,0,0,66,66,0,1,0,1,0,deny
59822,56205,0,0,66,66,0,1,0,1,0,deny
50396,62413,0,0,66,66,0,1,0,1,0,deny
49359,445,0,0,66,66,0,1,0,1,0,drop
49231,445,0,0,70,70,0,1,0,1,0,drop
53943,445,0,0,70,70,0,1,0,1,0,drop
57131,31061,0,0,145,145,0,1,0,1,0,deny
25565,41288,0,0,60,60,0,1,0,1,0,deny
52929,43890,0,0,66,66,0,1,0,1,0,deny
62575,12207,0,0,66,66,0,1,0,1,0,deny
53381,25174,0,0,62,62,0,1,0,1,0,deny
44414,23718,0,0,66,66,0,1,0,1,0,deny
18218,30349,0,0,148,148,0,1,0,1,0,deny
49356,445,0,0,66,66,0,1,0,1,0,drop
55312,64147,0,0,62,62,0,1,0,1,0,deny
18398,21247,0,0,66,66,0,1,0,1,0,deny
62020,64147,0,0,145,145,0,1,0,1,0,deny
38330,44847,0,0,66,66,0,1,0,1,0,deny
60416,37965,0,0,66,66,0,1,0,1,0,deny
23310,22114,0,0,66,66,0,1,0,1,0,deny
53759,42873,0,0,74,74,0,1,0,1,0,deny
61085,37965,0,0,62,62,0,1,0,1,0,deny
7561,43890,0,0,66,66,0,1,0,1,0,deny
49349,445,0,0,66,66,0,1,0,1,0,drop
49485,56972,0,0,62,62,0,1,0,1,0,deny
56924,26467,0,0,62,62,0,1,0,1,0,deny
37487,25174,0,0,66,66,0,1,0,1,0,deny
36729,443,18622,443,7480,1122,6358,27,257,13,14,allow
38644,1723,38644,1723,146,60,86,2,9,1,1,allow
48470,80,20195,80,959,544,415,11,315,6,5,allow
55681,53,52185,53,711,87,624,2,30,1,1,allow
56334,53,55727,53,170,87,83,2,30,1,1,allow
43686,443,17205,443,6804,914,5890,22,257,10,12,allow
49335,443,62056,443,125790,4516,121274,118,55,28,90,allow
57069,53,40804,53,1335,87,1248,4,32,2,2,allow
53947,867,53640,867,70,70,0,2,8,2,0,allow
60487,1134,57270,1134,70,70,0,1,5,1,0,allow
40218,443,5218,443,5254,927,4327,20,84,9,11,allow
55064,80,48645,80,1646,998,648,13,85,7,6,allow
55157,53,58441,53,711,87,624,2,30,1,1,allow
55710,53,65057,53,198,93,105,2,30,1,1,allow
38402,443,45229,443,3830718,112946,3717772,4353,224,1395,2958,allow
29126,7000,29126,7000,4124,2423,1701,20,16,11,9,allow
52154,4635,6285,4635,66,66,0,1,5,1,0,allow
57339,443,64003,443,1778020,204978,1573042,2589,987,1006,1583,allow
52710,443,22445,443,203346,21619,181727,301,376,140,161,allow
52829,443,52829,443,4613,1706,2907,19,30,11,8,allow
48551,443,38107,443,7104,888,6216,19,27,9,10,allow
48785,443,37520,443,6464,1223,5241,25,33,12,13,allow
59326,80,59326,80,109128,4773,104355,197,16,68,129,allow
60815,443,60815,443,1320,685,635,14,181,7,7,allow
54352,53,16730,53,578,286,292,9,16,5,4,allow
45314,80,7495,80,72376,2899,69477,79,16,29,50,allow
53075,53,27228,53,168,78,90,2,30,1,1,allow
35702,443,51381,443,13428,5815,7613,42,995,22,20,allow
36943,443,59404,443,15329,7087,8242,108,310,61,47,allow
36993,443,63240,443,7768,3071,4697,23,17,12,11,allow
31227,53,31227,53,407,261,146,3,32,2,1,allow
60486,8999,41044,8999,70,70,0,1,5,1,0,allow
43368,443,39927,443,190,70,120,4,15,2,2,allow
57760,80,57760,80,2934,1497,1437,10,16,6,4,allow
48786,443,62894,443,7130,1890,5240,25,33,12,13,allow
57240,53,57240,53,198,89,109,2,30,1,1,allow
56680,53,24501,53,711,87,624,2,30,1,1,allow
43024,53,45972,53,198,93,105,2,30,1,1,allow
57470,6881,1895,6881,528,528,0,9,1200,9,0,allow
55055,443,60639,443,14492,3190,11302,34,16,19,15,allow
1658,443,1658,443,12030,1282,10748,23,17,9,14,allow
40215,443,50672,443,5656,1009,4647,24,87,10,14,allow
25384,443,25384,443,3072,696,2376,13,16,8,5,allow
40220,443,35161,443,5448,989,4459,22,84,10,12,allow
53948,7370,61393,7370,70,70,0,2,8,2,0,allow
49300,443,11217,443,26747,8027,18720,58,92,25,33,allow
53614,443,10121,443,8347,1979,6368,32,19,17,15,allow
55936,53,2278,53,170,87,83,2,30,1,1,allow
51809,443,10522,443,82930,18836,64094,131,128,55,76,allow
19473,51413,8434,51413,459,149,310,2,1200,1,1,allow
36337,443,41043,443,3781,1917,1864,23,396,7,16,allow
58848,24855,0,0,66,66,0,1,90,1,0,allow
41156,443,9223,443,59486,3261,56225,74,360,29,45,allow
54517,443,8632,443,11460,2522,8938,19,122,9,10,allow
49343,445,0,0,66,66,0,1,0,1,0,drop
49218,445,0,0,70,70,0,1,0,1,0,drop
60645,35440,0,0,66,66,0,1,0,1,0,deny
62250,23117,0,0,66,66,0,1,0,1,0,deny
62208,37965,0,0,66,66,0,1,0,1,0,deny
31654,65473,0,0,148,148,0,1,0,1,0,deny
9226,57470,0,0,66,66,0,1,0,1,0,deny
49215,445,0,0,70,70,0,1,0,1,0,drop
37191,48817,0,0,159,159,0,1,0,1,0,deny
9745,26467,0,0,62,62,0,1,0,1,0,deny
13020,26467,0,0,66,66,0,1,0,1,0,deny
39171,22114,0,0,146,146,0,1,0,1,0,deny
54957,53,32234,53,102,102,0,1,30,1,0,allow
36697,443,4687,443,21563,17259,4304,70,78,37,33,allow
38711,443,23557,443,459089,10521,448568,449,16,141,308,allow
57979,443,3610,443,7970957,82522,7888435,6370,179,1027,5343,allow
41451,53,15515,53,359,86,273,2,30,1,1,allow
53934,445,0,0,70,70,0,1,0,1,0,drop
53932,445,0,0,70,70,0,1,0,1,0,drop
53931,445,0,0,70,70,0,1,0,1,0,drop
48016,57470,0,0,62,62,0,1,0,1,0,deny
59347,57470,0,0,66,66,0,1,0,1,0,deny
31130,30188,0,0,66,66,0,1,0,1,0,deny
49328,445,0,0,66,66,0,1,0,1,0,drop
49331,445,0,0,66,66,0,1,0,1,0,drop
49333,445,0,0,66,66,0,1,0,1,0,drop
49332,445,0,0,66,66,0,1,0,1,0,drop
49329,445,0,0,66,66,0,1,0,1,0,drop
49326,445,0,0,66,66,0,1,0,1,0,drop
53721,62413,0,0,146,146,0,1,0,1,0,deny
49211,445,0,0,70,70,0,1,0,1,0,drop
2780,23117,0,0,62,62,0,1,0,1,0,deny
49207,445,0,0,70,70,0,1,0,1,0,drop
51930,57470,0,0,62,62,0,1,0,1,0,deny
54011,44847,0,0,66,66,0,1,0,1,0,deny
19845,30024,0,0,62,62,0,1,0,1,0,deny
55842,64147,0,0,66,66,0,1,0,1,0,deny
49205,445,0,0,70,70,0,1,0,1,0,drop
58638,5900,0,0,62,62,0,1,0,1,0,deny
58638,5900,0,0,62,62,0,1,0,1,0,deny
58638,5900,0,0,62,62,0,1,0,1,0,deny
58638,5900,0,0,62,62,0,1,0,1,0,deny
58638,5900,0,0,62,62,0,1,0,1,0,deny
58638,5900,0,0,62,62,0,1,0,1,0,deny
58638,5900,0,0,62,62,0,1,0,1,0,deny
58638,5900,0,0,62,62,0,1,0,1,0,deny
58638,5900,0,0,62,62,0,1,0,1,0,deny
58638,5900,0,0,62,62,0,1,0,1,0,deny
58638,5900,0,0,62,62,0,1,0,1,0,deny
58638,5900,0,0,62,62,0,1,0,1,0,deny
58638,5900,0,0,62,62,0,1,0,1,0,deny
58638,5900,0,0,62,62,0,1,0,1,0,deny
58638,5900,0,0,62,62,0,1,0,1,0,deny
58638,5900,0,0,62,62,0,1,0,1,0,deny
58638,5900,0,0,62,62,0,1,0,1,0,deny
58638,5900,0,0,62,62,0,1,0,1,0,deny
58638,5900,0,0,62,62,0,1,0,1,0,deny
58638,5900,0,0,62,62,0,1,0,1,0,deny
58638,5900,0,0,62,62,0,1,0,1,0,deny
58638,5900,0,0,62,62,0,1,0,1,0,deny
58638,5900,0,0,62,62,0,1,0,1,0,deny
58638,5900,0,0,62,62,0,1,0,1,0,deny
58638,5900,0,0,62,62,0,1,0,1,0,deny
58638,5900,0,0,62,62,0,1,0,1,0,deny
58638,5900,0,0,62,62,0,1,0,1,0,deny
58638,5900,0,0,62,62,0,1,0,1,0,deny
58638,5900,0,0,62,62,0,1,0,1,0,deny
58638,5900,0,0,62,62,0,1,0,1,0,deny
58638,5900,0,0,62,62,0,1,0,1,0,deny
58638,5900,0,0,62,62,0,1,0,1,0,deny
58638,5900,0,0,62,62,0,1,0,1,0,deny
58638,5900,0,0,62,62,0,1,0,1,0,deny
58638,5900,0,0,62,62,0,1,0,1,0,deny
58638,5900,0,0,62,62,0,1,0,1,0,deny
58638,5900,0,0,62,62,0,1,0,1,0,deny
58638,5900,0,0,62,62,0,1,0,1,0,deny
58638,5900,0,0,62,62,0,1,0,1,0,deny
58638,5900,0,0,62,62,0,1,0,1,0,deny
58638,5900,0,0,62,62,0,1,0,1,0,deny
58638,5900,0,0,62,62,0,1,0,1,0,deny
58638,5900,0,0,62,62,0,1,0,1,0,deny
58638,5900,0,0,62,62,0,1,0,1,0,deny
58638,5900,0,0,62,62,0,1,0,1,0,deny
58638,5900,0,0,62,62,0,1,0,1,0,deny
58638,5900,0,0,62,62,0,1,0,1,0,deny
58638,5900,0,0,62,62,0,1,0,1,0,deny
58638,5900,0,0,62,62,0,1,0,1,0,deny
58638,5900,0,0,62,62,0,1,0,1,0,deny
58638,5900,0,0,62,62,0,1,0,1,0,deny
58638,5900,0,0,62,62,0,1,0,1,0,deny
58638,5900,0,0,62,62,0,1,0,1,0,deny
58638,5900,0,0,62,62,0,1,0,1,0,deny
58638,5900,0,0,62,62,0,1,0,1,0,deny
58638,5900,0,0,62,62,0,1,0,1,0,deny
58638,5900,0,0,62,62,0,1,0,1,0,deny
58638,5900,0,0,62,62,0,1,0,1,0,deny
58638,5900,0,0,62,62,0,1,0,1,0,deny
58638,5900,0,0,62,62,0,1,0,1,0,deny
58638,5900,0,0,62,62,0,1,0,1,0,deny
58638,5900,0,0,62,62,0,1,0,1,0,deny
58638,5900,0,0,62,62,0,1,0,1,0,deny
58638,5900,0,0,62,62,0,1,0,1,0,deny
58638,5900,0,0,62,62,0,1,0,1,0,deny
58638,5900,0,0,62,62,0,1,0,1,0,deny
58638,5900,0,0,62,62,0,1,0,1,0,deny
58638,5900,0,0,62,62,0,1,0,1,0,deny
58638,5900,0,0,62,62,0,1,0,1,0,deny
58638,5900,0,0,62,62,0,1,0,1,0,deny
58638,5900,0,0,62,62,0,1,0,1,0,deny
58638,5900,0,0,62,62,0,1,0,1,0,deny
58638,5900,0,0,62,62,0,1,0,1,0,deny
58638,5900,0,0,62,62,0,1,0,1,0,deny
58638,5900,0,0,62,62,0,1,0,1,0,deny
58638,5900,0,0,62,62,0,1,0,1,0,deny
58638,5900,0,0,62,62,0,1,0,1,0,deny
58638,5900,0,0,62,62,0,1,0,1,0,deny
58638,5900,0,0,62,62,0,1,0,1,0,deny
58638,5900,0,0,62,62,0,1,0,1,0,deny
58638,5900,0,0,62,62,0,1,0,1,0,deny
58638,5900,0,0,62,62,0,1,0,1,0,deny
58638,5900,0,0,62,62,0,1,0,1,0,deny
58638,5900,0,0,62,62,0,1,0,1,0,deny
58638,5900,0,0,62,62,0,1,0,1,0,deny
58638,5900,0,0,62,62,0,1,0,1,0,deny
58638,5900,0,0,62,62,0,1,0,1,0,deny
58638,5900,0,0,62,62,0,1,0,1,0,deny
58638,5900,0,0,62,62,0,1,0,1,0,deny
58638,5900,0,0,62,62,0,1,0,1,0,deny
58638,5900,0,0,62,62,0,1,0,1,0,deny
58638,5900,0,0,62,62,0,1,0,1,0,deny
58638,5900,0,0,62,62,0,1,0,1,0,deny
58638,5900,0,0,62,62,0,1,0,1,0,deny
58638,5900,0,0,62,62,0,1,0,1,0,deny
58638,5900,0,0,62,62,0,1,0,1,0,deny
52026,26467,0,0,60,60,0,1,0,1,0,deny
58638,5900,0,0,62,62,0,1,0,1,0,deny
58638,5900,0,0,62,62,0,1,0,1,0,deny
58638,5900,0,0,62,62,0,1,0,1,0,deny
58638,5900,0,0,62,62,0,1,0,1,0,deny
58638,5900,0,0,62,62,0,1,0,1,0,deny
58638,5900,0,0,62,62,0,1,0,1,0,deny
58638,5900,0,0,62,62,0,1,0,1,0,deny
58638,5900,0,0,62,62,0,1,0,1,0,deny
58638,5900,0,0,62,62,0,1,0,1,0,deny
58638,5900,0,0,62,62,0,1,0,1,0,deny
58638,5900,0,0,62,62,0,1,0,1,0,deny
58638,5900,0,0,62,62,0,1,0,1,0,deny
58638,5900,0,0,62,62,0,1,0,1,0,deny
58638,5900,0,0,62,62,0,1,0,1,0,deny
58638,5900,0,0,62,62,0,1,0,1,0,deny
58638,5900,0,0,62,62,0,1,0,1,0,deny
58638,5900,0,0,62,62,0,1,0,1,0,deny
58638,5900,0,0,62,62,0,1,0,1,0,deny
58638,5900,0,0,62,62,0,1,0,1,0,deny
58638,5900,0,0,62,62,0,1,0,1,0,deny
58638,5900,0,0,62,62,0,1,0,1,0,deny
58638,5900,0,0,62,62,0,1,0,1,0,deny
58638,5900,0,0,62,62,0,1,0,1,0,deny
58638,5900,0,0,62,62,0,1,0,1,0,deny
58638,5900,0,0,62,62,0,1,0,1,0,deny
58638,5900,0,0,62,62,0,1,0,1,0,deny
58638,5900,0,0,62,62,0,1,0,1,0,deny
58638,5900,0,0,62,62,0,1,0,1,0,deny
58638,5900,0,0,62,62,0,1,0,1,0,deny
58638,5900,0,0,62,62,0,1,0,1,0,deny
58638,5900,0,0,62,62,0,1,0,1,0,deny
58638,5900,0,0,62,62,0,1,0,1,0,deny
58638,5900,0,0,62,62,0,1,0,1,0,deny
58638,5900,0,0,62,62,0,1,0,1,0,deny
58638,5900,0,0,62,62,0,1,0,1,0,deny
58638,5900,0,0,62,62,0,1,0,1,0,deny
58638,5900,0,0,62,62,0,1,0,1,0,deny
58638,5900,0,0,62,62,0,1,0,1,0,deny
58638,5900,0,0,62,62,0,1,0,1,0,deny
58638,5900,0,0,62,62,0,1,0,1,0,deny
58638,5900,0,0,62,62,0,1,0,1,0,deny
58638,5900,0,0,62,62,0,1,0,1,0,deny
58638,5900,0,0,62,62,0,1,0,1,0,deny
58638,5900,0,0,62,62,0,1,0,1,0,deny
58638,5900,0,0,62,62,0,1,0,1,0,deny
58638,5900,0,0,62,62,0,1,0,1,0,deny
58638,5900,0,0,62,62,0,1,0,1,0,deny
58638,5900,0,0,62,62,0,1,0,1,0,deny
58638,5900,0,0,62,62,0,1,0,1,0,deny
58638,5900,0,0,62,62,0,1,0,1,0,deny
58638,5900,0,0,62,62,0,1,0,1,0,deny
58638,5900,0,0,62,62,0,1,0,1,0,deny
58638,5900,0,0,62,62,0,1,0,1,0,deny
58638,5900,0,0,62,62,0,1,0,1,0,deny
58638,5900,0,0,62,62,0,1,0,1,0,deny
58638,5900,0,0,62,62,0,1,0,1,0,deny
58638,5900,0,0,62,62,0,1,0,1,0,deny
58638,5900,0,0,62,62,0,1,0,1,0,deny
58638,5900,0,0,62,62,0,1,0,1,0,deny
58638,5900,0,0,62,62,0,1,0,1,0,deny
58638,5900,0,0,62,62,0,1,0,1,0,deny
58638,5900,0,0,62,62,0,1,0,1,0,deny
58638,5900,0,0,62,62,0,1,0,1,0,deny
58638,5900,0,0,62,62,0,1,0,1,0,deny
58638,5900,0,0,62,62,0,1,0,1,0,deny
58638,5900,0,0,62,62,0,1,0,1,0,deny
58638,5900,0,0,62,62,0,1,0,1,0,deny
58638,5900,0,0,62,62,0,1,0,1,0,deny
58638,5900,0,0,62,62,0,1,0,1,0,deny
58638,5900,0,0,62,62,0,1,0,1,0,deny
58638,5900,0,0,62,62,0,1,0,1,0,deny
58638,5900,0,0,62,62,0,1,0,1,0,deny
58638,5900,0,0,62,62,0,1,0,1,0,deny
58638,5900,0,0,62,62,0,1,0,1,0,deny
58638,5900,0,0,62,62,0,1,0,1,0,deny
58638,5900,0,0,62,62,0,1,0,1,0,deny
58638,5900,0,0,62,62,0,1,0,1,0,deny
58638,5900,0,0,62,62,0,1,0,1,0,deny
58638,5900,0,0,62,62,0,1,0,1,0,deny
58638,5900,0,0,62,62,0,1,0,1,0,deny
58638,5900,0,0,62,62,0,1,0,1,0,deny
58638,5900,0,0,62,62,0,1,0,1,0,deny
58638,5900,0,0,62,62,0,1,0,1,0,deny
58638,5900,0,0,62,62,0,1,0,1,0,deny
58638,5900,0,0,62,62,0,1,0,1,0,deny
58638,5900,0,0,62,62,0,1,0,1,0,deny
58638,5900,0,0,62,62,0,1,0,1,0,deny
58638,5900,0,0,62,62,0,1,0,1,0,deny
58638,5900,0,0,62,62,0,1,0,1,0,deny
58638,5900,0,0,62,62,0,1,0,1,0,deny
58638,5900,0,0,62,62,0,1,0,1,0,deny
58638,5900,0,0,62,62,0,1,0,1,0,deny
58638,5900,0,0,62,62,0,1,0,1,0,deny
58638,5900,0,0,62,62,0,1,0,1,0,deny
58638,5900,0,0,62,62,0,1,0,1,0,deny
58638,5900,0,0,62,62,0,1,0,1,0,deny
58638,5900,0,0,62,62,0,1,0,1,0,deny
58638,5900,0,0,62,62,0,1,0,1,0,deny
58638,5900,0,0,62,62,0,1,0,1,0,deny
58638,5900,0,0,62,62,0,1,0,1,0,deny
58638,5900,0,0,62,62,0,1,0,1,0,deny
58638,5900,0,0,62,62,0,1,0,1,0,deny
58638,5900,0,0,62,62,0,1,0,1,0,deny
58638,5900,0,0,62,62,0,1,0,1,0,deny
58638,5900,0,0,62,62,0,1,0,1,0,deny
58638,5900,0,0,62,62,0,1,0,1,0,deny
58638,5900,0,0,62,62,0,1,0,1,0,deny
58638,5900,0,0,62,62,0,1,0,1,0,deny
58638,5900,0,0,62,62,0,1,0,1,0,deny
58638,5900,0,0,62,62,0,1,0,1,0,deny
58638,5900,0,0,62,62,0,1,0,1,0,deny
58638,5900,0,0,62,62,0,1,0,1,0,deny
58638,5900,0,0,62,62,0,1,0,1,0,deny
58638,5900,0,0,62,62,0,1,0,1,0,deny
58638,5900,0,0,62,62,0,1,0,1,0,deny
58638,5900,0,0,62,62,0,1,0,1,0,deny
58638,5900,0,0,62,62,0,1,0,1,0,deny
58638,5900,0,0,62,62,0,1,0,1,0,deny
58638,5900,0,0,62,62,0,1,0,1,0,deny
58638,5900,0,0,62,62,0,1,0,1,0,deny
58638,5900,0,0,62,62,0,1,0,1,0,deny
58638,5900,0,0,62,62,0,1,0,1,0,deny
58638,5900,0,0,62,62,0,1,0,1,0,deny
58638,5900,0,0,62,62,0,1,0,1,0,deny
58638,5900,0,0,62,62,0,1,0,1,0,deny
58638,5900,0,0,62,62,0,1,0,1,0,deny
58638,5900,0,0,62,62,0,1,0,1,0,deny
58638,5900,0,0,62,62,0,1,0,1,0,deny
58638,5900,0,0,62,62,0,1,0,1,0,deny
58638,5900,0,0,62,62,0,1,0,1,0,deny
58638,5900,0,0,62,62,0,1,0,1,0,deny
58638,5900,0,0,62,62,0,1,0,1,0,deny
58638,5900,0,0,62,62,0,1,0,1,0,deny
58638,5900,0,0,62,62,0,1,0,1,0,deny
58638,5900,0,0,62,62,0,1,0,1,0,deny
58638,5900,0,0,62,62,0,1,0,1,0,deny
58638,5900,0,0,62,62,0,1,0,1,0,deny
58638,5900,0,0,62,62,0,1,0,1,0,deny
58638,5900,0,0,62,62,0,1,0,1,0,deny
58638,5900,0,0,62,62,0,1,0,1,0,deny
58638,5900,0,0,62,62,0,1,0,1,0,deny
58638,5900,0,0,62,62,0,1,0,1,0,deny
58638,5900,0,0,62,62,0,1,0,1,0,deny
58638,5900,0,0,62,62,0,1,0,1,0,deny
58638,5900,0,0,62,62,0,1,0,1,0,deny
58638,5900,0,0,62,62,0,1,0,1,0,deny
58638,5900,0,0,62,62,0,1,0,1,0,deny
58638,5900,0,0,62,62,0,1,0,1,0,deny
58638,5900,0,0,62,62,0,1,0,1,0,deny
58638,5900,0,0,62,62,0,1,0,1,0,deny
58638,5900,0,0,62,62,0,1,0,1,0,deny
58638,5900,0,0,62,62,0,1,0,1,0,deny
58638,5900,0,0,62,62,0,1,0,1,0,deny
58638,5900,0,0,62,62,0,1,0,1,0,deny
58638,5900,0,0,62,62,0,1,0,1,0,deny
58638,5900,0,0,62,62,0,1,0,1,0,deny
58638,5900,0,0,62,62,0,1,0,1,0,deny
58638,5900,0,0,62,62,0,1,0,1,0,deny
58638,5900,0,0,62,62,0,1,0,1,0,deny
53930,445,0,0,70,70,0,1,0,1,0,drop
58638,5900,0,0,62,62,0,1,0,1,0,deny
58638,5900,0,0,62,62,0,1,0,1,0,deny
53923,445,0,0,70,70,0,1,0,1,0,drop
58638,5900,0,0,62,62,0,1,0,1,0,deny
58638,5900,0,0,62,62,0,1,0,1,0,deny
53922,445,0,0,70,70,0,1,0,1,0,drop
58638,5900,0,0,62,62,0,1,0,1,0,deny
58638,5900,0,0,62,62,0,1,0,1,0,deny
53916,445,0,0,70,70,0,1,0,1,0,drop
58638,5900,0,0,62,62,0,1,0,1,0,deny
58638,5900,0,0,62,62,0,1,0,1,0,deny
58638,5900,0,0,62,62,0,1,0,1,0,deny
58638,5900,0,0,62,62,0,1,0,1,0,deny
58638,5900,0,0,62,62,0,1,0,1,0,deny
58638,5900,0,0,62,62,0,1,0,1,0,deny
58638,5900,0,0,62,62,0,1,0,1,0,deny
58638,5900,0,0,62,62,0,1,0,1,0,deny
58638,5900,0,0,62,62,0,1,0,1,0,deny
58638,5900,0,0,62,62,0,1,0,1,0,deny
58638,5900,0,0,62,62,0,1,0,1,0,deny
58638,5900,0,0,62,62,0,1,0,1,0,deny
58638,5900,0,0,62,62,0,1,0,1,0,deny
58638,5900,0,0,62,62,0,1,0,1,0,deny
58638,5900,0,0,62,62,0,1,0,1,0,deny
58638,5900,0,0,62,62,0,1,0,1,0,deny
58638,5900,0,0,62,62,0,1,0,1,0,deny
58638,5900,0,0,62,62,0,1,0,1,0,deny
58638,5900,0,0,62,62,0,1,0,1,0,deny
58638,5900,0,0,62,62,0,1,0,1,0,deny
58638,5900,0,0,62,62,0,1,0,1,0,deny
58638,5900,0,0,62,62,0,1,0,1,0,deny
58638,5900,0,0,62,62,0,1,0,1,0,deny
58638,5900,0,0,62,62,0,1,0,1,0,deny
58638,5900,0,0,62,62,0,1,0,1,0,deny
58638,5900,0,0,62,62,0,1,0,1,0,deny
58638,5900,0,0,62,62,0,1,0,1,0,deny
58638,5900,0,0,62,62,0,1,0,1,0,deny
58638,5900,0,0,62,62,0,1,0,1,0,deny
58638,5900,0,0,62,62,0,1,0,1,0,deny
58638,5900,0,0,62,62,0,1,0,1,0,deny
58638,5900,0,0,62,62,0,1,0,1,0,deny
58638,5900,0,0,62,62,0,1,0,1,0,deny
58638,5900,0,0,62,62,0,1,0,1,0,deny
58638,5900,0,0,62,62,0,1,0,1,0,deny
58638,5900,0,0,62,62,0,1,0,1,0,deny
58638,5900,0,0,62,62,0,1,0,1,0,deny
58638,5900,0,0,62,62,0,1,0,1,0,deny
58638,5900,0,0,62,62,0,1,0,1,0,deny
58638,5900,0,0,62,62,0,1,0,1,0,deny
58638,5900,0,0,62,62,0,1,0,1,0,deny
58638,5900,0,0,62,62,0,1,0,1,0,deny
58638,5900,0,0,62,62,0,1,0,1,0,deny
58638,5900,0,0,62,62,0,1,0,1,0,deny
58638,5900,0,0,62,62,0,1,0,1,0,deny
58638,5900,0,0,62,62,0,1,0,1,0,deny
58638,5900,0,0,62,62,0,1,0,1,0,deny
58638,5900,0,0,62,62,0,1,0,1,0,deny
58638,5900,0,0,62,62,0,1,0,1,0,deny
58638,5900,0,0,62,62,0,1,0,1,0,deny
58638,5900,0,0,62,62,0,1,0,1,0,deny
58638,5900,0,0,62,62,0,1,0,1,0,deny
58638,5900,0,0,62,62,0,1,0,1,0,deny
58638,5900,0,0,62,62,0,1,0,1,0,deny
58638,5900,0,0,62,62,0,1,0,1,0,deny
58638,5900,0,0,62,62,0,1,0,1,0,deny
58638,5900,0,0,62,62,0,1,0,1,0,deny
58638,5900,0,0,62,62,0,1,0,1,0,deny
58638,5900,0,0,62,62,0,1,0,1,0,deny
58638,5900,0,0,62,62,0,1,0,1,0,deny
58638,5900,0,0,62,62,0,1,0,1,0,deny
58638,5900,0,0,62,62,0,1,0,1,0,deny
58638,5900,0,0,62,62,0,1,0,1,0,deny
58638,5900,0,0,62,62,0,1,0,1,0,deny
58638,5900,0,0,62,62,0,1,0,1,0,deny
58638,5900,0,0,62,62,0,1,0,1,0,deny
58638,5900,0,0,62,62,0,1,0,1,0,deny
58638,5900,0,0,62,62,0,1,0,1,0,deny
58638,5900,0,0,62,62,0,1,0,1,0,deny
58638,5900,0,0,62,62,0,1,0,1,0,deny
58638,5900,0,0,62,62,0,1,0,1,0,deny
58638,5900,0,0,62,62,0,1,0,1,0,deny
58638,5900,0,0,62,62,0,1,0,1,0,deny
58638,5900,0,0,62,62,0,1,0,1,0,deny
58638,5900,0,0,62,62,0,1,0,1,0,deny
58638,5900,0,0,62,62,0,1,0,1,0,deny
58638,5900,0,0,62,62,0,1,0,1,0,deny
58638,5900,0,0,62,62,0,1,0,1,0,deny
58638,5900,0,0,62,62,0,1,0,1,0,deny
58638,5900,0,0,62,62,0,1,0,1,0,deny
58638,5900,0,0,62,62,0,1,0,1,0,deny
58638,5900,0,0,62,62,0,1,0,1,0,deny
58638,5900,0,0,62,62,0,1,0,1,0,deny
58638,5900,0,0,62,62,0,1,0,1,0,deny
58638,5900,0,0,62,62,0,1,0,1,0,deny
58638,5900,0,0,62,62,0,1,0,1,0,deny
58638,5900,0,0,62,62,0,1,0,1,0,deny
58638,5900,0,0,62,62,0,1,0,1,0,deny
58638,5900,0,0,62,62,0,1,0,1,0,deny
58638,5900,0,0,62,62,0,1,0,1,0,deny
58638,5900,0,0,62,62,0,1,0,1,0,deny
58638,5900,0,0,62,62,0,1,0,1,0,deny
58638,5900,0,0,62,62,0,1,0,1,0,deny
58638,5900,0,0,62,62,0,1,0,1,0,deny
58638,5900,0,0,62,62,0,1,0,1,0,deny
58638,5900,0,0,62,62,0,1,0,1,0,deny
58638,5900,0,0,62,62,0,1,0,1,0,deny
58638,5900,0,0,62,62,0,1,0,1,0,deny
58638,5900,0,0,62,62,0,1,0,1,0,deny
58638,5900,0,0,62,62,0,1,0,1,0,deny
58638,5900,0,0,62,62,0,1,0,1,0,deny
58638,5900,0,0,62,62,0,1,0,1,0,deny
58638,5900,0,0,62,62,0,1,0,1,0,deny
58638,5900,0,0,62,62,0,1,0,1,0,deny
58638,5900,0,0,62,62,0,1,0,1,0,deny
58638,5900,0,0,62,62,0,1,0,1,0,deny
58638,5900,0,0,62,62,0,1,0,1,0,deny
58638,5900,0,0,62,62,0,1,0,1,0,deny
58638,5900,0,0,62,62,0,1,0,1,0,deny
58638,5900,0,0,62,62,0,1,0,1,0,deny
58638,5900,0,0,62,62,0,1,0,1,0,deny
58638,5900,0,0,62,62,0,1,0,1,0,deny
58638,5900,0,0,62,62,0,1,0,1,0,deny
58638,5900,0,0,62,62,0,1,0,1,0,deny
58638,5900,0,0,62,62,0,1,0,1,0,deny
58638,5900,0,0,62,62,0,1,0,1,0,deny
58638,5900,0,0,62,62,0,1,0,1,0,deny
58638,5900,0,0,62,62,0,1,0,1,0,deny
58638,5900,0,0,62,62,0,1,0,1,0,deny
58638,5900,0,0,62,62,0,1,0,1,0,deny
58638,5900,0,0,62,62,0,1,0,1,0,deny
58638,5900,0,0,62,62,0,1,0,1,0,deny
58638,5900,0,0,62,62,0,1,0,1,0,deny
58638,5900,0,0,62,62,0,1,0,1,0,deny
58638,5900,0,0,62,62,0,1,0,1,0,deny
58638,5900,0,0,62,62,0,1,0,1,0,deny
58638,5900,0,0,62,62,0,1,0,1,0,deny
58638,5900,0,0,62,62,0,1,0,1,0,deny
58638,5900,0,0,62,62,0,1,0,1,0,deny
58638,5900,0,0,62,62,0,1,0,1,0,deny
58638,5900,0,0,62,62,0,1,0,1,0,deny
58638,5900,0,0,62,62,0,1,0,1,0,deny
58638,5900,0,0,62,62,0,1,0,1,0,deny
58638,5900,0,0,62,62,0,1,0,1,0,deny
58638,5900,0,0,62,62,0,1,0,1,0,deny
58638,5900,0,0,62,62,0,1,0,1,0,deny
58638,5900,0,0,62,62,0,1,0,1,0,deny
58638,5900,0,0,62,62,0,1,0,1,0,deny
58638,5900,0,0,62,62,0,1,0,1,0,deny
58638,5900,0,0,62,62,0,1,0,1,0,deny
58638,5900,0,0,62,62,0,1,0,1,0,deny
58638,5900,0,0,62,62,0,1,0,1,0,deny
58638,5900,0,0,62,62,0,1,0,1,0,deny
58638,5900,0,0,62,62,0,1,0,1,0,deny
58638,5900,0,0,62,62,0,1,0,1,0,deny
58638,5900,0,0,62,62,0,1,0,1,0,deny
58638,5900,0,0,62,62,0,1,0,1,0,deny
58638,5900,0,0,62,62,0,1,0,1,0,deny
58638,5900,0,0,62,62,0,1,0,1,0,deny
58638,5900,0,0,62,62,0,1,0,1,0,deny
58638,5900,0,0,62,62,0,1,0,1,0,deny
58638,5900,0,0,62,62,0,1,0,1,0,deny
58638,5900,0,0,62,62,0,1,0,1,0,deny
58638,5900,0,0,62,62,0,1,0,1,0,deny
58638,5900,0,0,62,62,0,1,0,1,0,deny
58638,5900,0,0,62,62,0,1,0,1,0,deny
58638,5900,0,0,62,62,0,1,0,1,0,deny
58638,5900,0,0,62,62,0,1,0,1,0,deny
58638,5900,0,0,62,62,0,1,0,1,0,deny
58638,5900,0,0,62,62,0,1,0,1,0,deny
58638,5900,0,0,62,62,0,1,0,1,0,deny
58638,5900,0,0,62,62,0,1,0,1,0,deny
58638,5900,0,0,62,62,0,1,0,1,0,deny
58638,5900,0,0,62,62,0,1,0,1,0,deny
58638,5900,0,0,62,62,0,1,0,1,0,deny
58638,5900,0,0,62,62,0,1,0,1,0,deny
58638,5900,0,0,62,62,0,1,0,1,0,deny
58638,5900,0,0,62,62,0,1,0,1,0,deny
58638,5900,0,0,62,62,0,1,0,1,0,deny
58638,5900,0,0,62,62,0,1,0,1,0,deny
58638,5900,0,0,62,62,0,1,0,1,0,deny
58638,5900,0,0,62,62,0,1,0,1,0,deny
58638,5900,0,0,62,62,0,1,0,1,0,deny
58638,5900,0,0,62,62,0,1,0,1,0,deny
58638,5900,0,0,62,62,0,1,0,1,0,deny
58638,5900,0,0,62,62,0,1,0,1,0,deny
58638,5900,0,0,62,62,0,1,0,1,0,deny
58638,5900,0,0,62,62,0,1,0,1,0,deny
58638,5900,0,0,62,62,0,1,0,1,0,deny
58638,5900,0,0,62,62,0,1,0,1,0,deny
58638,5900,0,0,62,62,0,1,0,1,0,deny
58638,5900,0,0,62,62,0,1,0,1,0,deny
58638,5900,0,0,62,62,0,1,0,1,0,deny
58638,5900,0,0,62,62,0,1,0,1,0,deny
58638,5900,0,0,62,62,0,1,0,1,0,deny
58638,5900,0,0,62,62,0,1,0,1,0,deny
58638,5900,0,0,62,62,0,1,0,1,0,deny
58638,5900,0,0,62,62,0,1,0,1,0,deny
58638,5900,0,0,62,62,0,1,0,1,0,deny
58638,5900,0,0,62,62,0,1,0,1,0,deny
58638,5900,0,0,62,62,0,1,0,1,0,deny
58638,5900,0,0,62,62,0,1,0,1,0,deny
58638,5900,0,0,62,62,0,1,0,1,0,deny
58638,5900,0,0,62,62,0,1,0,1,0,deny
58638,5900,0,0,62,62,0,1,0,1,0,deny
58638,5900,0,0,62,62,0,1,0,1,0,deny
58638,5900,0,0,62,62,0,1,0,1,0,deny
58638,5900,0,0,62,62,0,1,0,1,0,deny
58638,5900,0,0,62,62,0,1,0,1,0,deny
58638,5900,0,0,62,62,0,1,0,1,0,deny
58638,5900,0,0,62,62,0,1,0,1,0,deny
58638,5900,0,0,62,62,0,1,0,1,0,deny
58638,5900,0,0,62,62,0,1,0,1,0,deny
58638,5900,0,0,62,62,0,1,0,1,0,deny
58638,5900,0,0,62,62,0,1,0,1,0,deny
58638,5900,0,0,62,62,0,1,0,1,0,deny
58638,5900,0,0,62,62,0,1,0,1,0,deny
58638,5900,0,0,62,62,0,1,0,1,0,deny
58638,5900,0,0,62,62,0,1,0,1,0,deny
58638,5900,0,0,62,62,0,1,0,1,0,deny
58638,5900,0,0,62,62,0,1,0,1,0,deny
58638,5900,0,0,62,62,0,1,0,1,0,deny
58638,5900,0,0,62,62,0,1,0,1,0,deny
58638,5900,0,0,62,62,0,1,0,1,0,deny
58638,5900,0,0,62,62,0,1,0,1,0,deny
58638,5900,0,0,62,62,0,1,0,1,0,deny
58638,5900,0,0,62,62,0,1,0,1,0,deny
51993,25174,0,0,66,66,0,1,0,1,0,deny
58638,5900,0,0,62,62,0,1,0,1,0,deny
58638,5900,0,0,62,62,0,1,0,1,0,deny
58638,5900,0,0,62,62,0,1,0,1,0,deny
58638,5900,0,0,62,62,0,1,0,1,0,deny
58638,5900,0,0,62,62,0,1,0,1,0,deny
58638,5900,0,0,62,62,0,1,0,1,0,deny
58638,5900,0,0,62,62,0,1,0,1,0,deny
58638,5900,0,0,62,62,0,1,0,1,0,deny
58638,5900,0,0,62,62,0,1,0,1,0,deny
58638,5900,0,0,62,62,0,1,0,1,0,deny
58638,5900,0,0,62,62,0,1,0,1,0,deny
58638,5900,0,0,62,62,0,1,0,1,0,deny
58638,5900,0,0,62,62,0,1,0,1,0,deny
58638,5900,0,0,62,62,0,1,0,1,0,deny
58638,5900,0,0,62,62,0,1,0,1,0,deny
58638,5900,0,0,62,62,0,1,0,1,0,deny
58638,5900,0,0,62,62,0,1,0,1,0,deny
58638,5900,0,0,62,62,0,1,0,1,0,deny
58638,5900,0,0,62,62,0,1,0,1,0,deny
58638,5900,0,0,62,62,0,1,0,1,0,deny
58638,5900,0,0,62,62,0,1,0,1,0,deny
57928,30188,0,0,62,62,0,1,0,1,0,deny
443,54507,0,0,82,82,0,1,0,1,0,deny
6881,26171,65454,26171,219,118,101,2,1199,1,1,allow
60493,55172,57169,55172,320,140,180,6,7,3,3,allow
56345,443,39296,443,39990,1989,38001,50,147,17,33,allow
53332,80,59740,80,9094,5469,3625,22,166,12,10,allow
54796,443,9714,443,6668,1926,4742,20,15,11,9,allow
41056,443,45681,443,8185,1381,6804,22,831,11,11,allow
39293,443,5290,443,70,70,0,1,4,1,0,allow
55048,80,23955,80,3084,1646,1438,19,131,10,9,allow
57835,53,49650,53,308,118,190,2,29,1,1,allow
57700,53,7203,53,308,118,190,2,29,1,1,allow
58459,53,37044,53,307,86,221,2,29,1,1,allow
56038,53,40238,53,177,94,83,2,29,1,1,allow
55047,53,41022,53,308,94,214,2,29,1,1,allow
52599,53,38138,53,338,94,244,2,29,1,1,allow
65226,443,51904,443,35968,13816,22152,77,96,34,43,allow
64945,53,47640,53,292,126,166,2,29,1,1,allow
55936,53,21289,53,177,94,83,2,30,1,1,allow
49658,53,2388,53,195,102,93,2,30,1,1,allow
50241,53,25762,53,728,102,626,2,30,1,1,allow
56334,53,34646,53,177,94,83,2,30,1,1,allow
9480,443,14084,443,6100,777,5323,17,25,9,8,allow
45032,53,45032,53,216,82,134,2,33,1,1,allow
57665,53,28556,53,168,78,90,2,30,1,1,allow
41785,443,3150,443,13183,1682,11501,26,78,12,14,allow
50377,53,9572,53,167,78,89,2,30,1,1,allow
35817,443,2802,443,3120,1862,1258,18,15,11,7,allow
42574,53,42574,53,262,106,156,2,32,1,1,allow
31176,53,31176,53,414,268,146,3,32,2,1,allow
41664,53,40771,53,376,78,298,2,30,1,1,allow
56334,53,19616,53,177,94,83,2,30,1,1,allow
9479,443,13111,443,6100,777,5323,17,25,9,8,allow
56324,53,13523,53,177,94,83,2,30,1,1,allow
52182,53,34693,53,199,94,105,2,30,1,1,allow
56080,443,20631,443,3970,1726,2244,13,135,6,7,allow
59116,53,59116,53,203,82,121,2,30,1,1,allow
62077,443,1621,443,17761,7207,10554,44,46,25,19,allow
9474,443,14729,443,6100,777,5323,17,26,9,8,allow
9473,443,29099,443,6100,777,5323,17,26,9,8,allow
38555,443,24882,443,40928,36006,4922,59,16,34,25,allow
58369,53,2783,53,167,78,89,2,30,1,1,allow
50378,53,37644,53,167,78,89,2,30,1,1,allow
49454,53,42230,53,248,118,130,2,30,1,1,allow
56324,53,52043,53,177,94,83,2,30,1,1,allow
46461,53,27823,53,199,94,105,2,30,1,1,allow
57837,443,41125,443,17236,1691,15545,19,146,5,14,allow
38728,53,38728,53,414,268,146,3,33,2,1,allow
40865,8100,52976,8100,78,78,0,1,5,1,0,allow
9475,443,36657,443,4063,969,3094,16,26,9,7,allow
55710,63545,52051,63545,504,318,186,8,15,5,3,allow
33641,443,2360,443,15017,6951,8066,49,20,25,24,allow
65126,53,19594,53,216,94,122,2,30,1,1,allow
49634,53,7065,53,257,102,155,2,30,1,1,allow
58368,53,61007,53,167,78,89,2,30,1,1,allow
55074,443,36824,443,3143,2172,971,19,25,9,10,allow
55066,80,57629,80,2554,1742,812,15,77,8,7,allow
39995,443,36730,443,4160,2228,1932,25,159,13,12,allow
60416,443,11714,443,4953,1111,3842,22,104,12,10,allow
53831,443,42938,443,190,70,120,4,15,2,2,allow
60406,80,16333,80,1370,704,666,23,105,12,11,allow
43477,443,38784,443,20739,7254,13485,97,734,44,53,allow
58057,80,11789,80,2708,1386,1322,23,75,12,11,allow
52002,80,36032,80,546,300,246,10,24,6,4,allow
54957,53,30594,53,197,102,95,2,33,1,1,allow
54036,443,30085,443,43295,8391,34904,66,49,32,34,allow
53909,20545,63910,20545,612,366,246,10,19,6,4,allow
41786,443,30860,443,174542,9281,165261,227,78,104,123,allow
48372,8100,12918,8100,78,78,0,1,5,1,0,allow
56751,80,54705,80,1462,703,759,8,16,5,3,allow
9476,443,21369,443,3999,905,3094,15,26,8,7,allow
64282,53,55682,53,215,94,121,2,30,1,1,allow
65453,53,23093,53,311,94,217,2,30,1,1,allow
51103,5223,3221,5223,4968,1304,3664,26,1190,13,13,allow
60369,443,60379,443,7939,955,6984,22,107,11,11,allow
55936,53,1988,53,177,94,83,2,29,1,1,allow
40657,443,5933,443,9869,2395,7474,36,129,20,16,allow
49757,53,24825,53,212,94,118,2,29,1,1,allow
55817,53,47066,53,177,94,83,2,30,1,1,allow
50677,80,32544,80,3664,1440,2224,12,20,6,6,allow
56582,53,17999,53,196,102,94,2,32,1,1,allow
58366,53,25101,53,167,78,89,2,30,1,1,allow
60488,27615,38598,27615,70,70,0,1,5,1,0,allow
60485,13314,55482,13314,70,70,0,1,5,1,0,allow
58367,53,2848,53,167,78,89,2,30,1,1,allow
56038,53,12140,53,177,94,83,2,30,1,1,allow
44577,53,21603,53,199,94,105,2,30,1,1,allow
22114,4789,50813,4789,70,70,0,1,30,1,0,allow
58365,53,51432,53,260,86,174,2,30,1,1,allow
57464,53,0,0,86,86,0,1,30,1,0,allow
59183,53,39038,53,260,86,174,2,30,1,1,allow
57470,1,59410,1,132,132,0,3,1199,3,0,allow
64059,80,17237,80,374,192,182,7,15,4,3,allow
60415,443,32364,443,7727,2796,4931,36,104,18,18,allow
65517,443,57866,443,92117,4799,87318,107,15,43,64,allow
64432,53,45233,53,482,188,294,6,44,3,3,allow
46225,53,7961,53,199,94,105,2,30,1,1,allow
46912,53,4234,53,168,78,90,2,30,1,1,allow
51115,80,32483,80,1426,930,496,10,22,7,3,allow
59328,80,59328,80,24437,12718,11719,41,15,16,25,allow
64381,53,35709,53,168,86,82,2,32,1,1,allow
51804,53,51804,53,247,98,149,2,33,1,1,allow
49071,443,20590,443,130,70,60,3,5,2,1,allow
56752,80,35742,80,1462,703,759,8,16,5,3,allow
62076,443,11320,443,7370,2873,4497,23,47,13,10,allow
57075,53,34299,53,212,102,110,2,30,1,1,allow
60817,443,60817,443,1320,685,635,14,180,7,7,allow
50156,443,23478,443,6666,1682,4984,28,1157,15,13,allow
27114,53,27114,53,414,268,146,3,33,2,1,allow
64994,53,18089,53,216,102,114,2,30,1,1,allow
54533,443,7224,443,2638,330,2308,12,135,5,7,allow
49789,53,40494,53,177,94,83,2,30,1,1,allow
64690,53,18350,53,338,110,228,2,30,1,1,allow
56887,53,19033,53,177,94,83,2,31,1,1,allow
43732,443,60967,443,5719,1339,4380,19,361,9,10,allow
8941,443,25184,443,541643,15245,526398,507,416,103,404,allow
52196,25336,19782,25336,316,136,180,6,6,3,3,allow
52152,58114,56068,58114,70,70,0,1,5,1,0,allow
49573,443,10413,443,1326,876,450,11,55,6,5,allow
49674,443,19357,443,5917,1570,4347,20,53,10,10,allow
49578,443,49511,443,6947,833,6114,20,54,9,11,allow
49574,443,40939,443,16191,13348,2843,30,55,17,13,allow
3764,9694,0,0,66,66,0,1,0,1,0,deny
16862,21247,0,0,62,62,0,1,0,1,0,deny
58638,5900,0,0,62,62,0,1,0,1,0,deny
58638,5900,0,0,62,62,0,1,0,1,0,deny
58638,5900,0,0,62,62,0,1,0,1,0,deny
58638,5900,0,0,62,62,0,1,0,1,0,deny
49557,443,57017,443,38022,18448,19574,53,57,27,26,allow
63427,443,12602,443,15135,12791,2344,43,81,22,21,allow
62080,443,19549,443,2902,1562,1340,22,46,12,10,allow
55936,53,60791,53,177,94,83,2,30,1,1,allow
49227,53,48621,53,718,94,624,2,30,1,1,allow
49641,443,54383,443,5776,1079,4697,15,53,8,7,allow
50489,443,45489,443,1268,638,630,12,17,7,5,allow
49639,443,62054,443,5776,1079,4697,15,53,8,7,allow
52201,44054,14407,44054,70,70,0,1,5,1,0,allow
52150,37603,63249,37603,70,70,0,1,5,1,0,allow
49595,80,13926,80,1285,772,513,11,53,6,5,allow
64985,53,50795,53,412,97,315,4,58,2,2,allow
58638,5900,0,0,62,62,0,1,0,1,0,deny
58638,5900,0,0,62,62,0,1,0,1,0,deny
58638,5900,0,0,62,62,0,1,0,1,0,deny
58638,5900,0,0,62,62,0,1,0,1,0,deny
58638,5900,0,0,62,62,0,1,0,1,0,deny
58638,5900,0,0,62,62,0,1,0,1,0,deny
58638,5900,0,0,62,62,0,1,0,1,0,deny
58638,5900,0,0,62,62,0,1,0,1,0,deny
58638,5900,0,0,62,62,0,1,0,1,0,deny
58638,5900,0,0,62,62,0,1,0,1,0,deny
58638,5900,0,0,62,62,0,1,0,1,0,deny
58638,5900,0,0,62,62,0,1,0,1,0,deny
58638,5900,0,0,62,62,0,1,0,1,0,deny
58638,5900,0,0,62,62,0,1,0,1,0,deny
58638,5900,0,0,62,62,0,1,0,1,0,deny
58638,5900,0,0,62,62,0,1,0,1,0,deny
58638,5900,0,0,62,62,0,1,0,1,0,deny
58638,5900,0,0,62,62,0,1,0,1,0,deny
58638,5900,0,0,62,62,0,1,0,1,0,deny
58638,5900,0,0,62,62,0,1,0,1,0,deny
58638,5900,0,0,62,62,0,1,0,1,0,deny
58638,5900,0,0,62,62,0,1,0,1,0,deny
58638,5900,0,0,62,62,0,1,0,1,0,deny
58638,5900,0,0,62,62,0,1,0,1,0,deny
58638,5900,0,0,62,62,0,1,0,1,0,deny
58638,5900,0,0,62,62,0,1,0,1,0,deny
58638,5900,0,0,62,62,0,1,0,1,0,deny
58638,5900,0,0,62,62,0,1,0,1,0,deny
58638,5900,0,0,62,62,0,1,0,1,0,deny
58638,5900,0,0,62,62,0,1,0,1,0,deny
58638,5900,0,0,62,62,0,1,0,1,0,deny
58638,5900,0,0,62,62,0,1,0,1,0,deny
58638,5900,0,0,62,62,0,1,0,1,0,deny
58638,5900,0,0,62,62,0,1,0,1,0,deny
58638,5900,0,0,62,62,0,1,0,1,0,deny
58638,5900,0,0,62,62,0,1,0,1,0,deny
58638,5900,0,0,62,62,0,1,0,1,0,deny
58638,5900,0,0,62,62,0,1,0,1,0,deny
58638,5900,0,0,62,62,0,1,0,1,0,deny
58638,5900,0,0,62,62,0,1,0,1,0,deny
58638,5900,0,0,62,62,0,1,0,1,0,deny
58638,5900,0,0,62,62,0,1,0,1,0,deny
58638,5900,0,0,62,62,0,1,0,1,0,deny
58638,5900,0,0,62,62,0,1,0,1,0,deny
58638,5900,0,0,62,62,0,1,0,1,0,deny
58638,5900,0,0,62,62,0,1,0,1,0,deny
58638,5900,0,0,62,62,0,1,0,1,0,deny
58638,5900,0,0,62,62,0,1,0,1,0,deny
58638,5900,0,0,62,62,0,1,0,1,0,deny
58638,5900,0,0,62,62,0,1,0,1,0,deny
58638,5900,0,0,62,62,0,1,0,1,0,deny
58638,5900,0,0,62,62,0,1,0,1,0,deny
58638,5900,0,0,62,62,0,1,0,1,0,deny
58638,5900,0,0,62,62,0,1,0,1,0,deny
58638,5900,0,0,62,62,0,1,0,1,0,deny
58638,5900,0,0,62,62,0,1,0,1,0,deny
58638,5900,0,0,62,62,0,1,0,1,0,deny
58638,5900,0,0,62,62,0,1,0,1,0,deny
58638,5900,0,0,62,62,0,1,0,1,0,deny
58638,5900,0,0,62,62,0,1,0,1,0,deny
58638,5900,0,0,62,62,0,1,0,1,0,deny
58638,5900,0,0,62,62,0,1,0,1,0,deny
58638,5900,0,0,62,62,0,1,0,1,0,deny
58638,5900,0,0,62,62,0,1,0,1,0,deny
58638,5900,0,0,62,62,0,1,0,1,0,deny
58638,5900,0,0,62,62,0,1,0,1,0,deny
58638,5900,0,0,62,62,0,1,0,1,0,deny
58638,5900,0,0,62,62,0,1,0,1,0,deny
58638,5900,0,0,62,62,0,1,0,1,0,deny
58638,5900,0,0,62,62,0,1,0,1,0,deny
58638,5900,0,0,62,62,0,1,0,1,0,deny
58638,5900,0,0,62,62,0,1,0,1,0,deny
58638,5900,0,0,62,62,0,1,0,1,0,deny
58638,5900,0,0,62,62,0,1,0,1,0,deny
58638,5900,0,0,62,62,0,1,0,1,0,deny
58638,5900,0,0,62,62,0,1,0,1,0,deny
58638,5900,0,0,62,62,0,1,0,1,0,deny
58638,5900,0,0,62,62,0,1,0,1,0,deny
58638,5900,0,0,62,62,0,1,0,1,0,deny
58638,5900,0,0,62,62,0,1,0,1,0,deny
58638,5900,0,0,62,62,0,1,0,1,0,deny
58638,5900,0,0,62,62,0,1,0,1,0,deny
58638,5900,0,0,62,62,0,1,0,1,0,deny
58638,5900,0,0,62,62,0,1,0,1,0,deny
58638,5900,0,0,62,62,0,1,0,1,0,deny
58638,5900,0,0,62,62,0,1,0,1,0,deny
58638,5900,0,0,62,62,0,1,0,1,0,deny
58638,5900,0,0,62,62,0,1,0,1,0,deny
58638,5900,0,0,62,62,0,1,0,1,0,deny
58638,5900,0,0,62,62,0,1,0,1,0,deny
58638,5900,0,0,62,62,0,1,0,1,0,deny
58638,5900,0,0,62,62,0,1,0,1,0,deny
58638,5900,0,0,62,62,0,1,0,1,0,deny
49847,23,0,0,60,60,0,1,0,1,0,deny
58638,5900,0,0,62,62,0,1,0,1,0,deny
58638,5900,0,0,62,62,0,1,0,1,0,deny
58638,5900,0,0,62,62,0,1,0,1,0,deny
49314,445,0,0,66,66,0,1,0,1,0,drop
49312,445,0,0,66,66,0,1,0,1,0,drop
49311,445,0,0,66,66,0,1,0,1,0,drop
58638,5900,0,0,62,62,0,1,0,1,0,deny
58638,5900,0,0,62,62,0,1,0,1,0,deny
58638,5900,0,0,62,62,0,1,0,1,0,deny
58638,5900,0,0,62,62,0,1,0,1,0,deny
58638,5900,0,0,62,62,0,1,0,1,0,deny
58638,5900,0,0,62,62,0,1,0,1,0,deny
58638,5900,0,0,62,62,0,1,0,1,0,deny
58638,5900,0,0,62,62,0,1,0,1,0,deny
58638,5900,0,0,62,62,0,1,0,1,0,deny
58638,5900,0,0,62,62,0,1,0,1,0,deny
58638,5900,0,0,62,62,0,1,0,1,0,deny
58638,5900,0,0,62,62,0,1,0,1,0,deny
58638,5900,0,0,62,62,0,1,0,1,0,deny
58638,5900,0,0,62,62,0,1,0,1,0,deny
58638,5900,0,0,62,62,0,1,0,1,0,deny
58638,5900,0,0,62,62,0,1,0,1,0,deny
58638,5900,0,0,62,62,0,1,0,1,0,deny
58638,5900,0,0,62,62,0,1,0,1,0,deny
58638,5900,0,0,62,62,0,1,0,1,0,deny
58638,5900,0,0,62,62,0,1,0,1,0,deny
58638,5900,0,0,62,62,0,1,0,1,0,deny
58638,5900,0,0,62,62,0,1,0,1,0,deny
58638,5900,0,0,62,62,0,1,0,1,0,deny
58638,5900,0,0,62,62,0,1,0,1,0,deny
58638,5900,0,0,62,62,0,1,0,1,0,deny
58638,5900,0,0,62,62,0,1,0,1,0,deny
58638,5900,0,0,62,62,0,1,0,1,0,deny
58638,5900,0,0,62,62,0,1,0,1,0,deny
58638,5900,0,0,62,62,0,1,0,1,0,deny
58638,5900,0,0,62,62,0,1,0,1,0,deny
58638,5900,0,0,62,62,0,1,0,1,0,deny
58638,5900,0,0,62,62,0,1,0,1,0,deny
58638,5900,0,0,62,62,0,1,0,1,0,deny
58638,5900,0,0,62,62,0,1,0,1,0,deny
58638,5900,0,0,62,62,0,1,0,1,0,deny
58638,5900,0,0,62,62,0,1,0,1,0,deny
58638,5900,0,0,62,62,0,1,0,1,0,deny
58638,5900,0,0,62,62,0,1,0,1,0,deny
58638,5900,0,0,62,62,0,1,0,1,0,deny
58638,5900,0,0,62,62,0,1,0,1,0,deny
58638,5900,0,0,62,62,0,1,0,1,0,deny
58638,5900,0,0,62,62,0,1,0,1,0,deny
58638,5900,0,0,62,62,0,1,0,1,0,deny
58638,5900,0,0,62,62,0,1,0,1,0,deny
58638,5900,0,0,62,62,0,1,0,1,0,deny
58638,5900,0,0,62,62,0,1,0,1,0,deny
58638,5900,0,0,62,62,0,1,0,1,0,deny
58638,5900,0,0,62,62,0,1,0,1,0,deny
58638,5900,0,0,62,62,0,1,0,1,0,deny
58638,5900,0,0,62,62,0,1,0,1,0,deny
58638,5900,0,0,62,62,0,1,0,1,0,deny
58638,5900,0,0,62,62,0,1,0,1,0,deny
58638,5900,0,0,62,62,0,1,0,1,0,deny
58638,5900,0,0,62,62,0,1,0,1,0,deny
58638,5900,0,0,62,62,0,1,0,1,0,deny
58638,5900,0,0,62,62,0,1,0,1,0,deny
58638,5900,0,0,62,62,0,1,0,1,0,deny
58638,5900,0,0,62,62,0,1,0,1,0,deny
58638,5900,0,0,62,62,0,1,0,1,0,deny
58638,5900,0,0,62,62,0,1,0,1,0,deny
58638,5900,0,0,62,62,0,1,0,1,0,deny
58638,5900,0,0,62,62,0,1,0,1,0,deny
58638,5900,0,0,62,62,0,1,0,1,0,deny
58638,5900,0,0,62,62,0,1,0,1,0,deny
58638,5900,0,0,62,62,0,1,0,1,0,deny
58638,5900,0,0,62,62,0,1,0,1,0,deny
58638,5900,0,0,62,62,0,1,0,1,0,deny
58638,5900,0,0,62,62,0,1,0,1,0,deny
58638,5900,0,0,62,62,0,1,0,1,0,deny
58638,5900,0,0,62,62,0,1,0,1,0,deny
58638,5900,0,0,62,62,0,1,0,1,0,deny
58638,5900,0,0,62,62,0,1,0,1,0,deny
58638,5900,0,0,62,62,0,1,0,1,0,deny
58638,5900,0,0,62,62,0,1,0,1,0,deny
58638,5900,0,0,62,62,0,1,0,1,0,deny
58638,5900,0,0,62,62,0,1,0,1,0,deny
58638,5900,0,0,62,62,0,1,0,1,0,deny
58638,5900,0,0,62,62,0,1,0,1,0,deny
58638,5900,0,0,62,62,0,1,0,1,0,deny
58638,5900,0,0,62,62,0,1,0,1,0,deny
58638,5900,0,0,62,62,0,1,0,1,0,deny
58638,5900,0,0,62,62,0,1,0,1,0,deny
58638,5900,0,0,62,62,0,1,0,1,0,deny
58638,5900,0,0,62,62,0,1,0,1,0,deny
58638,5900,0,0,62,62,0,1,0,1,0,deny
58638,5900,0,0,62,62,0,1,0,1,0,deny
58638,5900,0,0,62,62,0,1,0,1,0,deny
58638,5900,0,0,62,62,0,1,0,1,0,deny
58638,5900,0,0,62,62,0,1,0,1,0,deny
58638,5900,0,0,62,62,0,1,0,1,0,deny
58638,5900,0,0,62,62,0,1,0,1,0,deny
58638,5900,0,0,62,62,0,1,0,1,0,deny
58638,5900,0,0,62,62,0,1,0,1,0,deny
58638,5900,0,0,62,62,0,1,0,1,0,deny
58638,5900,0,0,62,62,0,1,0,1,0,deny
58638,5900,0,0,62,62,0,1,0,1,0,deny
58638,5900,0,0,62,62,0,1,0,1,0,deny
58638,5900,0,0,62,62,0,1,0,1,0,deny
58638,5900,0,0,62,62,0,1,0,1,0,deny
58638,5900,0,0,62,62,0,1,0,1,0,deny
58638,5900,0,0,62,62,0,1,0,1,0,deny
58638,5900,0,0,62,62,0,1,0,1,0,deny
58638,5900,0,0,62,62,0,1,0,1,0,deny
58638,5900,0,0,62,62,0,1,0,1,0,deny
58638,5900,0,0,62,62,0,1,0,1,0,deny
58638,5900,0,0,62,62,0,1,0,1,0,deny
58638,5900,0,0,62,62,0,1,0,1,0,deny
58638,5900,0,0,62,62,0,1,0,1,0,deny
58638,5900,0,0,62,62,0,1,0,1,0,deny
58638,5900,0,0,62,62,0,1,0,1,0,deny
58638,5900,0,0,62,62,0,1,0,1,0,deny
58638,5900,0,0,62,62,0,1,0,1,0,deny
58638,5900,0,0,62,62,0,1,0,1,0,deny
58638,5900,0,0,62,62,0,1,0,1,0,deny
58638,5900,0,0,62,62,0,1,0,1,0,deny
58638,5900,0,0,62,62,0,1,0,1,0,deny
58638,5900,0,0,62,62,0,1,0,1,0,deny
58638,5900,0,0,62,62,0,1,0,1,0,deny
58638,5900,0,0,62,62,0,1,0,1,0,deny
58638,5900,0,0,62,62,0,1,0,1,0,deny
58638,5900,0,0,62,62,0,1,0,1,0,deny
58638,5900,0,0,62,62,0,1,0,1,0,deny
58638,5900,0,0,62,62,0,1,0,1,0,deny
58638,5900,0,0,62,62,0,1,0,1,0,deny
58638,5900,0,0,62,62,0,1,0,1,0,deny
58638,5900,0,0,62,62,0,1,0,1,0,deny
58638,5900,0,0,62,62,0,1,0,1,0,deny
58638,5900,0,0,62,62,0,1,0,1,0,deny
58638,5900,0,0,62,62,0,1,0,1,0,deny
58638,5900,0,0,62,62,0,1,0,1,0,deny
58638,5900,0,0,62,62,0,1,0,1,0,deny
58638,5900,0,0,62,62,0,1,0,1,0,deny
58638,5900,0,0,62,62,0,1,0,1,0,deny
58638,5900,0,0,62,62,0,1,0,1,0,deny
58638,5900,0,0,62,62,0,1,0,1,0,deny
58638,5900,0,0,62,62,0,1,0,1,0,deny
58638,5900,0,0,62,62,0,1,0,1,0,deny
58638,5900,0,0,62,62,0,1,0,1,0,deny
58638,5900,0,0,62,62,0,1,0,1,0,deny
58638,5900,0,0,62,62,0,1,0,1,0,deny
58638,5900,0,0,62,62,0,1,0,1,0,deny
58638,5900,0,0,62,62,0,1,0,1,0,deny
58638,5900,0,0,62,62,0,1,0,1,0,deny
58638,5900,0,0,62,62,0,1,0,1,0,deny
58638,5900,0,0,62,62,0,1,0,1,0,deny
58638,5900,0,0,62,62,0,1,0,1,0,deny
58638,5900,0,0,62,62,0,1,0,1,0,deny
58638,5900,0,0,62,62,0,1,0,1,0,deny
58638,5900,0,0,62,62,0,1,0,1,0,deny
58638,5900,0,0,62,62,0,1,0,1,0,deny
58638,5900,0,0,62,62,0,1,0,1,0,deny
58638,5900,0,0,62,62,0,1,0,1,0,deny
58638,5900,0,0,62,62,0,1,0,1,0,deny
58638,5900,0,0,62,62,0,1,0,1,0,deny
58638,5900,0,0,62,62,0,1,0,1,0,deny
58638,5900,0,0,62,62,0,1,0,1,0,deny
58638,5900,0,0,62,62,0,1,0,1,0,deny
58638,5900,0,0,62,62,0,1,0,1,0,deny
58638,5900,0,0,62,62,0,1,0,1,0,deny
58638,5900,0,0,62,62,0,1,0,1,0,deny
58638,5900,0,0,62,62,0,1,0,1,0,deny
58638,5900,0,0,62,62,0,1,0,1,0,deny
58638,5900,0,0,62,62,0,1,0,1,0,deny
58638,5900,0,0,62,62,0,1,0,1,0,deny
58638,5900,0,0,62,62,0,1,0,1,0,deny
58638,5900,0,0,62,62,0,1,0,1,0,deny
58638,5900,0,0,62,62,0,1,0,1,0,deny
58638,5900,0,0,62,62,0,1,0,1,0,deny
58638,5900,0,0,62,62,0,1,0,1,0,deny
58638,5900,0,0,62,62,0,1,0,1,0,deny
14656,36237,0,0,66,66,0,1,0,1,0,deny
64363,22114,0,0,62,62,0,1,0,1,0,deny
52236,25174,0,0,66,66,0,1,0,1,0,deny
60899,25174,0,0,62,62,0,1,0,1,0,deny
49197,445,0,0,70,70,0,1,0,1,0,drop
58638,5900,0,0,62,62,0,1,0,1,0,deny
58638,5900,0,0,62,62,0,1,0,1,0,deny
58638,5900,0,0,62,62,0,1,0,1,0,deny
58638,5900,0,0,62,62,0,1,0,1,0,deny
58638,5900,0,0,62,62,0,1,0,1,0,deny
58638,5900,0,0,62,62,0,1,0,1,0,deny
58638,5900,0,0,62,62,0,1,0,1,0,deny
58638,5900,0,0,62,62,0,1,0,1,0,deny
58638,5900,0,0,62,62,0,1,0,1,0,deny
58638,5900,0,0,62,62,0,1,0,1,0,deny
58638,5900,0,0,62,62,0,1,0,1,0,deny
58638,5900,0,0,62,62,0,1,0,1,0,deny
58638,5900,0,0,62,62,0,1,0,1,0,deny
58638,5900,0,0,62,62,0,1,0,1,0,deny
58638,5900,0,0,62,62,0,1,0,1,0,deny
58638,5900,0,0,62,62,0,1,0,1,0,deny
58638,5900,0,0,62,62,0,1,0,1,0,deny
58638,5900,0,0,62,62,0,1,0,1,0,deny
43888,64147,0,0,62,62,0,1,0,1,0,deny
58638,5900,0,0,62,62,0,1,0,1,0,deny
58638,5900,0,0,62,62,0,1,0,1,0,deny
56528,64147,0,0,62,62,0,1,0,1,0,deny
49195,445,0,0,70,70,0,1,0,1,0,drop
62642,25174,0,0,66,66,0,1,0,1,0,deny
14333,51050,0,0,62,62,0,1,0,1,0,deny
53911,445,0,0,70,70,0,1,0,1,0,drop
39063,44847,0,0,66,66,0,1,0,1,0,deny
28649,43890,0,0,62,62,0,1,0,1,0,deny
53910,445,0,0,70,70,0,1,0,1,0,drop
53902,445,0,0,70,70,0,1,0,1,0,drop
53901,445,0,0,70,70,0,1,0,1,0,drop
33948,50432,0,0,146,146,0,1,0,1,0,deny
31066,57470,0,0,74,74,0,1,0,1,0,deny
443,44138,0,0,60,60,0,1,0,1,0,deny
49194,445,0,0,70,70,0,1,0,1,0,drop
57236,53733,0,0,66,66,0,1,0,1,0,deny
49193,445,0,0,70,70,0,1,0,1,0,drop
52944,23,0,0,60,60,0,1,0,1,0,deny
55155,2767,0,0,62,62,0,1,0,1,0,deny
49192,445,0,0,70,70,0,1,0,1,0,drop
23512,57354,0,0,145,145,0,1,0,1,0,deny
11136,19910,0,0,62,62,0,1,0,1,0,deny
49189,445,0,0,70,70,0,1,0,1,0,drop
49190,445,0,0,70,70,0,1,0,1,0,drop
8194,21247,0,0,62,62,0,1,0,1,0,deny
1280,25174,0,0,62,62,0,1,0,1,0,deny
22263,30188,0,0,66,66,0,1,0,1,0,deny
59436,22114,0,0,62,62,0,1,0,1,0,deny
49172,445,0,0,70,70,0,1,0,1,0,drop
49171,445,0,0,70,70,0,1,0,1,0,drop
49169,445,0,0,70,70,0,1,0,1,0,drop
23079,9694,0,0,62,62,0,1,0,1,0,deny
49160,445,0,0,70,70,0,1,0,1,0,drop
49161,445,0,0,70,70,0,1,0,1,0,drop
53892,445,0,0,70,70,0,1,0,1,0,drop
53889,445,0,0,70,70,0,1,0,1,0,drop
53887,445,0,0,70,70,0,1,0,1,0,drop
58435,64631,0,0,74,74,0,1,0,1,0,deny
1660,8696,0,0,62,62,0,1,0,1,0,deny
47561,26467,0,0,62,62,0,1,0,1,0,deny
37008,42707,0,0,62,62,0,1,0,1,0,deny
49300,445,0,0,66,66,0,1,0,1,0,drop
18173,25174,0,0,66,66,0,1,0,1,0,deny
65529,445,0,0,70,70,0,1,0,1,0,drop
49607,25174,0,0,66,66,0,1,0,1,0,deny
7686,25174,0,0,62,62,0,1,0,1,0,deny
58148,43890,0,0,66,66,0,1,0,1,0,deny
53193,22,53193,22,295,126,169,4,0,2,2,deny
53886,445,0,0,70,70,0,1,0,1,0,drop
36419,50584,0,0,62,62,0,1,0,1,0,deny
36629,23117,0,0,62,62,0,1,0,1,0,deny
1117,37965,0,0,62,62,0,1,0,1,0,deny
53884,445,0,0,70,70,0,1,0,1,0,drop
53579,42707,0,0,66,66,0,1,0,1,0,deny
57585,51221,0,0,62,62,0,1,0,1,0,deny
17004,64147,0,0,66,66,0,1,0,1,0,deny
40301,8696,0,0,60,60,0,1,0,1,0,deny
1955,35974,0,0,60,60,0,1,0,1,0,deny
17842,22114,0,0,62,62,0,1,0,1,0,deny
5912,22114,0,0,62,62,0,1,0,1,0,deny
49283,445,0,0,66,66,0,1,0,1,0,drop
49286,445,0,0,66,66,0,1,0,1,0,drop
2049,32480,0,0,62,62,0,1,0,1,0,deny
59048,57470,0,0,66,66,0,1,0,1,0,deny
24351,57470,0,0,62,62,0,1,0,1,0,deny
65525,445,0,0,70,70,0,1,0,1,0,drop
25328,23,0,0,60,60,0,1,0,1,0,deny
50169,25174,0,0,62,62,0,1,0,1,0,deny
49182,21247,0,0,66,66,0,1,0,1,0,deny
8080,37965,0,0,62,62,0,1,0,1,0,deny
4748,64147,0,0,62,62,0,1,0,1,0,deny
53874,445,0,0,70,70,0,1,0,1,0,drop
53867,445,0,0,70,70,0,1,0,1,0,drop
53866,445,0,0,70,70,0,1,0,1,0,drop
53864,445,0,0,70,70,0,1,0,1,0,drop
52518,35440,0,0,66,66,0,1,0,1,0,deny
24931,25174,0,0,62,62,0,1,0,1,0,deny
54598,37965,0,0,66,66,0,1,0,1,0,deny
65516,445,0,0,70,70,0,1,0,1,0,drop
65513,445,0,0,70,70,0,1,0,1,0,drop
65514,445,0,0,70,70,0,1,0,1,0,drop
61948,48817,0,0,145,145,0,1,0,1,0,deny
64461,31652,0,0,62,62,0,1,0,1,0,reset-both
65511,445,0,0,70,70,0,1,0,1,0,drop
45908,3383,0,0,60,60,0,1,0,1,0,deny
65508,445,0,0,70,70,0,1,0,1,0,drop
49281,445,0,0,66,66,0,1,0,1,0,drop
52969,44847,0,0,66,66,0,1,0,1,0,deny
49272,445,0,0,66,66,0,1,0,1,0,drop
49274,445,0,0,66,66,0,1,0,1,0,drop
49264,445,0,0,66,66,0,1,0,1,0,drop
49269,445,0,0,66,66,0,1,0,1,0,drop
49271,445,0,0,66,66,0,1,0,1,0,drop
49267,445,0,0,66,66,0,1,0,1,0,drop
49263,445,0,0,66,66,0,1,0,1,0,drop
10380,5223,0,0,148,148,0,1,0,1,0,deny
55985,44847,0,0,146,146,0,1,0,1,0,deny
53860,445,0,0,70,70,0,1,0,1,0,drop
53856,445,0,0,70,70,0,1,0,1,0,drop
53854,445,0,0,70,70,0,1,0,1,0,drop
53852,445,0,0,70,70,0,1,0,1,0,drop
2864,25174,0,0,66,66,0,1,0,1,0,deny
65503,445,0,0,70,70,0,1,0,1,0,drop
21179,44847,0,0,62,62,0,1,0,1,0,deny
13285,29892,0,0,145,145,0,1,0,1,0,deny
7342,22114,0,0,66,66,0,1,0,1,0,deny
23843,26467,0,0,62,62,0,1,0,1,0,deny
50990,23884,0,0,66,66,0,1,0,1,0,deny
35589,25174,0,0,66,66,0,1,0,1,0,deny
65495,445,0,0,70,70,0,1,0,1,0,drop
65493,445,0,0,70,70,0,1,0,1,0,drop
53850,445,0,0,70,70,0,1,0,1,0,drop
53845,445,0,0,70,70,0,1,0,1,0,drop
53844,445,0,0,70,70,0,1,0,1,0,drop
49256,445,0,0,66,66,0,1,0,1,0,drop
53843,445,0,0,70,70,0,1,0,1,0,drop
63867,35993,0,0,66,66,0,1,0,1,0,deny
49254,445,0,0,66,66,0,1,0,1,0,drop
62902,32468,0,0,66,66,0,1,0,1,0,deny
38565,51505,0,0,62,62,0,1,0,1,0,deny
49252,445,0,0,66,66,0,1,0,1,0,drop
49250,445,0,0,66,66,0,1,0,1,0,drop
443,4205,0,0,320,320,0,1,0,1,0,deny
65489,445,0,0,70,70,0,1,0,1,0,drop
12290,22114,0,0,66,66,0,1,0,1,0,deny
49248,445,0,0,66,66,0,1,0,1,0,drop
65487,445,0,0,70,70,0,1,0,1,0,drop
28583,22114,0,0,146,146,0,1,0,1,0,deny
54277,22114,0,0,62,62,0,1,0,1,0,deny
65483,445,0,0,70,70,0,1,0,1,0,drop
53836,445,0,0,70,70,0,1,0,1,0,drop
53830,445,0,0,70,70,0,1,0,1,0,drop
53827,445,0,0,70,70,0,1,0,1,0,drop
65482,445,0,0,70,70,0,1,0,1,0,drop
55586,23,0,0,60,60,0,1,0,1,0,deny
60527,35440,0,0,66,66,0,1,0,1,0,deny
9731,64147,0,0,62,62,0,1,0,1,0,deny
30270,37965,0,0,66,66,0,1,0,1,0,deny
14023,37965,0,0,62,62,0,1,0,1,0,deny
18574,56205,0,0,66,66,0,1,0,1,0,deny
49336,25174,0,0,62,62,0,1,0,1,0,deny
56887,53,57938,53,170,87,83,2,30,1,1,allow
36215,443,40898,443,3554,2208,1346,18,256,10,8,allow
64231,443,45459,443,2227,1018,1209,17,16,8,9,allow
49452,443,8798,443,16012,6573,9439,43,175,20,23,allow
49353,443,32645,443,7030,1195,5835,20,76,10,10,allow
49349,80,16332,80,2391,532,1859,11,76,6,5,allow
50269,443,40163,443,7543,2533,5010,26,55,14,12,allow
14667,80,14667,80,3197,2167,1030,17,72,10,7,allow
55376,53,17927,53,711,87,624,2,30,1,1,allow
43576,80,43576,80,44566,6675,37891,58,23,27,31,allow
64385,443,64385,443,18895,2061,16834,34,18,18,16,allow
49385,443,8821,443,16316,7445,8871,49,237,23,26,allow
55660,443,55660,443,51312,5706,45606,77,48,38,39,allow
57093,53,32863,53,711,87,624,2,30,1,1,allow
57888,443,62185,443,9802,5628,4174,56,225,29,27,allow
49351,443,50580,443,11389,1184,10205,22,76,9,13,allow
61614,53,61614,53,257,101,156,2,33,1,1,allow
39223,80,40485,80,1052,612,440,10,15,5,5,allow
64376,443,64376,443,4592,1685,2907,19,29,11,8,allow
65462,53,18628,53,98,98,0,1,30,1,0,allow
54627,80,54627,80,12385,1831,10554,20,20,9,11,allow
50584,49001,53256,49001,480,150,330,2,1200,1,1,allow
57598,80,57598,80,40484,2008,38476,47,145,17,30,allow
57594,80,57594,80,110070,5374,104696,112,156,36,76,allow
55659,443,55659,443,25716,7632,18084,52,48,31,21,allow
52147,30265,61743,30265,66,66,0,1,5,1,0,allow
60143,443,49806,443,16448,5420,11028,47,319,23,24,allow
1230,3389,1230,3389,3910,1805,2105,20,19,12,8,allow
49196,53,19330,53,91,91,0,1,30,1,0,allow
55646,443,13625,443,11771,2624,9147,50,19,25,25,allow
64095,53,19951,53,170,87,83,2,30,1,1,allow
55602,53,61633,53,711,87,624,2,30,1,1,allow
57288,53,40155,53,170,87,83,2,30,1,1,allow
49661,443,62284,443,6950,2484,4466,20,53,11,9,allow
55054,443,36646,443,7993,677,7316,16,15,8,8,allow
36336,443,11755,443,8111,5060,3051,31,396,11,20,allow
38369,15000,42954,15000,130,70,60,2,6,1,1,allow
52184,57262,18616,57262,70,70,0,2,8,2,0,allow
55127,53,18845,53,253,87,166,4,44,2,2,allow
52151,30692,49782,30692,66,66,0,1,5,1,0,allow
2001,80,2001,80,1535,652,883,9,16,5,4,allow
49352,443,51520,443,10055,1184,8871,21,76,9,12,allow
37997,80,37997,80,3581,2902,679,13,23,8,5,allow
55456,53,57964,53,711,87,624,2,30,1,1,allow
56658,53,1646,53,170,87,83,2,30,1,1,allow
56945,53,29864,53,711,87,624,2,30,1,1,allow
55097,53,65390,53,170,87,83,2,31,1,1,allow
30960,45761,37537,45761,462,462,0,8,3632,8,0,allow
57170,3389,57170,3389,3413,1458,1955,16,19,8,8,allow
49481,53,49481,53,222,101,121,2,31,1,1,allow
55820,60038,0,0,66,66,0,1,91,1,0,allow
57052,53,52166,53,170,87,83,2,31,1,1,allow
30960,45760,12069,45760,462,462,0,8,3632,8,0,allow
53191,443,21271,443,7694,3364,4330,21,123,11,10,allow
55833,53,54382,53,170,87,83,2,31,1,1,allow
65477,445,0,0,70,70,0,1,0,1,0,drop
58399,56205,0,0,66,66,0,1,0,1,0,deny
41719,50584,0,0,146,146,0,1,0,1,0,deny
57578,51221,0,0,62,62,0,1,0,1,0,deny
443,54507,0,0,82,82,0,1,0,1,0,deny
49230,445,0,0,66,66,0,1,0,1,0,drop
23873,30188,0,0,66,66,0,1,0,1,0,deny
53815,445,0,0,70,70,0,1,0,1,0,drop
58608,62413,0,0,62,62,0,1,0,1,0,deny
34166,50584,0,0,146,146,0,1,0,1,0,deny
23844,26467,0,0,62,62,0,1,0,1,0,deny
57484,30317,0,0,66,66,0,1,0,1,0,deny
44265,80,44265,80,22407,7251,15156,35,23,16,19,allow
28040,443,50475,443,5578,1390,4188,19,15,9,10,allow
26054,80,26054,80,1798,540,1258,10,15,6,4,allow
34408,443,19414,443,9649,3714,5935,47,340,24,23,allow
56658,53,51855,53,177,94,83,2,30,1,1,allow
44812,443,17089,443,6152,420,5732,13,120,6,7,allow
57600,80,57600,80,3164,815,2349,12,144,6,6,allow
53918,24300,60964,24300,1735,975,760,11,16,7,4,allow
49559,443,14886,443,1332,876,456,11,56,6,5,allow
57444,443,3253,443,9581,3281,6300,36,16,16,20,allow
60033,443,2482,443,4223,2828,1395,23,28,13,10,allow
53214,443,52186,443,526,156,370,8,14,3,5,allow
64117,53,35902,53,350,94,256,2,29,1,1,allow
53227,53,11040,53,78,78,0,1,29,1,0,allow
56031,53,65070,53,177,94,83,2,30,1,1,allow
41688,443,15969,443,626036,38764,587272,713,191,245,468,allow
49302,443,38802,443,9232,3149,6083,55,40,31,24,allow
49214,80,50752,80,2734,1498,1236,21,262,11,10,allow
53164,443,44686,443,38442,16213,22229,67,46,30,37,allow
57599,80,57599,80,60244,2829,57415,65,144,22,43,allow
60513,443,14543,443,9456,1987,7469,28,30,15,13,allow
57597,80,57597,80,80556,2669,77887,84,144,28,56,allow
49638,443,58989,443,5776,1079,4697,15,52,8,7,allow
51123,443,33422,443,6625,1673,4952,20,20,10,10,allow
49587,443,57871,443,5879,870,5009,18,53,9,9,allow
49481,80,30554,80,11436,5021,6415,38,126,20,18,allow
49364,443,4324,443,5141,896,4245,17,69,8,9,allow
60804,40010,37467,40010,316,136,180,6,5,3,3,allow
56611,53,59791,53,181,94,87,2,31,1,1,allow
44984,80,44984,80,7061,2943,4118,16,23,9,7,allow
49989,53,19506,53,301,85,216,4,53,2,2,allow
49658,53,46008,53,195,102,93,2,29,1,1,allow
55695,53,3075,53,177,94,83,2,29,1,1,allow
50412,80,26565,80,1524,341,1183,11,36,4,7,allow
62082,443,37456,443,2826,1618,1208,21,45,12,9,allow
49572,443,30462,443,7538,4953,2585,21,54,12,9,allow
49577,443,34979,443,6947,833,6114,20,53,9,11,allow
49670,443,18797,443,16957,6203,10754,30,52,14,16,allow
49994,53,33575,53,86,86,0,1,29,1,0,allow
38710,443,50238,443,89931,3417,86514,94,15,30,64,allow
56658,53,42222,53,177,94,83,2,29,1,1,allow
1936,80,29393,80,214,140,74,4,15,3,1,allow
65254,53,46437,53,459,94,365,4,45,2,2,allow
56668,53,61814,53,177,94,83,2,29,1,1,allow
64095,53,40106,53,177,94,83,2,30,1,1,allow
55695,53,64745,53,177,94,83,2,29,1,1,allow
57288,53,46993,53,177,94,83,2,30,1,1,allow
55541,53,64093,53,177,94,83,2,30,1,1,allow
21133,33447,47731,33447,481,150,331,2,1199,1,1,allow
49100,80,49100,80,3568,2889,679,13,23,8,5,allow
43228,443,18463,443,1527,940,587,14,22,8,6,allow
52174,43106,42661,43106,258,70,188,4,9,2,2,allow
52149,52188,10170,52188,70,70,0,1,5,1,0,allow
55127,53,39994,53,253,87,166,4,43,2,2,allow
57288,53,13037,53,177,94,83,2,30,1,1,allow
49303,443,12405,443,10844,5117,5727,42,17,25,17,allow
51118,80,35500,80,366,240,126,7,21,5,2,allow
50272,53,50516,53,168,78,90,2,30,1,1,allow
53079,80,59311,80,2424,1110,1314,11,78,7,4,allow
53921,18183,42637,18183,826,386,440,12,15,6,6,allow
49304,443,13306,443,12436,7656,4780,41,17,23,18,allow
52148,29104,16660,29104,70,70,0,1,5,1,0,allow
57375,443,64184,443,130,70,60,2,15,1,1,allow
55658,443,55658,443,26504,10384,16120,58,48,37,21,allow
37662,443,57596,443,4428,2241,2187,19,46,11,8,allow
54260,443,6069,443,5904,1876,4028,18,18,10,8,allow
64973,53,14211,53,210,102,108,2,30,1,1,allow
49633,53,37557,53,210,102,108,2,30,1,1,allow
49346,443,65391,443,7292,950,6342,19,75,9,10,allow
56678,443,37527,443,4099,2450,1649,36,2615,19,17,allow
64784,53,13638,53,226,102,124,2,30,1,1,allow
57052,53,26525,53,177,94,83,2,30,1,1,allow
65225,443,9124,443,3350,2037,1313,25,95,14,11,allow
64095,53,56290,53,177,94,83,2,30,1,1,allow
57316,53,12512,53,177,94,83,2,30,1,1,allow
57316,53,3738,53,177,94,83,2,30,1,1,allow
50276,53,20646,53,94,94,0,1,30,1,0,allow
57288,53,40505,53,177,94,83,2,30,1,1,allow
55541,53,4475,53,177,94,83,2,30,1,1,allow
50418,443,31085,443,4507,744,3763,17,29,7,10,allow
44307,443,62796,443,92044,19483,72561,147,186,55,92,allow
55295,3389,55295,3389,4365,2581,1784,20,33,11,9,allow
50643,80,56301,80,5660,3544,2116,17,47,10,7,allow
38139,443,10441,443,49386,4604,44782,82,32,43,39,allow
62081,443,56055,443,3044,1694,1350,23,45,13,10,allow
38113,443,46610,443,2849678,105912,2743766,3255,124,1284,1971,allow
49479,80,63239,80,9192,4788,4404,30,126,17,13,allow
49579,443,1881,443,6629,827,5802,19,53,9,10,allow
43897,443,6897,443,6259,1816,4443,30,2615,16,14,allow
50486,443,7512,443,1043,556,487,10,16,6,4,allow
62073,443,32648,443,9559,3243,6316,28,46,16,12,allow
55600,443,16865,443,11891,2141,9750,40,231,19,21,allow
62075,443,48853,443,9318,3002,6316,28,46,16,12,allow
57596,80,57596,80,64768,3074,61694,72,145,26,46,allow
49586,443,54181,443,5879,870,5009,18,53,9,9,allow
49636,443,48846,443,6158,1149,5009,17,52,9,8,allow
49657,443,3247,443,6181,833,5348,19,52,9,10,allow
49588,443,55419,443,5879,870,5009,18,53,9,9,allow
49656,443,39036,443,6006,763,5243,17,52,8,9,allow
52910,53,52910,53,414,268,146,3,32,2,1,allow
55966,443,29704,443,214312,69934,144378,612,671,303,309,allow
52185,13269,32926,13269,70,70,0,2,7,2,0,allow
26253,53,26253,53,414,268,146,3,33,2,1,allow
52182,60769,63523,60769,70,70,0,2,8,2,0,allow
52200,42430,1127,42430,70,70,0,1,5,1,0,allow
52202,64241,11975,64241,164,70,94,2,4,1,1,allow
52199,35549,6211,35549,70,70,0,1,5,1,0,allow
49347,443,42711,443,8309,949,7360,19,75,9,10,allow
52198,12727,17212,12727,70,70,0,1,5,1,0,allow
51974,443,46910,443,17456,7877,9579,47,49,24,23,allow
51135,80,18450,80,254,128,126,5,15,3,2,allow
51120,80,28128,80,366,240,126,7,21,5,2,allow
43218,443,34506,443,2683108,71922,2611186,2467,150,623,1844,allow
65303,53,28109,53,94,94,0,1,29,1,0,allow
38066,443,48945,443,328599,275779,52820,868,342,483,385,allow
49931,53,22854,53,594,196,398,6,82,3,3,allow
65068,53,6356,53,336,111,225,4,29,2,2,allow
56668,53,54886,53,177,94,83,2,29,1,1,allow
64036,53,37626,53,692,224,468,6,49,3,3,allow
64095,53,63030,53,177,94,83,2,29,1,1,allow
56334,53,1244,53,177,94,83,2,29,1,1,allow
18657,53,18657,53,295,90,205,2,29,1,1,allow
49434,53,25380,53,183,86,97,2,29,1,1,allow
56658,53,20785,53,177,94,83,2,29,1,1,allow
56031,53,4995,53,177,94,83,2,29,1,1,allow
49789,53,65450,53,177,94,83,2,30,1,1,allow
59829,443,54560,443,948180,35714,912466,1121,119,378,743,allow
59683,443,7689,443,16524,4274,12250,35,133,15,20,allow
65221,53,28071,53,196,86,110,2,30,1,1,allow
65221,53,13826,53,168,86,82,2,30,1,1,allow
57052,53,38641,53,177,94,83,2,30,1,1,allow
61686,53,52741,53,196,86,110,2,30,1,1,allow
9068,443,2083,443,5045,2005,3040,14,119,7,7,allow
41906,80,41906,80,127215,3221,123994,137,3685,42,95,allow
50012,53,43824,53,94,94,0,1,30,1,0,allow
60340,443,5002,443,6844,2441,4403,19,181,9,10,allow
52090,80,61372,80,2774,703,2071,12,22,7,5,allow
43226,443,42884,443,1583877,43930,1539947,1405,93,297,1108,allow
49300,443,11326,443,10704,4094,6610,52,47,29,23,allow
56887,53,35999,53,177,94,83,2,30,1,1,allow
56172,53,39320,53,216,102,114,2,30,1,1,allow
55026,443,35367,443,17336,5332,12004,33,121,18,15,allow
44847,6892,1040,6892,279,161,118,3,1200,2,1,allow
30188,14038,49780,14038,502,150,352,2,1200,1,1,allow
47929,80,47929,80,11976,6928,5048,25,24,14,11,allow
53958,80,11138,80,130,70,60,2,15,1,1,allow
52183,13503,62699,13503,70,70,0,2,8,2,0,allow
51700,80,43241,80,30853,2456,28397,48,78,25,23,allow
39980,443,41321,443,130,70,60,2,15,1,1,allow
45418,443,36338,443,137754,15176,122578,229,99,106,123,allow
55127,53,60626,53,253,87,166,4,44,2,2,allow
52091,80,64640,80,2825,716,2109,12,22,7,5,allow
62072,443,3018,443,6095,1965,4130,26,46,15,11,allow
38065,443,63801,443,911697,74083,837614,1247,343,459,788,allow
40392,443,64453,443,8105,2278,5827,27,196,15,12,allow
49424,53,36639,53,210,102,108,2,30,1,1,allow
56887,53,63111,53,177,94,83,2,30,1,1,allow
49609,53,45961,53,177,94,83,2,31,1,1,allow
49469,53,17330,53,718,94,624,2,30,1,1,allow
65448,53,13119,53,209,110,99,2,30,1,1,allow
58320,53,15987,53,331,86,245,2,30,1,1,allow
55189,53,54191,53,211,102,109,2,30,1,1,allow
55677,53,59623,53,177,94,83,2,30,1,1,allow
57052,53,21671,53,177,94,83,2,30,1,1,allow
56291,53,26927,53,177,94,83,2,31,1,1,allow
57673,53,25100,53,273,94,179,2,30,1,1,allow
60812,443,60812,443,2871,1671,1200,17,179,9,8,allow
56375,53,31585,53,177,94,83,2,31,1,1,allow
53202,443,37949,443,6043,1568,4475,11,120,4,7,allow
56394,443,33249,443,12371,1344,11027,30,3944,10,20,allow
64106,53,22227,53,309,102,207,4,53,2,2,allow
49414,443,32360,443,11485,3381,8104,39,124,23,16,allow
49410,443,22106,443,87590,6597,80993,129,125,48,81,allow
55127,53,49558,53,253,87,166,4,44,2,2,allow
45440,25,45440,25,7679,1922,5757,34,17,15,19,allow
52179,14354,64270,14354,70,70,0,2,8,2,0,allow
53941,53739,11665,53739,70,70,0,2,8,2,0,allow
52146,18174,63624,18174,70,70,0,1,5,1,0,allow
52933,443,60920,443,5582,1388,4194,19,15,9,10,allow
52088,80,52684,80,3442,1728,1714,15,21,9,6,allow
44943,443,56912,443,16225,2078,14147,38,42,19,19,allow
55929,80,55929,80,450,246,204,8,29,5,3,allow
43886,5223,33165,5223,3721,1173,2548,18,257,11,7,allow
28039,443,43641,443,5576,1388,4188,19,15,9,10,allow
38647,443,52794,443,15266,12916,2350,42,81,24,18,allow
46683,443,34091,443,416,210,206,7,28,4,3,allow
55926,80,55926,80,450,246,204,8,29,5,3,allow
55927,80,55927,80,450,246,204,8,29,5,3,allow
52932,443,34898,443,20789,4927,15862,35,31,20,15,allow
64622,36829,0,0,66,66,0,1,0,1,0,deny
21704,16933,0,0,62,62,0,1,0,1,0,deny
40787,57470,0,0,62,62,0,1,0,1,0,deny
49227,445,0,0,66,66,0,1,0,1,0,drop
60389,16933,0,0,66,66,0,1,0,1,0,deny
49220,445,0,0,66,66,0,1,0,1,0,drop
1053,2310,0,0,148,148,0,1,0,1,0,deny
12348,50265,0,0,62,62,0,1,0,1,0,deny
65464,445,0,0,70,70,0,1,0,1,0,drop
49216,445,0,0,66,66,0,1,0,1,0,drop
64723,56205,0,0,62,62,0,1,0,1,0,deny
56388,22114,0,0,66,66,0,1,0,1,0,deny
64949,44847,0,0,66,66,0,1,0,1,0,deny
65461,445,0,0,70,70,0,1,0,1,0,drop
1377,44847,0,0,146,146,0,1,0,1,0,deny
62149,22114,0,0,66,66,0,1,0,1,0,deny
18725,35440,0,0,62,62,0,1,0,1,0,deny
18725,35440,0,0,146,146,0,1,0,1,0,deny
52026,26467,0,0,60,60,0,1,0,1,0,deny
54633,36237,0,0,66,66,0,1,0,1,0,deny
42094,35440,0,0,62,62,0,1,0,1,0,deny
60571,26467,0,0,62,62,0,1,0,1,0,deny
53806,445,0,0,70,70,0,1,0,1,0,drop
53804,445,0,0,70,70,0,1,0,1,0,drop
53803,445,0,0,70,70,0,1,0,1,0,drop
49204,445,0,0,66,66,0,1,0,1,0,drop
49198,445,0,0,66,66,0,1,0,1,0,drop
49199,445,0,0,66,66,0,1,0,1,0,drop
49201,445,0,0,66,66,0,1,0,1,0,drop
49203,445,0,0,66,66,0,1,0,1,0,drop
49202,445,0,0,66,66,0,1,0,1,0,drop
49200,445,0,0,66,66,0,1,0,1,0,drop
49196,445,0,0,66,66,0,1,0,1,0,drop
65456,445,0,0,70,70,0,1,0,1,0,drop
49938,57470,0,0,66,66,0,1,0,1,0,deny
65455,445,0,0,70,70,0,1,0,1,0,drop
62348,50584,0,0,66,66,0,1,0,1,0,deny
51754,18375,0,0,62,62,0,1,0,1,0,deny
2525,23,0,0,60,60,0,1,0,1,0,deny
65453,445,0,0,70,70,0,1,0,1,0,drop
11585,56205,0,0,66,66,0,1,0,1,0,deny
50488,22114,0,0,66,66,0,1,0,1,0,deny
57677,57470,0,0,62,62,0,1,0,1,0,deny
55406,25174,0,0,62,62,0,1,0,1,0,deny
49196,25174,0,0,66,66,0,1,0,1,0,deny
1369,48817,0,0,145,145,0,1,0,1,0,deny
53800,445,0,0,70,70,0,1,0,1,0,drop
53801,445,0,0,70,70,0,1,0,1,0,drop
53799,445,0,0,70,70,0,1,0,1,0,drop
53794,445,0,0,70,70,0,1,0,1,0,drop
55620,30188,0,0,66,66,0,1,0,1,0,deny
4752,30188,0,0,62,62,0,1,0,1,0,deny
47125,8055,0,0,159,159,0,1,0,1,0,deny
64989,50265,0,0,66,66,0,1,0,1,0,deny
32796,37965,0,0,66,66,0,1,0,1,0,deny
32679,37965,0,0,62,62,0,1,0,1,0,deny
49184,445,0,0,66,66,0,1,0,1,0,drop
49182,445,0,0,66,66,0,1,0,1,0,drop
49183,445,0,0,66,66,0,1,0,1,0,drop
65446,445,0,0,70,70,0,1,0,1,0,drop
39941,2767,0,0,62,62,0,1,0,1,0,deny
65444,445,0,0,70,70,0,1,0,1,0,drop
36881,56205,0,0,62,62,0,1,0,1,0,deny
49393,30188,0,0,62,62,0,1,0,1,0,deny
65443,445,0,0,70,70,0,1,0,1,0,drop
53783,445,0,0,70,70,0,1,0,1,0,drop
65442,445,0,0,70,70,0,1,0,1,0,drop
65441,445,0,0,70,70,0,1,0,1,0,drop
53781,445,0,0,70,70,0,1,0,1,0,drop
53777,445,0,0,70,70,0,1,0,1,0,drop
53776,445,0,0,70,70,0,1,0,1,0,drop
443,54507,0,0,82,82,0,1,0,1,0,deny
65439,445,0,0,70,70,0,1,0,1,0,drop
65438,445,0,0,70,70,0,1,0,1,0,deny
51046,25174,0,0,66,66,0,1,0,1,0,deny
48478,49903,0,0,62,62,0,1,0,1,0,deny
16979,56205,0,0,66,66,0,1,0,1,0,deny
29177,44847,0,0,66,66,0,1,0,1,0,deny
58751,51221,0,0,62,62,0,1,0,1,0,deny
443,14591,0,0,131,131,0,1,0,1,0,deny
61711,35440,0,0,66,66,0,1,0,1,0,deny
443,4205,0,0,320,320,0,1,0,1,0,deny
61784,49903,0,0,66,66,0,1,0,1,0,deny
59326,57470,0,0,74,74,0,1,0,1,0,deny
53927,443,24116,443,495,421,74,4,0,3,1,allow
53923,443,32187,443,499,425,74,4,0,3,1,allow
2238,22114,0,0,62,62,0,1,0,1,0,deny
65423,445,0,0,70,70,0,1,0,1,0,drop
65422,445,0,0,70,70,0,1,0,1,0,drop
65418,445,0,0,70,70,0,1,0,1,0,drop
22350,25174,0,0,66,66,0,1,0,1,0,deny
65413,445,0,0,70,70,0,1,0,1,0,drop
65412,445,0,0,70,70,0,1,0,1,0,drop
56719,37807,0,0,66,66,0,1,0,1,0,deny
61911,15503,0,0,146,146,0,1,0,1,0,deny
43747,22114,0,0,66,66,0,1,0,1,0,deny
53764,445,0,0,70,70,0,1,0,1,0,drop
53761,445,0,0,70,70,0,1,0,1,0,drop
53759,445,0,0,70,70,0,1,0,1,0,drop
40301,8696,0,0,60,60,0,1,0,1,0,deny
1955,35974,0,0,60,60,0,1,0,1,0,deny
52596,17372,0,0,66,66,0,1,0,1,0,deny
45941,23386,0,0,60,60,0,1,0,1,0,deny
49172,445,0,0,66,66,0,1,0,1,0,drop
24376,50584,0,0,66,66,0,1,0,1,0,deny
34360,25174,0,0,66,66,0,1,0,1,0,deny
58118,22114,0,0,66,66,0,1,0,1,0,deny
65401,445,0,0,70,70,0,1,0,1,0,drop
6832,51505,0,0,62,62,0,1,0,1,0,deny
31660,35440,0,0,66,66,0,1,0,1,0,deny
64811,51221,0,0,66,66,0,1,0,1,0,deny
42453,17,0,0,60,60,0,1,0,1,0,deny
443,54507,0,0,82,82,0,1,0,1,0,deny
53758,445,0,0,70,70,0,1,0,1,0,drop
53757,445,0,0,70,70,0,1,0,1,0,drop
15333,60043,0,0,62,62,0,1,0,1,0,deny
11692,25174,0,0,66,66,0,1,0,1,0,deny
62400,35993,0,0,62,62,0,1,0,1,0,deny
61911,3855,0,0,146,146,0,1,0,1,0,deny
65397,445,0,0,70,70,0,1,0,1,0,drop
55893,45711,0,0,78,78,0,1,0,1,0,deny
49156,445,0,0,66,66,0,1,0,1,0,drop
65533,445,0,0,66,66,0,1,0,1,0,drop
53071,25174,0,0,66,66,0,1,0,1,0,deny
3524,25174,0,0,62,62,0,1,0,1,0,deny
61898,50584,0,0,66,66,0,1,0,1,0,deny
38629,25174,0,0,66,66,0,1,0,1,0,deny
64334,25174,0,0,66,66,0,1,0,1,0,deny
65388,445,0,0,70,70,0,1,0,1,0,drop
65387,445,0,0,70,70,0,1,0,1,0,drop
65386,445,0,0,70,70,0,1,0,1,0,drop
18577,25174,0,0,62,62,0,1,0,1,0,deny
64923,25174,0,0,66,66,0,1,0,1,0,deny
65382,445,0,0,70,70,0,1,0,1,0,drop
53748,445,0,0,70,70,0,1,0,1,0,drop
53745,445,0,0,70,70,0,1,0,1,0,drop
53746,445,0,0,70,70,0,1,0,1,0,drop
53737,445,0,0,70,70,0,1,0,1,0,drop
60485,22114,0,0,66,66,0,1,0,1,0,deny
65381,445,0,0,70,70,0,1,0,1,0,drop
3765,64147,0,0,66,66,0,1,0,1,0,deny
53844,22114,0,0,66,66,0,1,0,1,0,deny
19068,37965,0,0,62,62,0,1,0,1,0,deny
443,54507,0,0,82,82,0,1,0,1,0,deny
51313,25174,0,0,66,66,0,1,0,1,0,deny
65530,445,0,0,66,66,0,1,0,1,0,drop
0,0,0,0,480,244,236,4,0,2,2,allow
56377,51505,0,0,66,66,0,1,0,1,0,deny
1594,44847,0,0,62,62,0,1,0,1,0,deny
61911,1,0,0,146,146,0,1,0,1,0,deny
65519,445,0,0,66,66,0,1,0,1,0,drop
65522,445,0,0,66,66,0,1,0,1,0,drop
65513,445,0,0,66,66,0,1,0,1,0,drop
65524,445,0,0,66,66,0,1,0,1,0,drop
65521,445,0,0,66,66,0,1,0,1,0,drop
65515,445,0,0,66,66,0,1,0,1,0,drop
65518,445,0,0,66,66,0,1,0,1,0,drop
54043,36237,0,0,66,66,0,1,0,1,0,deny
53730,445,0,0,70,70,0,1,0,1,0,drop
443,4205,0,0,320,320,0,1,0,1,0,deny
20741,64147,0,0,62,62,0,1,0,1,0,deny
51414,50584,0,0,62,62,0,1,0,1,0,deny
65374,445,0,0,70,70,0,1,0,1,0,drop
53728,445,0,0,70,70,0,1,0,1,0,drop
53724,445,0,0,70,70,0,1,0,1,0,drop
53726,445,0,0,70,70,0,1,0,1,0,drop
443,56513,0,0,78,78,0,1,0,1,0,deny
57761,15503,0,0,66,66,0,1,0,1,0,deny
3580,25174,0,0,62,62,0,1,0,1,0,deny
65367,445,0,0,70,70,0,1,0,1,0,drop
32701,23,0,0,60,60,0,1,0,1,0,deny
65365,445,0,0,70,70,0,1,0,1,0,drop
3381,44847,0,0,78,78,0,1,0,1,0,deny
20619,25174,0,0,62,62,0,1,0,1,0,deny
16424,55108,0,0,145,145,0,1,0,1,0,deny
10627,23117,0,0,66,66,0,1,0,1,0,deny
53722,445,0,0,70,70,0,1,0,1,0,drop
53718,445,0,0,70,70,0,1,0,1,0,drop
53717,445,0,0,70,70,0,1,0,1,0,drop
39839,22114,0,0,62,62,0,1,0,1,0,deny
65506,445,0,0,66,66,0,1,0,1,0,drop
53715,445,0,0,70,70,0,1,0,1,0,drop
65360,445,0,0,70,70,0,1,0,1,0,drop
19875,30170,0,0,145,145,0,1,0,1,0,deny
65503,445,0,0,66,66,0,1,0,1,0,drop
10467,25174,0,0,62,62,0,1,0,1,0,deny
443,54507,0,0,82,82,0,1,0,1,0,deny
65359,445,0,0,70,70,0,1,0,1,0,drop
65502,445,0,0,66,66,0,1,0,1,0,drop
65500,445,0,0,66,66,0,1,0,1,0,drop
19579,23,0,0,60,60,0,1,0,1,0,deny
65499,445,0,0,66,66,0,1,0,1,0,drop
12457,57866,0,0,66,66,0,1,0,1,0,deny
54440,26467,0,0,66,66,0,1,0,1,0,deny
8889,2917,0,0,60,60,0,1,0,1,0,deny
65355,445,0,0,70,70,0,1,0,1,0,drop
23519,25174,0,0,62,62,0,1,0,1,0,deny
47612,5228,36863,5228,2880,1648,1232,22,3602,10,12,allow
52961,5228,16793,5228,1410,933,477,11,3600,6,5,allow
56951,53,51481,53,250,86,164,4,31,2,2,allow
49800,53,17712,53,87,87,0,1,30,1,0,allow
52006,443,14012,443,2898,2047,851,19,22,11,8,allow
53932,27258,15001,27258,70,70,0,2,7,2,0,allow
19302,443,26733,443,2227,1018,1209,17,15,8,9,allow
57470,13613,11885,13613,1577,594,983,20,1601,10,10,allow
49609,53,22044,53,170,87,83,2,30,1,1,allow
47039,443,29901,443,2809,1884,925,19,25,11,8,allow
53936,5915,64456,5915,70,70,0,2,7,2,0,allow
62060,443,7381,443,12169,4985,7184,34,52,19,15,allow
34768,443,18480,443,11605,6867,4738,29,256,17,12,allow
55276,53,33496,53,170,87,83,2,31,1,1,allow
55661,443,55661,443,24362,8850,15512,52,47,32,20,allow
49408,443,34465,443,7967,2176,5791,27,125,14,13,allow
54669,80,16041,80,1148,599,549,14,318,7,7,allow
52181,1038,23058,1038,70,70,0,2,8,2,0,allow
48110,443,9219,443,537031,23421,513610,622,43,258,364,allow
2298,53,2298,53,221,83,138,2,32,1,1,allow
27727,53,27727,53,407,261,146,3,32,2,1,allow
57172,3389,57172,3389,3347,1458,1889,15,18,8,7,allow
55277,53,53790,53,701,88,613,2,30,1,1,allow
57880,53,57880,53,231,97,134,2,30,1,1,allow
55967,53,9494,53,701,88,613,2,30,1,1,allow
64381,53,43493,53,168,86,82,2,31,1,1,allow
55375,53,46240,53,711,87,624,2,31,1,1,allow
53912,8999,51602,8999,1869,1009,860,15,18,9,6,allow
60452,443,43264,443,5807,2168,3639,17,135,8,9,allow
46212,443,28562,443,190,70,120,4,15,2,2,allow
50460,443,50460,443,1159,668,491,11,31,6,5,allow
52709,443,18513,443,266282,13744,252538,313,374,128,185,allow
50817,443,46052,443,17161,1619,15542,18,153,4,14,allow
53872,443,4533,443,11541,4181,7360,62,283,27,35,allow
62828,443,62828,443,4604,1697,2907,19,29,11,8,allow
34477,5900,34477,5900,60,60,0,1,5,1,0,allow
35924,443,41677,443,4310,1640,2670,22,159,10,12,allow
56756,53,22443,53,711,87,624,2,30,1,1,allow
59111,443,56216,443,10912,6095,4817,28,17,15,13,allow
61508,443,13468,443,215490,8471,207019,194,45,45,149,allow
61507,443,11095,443,443128,10267,432861,362,45,60,302,allow
50198,443,55477,443,29124,1724,27400,41,160,16,25,allow
59363,443,28293,443,15860,1930,13930,37,195,14,23,allow
50478,80,50478,80,2086,1637,449,10,19,6,4,allow
52173,44632,63328,44632,258,70,188,4,9,2,2,allow
46211,443,37976,443,190,70,120,4,16,2,2,allow
56985,53,26642,53,916,86,830,2,30,1,1,allow
57220,53,51033,53,701,88,613,2,30,1,1,allow
57340,53,41414,53,711,87,624,2,30,1,1,allow
56375,53,7933,53,170,87,83,2,30,1,1,allow
37075,48817,0,0,62,62,0,1,0,1,0,deny
55973,25174,0,0,62,62,0,1,0,1,0,deny
16490,25174,0,0,66,66,0,1,0,1,0,deny
443,4205,0,0,187,187,0,1,0,1,0,deny
12226,37965,0,0,62,62,0,1,0,1,0,deny
53709,445,0,0,70,70,0,1,0,1,0,drop
34932,38608,0,0,62,62,0,1,0,1,0,deny
57557,64147,0,0,66,66,0,1,0,1,0,deny
65354,445,0,0,70,70,0,1,0,1,0,drop
49308,22114,0,0,66,66,0,1,0,1,0,deny
49418,22114,0,0,62,62,0,1,0,1,0,deny
53706,445,0,0,70,70,0,1,0,1,0,drop
53701,445,0,0,70,70,0,1,0,1,0,drop
33948,15503,0,0,146,146,0,1,0,1,0,deny
28064,36237,0,0,62,62,0,1,0,1,0,deny
53838,36829,0,0,66,66,0,1,0,1,0,deny
65487,445,0,0,66,66,0,1,0,1,0,drop
65349,445,0,0,70,70,0,1,0,1,0,drop
57470,13613,29471,13613,1577,594,983,20,1600,10,10,allow
49406,80,42946,80,2074,1309,765,10,124,6,4,allow
50454,80,50454,80,450,246,204,8,33,5,3,allow
53921,443,59413,443,499,425,74,4,0,3,1,allow
53912,443,42597,443,499,425,74,4,0,3,1,allow
53922,443,26654,443,499,425,74,4,0,3,1,allow
53920,443,44819,443,499,425,74,4,0,3,1,allow
53915,443,3997,443,499,425,74,4,0,3,1,allow
53911,443,51915,443,499,425,74,4,0,3,1,allow
53909,443,45501,443,499,425,74,4,0,3,1,allow
53919,443,62398,443,499,425,74,4,0,3,1,allow
53916,443,57375,443,499,425,74,4,0,3,1,allow
53907,443,41234,443,499,425,74,4,0,3,1,allow
53917,443,58017,443,499,425,74,4,0,3,1,allow
53918,443,16862,443,499,425,74,4,0,3,1,allow
53908,443,36300,443,499,425,74,4,0,3,1,allow
53914,443,31627,443,499,425,74,4,0,3,1,allow
53906,443,56748,443,499,425,74,4,0,3,1,allow
53913,443,40081,443,499,425,74,4,0,3,1,allow
53910,443,14287,443,499,425,74,4,0,3,1,allow
53905,443,17585,443,499,425,74,4,0,3,1,allow
443,4205,0,0,187,187,0,1,0,1,0,deny
443,60040,0,0,60,60,0,1,0,1,0,deny
26239,25174,0,0,66,66,0,1,0,1,0,deny
23218,62413,0,0,62,62,0,1,0,1,0,deny
20706,23718,0,0,66,66,0,1,0,1,0,deny
55246,31573,0,0,66,66,0,1,0,1,0,deny
65480,445,0,0,66,66,0,1,0,1,0,drop
35100,11392,0,0,62,62,0,1,0,1,0,deny
53687,445,0,0,70,70,0,1,0,1,0,drop
37308,43890,0,0,62,62,0,1,0,1,0,deny
45944,44847,0,0,62,62,0,1,0,1,0,deny
50198,5529,0,0,148,148,0,1,0,1,0,deny
59032,25174,0,0,66,66,0,1,0,1,0,deny
15018,37965,0,0,62,62,0,1,0,1,0,deny
52026,26467,0,0,60,60,0,1,0,1,0,deny
65478,445,0,0,66,66,0,1,0,1,0,drop
51865,61689,0,0,66,66,0,1,0,1,0,deny
30181,61689,0,0,62,62,0,1,0,1,0,deny
55833,53,8720,53,177,94,83,2,30,1,1,allow
57271,53,1300,53,228,102,126,2,30,1,1,allow
40362,443,26484,443,8229,2091,6138,24,361,12,12,allow
57102,443,24363,443,17207,7111,10096,44,51,23,21,allow
39353,9339,55496,9339,170706,9877,160829,260,46,110,150,allow
49409,443,26346,443,6574,2176,4398,28,124,14,14,allow
37664,443,11325,443,3338,2337,1001,18,45,11,7,allow
52180,20121,52199,20121,70,70,0,2,7,2,0,allow
52934,443,64385,443,5584,1390,4194,19,14,9,10,allow
53167,22083,32129,22083,70,70,0,1,4,1,0,allow
33042,443,44384,443,10328,5341,4987,26,35,13,13,allow
49412,443,12912,443,9266,2595,6671,35,123,18,17,allow
52178,30922,40190,30922,70,70,0,2,7,2,0,allow
55097,53,14648,53,177,94,83,2,29,1,1,allow
33261,443,59567,443,14176,1843,12333,30,201,16,14,allow
55097,53,54198,53,177,94,83,2,29,1,1,allow
50393,80,25546,80,366,180,186,7,26,4,3,allow
56669,443,3032,443,7458,4186,3272,24,102,14,10,allow
50391,80,6997,80,300,180,120,6,26,4,2,allow
57867,27019,27516,27019,468,390,78,5,30,4,1,allow
55276,53,62860,53,177,94,83,2,30,1,1,allow
57350,53,14841,53,177,94,83,2,30,1,1,allow
34147,53,34147,53,227,106,121,2,30,1,1,allow
56273,53,48350,53,197,102,95,2,33,1,1,allow
32228,53,32228,53,228,90,138,2,33,1,1,allow
50395,80,11837,80,487,180,307,6,26,4,2,allow
45717,80,45717,80,2081,1632,449,10,19,6,4,allow
50394,80,50061,80,306,180,126,6,26,4,2,allow
40358,53,40358,53,414,268,146,3,32,2,1,allow
5588,5588,0,0,3498,1872,1626,48,200,24,24,allow
35066,443,6201,443,33823,28233,5590,84,102,47,37,allow
64898,53,64087,53,487,201,286,6,39,3,3,allow
56273,53,58204,53,197,102,95,2,30,1,1,allow
56375,53,41703,53,177,94,83,2,30,1,1,allow
65426,80,28723,80,65980,5156,60824,86,23,39,47,allow
57470,64050,27080,64050,1660,677,983,20,1600,10,10,allow
57408,53,37720,53,195,102,93,2,30,1,1,allow
65469,53,36424,53,308,110,198,2,30,1,1,allow
57350,53,37868,53,177,94,83,2,30,1,1,allow
32914,5222,62781,5222,8702,4668,4034,92,626,50,42,allow
57408,53,13747,53,195,102,93,2,33,1,1,allow
50392,80,28117,80,306,180,126,6,26,4,2,allow
9417,443,16764,443,324745,7830,316915,327,31,112,215,allow
52002,80,8270,80,7480,4670,2810,47,324,30,17,allow
64758,53,44548,53,311,102,209,2,30,1,1,allow
56291,53,26835,53,177,94,83,2,30,1,1,allow
49609,53,44498,53,177,94,83,2,30,1,1,allow
17750,6881,35389,6881,150,150,0,1,1200,1,0,allow
50265,60276,27315,60276,481,150,331,2,1200,1,1,allow
55893,443,18162,443,6176,908,5268,17,15,8,9,allow
43674,80,1697,80,13872,1244,12628,29,19,14,15,allow
52176,17572,27555,17572,70,70,0,2,8,2,0,allow
56066,53,13837,53,184,102,82,2,30,1,1,allow
60851,443,17568,443,36974,3935,33039,56,61,27,29,allow
50396,80,52675,80,487,180,307,6,26,4,2,allow
53933,20801,58007,20801,70,70,0,2,7,2,0,allow
55924,80,55924,80,450,246,204,8,28,5,3,allow
52143,33283,33804,33283,70,70,0,1,5,1,0,allow
55925,80,55925,80,450,246,204,8,28,5,3,allow
47785,443,12110,443,9224,2055,7169,37,41,19,18,allow
42607,443,6741,443,10221,3259,6962,36,120,18,18,allow
49413,443,21606,443,7849,1104,6745,23,123,12,11,allow
55928,80,55928,80,17982,2112,15870,35,28,18,17,allow
51502,443,63032,443,6559,2158,4401,30,17,16,14,allow
49407,80,27843,80,2408,1466,942,10,124,6,4,allow
46684,443,11949,443,26724,2570,24154,52,42,26,26,allow
52175,1101,39473,1101,70,70,0,2,8,2,0,allow
37661,443,23960,443,3226,2225,1001,18,46,11,7,allow
52111,80,49500,80,1582,866,716,11,20,7,4,allow
54101,443,19141,443,4013,2840,1173,23,27,13,10,allow
49415,443,37841,443,9623,3235,6388,33,118,18,15,allow
49411,443,49244,443,17524,2569,14955,38,124,17,21,allow
50453,80,50453,80,450,246,204,8,30,5,3,allow
64798,53,18186,53,177,94,83,2,29,1,1,allow
34661,53,34661,53,414,268,146,3,33,2,1,allow
56795,53,50687,53,177,94,83,2,29,1,1,allow
38759,443,29453,443,8057,2726,5331,27,239,13,14,allow
64798,53,6106,53,177,94,83,2,29,1,1,allow
49960,53,57227,53,198,94,104,2,29,1,1,allow
55677,53,14201,53,177,94,83,2,29,1,1,allow
65329,53,20205,53,278,102,176,2,29,1,1,allow
49215,53,25508,53,214,102,112,2,30,1,1,allow
49954,53,47734,53,228,110,118,2,30,1,1,allow
56795,53,22826,53,177,94,83,2,30,1,1,allow
55833,53,34904,53,177,94,83,2,30,1,1,allow
32813,53,32813,53,414,268,146,3,33,2,1,allow
36079,53,36079,53,235,90,145,2,32,1,1,allow
52144,15208,55499,15208,70,70,0,1,5,1,0,allow
51169,443,52987,443,21686,7655,14031,77,379,40,37,allow
33044,443,11890,443,9695,5259,4436,24,35,12,12,allow
44448,443,36659,443,5960,1651,4309,21,85,12,9,allow
27997,53,0,0,223,86,137,2,30,1,1,allow
33583,443,54351,443,479444,14906,464538,489,62,173,316,allow
55276,53,58176,53,177,94,83,2,30,1,1,allow
48223,5222,8848,5222,14939,1037,13902,35,579,11,24,allow
61631,443,61631,443,4748,1841,2907,19,26,11,8,allow
50390,80,49086,80,360,180,180,7,26,4,3,allow
49301,443,5775,443,6550,1836,4714,25,46,15,10,allow
25849,53,25849,53,404,259,145,3,32,2,1,allow
50485,443,22667,443,6028,2012,4016,25,16,14,11,allow
56066,53,44669,53,196,86,110,2,30,1,1,allow
56375,53,48204,53,177,94,83,2,30,1,1,allow
56573,443,64654,443,16205,6113,10092,36,110,20,16,allow
54360,443,26291,443,12260,3870,8390,52,283,27,25,allow
50389,443,61820,443,306,180,126,6,26,4,2,allow
10371,53,10371,53,404,259,145,3,33,2,1,allow
42630,53,12099,53,168,78,90,2,30,1,1,allow
60222,443,32889,443,12428,5331,7097,47,32,21,26,allow
56476,53,12813,53,94,94,0,1,30,1,0,allow
57163,443,53866,443,4694,2454,2240,14,135,7,7,allow
62323,443,8004,443,6383,2838,3545,17,135,9,8,allow
57631,443,50238,443,16277,3466,12811,46,1801,22,24,allow
52171,63033,49679,63033,70,70,0,2,8,2,0,allow
49722,53,53892,53,873,280,593,8,80,4,4,allow
64053,47783,24062,47783,70,70,0,1,5,1,0,allow
54955,53,60657,53,177,94,83,2,31,1,1,allow
55939,53,41055,53,177,94,83,2,30,1,1,allow
64780,53,37698,53,627,224,403,6,56,3,3,allow
58900,5223,13059,5223,160,86,74,2,6,1,1,allow
61408,443,17703,443,9492,3543,5949,49,117,25,24,allow
60880,443,55222,443,25751,2629,23122,49,49,23,26,allow
55375,53,40220,53,222,102,120,2,30,1,1,allow
55833,53,32426,53,177,94,83,2,30,1,1,allow
34378,443,1903,443,11269403,319214,10950189,11392,382,3773,7619,allow
49246,53,17908,53,177,94,83,2,30,1,1,allow
56143,53,50780,53,177,94,83,2,30,1,1,allow
52231,50934,0,0,62,62,0,1,0,1,0,deny
41914,443,49039,443,466,392,74,4,0,3,1,allow
65336,445,0,0,70,70,0,1,0,1,0,drop
17213,22114,0,0,146,146,0,1,0,1,0,deny
42558,64147,0,0,62,62,0,1,0,1,0,deny
65469,445,0,0,66,66,0,1,0,1,0,drop
50765,22114,0,0,62,62,0,1,0,1,0,deny
65463,445,0,0,66,66,0,1,0,1,0,drop
65333,445,0,0,70,70,0,1,0,1,0,drop
54189,64147,0,0,66,66,0,1,0,1,0,deny
3875,25174,0,0,62,62,0,1,0,1,0,deny
1480,12447,0,0,62,62,0,1,0,1,0,deny
26921,26467,0,0,62,62,0,1,0,1,0,deny
45941,23386,0,0,60,60,0,1,0,1,0,deny
11030,17372,0,0,62,62,0,1,0,1,0,deny
61387,43890,0,0,62,62,0,1,0,1,0,deny
53532,22114,0,0,62,62,0,1,0,1,0,deny
17811,23,0,0,60,60,0,1,0,1,0,deny
59097,2767,0,0,66,66,0,1,0,1,0,deny
65328,445,0,0,70,70,0,1,0,1,0,drop
53678,445,0,0,70,70,0,1,0,1,0,drop
53676,445,0,0,70,70,0,1,0,1,0,drop
53674,445,0,0,70,70,0,1,0,1,0,drop
65327,445,0,0,70,70,0,1,0,1,0,drop
65451,445,0,0,66,66,0,1,0,1,0,drop
65453,445,0,0,66,66,0,1,0,1,0,drop
65448,445,0,0,66,66,0,1,0,1,0,drop
65450,445,0,0,66,66,0,1,0,1,0,drop
65449,445,0,0,66,66,0,1,0,1,0,drop
65452,445,0,0,66,66,0,1,0,1,0,drop
65447,445,0,0,66,66,0,1,0,1,0,drop
43056,11119,0,0,146,146,0,1,0,1,0,deny
65325,445,0,0,70,70,0,1,0,1,0,drop
64727,25174,0,0,66,66,0,1,0,1,0,deny
6889,9074,0,0,143,143,0,1,0,1,0,deny
39380,49903,0,0,146,146,0,1,0,1,0,deny
39380,46783,0,0,146,146,0,1,0,1,0,deny
50311,443,61436,443,466,392,74,4,0,3,1,allow
50326,46824,0,0,66,66,0,1,0,1,0,deny
25889,11446,0,0,62,62,0,1,0,1,0,deny
31003,10511,0,0,145,145,0,1,0,1,0,deny
19270,56448,0,0,78,78,0,1,0,1,0,deny
31619,51221,0,0,62,62,0,1,0,1,0,deny
63690,64147,0,0,66,66,0,1,0,1,0,deny
63469,64147,0,0,62,62,0,1,0,1,0,deny
20487,50584,0,0,66,66,0,1,0,1,0,deny
56604,17372,0,0,66,66,0,1,0,1,0,deny
53672,445,0,0,70,70,0,1,0,1,0,drop
53666,445,0,0,70,70,0,1,0,1,0,drop
53665,445,0,0,70,70,0,1,0,1,0,drop
53661,445,0,0,70,70,0,1,0,1,0,drop
65318,445,0,0,70,70,0,1,0,1,0,drop
32381,50584,0,0,66,66,0,1,0,1,0,deny
53692,44512,0,0,66,66,0,1,0,1,0,deny
65316,445,0,0,70,70,0,1,0,1,0,drop
65435,445,0,0,66,66,0,1,0,1,0,drop
65434,445,0,0,66,66,0,1,0,1,0,drop
65433,445,0,0,66,66,0,1,0,1,0,drop
56219,22114,0,0,66,66,0,1,0,1,0,deny
65315,445,0,0,70,70,0,1,0,1,0,drop
63873,44847,0,0,66,66,0,1,0,1,0,deny
65314,445,0,0,70,70,0,1,0,1,0,drop
65313,445,0,0,70,70,0,1,0,1,0,drop
65216,35440,0,0,66,66,0,1,0,1,0,deny
65308,445,0,0,70,70,0,1,0,1,0,drop
65307,445,0,0,70,70,0,1,0,1,0,drop
53654,445,0,0,70,70,0,1,0,1,0,drop
40301,8696,0,0,60,60,0,1,0,1,0,deny
1955,35974,0,0,60,60,0,1,0,1,0,deny
55439,37965,0,0,66,66,0,1,0,1,0,deny
53646,445,0,0,70,70,0,1,0,1,0,drop
53644,445,0,0,70,70,0,1,0,1,0,drop
53643,445,0,0,70,70,0,1,0,1,0,drop
49788,1433,0,0,60,60,0,1,0,1,0,deny
49788,1433,0,0,60,60,0,1,0,1,0,deny
65295,445,0,0,70,70,0,1,0,1,0,drop
65294,445,0,0,70,70,0,1,0,1,0,drop
65291,445,0,0,70,70,0,1,0,1,0,drop
4015,23117,0,0,62,62,0,1,0,1,0,deny
65285,445,0,0,70,70,0,1,0,1,0,drop
65284,445,0,0,70,70,0,1,0,1,0,drop
56826,22114,0,0,62,62,0,1,0,1,0,deny
39380,1,0,0,146,146,0,1,0,1,0,deny
59782,26467,0,0,62,62,0,1,0,1,0,deny
53637,445,0,0,70,70,0,1,0,1,0,drop
53635,445,0,0,70,70,0,1,0,1,0,drop
53633,445,0,0,70,70,0,1,0,1,0,drop
54007,50265,0,0,66,66,0,1,0,1,0,deny
49929,26467,0,0,62,62,0,1,0,1,0,deny
55893,45711,0,0,78,78,0,1,0,1,0,deny
14869,44847,0,0,62,62,0,1,0,1,0,deny
65421,445,0,0,66,66,0,1,0,1,0,drop
65273,445,0,0,70,70,0,1,0,1,0,drop
1029,44847,0,0,62,62,0,1,0,1,0,deny
59223,17500,0,0,66,66,0,1,0,1,0,deny
61280,26467,0,0,66,66,0,1,0,1,0,deny
59225,57587,0,0,66,66,0,1,0,1,0,deny
54555,25174,0,0,66,66,0,1,0,1,0,deny
60479,25174,0,0,62,62,0,1,0,1,0,deny
40845,64147,0,0,62,62,0,1,0,1,0,deny
39795,5900,0,0,60,60,0,1,0,1,0,deny
11337,15503,0,0,62,62,0,1,0,1,0,deny
58421,30188,0,0,66,66,0,1,0,1,0,deny
53629,445,0,0,70,70,0,1,0,1,0,drop
56909,50584,0,0,66,66,0,1,0,1,0,deny
64295,26467,0,0,62,62,0,1,0,1,0,deny
41885,25174,0,0,66,66,0,1,0,1,0,deny
8560,50584,0,0,66,66,0,1,0,1,0,deny
0,0,0,0,70,70,0,1,0,1,0,deny
53626,445,0,0,70,70,0,1,0,1,0,drop
55587,43890,0,0,62,62,0,1,0,1,0,deny
65268,445,0,0,70,70,0,1,0,1,0,drop
64016,25174,0,0,62,62,0,1,0,1,0,deny
65407,445,0,0,66,66,0,1,0,1,0,drop
65403,445,0,0,66,66,0,1,0,1,0,drop
56614,25174,0,0,66,66,0,1,0,1,0,deny
65260,445,0,0,70,70,0,1,0,1,0,drop
65258,445,0,0,70,70,0,1,0,1,0,drop
65257,445,0,0,70,70,0,1,0,1,0,drop
50052,65008,0,0,60,60,0,1,0,1,0,deny
65255,445,0,0,70,70,0,1,0,1,0,drop
39809,23,0,0,60,60,0,1,0,1,0,deny
65252,445,0,0,70,70,0,1,0,1,0,drop
64882,43890,0,0,66,66,0,1,0,1,0,deny
62197,22114,0,0,66,66,0,1,0,1,0,deny
49531,26467,0,0,66,66,0,1,0,1,0,deny
53614,445,0,0,70,70,0,1,0,1,0,drop
53608,445,0,0,70,70,0,1,0,1,0,drop
50974,11392,0,0,66,66,0,1,0,1,0,deny
53611,445,0,0,70,70,0,1,0,1,0,drop
53609,445,0,0,70,70,0,1,0,1,0,drop
52604,25174,0,0,66,66,0,1,0,1,0,deny
30542,25174,0,0,62,62,0,1,0,1,0,deny
51533,44847,0,0,66,66,0,1,0,1,0,deny
65401,445,0,0,66,66,0,1,0,1,0,drop
4232,50584,0,0,62,62,0,1,0,1,0,deny
52280,44847,0,0,66,66,0,1,0,1,0,deny
52929,43890,0,0,66,66,0,1,0,1,0,deny
65394,445,0,0,66,66,0,1,0,1,0,drop
65392,445,0,0,66,66,0,1,0,1,0,drop
65393,445,0,0,66,66,0,1,0,1,0,drop
65396,445,0,0,66,66,0,1,0,1,0,drop
65388,445,0,0,66,66,0,1,0,1,0,drop
65389,445,0,0,66,66,0,1,0,1,0,drop
65386,445,0,0,66,66,0,1,0,1,0,drop
65247,445,0,0,70,70,0,1,0,1,0,drop
44414,23718,0,0,66,66,0,1,0,1,0,deny
53602,445,0,0,70,70,0,1,0,1,0,drop
25276,50584,0,0,146,146,0,1,0,1,0,deny
64870,65473,0,0,148,148,0,1,0,1,0,deny
5826,26467,0,0,62,62,0,1,0,1,0,deny
53599,445,0,0,70,70,0,1,0,1,0,drop
53597,445,0,0,70,70,0,1,0,1,0,drop
53595,445,0,0,70,70,0,1,0,1,0,drop
1024,44847,0,0,146,146,0,1,0,1,0,deny
53161,51221,0,0,66,66,0,1,0,1,0,deny
48071,25174,0,0,146,146,0,1,0,1,0,deny
58049,50265,0,0,145,145,0,1,0,1,0,deny
65239,445,0,0,70,70,0,1,0,1,0,drop
58007,62413,0,0,62,62,0,1,0,1,0,deny
65236,445,0,0,70,70,0,1,0,1,0,drop
33973,50265,0,0,62,62,0,1,0,1,0,deny
56400,35440,0,0,66,66,0,1,0,1,0,deny
48839,37807,0,0,62,62,0,1,0,1,0,deny
43563,443,50861,443,466,392,74,4,0,3,1,allow
52169,59681,50827,59681,70,70,0,2,8,2,0,allow
55037,443,53217,443,13372,3722,9650,37,47,21,16,allow
52010,80,6411,80,1327,822,505,11,21,7,4,allow
55715,34309,29460,34309,260,140,120,5,8,3,2,allow
55133,53,7400,53,711,87,624,2,30,1,1,allow
55647,53,47322,53,711,87,624,2,30,1,1,allow
33498,25,33498,25,7825,2062,5763,36,17,17,19,allow
64051,19548,23106,19548,66,66,0,1,5,1,0,allow
18485,81,18485,81,146,60,86,2,10,1,1,allow
55708,22094,3066,22094,564,318,246,9,15,5,4,allow
6881,8229,31730,8229,150,150,0,1,1200,1,0,allow
56893,53,37100,53,170,87,83,2,31,1,1,allow
57150,53,24486,53,170,87,83,2,30,1,1,allow
59957,25,59957,25,1721,681,1040,22,17,10,12,allow
37593,443,32259,443,21234,9602,11632,48,70,28,20,allow
49275,7000,49275,7000,2163,676,1487,14,15,7,7,allow
52170,45144,16828,45144,70,70,0,2,8,2,0,allow
52142,54954,48530,54954,66,66,0,1,5,1,0,allow
47903,443,31427,443,9323,2192,7131,25,25,13,12,allow
40379,53,38675,53,168,78,90,2,30,1,1,allow
51859,7700,19893,7700,8425,6015,2410,73,34,37,36,allow
64056,51266,3673,51266,66,66,0,1,5,1,0,allow
50428,443,6305,443,4356,806,3550,14,15,7,7,allow
55496,80,55496,80,124,60,64,2,5,1,1,allow
56217,53,65360,53,711,87,624,2,30,1,1,allow
55259,443,24007,443,4523,3044,1479,17,64,10,7,allow
64279,53,15836,53,170,87,83,2,30,1,1,allow
56597,53,51184,53,711,87,624,2,30,1,1,allow
56998,53,18836,53,711,87,624,2,30,1,1,allow
55757,53,46754,53,170,87,83,2,30,1,1,allow
54955,53,57414,53,170,87,83,2,30,1,1,allow
26900,27017,56455,27017,926,410,516,12,31,6,6,allow
36812,53,60347,53,168,78,90,2,31,1,1,allow
57192,53,34742,53,170,87,83,2,31,1,1,allow
45189,443,22726,443,10789,5723,5066,36,136,17,19,allow
56924,53,50260,53,170,87,83,2,31,1,1,allow
49985,53,61904,53,312,90,222,2,31,1,1,allow
56075,443,56807,443,5640,3241,2399,22,120,11,11,allow
43747,22114,0,0,62,62,0,1,0,1,0,deny
60645,35440,0,0,66,66,0,1,0,1,0,deny
48978,25174,0,0,62,62,0,1,0,1,0,deny
53591,445,0,0,70,70,0,1,0,1,0,drop
53589,445,0,0,70,70,0,1,0,1,0,drop
53588,445,0,0,70,70,0,1,0,1,0,drop
65233,445,0,0,70,70,0,1,0,1,0,drop
9327,57470,0,0,62,62,0,1,0,1,0,deny
65377,445,0,0,66,66,0,1,0,1,0,drop
65231,445,0,0,70,70,0,1,0,1,0,drop
53586,445,0,0,70,70,0,1,0,1,0,drop
9226,57470,0,0,66,66,0,1,0,1,0,deny
45941,23386,0,0,60,60,0,1,0,1,0,deny
18517,31652,0,0,62,62,0,1,0,1,0,reset-both
65376,445,0,0,66,66,0,1,0,1,0,drop
65374,445,0,0,66,66,0,1,0,1,0,drop
65373,445,0,0,66,66,0,1,0,1,0,drop
61785,64147,0,0,66,66,0,1,0,1,0,deny
36369,443,28864,443,4039,2616,1423,24,45,14,10,allow
52172,7353,52329,7353,70,70,0,2,7,2,0,allow
60881,443,30566,443,8284,1577,6707,29,48,14,15,allow
49246,53,4565,53,177,94,83,2,30,1,1,allow
56143,53,46074,53,177,94,83,2,30,1,1,allow
54340,443,58977,443,79305,3202,76103,98,347,32,66,allow
38160,443,10215,443,8185,2274,5911,18,135,8,10,allow
57470,51413,33371,51413,460,150,310,2,1199,1,1,allow
37965,10909,61398,10909,844,152,692,4,1199,2,2,allow
55588,53,19559,53,168,86,82,2,30,1,1,allow
36379,443,4482,443,4041,2623,1418,22,94,12,10,allow
14247,53,14247,53,197,90,107,2,30,1,1,allow
56086,443,37563,443,7535,1003,6532,24,304,7,17,allow
57040,443,58515,443,59451,47894,11557,177,91,99,78,allow
9462,443,5144,443,4717,2929,1788,23,26,13,10,allow
9401,443,34975,443,7135,1346,5789,21,32,10,11,allow
53943,40534,14905,40534,320,140,180,6,5,3,3,allow
49392,80,13895,80,156587,46628,109959,307,314,203,104,allow
49227,2710,25043,2710,70,70,0,1,5,1,0,allow
50589,443,28626,443,10257,6305,3952,31,134,19,12,allow
49274,53,43421,53,212,102,110,2,29,1,1,allow
55276,53,25720,53,177,94,83,2,29,1,1,allow
55757,53,24073,53,177,94,83,2,30,1,1,allow
64279,53,29219,53,177,94,83,2,29,1,1,allow
55718,16805,42718,16805,70,70,0,2,8,2,0,allow
65023,53,34897,53,587,104,483,4,40,2,2,allow
49226,443,24983,443,532687,14365,518322,560,20,211,349,allow
32911,443,37831,443,970703,43045,927658,1244,141,563,681,allow
26900,27017,54890,27017,758,328,430,10,30,5,5,allow
33045,443,23219,443,4446,1298,3148,15,34,8,7,allow
50636,80,12150,80,16521,6496,10025,31,49,16,15,allow
65082,53,42896,53,305,94,211,4,35,2,2,allow
53914,44209,7956,44209,1729,985,744,16,16,9,7,allow
55605,53,59793,53,198,102,96,2,33,1,1,allow
55646,53,7208,53,216,94,122,2,30,1,1,allow
60227,443,25151,443,6553,871,5682,19,45,9,10,allow
64381,53,44937,53,952,291,661,8,68,4,4,allow
55605,53,59160,53,198,102,96,2,30,1,1,allow
49905,443,37995,443,798502,33164,765338,927,103,379,548,allow
65177,53,43720,53,258,110,148,2,30,1,1,allow
55601,53,58800,53,177,94,83,2,30,1,1,allow
21447,53,34557,53,80280,68084,12196,889,90,816,73,allow
59182,53,44334,53,260,86,174,2,30,1,1,allow
63970,53,19074,53,228,110,118,2,30,1,1,allow
57150,53,64897,53,177,94,83,2,30,1,1,allow
56566,53,0,0,86,86,0,1,30,1,0,allow
55584,53,28071,53,177,94,83,2,30,1,1,allow
11491,53,11491,53,247,98,149,2,32,1,1,allow
51976,443,42576,443,2466,1497,969,21,46,12,9,allow
56467,80,52250,80,22601,1621,20980,35,142,18,17,allow
65226,53,19267,53,79,79,0,2,34,2,0,allow
58760,443,41927,443,45482,2178,43304,56,15,22,34,allow
51975,443,30656,443,4692,2376,2316,30,47,16,14,allow
40457,443,34174,443,5630,3451,2179,39,67,20,19,allow
60878,443,39667,443,31315,6036,25279,65,49,32,33,allow
60879,443,57510,443,15774,5540,10234,48,48,26,22,allow
52003,80,10916,80,7464,4661,2803,47,323,30,17,allow
60702,443,49529,443,13618,5262,8356,54,101,26,28,allow
53934,48339,61953,48339,320,140,180,6,6,3,3,allow
40510,1488,40510,1488,156,156,0,3,7,3,0,allow
50591,443,54685,443,5611,3452,2159,22,133,13,9,allow
52168,62118,2887,62118,70,70,0,2,8,2,0,allow
58046,80,28676,80,2306,1112,1194,23,76,12,11,allow
51977,443,5724,443,2497,1528,969,22,46,13,9,allow
58014,443,11079,443,5528,3392,2136,31,80,16,15,allow
51635,80,51635,80,699944,13137,686807,676,20,195,481,allow
51113,80,51632,80,1948,1092,856,10,20,7,3,allow
32909,443,28727,443,160821,7879,152942,201,141,88,113,allow
53942,28921,35066,28921,320,140,180,6,6,3,3,allow
42226,53,42226,53,259,114,145,2,29,1,1,allow
40355,443,8929,443,15367456,244322,15123134,12866,268,1819,11047,allow
49609,53,20657,53,177,94,83,2,29,1,1,allow
55939,53,47586,53,177,94,83,2,29,1,1,allow
64055,45105,31145,45105,70,70,0,1,4,1,0,allow
54955,53,54702,53,177,94,83,2,29,1,1,allow
50214,53,15199,53,718,94,624,2,29,1,1,allow
56951,53,31366,53,168,86,82,2,29,1,1,allow
65456,53,31398,53,364,102,262,2,29,1,1,allow
56808,53,18042,53,180,94,86,2,35,1,1,allow
55013,53,63318,53,728,102,626,2,29,1,1,allow
56951,53,44679,53,168,86,82,2,29,1,1,allow
52087,80,10358,80,2757,648,2109,12,23,7,5,allow
63419,53,63419,53,216,90,126,2,30,1,1,allow
32910,443,36297,443,2299332,50663,2248669,2117,141,553,1564,allow
55959,53,27240,53,216,102,114,2,29,1,1,allow
50021,53,13540,53,821,102,719,2,30,1,1,allow
56951,53,25030,53,168,86,82,2,29,1,1,allow
56893,53,21610,53,177,94,83,2,30,1,1,allow
64279,53,42792,53,177,94,83,2,30,1,1,allow
57395,53,57395,53,208,82,126,2,30,1,1,allow
55757,53,45063,53,177,94,83,2,30,1,1,allow
54955,53,32337,53,177,94,83,2,30,1,1,allow
47548,53,51360,53,168,78,90,2,30,1,1,allow
64951,53,50176,53,402,118,284,2,30,1,1,allow
57150,53,36180,53,177,94,83,2,30,1,1,allow
64783,53,10599,53,214,94,120,2,30,1,1,allow
51112,80,46143,80,2433,1280,1153,11,20,7,4,allow
58920,80,59955,80,318,192,126,6,37,4,2,allow
52140,53155,46318,53155,70,70,0,1,5,1,0,allow
50684,80,50889,80,1658,1247,411,8,15,5,3,allow
50674,443,55479,443,8709,1708,7001,22,19,11,11,allow
32908,443,31863,443,1780845,46018,1734827,1751,141,546,1205,allow
58153,443,33248,443,12215,7275,4940,26,26,16,10,allow
49472,53,52589,53,209,102,107,2,30,1,1,allow
55778,53,1773,53,94,94,0,1,30,1,0,allow
50284,53,6888,53,168,78,90,2,30,1,1,allow
21954,53,21954,53,220,90,130,2,30,1,1,allow
41348,53,0,0,86,86,0,1,30,1,0,allow
55719,13302,11300,13302,70,70,0,2,8,2,0,allow
55720,51610,62012,51610,70,70,0,2,8,2,0,allow
60401,80,25195,80,190,64,126,4,103,2,2,allow
34388,443,29047,443,7002,1252,5750,28,258,15,13,allow
64279,53,4406,53,177,94,83,2,30,1,1,allow
56893,53,56270,53,177,94,83,2,30,1,1,allow
55757,53,50237,53,177,94,83,2,30,1,1,allow
36058,443,41067,443,11769,1894,9875,27,99,13,14,allow
49299,443,14634,443,6681,1950,4731,24,45,14,10,allow
52097,80,35130,80,1621,896,725,11,19,7,4,allow
37435,53,37435,53,414,268,146,3,32,2,1,allow
55717,13517,61965,13517,70,70,0,2,8,2,0,allow
60066,80,60066,80,355862,9048,346814,358,163,116,242,allow
48713,80,15220,80,3588672,75353,3513319,3500,154,1175,2325,allow
56716,80,53461,80,3742344,115431,3626913,3995,79,1382,2613,allow
32928,443,19319,443,1527,940,587,14,90,8,6,allow
55601,53,28384,53,177,94,83,2,30,1,1,allow
57385,53,16664,53,177,94,83,2,30,1,1,allow
55588,53,33228,53,168,86,82,2,30,1,1,allow
44351,53,3058,53,168,78,90,2,30,1,1,allow
55067,53,26485,53,178,94,84,2,31,1,1,allow
56924,53,38205,53,177,94,83,2,31,1,1,allow
55257,80,57672,80,3564,1625,1939,12,131,6,6,allow
65227,53,53714,53,180,86,94,2,30,1,1,allow
51551,53,57627,53,304,86,218,2,30,1,1,allow
57385,53,42061,53,177,94,83,2,30,1,1,allow
55921,53,32858,53,177,94,83,2,30,1,1,allow
26900,27017,37818,27017,422,164,258,6,30,3,3,allow
64573,443,4149,443,4158,2117,2041,11,120,6,5,allow
49160,61365,56372,61365,502,150,352,3,1200,2,1,allow
55859,443,4096,443,399086,26649,372437,488,462,156,332,allow
50265,27813,47510,27813,198,198,0,4,1200,4,0,allow
34960,443,12324,443,190,70,120,4,15,2,2,allow
50302,443,11942,443,11313,2617,8696,27,47,15,12,allow
38323,443,27893,443,130,70,60,2,15,1,1,allow
54957,53,54042,53,197,102,95,2,35,1,1,allow
59788,443,27023,443,248845,14935,233910,308,49,148,160,allow
57007,80,33678,80,214,140,74,4,31,3,1,allow
57008,80,59299,80,214,140,74,4,31,3,1,allow
57012,80,14292,80,214,140,74,4,31,3,1,allow
55067,53,40121,53,178,94,84,2,30,1,1,allow
39915,443,23556,443,27886,17603,10283,138,462,76,62,allow
57015,80,24329,80,214,140,74,4,31,3,1,allow
57909,80,13139,80,6510,1210,5300,15,18,8,7,allow
26900,27017,15895,27017,254,82,172,4,30,2,2,allow
56893,53,50861,53,177,94,83,2,30,1,1,allow
65152,53,13700,53,177,94,83,2,30,1,1,allow
55498,53,32880,53,177,94,83,2,31,1,1,allow
60802,40010,3447,40010,316,136,180,6,6,3,3,allow
52167,61948,12539,61948,70,70,0,2,8,2,0,allow
52001,80,32528,80,7578,4652,2926,49,323,30,19,allow
14752,53,14752,53,229,98,131,2,30,1,1,allow
13020,26467,0,0,66,66,0,1,0,1,0,deny
9745,26467,0,0,62,62,0,1,0,1,0,deny
31130,30188,0,0,66,66,0,1,0,1,0,deny
65371,445,0,0,66,66,0,1,0,1,0,drop
65227,445,0,0,70,70,0,1,0,1,0,drop
65226,445,0,0,70,70,0,1,0,1,0,drop
54816,35440,0,0,62,62,0,1,0,1,0,deny
49923,443,51816,443,466,392,74,4,1,3,1,allow
65332,56205,0,0,66,66,0,1,0,1,0,deny
53580,445,0,0,70,70,0,1,0,1,0,drop
1043,30170,0,0,159,159,0,1,0,1,0,deny
54816,35440,0,0,146,146,0,1,0,1,0,deny
53573,445,0,0,70,70,0,1,0,1,0,drop
53571,445,0,0,70,70,0,1,0,1,0,drop
10390,26467,0,0,66,66,0,1,0,1,0,deny
65221,445,0,0,70,70,0,1,0,1,0,drop
65360,445,0,0,66,66,0,1,0,1,0,drop
51430,25174,0,0,62,62,0,1,0,1,0,deny
57550,50584,0,0,62,62,0,1,0,1,0,deny
19594,23117,0,0,62,62,0,1,0,1,0,deny
52236,25174,0,0,66,66,0,1,0,1,0,deny
33814,22114,0,0,62,62,0,1,0,1,0,deny
59874,22114,0,0,66,66,0,1,0,1,0,deny
57985,26467,0,0,62,62,0,1,0,1,0,deny
65352,445,0,0,66,66,0,1,0,1,0,drop
53559,445,0,0,70,70,0,1,0,1,0,drop
65349,445,0,0,66,66,0,1,0,1,0,drop
20682,57470,0,0,62,62,0,1,0,1,0,deny
65208,445,0,0,70,70,0,1,0,1,0,drop
50052,65010,0,0,60,60,0,1,0,1,0,deny
62642,25174,0,0,66,66,0,1,0,1,0,deny
8194,21247,0,0,62,62,0,1,0,1,0,deny
4545,1900,0,0,136,136,0,1,0,1,0,deny
1865,25174,0,0,146,146,0,1,0,1,0,deny
65205,445,0,0,70,70,0,1,0,1,0,drop
65342,445,0,0,66,66,0,1,0,1,0,drop
27046,51505,0,0,66,66,0,1,0,1,0,deny
22263,30188,0,0,66,66,0,1,0,1,0,deny
65335,445,0,0,66,66,0,1,0,1,0,drop
23079,9694,0,0,62,62,0,1,0,1,0,deny
26698,25174,0,0,62,62,0,1,0,1,0,deny
18415,37965,0,0,62,62,0,1,0,1,0,deny
50637,36237,0,0,66,66,0,1,0,1,0,deny
1090,26296,0,0,159,159,0,1,0,1,0,deny
57131,7774,0,0,145,145,0,1,0,1,0,deny
65201,445,0,0,70,70,0,1,0,1,0,drop
65199,445,0,0,70,70,0,1,0,1,0,drop
18173,25174,0,0,66,66,0,1,0,1,0,deny
19270,56448,0,0,78,78,0,1,0,1,0,deny
53579,42707,0,0,66,66,0,1,0,1,0,deny
53550,445,0,0,70,70,0,1,0,1,0,drop
53548,445,0,0,70,70,0,1,0,1,0,drop
53546,445,0,0,70,70,0,1,0,1,0,drop
65197,445,0,0,70,70,0,1,0,1,0,drop
64014,3389,64014,3389,293,223,70,4,0,3,1,reset-both
65324,445,0,0,66,66,0,1,0,1,0,drop
65321,445,0,0,66,66,0,1,0,1,0,drop
65325,445,0,0,66,66,0,1,0,1,0,drop
65326,445,0,0,66,66,0,1,0,1,0,drop
65319,445,0,0,66,66,0,1,0,1,0,drop
65327,445,0,0,66,66,0,1,0,1,0,drop
65323,445,0,0,66,66,0,1,0,1,0,drop
65320,445,0,0,66,66,0,1,0,1,0,drop
37008,42707,0,0,62,62,0,1,0,1,0,deny
36419,50584,0,0,62,62,0,1,0,1,0,deny
29512,30188,0,0,66,66,0,1,0,1,0,deny
36629,23117,0,0,62,62,0,1,0,1,0,deny
26651,25174,0,0,62,62,0,1,0,1,0,deny
14447,25174,0,0,62,62,0,1,0,1,0,deny
10381,22114,0,0,62,62,0,1,0,1,0,deny
15319,51505,0,0,62,62,0,1,0,1,0,deny
2938,64147,0,0,62,62,0,1,0,1,0,deny
14692,25174,0,0,146,146,0,1,0,1,0,deny
65190,445,0,0,70,70,0,1,0,1,0,drop
61761,44847,0,0,66,66,0,1,0,1,0,deny
6666,27017,0,0,60,60,0,1,0,1,0,deny
53543,445,0,0,70,70,0,1,0,1,0,drop
53532,445,0,0,70,70,0,1,0,1,0,drop
53531,445,0,0,70,70,0,1,0,1,0,drop
53529,445,0,0,70,70,0,1,0,1,0,drop
65188,445,0,0,70,70,0,1,0,1,0,drop
56213,26467,0,0,66,66,0,1,0,1,0,deny
49182,21247,0,0,66,66,0,1,0,1,0,deny
38859,22114,0,0,62,62,0,1,0,1,0,deny
65306,445,0,0,66,66,0,1,0,1,0,drop
65305,445,0,0,66,66,0,1,0,1,0,drop
65304,445,0,0,66,66,0,1,0,1,0,drop
65187,445,0,0,70,70,0,1,0,1,0,drop
65186,445,0,0,70,70,0,1,0,1,0,drop
65185,445,0,0,70,70,0,1,0,1,0,drop
65183,445,0,0,70,70,0,1,0,1,0,drop
65181,445,0,0,70,70,0,1,0,1,0,drop
53527,445,0,0,70,70,0,1,0,1,0,drop
57928,30188,0,0,62,62,0,1,0,1,0,deny
53524,445,0,0,70,70,0,1,0,1,0,drop
53523,445,0,0,70,70,0,1,0,1,0,drop
53520,445,0,0,70,70,0,1,0,1,0,drop
17101,25174,0,0,62,62,0,1,0,1,0,deny
65167,445,0,0,70,70,0,1,0,1,0,drop
2932,44847,0,0,66,66,0,1,0,1,0,deny
65166,445,0,0,70,70,0,1,0,1,0,drop
55893,45711,0,0,78,78,0,1,0,1,0,deny
65161,445,0,0,70,70,0,1,0,1,0,drop
57928,30188,0,0,146,146,0,1,0,1,0,deny
65157,445,0,0,70,70,0,1,0,1,0,drop
65156,445,0,0,70,70,0,1,0,1,0,drop
11136,19910,0,0,62,62,0,1,0,1,0,deny
7342,22114,0,0,66,66,0,1,0,1,0,deny
21179,44847,0,0,62,62,0,1,0,1,0,deny
13285,29892,0,0,145,145,0,1,0,1,0,deny
35589,25174,0,0,66,66,0,1,0,1,0,deny
34281,52862,0,0,145,145,0,1,0,1,0,deny
53120,25174,0,0,62,62,0,1,0,1,0,deny
53508,445,0,0,70,70,0,1,0,1,0,drop
53507,445,0,0,70,70,0,1,0,1,0,drop
53503,445,0,0,70,70,0,1,0,1,0,drop
36405,443,39984,443,466,392,74,4,0,3,1,allow
65145,445,0,0,70,70,0,1,0,1,0,drop
65292,445,0,0,66,66,0,1,0,1,0,drop
51548,995,0,0,60,60,0,1,0,1,0,deny
33720,995,0,0,60,60,0,1,0,1,0,deny
52462,25174,0,0,66,66,0,1,0,1,0,deny
12694,22114,0,0,66,66,0,1,0,1,0,deny
68,67,0,0,594,594,0,1,0,1,0,deny
27110,22114,0,0,60,60,0,1,0,1,0,deny
12290,22114,0,0,66,66,0,1,0,1,0,deny
53501,445,0,0,70,70,0,1,0,1,0,drop
65141,445,0,0,70,70,0,1,0,1,0,drop
53499,445,0,0,70,70,0,1,0,1,0,drop
27502,50584,0,0,66,66,0,1,0,1,0,deny
10192,25174,0,0,66,66,0,1,0,1,0,deny
65132,445,0,0,70,70,0,1,0,1,0,drop
65130,445,0,0,70,70,0,1,0,1,0,drop
65131,445,0,0,70,70,0,1,0,1,0,drop
65126,445,0,0,70,70,0,1,0,1,0,drop
65280,445,0,0,66,66,0,1,0,1,0,drop
65276,445,0,0,66,66,0,1,0,1,0,drop
57172,17,0,0,60,60,0,1,0,1,0,deny
65125,445,0,0,70,70,0,1,0,1,0,deny
15585,64147,0,0,62,62,0,1,0,1,0,deny
53563,35440,0,0,62,62,0,1,0,1,0,deny
55735,50584,0,0,62,62,0,1,0,1,0,deny
57677,57470,0,0,62,62,0,1,0,1,0,deny
63398,25174,0,0,66,66,0,1,0,1,0,deny
53487,445,0,0,70,70,0,1,0,1,0,drop
53486,445,0,0,70,70,0,1,0,1,0,drop
53482,445,0,0,70,70,0,1,0,1,0,drop
53481,445,0,0,70,70,0,1,0,1,0,drop
35268,81,0,0,60,60,0,1,0,1,0,deny
49160,1171,0,0,146,146,0,1,0,1,0,deny
65271,445,0,0,66,66,0,1,0,1,0,drop
58399,56205,0,0,66,66,0,1,0,1,0,deny
11754,25174,0,0,62,62,0,1,0,1,0,deny
49754,35440,0,0,62,62,0,1,0,1,0,deny
37657,443,62208,443,8926,2746,6180,27,46,16,11,allow
26755,443,24399,443,7283,2586,4697,22,19,11,11,allow
55588,53,17857,53,168,86,82,2,34,1,1,allow
52166,57975,14625,57975,70,70,0,2,8,2,0,allow
53975,443,21855,443,2845,1694,1151,18,125,10,8,allow
39717,443,63809,443,10921,3102,7819,25,217,13,12,allow
59244,53,54257,53,168,78,90,2,30,1,1,allow
54512,80,54512,80,1923,1474,449,10,20,6,4,allow
39718,443,30883,443,10457,3150,7307,25,217,13,12,allow
53915,1026,61852,1026,70,70,0,1,5,1,0,allow
49531,80,9012,80,78,78,0,1,5,1,0,allow
57004,80,5611,80,214,140,74,4,30,3,1,allow
60571,443,5687,443,8728,4031,4697,23,17,12,11,allow
59955,25,59955,25,1656,677,979,21,16,10,11,allow
57010,80,42816,80,214,140,74,4,30,3,1,allow
26900,27017,57110,27017,422,164,258,6,30,3,3,allow
26900,27017,64702,27017,422,164,258,6,30,3,3,allow
55035,443,52274,443,13310,3162,10148,31,46,16,15,allow
55034,443,64856,443,45487,4986,40501,74,47,36,38,allow
56609,3389,56609,3389,3327,1438,1889,15,16,8,7,allow
39272,443,24238,443,7134,1963,5171,22,284,11,11,allow
39715,443,41417,443,65276,4554,60722,82,217,34,48,allow
39714,443,60107,443,922046,41258,880788,1106,218,498,608,allow
45628,80,45628,80,1243,530,713,10,20,5,5,allow
37659,443,25278,443,3354,2353,1001,18,45,11,7,allow
65482,443,27020,443,6762,3351,3411,31,160,14,17,allow
50116,22,50116,22,60,60,0,1,5,1,0,allow
64064,29856,35804,29856,66,66,0,2,8,2,0,allow
44885,443,34599,443,296,78,218,4,19,1,3,allow
53976,443,52741,443,1591,1004,587,15,125,8,7,allow
10026,443,31835,443,3409,1599,1810,24,80,12,12,allow
19520,7000,19520,7000,4579,2182,2397,16,17,9,7,allow
26900,27017,31530,27017,168,82,86,2,30,1,1,allow
53661,443,31154,443,8267,1779,6488,23,150,13,10,allow
60332,53,8836,53,419,111,308,2,31,1,1,allow
52326,443,20319,443,4939,2553,2386,51,72,28,23,allow
56606,3389,56606,3389,4130,2105,2025,18,16,9,9,allow
37660,443,48083,443,3354,2353,1001,18,45,11,7,allow
59956,25,59956,25,1867,743,1124,24,16,11,13,allow
39318,443,24928,443,6933,2226,4707,33,140,18,15,allow
39719,443,7093,443,450036,17745,432291,541,217,241,300,allow
44884,443,49689,443,296,78,218,4,19,1,3,allow
59900,3389,59900,3389,4286,2261,2025,20,18,11,9,allow
57456,443,62626,443,6350,1550,4800,23,41,12,11,allow
55033,443,57495,443,19846,10062,9784,42,47,22,20,allow
65445,80,60875,80,1279,714,565,11,19,6,5,allow
47971,443,27561,443,11482,2506,8976,48,1329,24,24,allow
26900,27017,50644,27017,422,164,258,6,30,3,3,allow
65152,53,43515,53,170,87,83,2,30,1,1,allow
55067,53,8321,53,172,88,84,2,30,1,1,allow
55498,53,58802,53,170,87,83,2,30,1,1,allow
55877,1135,9849,1135,489,149,340,2,1200,1,1,allow
26900,27017,11369,27017,422,164,258,6,30,3,3,allow
56519,53,32715,53,711,87,624,2,30,1,1,allow
49223,443,17029,443,14838,6995,7843,52,244,26,26,allow
46563,443,26794,443,127147,41867,85280,198,240,91,107,allow
56905,443,19184,443,7537,2310,5227,19,142,8,11,allow
65119,445,0,0,70,70,0,1,0,1,0,drop
44235,50265,0,0,145,145,0,1,0,1,0,deny
23873,30188,0,0,66,66,0,1,0,1,0,deny
47303,31170,0,0,145,145,0,1,0,1,0,deny
65263,445,0,0,66,66,0,1,0,1,0,drop
65262,445,0,0,66,66,0,1,0,1,0,drop
65268,445,0,0,66,66,0,1,0,1,0,drop
65267,445,0,0,66,66,0,1,0,1,0,drop
65259,445,0,0,66,66,0,1,0,1,0,drop
65264,445,0,0,66,66,0,1,0,1,0,drop
65257,445,0,0,66,66,0,1,0,1,0,drop
53473,445,0,0,70,70,0,1,0,1,0,drop
57484,30317,0,0,66,66,0,1,0,1,0,deny
53471,445,0,0,70,70,0,1,0,1,0,drop
21704,16933,0,0,62,62,0,1,0,1,0,deny
53469,445,0,0,70,70,0,1,0,1,0,drop
53467,445,0,0,70,70,0,1,0,1,0,drop
65111,445,0,0,70,70,0,1,0,1,0,drop
65109,445,0,0,70,70,0,1,0,1,0,drop
54221,57470,0,0,66,66,0,1,0,1,0,deny
59966,37965,0,0,66,66,0,1,0,1,0,deny
53015,64147,0,0,62,62,0,1,0,1,0,deny
65104,445,0,0,70,70,0,1,0,1,0,drop
443,14591,0,0,131,131,0,1,0,1,0,deny
65103,445,0,0,70,70,0,1,0,1,0,drop
64723,56205,0,0,62,62,0,1,0,1,0,deny
53462,445,0,0,70,70,0,1,0,1,0,drop
53460,445,0,0,70,70,0,1,0,1,0,drop
53459,445,0,0,70,70,0,1,0,1,0,drop
48448,48817,0,0,66,66,0,1,0,1,0,deny
61550,5529,0,0,145,145,0,1,0,1,0,deny
65250,445,0,0,66,66,0,1,0,1,0,drop
53458,445,0,0,70,70,0,1,0,1,0,drop
62914,11392,0,0,146,146,0,1,0,1,0,deny
10126,57470,0,0,62,62,0,1,0,1,0,deny
65248,445,0,0,66,66,0,1,0,1,0,drop
443,49689,0,0,60,60,0,1,0,1,0,deny
443,34599,0,0,60,60,0,1,0,1,0,deny
53704,23,0,0,60,60,0,1,0,1,0,deny
65099,445,0,0,70,70,0,1,0,1,0,drop
1024,25174,0,0,62,62,0,1,0,1,0,deny
65246,445,0,0,66,66,0,1,0,1,0,drop
65244,445,0,0,66,66,0,1,0,1,0,drop
13110,52126,0,0,145,145,0,1,0,1,0,deny
65242,445,0,0,66,66,0,1,0,1,0,drop
65098,445,0,0,70,70,0,1,0,1,0,drop
62348,50584,0,0,66,66,0,1,0,1,0,deny
49938,57470,0,0,66,66,0,1,0,1,0,deny
49370,443,33059,443,5782,1008,4774,17,1,8,9,allow
40787,57470,0,0,62,62,0,1,0,1,0,deny
65496,57470,0,0,146,146,0,1,0,1,0,deny
22547,48817,0,0,72,72,0,1,0,1,0,deny
53456,445,0,0,70,70,0,1,0,1,0,drop
50488,22114,0,0,66,66,0,1,0,1,0,deny
58715,64097,0,0,62,62,0,1,0,1,0,deny
8760,22114,0,0,66,66,0,1,0,1,0,deny
53448,445,0,0,70,70,0,1,0,1,0,drop
53442,445,0,0,70,70,0,1,0,1,0,drop
54883,51505,0,0,62,62,0,1,0,1,0,deny
62149,22114,0,0,66,66,0,1,0,1,0,deny
65093,445,0,0,70,70,0,1,0,1,0,drop
31066,57470,0,0,74,74,0,1,0,1,0,deny
37732,5007,0,0,60,60,0,1,0,1,0,deny
49196,25174,0,0,66,66,0,1,0,1,0,deny
65232,445,0,0,66,66,0,1,0,1,0,drop
52827,25174,0,0,62,62,0,1,0,1,0,deny
59096,57866,0,0,62,62,0,1,0,1,0,deny
64653,53,13693,53,241,94,147,2,30,1,1,allow
54022,443,12904,443,7653,1188,6465,21,16,12,9,allow
38135,443,62915,443,2568507,98538,2469969,2956,65,1228,1728,allow
55075,53,27475,53,168,78,90,2,30,1,1,allow
53121,443,47087,443,36181,3264,32917,51,62,24,27,allow
52007,80,41883,80,83736,4405,79331,114,19,48,66,allow
56742,443,19670,443,1327,918,409,10,34,6,4,allow
39011,80,17481,80,1114,534,580,12,15,7,5,allow
59789,443,29818,443,103556,8767,94789,144,48,75,69,allow
59790,443,41784,443,238429,14932,223497,314,48,159,155,allow
57150,53,60378,53,177,94,83,2,29,1,1,allow
55921,53,64539,53,177,94,83,2,29,1,1,allow
42520,53,41857,53,168,78,90,2,30,1,1,allow
57578,443,34885,443,13999,3478,10521,33,134,15,18,allow
55957,53,34097,53,178,94,84,2,30,1,1,allow
57006,80,58727,80,214,140,74,4,30,3,1,allow
57014,80,25497,80,214,140,74,4,30,3,1,allow
59122,80,13058,80,2865,2000,865,12,16,7,5,allow
57011,80,37769,80,214,140,74,4,30,3,1,allow
59407,443,59407,443,4736,1829,2907,19,29,11,8,allow
57009,80,12239,80,214,140,74,4,30,3,1,allow
49670,443,17269,443,98424,28850,69574,508,2054,274,234,allow
50637,80,36749,80,175050,8089,166961,167,48,48,119,allow
57013,80,33223,80,526,304,222,8,30,5,3,allow
52139,38259,26811,38259,70,70,0,1,4,1,0,allow
59787,443,50421,443,173218,14836,158382,227,48,114,113,allow
59786,443,7763,443,170002,17069,152933,229,48,118,111,allow
52164,42271,30250,42271,70,70,0,2,8,2,0,allow
53917,35885,37941,35885,70,70,0,1,4,1,0,allow
64063,37832,48121,37832,66,66,0,2,7,2,0,allow
58267,443,58267,443,4674,1767,2907,19,26,11,8,allow
58983,53,44611,53,168,78,90,2,29,1,1,allow
49985,53,62790,53,227,102,125,2,29,1,1,allow
57192,53,44126,53,177,94,83,2,30,1,1,allow
57192,53,42489,53,177,94,83,2,30,1,1,allow
39852,53,51714,53,223,78,145,2,30,1,1,allow
54023,443,2526,443,7653,1188,6465,21,16,12,9,allow
51965,443,54764,443,12738,5385,7353,37,67,21,16,allow
21447,53,55331,53,245648,213726,31922,2763,89,2579,184,allow
26900,27017,43770,27017,422,164,258,6,30,3,3,allow
46881,53,46881,53,197,90,107,2,30,1,1,allow
56414,53,14395,53,178,94,84,2,30,1,1,allow
64985,53,10267,53,86,86,0,1,60,1,0,allow
53922,42285,39226,42285,70,70,0,2,8,2,0,allow
64630,53,37942,53,350,94,256,2,30,1,1,allow
53171,443,32050,443,11080,4277,6803,23,42,10,13,allow
51605,443,15283,443,4343,2350,1993,17,36,9,8,allow
64586,443,13912,443,8573,2039,6534,25,32,14,11,allow
55709,30217,48170,30217,70,70,0,1,5,1,0,allow
50178,443,40731,443,6353,1075,5278,18,26,10,8,allow
49407,53,49407,53,247,98,149,2,32,1,1,allow
65431,53,65431,53,262,106,156,2,31,1,1,allow
5588,5588,0,0,3498,1872,1626,48,195,24,24,allow
50487,80,64502,80,13796,627,13169,20,30,8,12,allow
15732,53,15732,53,414,268,146,3,32,2,1,allow
55244,53,11760,53,168,78,90,2,30,1,1,allow
26900,27017,31467,27017,422,164,258,6,30,3,3,allow
26900,27017,33518,27017,422,164,258,6,30,3,3,allow
55498,53,29212,53,177,94,83,2,30,1,1,allow
26900,27017,60170,27017,422,164,258,6,30,3,3,allow
26900,27017,41644,27017,422,164,258,6,30,3,3,allow
26900,27017,15818,27017,422,164,258,6,30,3,3,allow
26900,27017,41011,27017,422,164,258,6,30,3,3,allow
26900,27017,26279,27017,422,164,258,6,30,3,3,allow
55407,53,58404,53,195,94,101,2,30,1,1,allow
56924,53,57471,53,177,94,83,2,30,1,1,allow
53162,443,22912,443,23929,10333,13596,51,43,25,26,allow
52138,25621,21857,25621,70,70,0,1,5,1,0,allow
49484,80,9940,80,3333,672,2661,12,15,7,5,allow
33893,443,60654,443,8623,1758,6865,36,28,17,19,allow
54025,443,49847,443,7653,1188,6465,21,16,12,9,allow
51602,443,19989,443,19664,8943,10721,42,37,22,20,allow
55498,53,62567,53,177,94,83,2,30,1,1,allow
40404,80,22213,80,1502,467,1035,9,180,5,4,allow
19787,53,19787,53,414,268,146,3,32,2,1,allow
40430,80,30893,80,1566,754,812,10,15,6,4,allow
26900,27017,6136,27017,422,164,258,6,30,3,3,allow
65152,53,60141,53,177,94,83,2,30,1,1,allow
48817,6886,48817,6886,491,150,341,2,1200,1,1,allow
6881,47488,39178,47488,150,150,0,2,1200,2,0,allow
56182,80,62619,80,2085,797,1288,10,15,6,4,allow
41763,443,59315,443,9797,1934,7863,21,15,12,9,allow
56744,443,47935,443,6205,986,5219,16,32,10,6,allow
57005,80,30107,80,214,140,74,4,30,3,1,allow
51996,80,49659,80,6518746,206365,6312381,6886,22,2687,4199,allow
57445,66,37294,66,70,70,0,2,8,2,0,allow
51690,80,20015,80,1273,471,802,11,290,6,5,allow
52163,14181,24095,14181,70,70,0,2,8,2,0,allow
10903,53,10903,53,247,98,149,2,32,1,1,allow
52165,49740,56721,49740,70,70,0,2,8,2,0,allow
6775,53,6775,53,228,90,138,2,32,1,1,allow
53930,19831,49369,19831,70,70,0,2,7,2,0,allow
443,35556,443,35556,70,70,0,1,4,1,0,allow
59785,443,14021,443,1077274,41232,1036042,1152,49,455,697,allow
60492,11339,16258,11339,70,70,0,2,8,2,0,allow
50684,80,15318,80,62,62,0,1,5,1,0,allow
55584,53,38540,53,177,94,83,2,29,1,1,allow
53122,443,60812,443,12409,2224,10185,36,26,19,17,allow
54658,6881,23302,6881,705,583,122,6,26,4,2,allow
58002,80,62017,80,2362,1608,754,22,80,12,10,allow
64398,53,23095,53,181,86,95,2,29,1,1,allow
26900,27017,9336,27017,422,164,258,6,30,3,3,allow
42813,443,40546,443,1241645,28525,1213120,1200,65,328,872,allow
65152,53,30200,53,177,94,83,2,30,1,1,allow
41940,443,2811,443,26974,22004,4970,80,216,42,38,allow
54979,53,4787,53,102,102,0,1,59,1,0,allow
65075,53,31161,53,293,94,199,2,29,1,1,allow
55199,53,60419,53,223,78,145,2,30,1,1,allow
26900,27017,55012,27017,422,164,258,6,30,3,3,allow
49861,53,46345,53,261,94,167,2,30,1,1,allow
26900,27017,46101,27017,422,164,258,6,30,3,3,allow
49996,53,34015,53,210,102,108,2,30,1,1,allow
51608,443,59688,443,4646,2347,2299,17,34,9,8,allow
56994,53,32105,53,177,94,83,2,30,1,1,allow
49201,53,24647,53,243,86,157,2,30,1,1,allow
33671,443,8770,443,12536,1564,10972,30,809,13,17,allow
52651,53,52651,53,414,268,146,3,31,2,1,allow
57396,443,49419,443,362,302,60,2,5,1,1,allow
52136,42939,1692,42939,70,70,0,1,5,1,0,allow
54024,443,29413,443,7653,1188,6465,21,16,12,9,allow
56924,53,46939,53,177,94,83,2,30,1,1,allow
51604,443,33369,443,19611,6865,12746,46,37,24,22,allow
26900,27017,12054,27017,422,164,258,6,30,3,3,allow
36946,123,44700,123,184,94,90,2,30,1,1,allow
59038,53,59038,53,832,106,726,2,30,1,1,allow
65403,53,49597,53,359,94,265,2,30,1,1,allow
6755,53,6755,53,247,98,149,2,32,1,1,allow
60489,53151,64380,53151,70,70,0,2,8,2,0,allow
53925,61701,5754,61701,70,70,0,2,8,2,0,allow
53916,23505,16942,23505,70,70,0,1,5,1,0,allow
50684,80,37949,80,66772,4924,61848,110,19,60,50,allow
26900,27017,32007,27017,422,164,258,6,30,3,3,allow
26900,27017,38519,27017,422,164,258,6,30,3,3,allow
51609,443,37311,443,4598,2312,2286,17,34,9,8,allow
65092,53,51583,53,263,94,169,2,30,1,1,allow
65319,53,54613,53,200,94,106,2,30,1,1,allow
57354,53,4539,53,177,94,83,2,30,1,1,allow
50356,443,55689,443,505625,19174,486451,584,143,204,380,allow
58170,443,59368,443,12391,6068,6323,52,133,24,28,allow
55891,443,55891,443,4581,1674,2907,19,30,11,8,allow
57021,443,20461,443,227559,47160,180399,379,143,187,192,allow
54539,80,58817,80,4162,3455,707,14,15,8,6,allow
17840,53,17840,53,414,268,146,3,32,2,1,allow
58732,443,10734,443,1038,502,536,16,33,8,8,allow
53924,45212,48371,45212,70,70,0,2,8,2,0,allow
44979,443,29869,443,130,70,60,3,5,2,1,allow
43513,443,9885,443,224,164,60,3,5,2,1,allow
50629,443,56409,443,70,70,0,1,5,1,0,allow
65515,443,2957,443,419763,12080,407683,429,16,147,282,allow
54021,443,39071,443,7653,1188,6465,21,16,12,9,allow
55067,53,59893,53,178,94,84,2,30,1,1,allow
51603,443,54804,443,19849,6817,13032,45,37,23,22,allow
40554,53,2086,53,223,78,145,2,30,1,1,allow
64470,53,40171,53,261,94,167,2,30,1,1,allow
65194,53,61837,53,402,142,260,2,31,1,1,allow
6881,48947,47849,48947,228,118,110,2,1199,1,1,allow
4544,41599,1547,41599,710,710,0,6,302,6,0,allow
54035,443,14205,443,4454,2001,2453,11,120,6,5,allow
64049,1029,15442,1029,70,70,0,1,5,1,0,allow
57192,53,38984,53,177,94,83,2,30,1,1,allow
6881,6881,10552,6881,238,118,120,2,1200,1,1,allow
52161,19897,63116,19897,70,70,0,2,8,2,0,allow
52135,46475,11599,46475,70,70,0,1,5,1,0,allow
49368,443,7264,443,9482,4710,4772,19,17,11,8,allow
39323,443,25500,443,1394,733,661,14,81,8,6,allow
52004,80,9207,80,84657,4275,80382,105,19,45,60,allow
46212,443,38830,443,67265,57889,9376,174,102,98,76,allow
51137,443,57006,443,9269,5449,3820,70,460,33,37,allow
59177,443,33565,443,280,140,140,5,130,3,2,allow
63046,443,63046,443,4419,1512,2907,19,30,11,8,allow
61988,443,61988,443,4338,1431,2907,19,30,11,8,allow
26900,27017,55723,27017,20322,11404,8918,118,133,67,51,allow
64647,53,58835,53,575,193,382,6,80,3,3,allow
64260,53,38791,53,211,78,133,2,30,1,1,allow
54277,22114,0,0,62,62,0,1,0,1,0,deny
58143,57866,0,0,66,66,0,1,0,1,0,deny
37007,22114,0,0,146,146,0,1,0,1,0,deny
36881,56205,0,0,62,62,0,1,0,1,0,deny
65224,445,0,0,66,66,0,1,0,1,0,drop
53431,445,0,0,70,70,0,1,0,1,0,drop
63213,57866,0,0,62,62,0,1,0,1,0,deny
42228,51050,0,0,66,66,0,1,0,1,0,deny
61591,22114,0,0,146,146,0,1,0,1,0,deny
65080,445,0,0,70,70,0,1,0,1,0,drop
51046,25174,0,0,66,66,0,1,0,1,0,deny
63334,37807,0,0,66,66,0,1,0,1,0,deny
48478,49903,0,0,62,62,0,1,0,1,0,deny
65221,445,0,0,66,66,0,1,0,1,0,drop
40967,1433,0,0,60,60,0,1,0,1,0,deny
61784,49903,0,0,66,66,0,1,0,1,0,deny
57782,57470,0,0,66,66,0,1,0,1,0,deny
65077,445,0,0,70,70,0,1,0,1,0,drop
2238,22114,0,0,62,62,0,1,0,1,0,deny
1024,64147,0,0,62,62,0,1,0,1,0,deny
22350,25174,0,0,66,66,0,1,0,1,0,deny
40967,1433,0,0,60,60,0,1,0,1,0,deny
65215,445,0,0,66,66,0,1,0,1,0,drop
9731,64147,0,0,62,62,0,1,0,1,0,deny
45964,2225,0,0,60,60,0,1,0,1,0,deny
19270,56448,0,0,78,78,0,1,0,1,0,deny
65207,445,0,0,66,66,0,1,0,1,0,drop
7067,22114,0,0,146,146,0,1,0,1,0,deny
56562,44847,0,0,66,66,0,1,0,1,0,deny
31281,30188,0,0,62,62,0,1,0,1,0,deny
65072,445,0,0,70,70,0,1,0,1,0,drop
65071,445,0,0,70,70,0,1,0,1,0,drop
64878,26467,0,0,145,145,0,1,0,1,0,deny
52640,64147,0,0,62,62,0,1,0,1,0,deny
60571,26467,0,0,62,62,0,1,0,1,0,deny
58725,10387,0,0,145,145,0,1,0,1,0,deny
65069,445,0,0,70,70,0,1,0,1,0,drop
61369,64147,0,0,62,62,0,1,0,1,0,deny
34360,25174,0,0,66,66,0,1,0,1,0,deny
58118,22114,0,0,66,66,0,1,0,1,0,deny
53423,445,0,0,70,70,0,1,0,1,0,drop
53419,445,0,0,70,70,0,1,0,1,0,drop
53418,445,0,0,70,70,0,1,0,1,0,drop
1594,44847,0,0,62,62,0,1,0,1,0,deny
65198,445,0,0,66,66,0,1,0,1,0,drop
65195,445,0,0,66,66,0,1,0,1,0,drop
65192,445,0,0,66,66,0,1,0,1,0,drop
65199,445,0,0,66,66,0,1,0,1,0,drop
65196,445,0,0,66,66,0,1,0,1,0,drop
65197,445,0,0,66,66,0,1,0,1,0,drop
65193,445,0,0,66,66,0,1,0,1,0,drop
65191,445,0,0,66,66,0,1,0,1,0,drop
57677,23,0,0,60,60,0,1,0,1,0,deny
64811,51221,0,0,66,66,0,1,0,1,0,deny
56952,22114,0,0,146,146,0,1,0,1,0,deny
58751,51221,0,0,62,62,0,1,0,1,0,deny
64847,22114,0,0,66,66,0,1,0,1,0,deny
42094,35440,0,0,62,62,0,1,0,1,0,deny
1968,23,0,0,60,60,0,1,0,1,0,deny
51076,25174,0,0,146,146,0,1,0,1,0,deny
56639,48817,0,0,66,66,0,1,0,1,0,deny
65062,445,0,0,70,70,0,1,0,1,0,drop
25457,25604,0,0,62,62,0,1,0,1,0,deny
65060,445,0,0,70,70,0,1,0,1,0,drop
46604,57866,0,0,62,62,0,1,0,1,0,deny
55893,45711,0,0,78,78,0,1,0,1,0,deny
53416,445,0,0,70,70,0,1,0,1,0,drop
53408,445,0,0,70,70,0,1,0,1,0,drop
53404,445,0,0,70,70,0,1,0,1,0,drop
53403,445,0,0,70,70,0,1,0,1,0,drop
65059,445,0,0,70,70,0,1,0,1,0,drop
56578,25174,0,0,62,62,0,1,0,1,0,deny
19204,57866,0,0,62,62,0,1,0,1,0,deny
38629,25174,0,0,66,66,0,1,0,1,0,deny
18577,25174,0,0,62,62,0,1,0,1,0,deny
65058,445,0,0,70,70,0,1,0,1,0,drop
65057,445,0,0,70,70,0,1,0,1,0,drop
65178,445,0,0,66,66,0,1,0,1,0,drop
65177,445,0,0,66,66,0,1,0,1,0,drop
65176,445,0,0,66,66,0,1,0,1,0,drop
57471,62413,0,0,62,62,0,1,0,1,0,deny
65055,445,0,0,70,70,0,1,0,1,0,drop
65051,445,0,0,70,70,0,1,0,1,0,drop
3765,64147,0,0,66,66,0,1,0,1,0,deny
7905,22114,0,0,62,62,0,1,0,1,0,deny
60337,30188,0,0,66,66,0,1,0,1,0,deny
31785,25174,0,0,146,146,0,1,0,1,0,deny
62043,25174,0,0,62,62,0,1,0,1,0,deny
64334,25174,0,0,66,66,0,1,0,1,0,deny
60485,22114,0,0,66,66,0,1,0,1,0,deny
0,0,0,0,156,156,0,2,0,2,0,deny
0,0,0,0,156,156,0,2,0,2,0,deny
0,0,0,0,156,156,0,2,0,2,0,deny
0,0,0,0,156,156,0,2,0,2,0,deny
0,0,0,0,102,102,0,1,0,1,0,deny
61609,25174,0,0,146,146,0,1,0,1,0,deny
51313,25174,0,0,66,66,0,1,0,1,0,deny
50593,64147,0,0,62,62,0,1,0,1,0,deny
56377,51505,0,0,66,66,0,1,0,1,0,deny
12794,35440,0,0,146,146,0,1,0,1,0,deny
53398,445,0,0,70,70,0,1,0,1,0,drop
60049,25174,0,0,66,66,0,1,0,1,0,deny
65039,445,0,0,70,70,0,1,0,1,0,drop
65038,445,0,0,70,70,0,1,0,1,0,drop
65034,445,0,0,70,70,0,1,0,1,0,drop
27055,25174,0,0,62,62,0,1,0,1,0,deny
53395,445,0,0,70,70,0,1,0,1,0,drop
53394,445,0,0,70,70,0,1,0,1,0,drop
53392,445,0,0,70,70,0,1,0,1,0,drop
65029,445,0,0,70,70,0,1,0,1,0,drop
65028,445,0,0,70,70,0,1,0,1,0,drop
11056,6881,0,0,146,146,0,1,0,1,0,deny
55250,25174,0,0,146,146,0,1,0,1,0,deny
54043,36237,0,0,66,66,0,1,0,1,0,deny
3580,25174,0,0,62,62,0,1,0,1,0,deny
57761,15503,0,0,66,66,0,1,0,1,0,deny
2919,37965,0,0,62,62,0,1,0,1,0,deny
52699,25174,0,0,62,62,0,1,0,1,0,deny
25009,35440,0,0,66,66,0,1,0,1,0,deny
22542,30188,0,0,62,62,0,1,0,1,0,deny
63786,25174,0,0,62,62,0,1,0,1,0,deny
65017,445,0,0,70,70,0,1,0,1,0,drop
53380,445,0,0,70,70,0,1,0,1,0,deny
53379,445,0,0,70,70,0,1,0,1,0,drop
53375,445,0,0,70,70,0,1,0,1,0,drop
6486,64147,0,0,66,66,0,1,0,1,0,deny
54189,22114,0,0,66,66,0,1,0,1,0,deny
65165,445,0,0,66,66,0,1,0,1,0,drop
10627,23117,0,0,66,66,0,1,0,1,0,deny
55082,25174,0,0,62,62,0,1,0,1,0,deny
58091,51505,0,0,62,62,0,1,0,1,0,deny
37834,30349,0,0,145,145,0,1,0,1,0,deny
63173,36237,0,0,62,62,0,1,0,1,0,deny
54542,25604,0,0,66,66,0,1,0,1,0,deny
12457,57866,0,0,66,66,0,1,0,1,0,deny
65013,445,0,0,70,70,0,1,0,1,0,drop
24616,48983,0,0,146,146,0,1,0,1,0,deny
58079,50584,0,0,66,66,0,1,0,1,0,deny
30583,25174,0,0,66,66,0,1,0,1,0,deny
23519,25174,0,0,62,62,0,1,0,1,0,deny
53373,445,0,0,70,70,0,1,0,1,0,drop
32474,48817,0,0,148,148,0,1,0,1,0,deny
18655,44847,0,0,66,66,0,1,0,1,0,deny
52130,1035,52488,1035,66,66,0,1,5,1,0,allow
41630,15000,14960,15000,130,70,60,2,5,1,1,allow
46409,80,19897,80,4674,767,3907,17,15,9,8,allow
56263,443,47325,443,101747,13436,88311,135,319,53,82,allow
55521,53,16753,53,711,87,624,2,30,1,1,allow
60491,38789,32066,38789,320,140,180,6,7,3,3,allow
58888,443,23971,443,7329,949,6380,17,35,7,10,allow
56112,80,39554,80,8113,1082,7031,19,16,10,9,allow
9439,443,40829,443,6092,775,5317,17,25,9,8,allow
55440,53,50711,53,711,87,624,2,30,1,1,allow
9430,443,49322,443,6094,771,5323,17,26,9,8,allow
59810,443,33915,443,630054,19786,610268,711,381,261,450,allow
54957,53,36470,53,99,99,0,1,30,1,0,allow
49394,443,62275,443,1392,731,661,14,80,8,6,allow
62120,443,62120,443,4378,1471,2907,19,27,11,8,allow
9432,443,6777,443,6094,771,5323,17,26,9,8,allow
56110,80,5106,80,31087,1654,29433,42,16,18,24,allow
58890,15000,13228,15000,138,78,60,2,5,1,1,allow
64898,53,23347,53,487,201,286,6,37,3,3,allow
49878,53,34561,53,216,94,122,2,30,1,1,allow
13794,3389,13794,3389,3910,1805,2105,20,19,12,8,allow
55772,53,55772,53,194,87,107,2,30,1,1,allow
37319,80,37445,80,1056,682,374,10,15,6,4,allow
9442,443,1324,443,6100,777,5323,17,25,9,8,allow
49396,443,4932,443,1394,733,661,14,80,8,6,allow
9437,443,16715,443,6285,839,5446,19,25,10,9,allow
52133,15015,35766,15015,66,66,0,1,5,1,0,allow
56998,53,8754,53,170,87,83,2,31,1,1,allow
55032,443,43927,443,12704,3182,9522,35,49,16,19,allow
52348,80,52348,80,2910,1489,1421,10,16,6,4,allow
52131,28980,37358,28980,66,66,0,1,5,1,0,allow
56808,53,41016,53,90,90,0,1,30,1,0,allow
55568,443,60113,443,8979,5057,3922,89,110,51,38,allow
56994,53,65507,53,170,87,83,2,30,1,1,allow
55957,53,38699,53,172,88,84,2,30,1,1,allow
56273,53,61553,53,194,99,95,2,30,1,1,allow
50584,53,13408,53,793,101,692,2,30,1,1,allow
37682,5228,19029,5228,5554,755,4799,14,3600,8,6,allow
54888,443,50282,443,1775,169,1606,7,122,3,4,allow
65498,53,22566,53,752,93,659,2,31,1,1,allow
15503,61471,17657,61471,490,149,341,2,1200,1,1,allow
22571,51505,0,0,62,62,0,1,0,1,0,deny
6121,51505,0,0,66,66,0,1,0,1,0,deny
53366,445,0,0,70,70,0,1,0,1,0,drop
65003,445,0,0,70,70,0,1,0,1,0,drop
65002,445,0,0,70,70,0,1,0,1,0,drop
65001,445,0,0,70,70,0,1,0,1,0,drop
37075,48817,0,0,62,62,0,1,0,1,0,deny
65000,445,0,0,70,70,0,1,0,1,0,drop
57557,64147,0,0,66,66,0,1,0,1,0,deny
64997,445,0,0,70,70,0,1,0,1,0,drop
65150,445,0,0,66,66,0,1,0,1,0,drop
65147,445,0,0,66,66,0,1,0,1,0,drop
47063,15503,0,0,146,146,0,1,0,1,0,deny
54440,26467,0,0,66,66,0,1,0,1,0,deny
53360,445,0,0,70,70,0,1,0,1,0,drop
53358,445,0,0,70,70,0,1,0,1,0,drop
53354,445,0,0,70,70,0,1,0,1,0,drop
53352,445,0,0,70,70,0,1,0,1,0,drop
27811,57866,0,0,146,146,0,1,0,1,0,deny
55246,31573,0,0,66,66,0,1,0,1,0,deny
64990,445,0,0,70,70,0,1,0,1,0,drop
53838,36829,0,0,66,66,0,1,0,1,0,deny
65143,445,0,0,66,66,0,1,0,1,0,drop
26239,25174,0,0,66,66,0,1,0,1,0,deny
64808,27098,0,0,66,66,0,1,0,1,0,deny
65135,445,0,0,66,66,0,1,0,1,0,drop
65136,445,0,0,66,66,0,1,0,1,0,drop
65138,445,0,0,66,66,0,1,0,1,0,drop
65130,445,0,0,66,66,0,1,0,1,0,drop
65131,445,0,0,66,66,0,1,0,1,0,drop
65132,445,0,0,66,66,0,1,0,1,0,drop
65128,445,0,0,66,66,0,1,0,1,0,drop
53346,445,0,0,70,70,0,1,0,1,0,drop
56793,56205,0,0,62,62,0,1,0,1,0,deny
45944,44847,0,0,62,62,0,1,0,1,0,deny
64981,445,0,0,70,70,0,1,0,1,0,drop
33401,51505,0,0,62,62,0,1,0,1,0,deny
64980,445,0,0,70,70,0,1,0,1,0,drop
53343,445,0,0,70,70,0,1,0,1,0,drop
53342,445,0,0,70,70,0,1,0,1,0,drop
53340,445,0,0,70,70,0,1,0,1,0,drop
60976,22114,0,0,62,62,0,1,0,1,0,deny
52091,11392,0,0,62,62,0,1,0,1,0,deny
11235,30188,0,0,66,66,0,1,0,1,0,deny
1030,35776,0,0,139,139,0,1,0,1,0,deny
29884,25174,0,0,62,62,0,1,0,1,0,deny
64974,445,0,0,70,70,0,1,0,1,0,drop
64973,445,0,0,70,70,0,1,0,1,0,drop
17280,22114,0,0,62,62,0,1,0,1,0,deny
49894,1433,0,0,60,60,0,1,0,1,0,deny
49894,1433,0,0,60,60,0,1,0,1,0,deny
27841,35894,0,0,62,62,0,1,0,1,0,deny
62339,25174,0,0,66,66,0,1,0,1,0,deny
52358,30188,0,0,66,66,0,1,0,1,0,deny
31845,55777,0,0,62,62,0,1,0,1,0,deny
58955,57470,0,0,74,74,0,1,0,1,0,deny
59493,44847,0,0,66,66,0,1,0,1,0,deny
53337,445,0,0,70,70,0,1,0,1,0,drop
53336,445,0,0,70,70,0,1,0,1,0,drop
53335,445,0,0,70,70,0,1,0,1,0,drop
34772,15503,0,0,146,146,0,1,0,1,0,deny
65121,445,0,0,66,66,0,1,0,1,0,drop
53330,445,0,0,70,70,0,1,0,1,0,drop
64969,445,0,0,70,70,0,1,0,1,0,drop
65120,445,0,0,66,66,0,1,0,1,0,drop
65117,445,0,0,66,66,0,1,0,1,0,drop
42065,53,0,0,86,86,0,1,30,1,0,allow
24486,53,24486,53,414,268,146,3,31,2,1,allow
123,123,26744,123,184,94,90,2,30,1,1,allow
25436,53,25436,53,220,90,130,2,30,1,1,allow
52086,80,55343,80,2703,632,2071,12,22,7,5,allow
9456,443,36831,443,6096,777,5319,17,25,9,8,allow
54811,443,21381,443,3392,2305,1087,22,80,11,11,allow
64045,7426,33466,7426,70,70,0,1,4,1,0,allow
64047,16221,14226,16221,70,70,0,1,4,1,0,allow
55716,36989,39721,36989,320,140,180,6,6,3,3,allow
52132,55014,27986,55014,70,70,0,1,4,1,0,allow
9455,443,43647,443,6096,777,5319,17,25,9,8,allow
56414,53,12496,53,178,94,84,2,29,1,1,allow
55957,53,35891,53,178,94,84,2,29,1,1,allow
52134,18470,56970,18470,70,70,0,1,4,1,0,allow
55957,53,33865,53,178,94,84,2,30,1,1,allow
52853,443,21647,443,9582,3906,5676,21,135,10,11,allow
37965,18122,9264,18122,3957,2324,1633,51,1794,29,22,allow
59377,443,61380,443,43483,26315,17168,86,62,54,32,allow
60136,443,31780,443,21278,12533,8745,57,183,36,21,allow
56922,53,40001,53,168,86,82,2,30,1,1,allow
47230,443,43067,443,9930,3002,6928,34,120,17,17,allow
60703,443,30992,443,66716,4091,62625,98,278,43,55,allow
56126,53,5534,53,177,94,83,2,30,1,1,allow
64852,53,45042,53,209,110,99,2,30,1,1,allow
58808,80,14493,80,2295,1574,721,10,375,6,4,allow
64966,53,61255,53,347,100,247,4,49,2,2,allow
52206,443,46301,443,6278,682,5596,17,20,8,9,allow
38709,443,40146,443,398925,9369,389556,391,16,123,268,allow
55705,54638,46726,54638,504,318,186,8,15,5,3,allow
56273,53,51229,53,197,102,95,2,33,1,1,allow
63873,61002,7411,61002,5431,3164,2267,32,76,18,14,allow
49768,53,39040,53,459,103,356,4,43,2,2,allow
55704,13343,3338,13343,564,318,246,9,15,5,4,allow
49369,443,29095,443,7165,1099,6066,16,15,9,7,allow
61391,443,41670,443,11151,3001,8150,51,365,25,26,allow
18157,53,35666,53,215,94,121,2,30,1,1,allow
37590,443,37590,443,4572,1665,2907,19,27,11,8,allow
57149,53,34608,53,382,94,288,2,30,1,1,allow
63141,55860,18547,55860,316,190,126,5,15,3,2,allow
49435,53,64990,53,608,199,409,6,69,3,3,allow
53166,39564,63800,39564,70,70,0,1,5,1,0,allow
56654,53,47578,53,102,102,0,1,30,1,0,allow
65035,53,56043,53,234,102,132,2,30,1,1,allow
56998,53,31320,53,177,94,83,2,30,1,1,allow
56998,53,64754,53,177,94,83,2,30,1,1,allow
62995,53,21772,53,102,102,0,1,30,1,0,allow
53166,53,17813,53,168,78,90,2,30,1,1,allow
33861,443,34883,443,8084,2638,5446,26,20,14,12,allow
47957,443,9309,443,7658,4247,3411,29,31,15,14,allow
65374,53,40635,53,376,102,274,4,47,2,2,allow
64932,53,8604,53,230,102,128,2,30,1,1,allow
57121,53,54174,53,257,110,147,2,30,1,1,allow
65352,53,23820,53,416,102,314,2,30,1,1,allow
34981,80,29727,80,1658,1344,314,10,15,5,5,allow
5924,53,5924,53,220,90,130,2,30,1,1,allow
56600,443,42581,443,13773,6668,7105,31,105,19,12,allow
65323,53,53376,53,247,118,129,2,30,1,1,allow
64406,53,3194,53,102,102,0,1,30,1,0,allow
57158,53,11939,53,969,86,883,2,30,1,1,allow
42578,443,22827,443,68806,2442,66364,71,215,19,52,allow
39325,443,37130,443,1396,735,661,14,80,8,6,allow
46525,53,46525,53,404,259,145,3,32,2,1,allow
55713,47783,7321,47783,70,70,0,2,8,2,0,allow
52162,15104,33803,15104,70,70,0,2,7,2,0,allow
65514,443,30386,443,92638,4519,88119,105,15,39,66,allow
64048,44918,54494,44918,70,70,0,1,4,1,0,allow
42569,443,10285,443,7284,1456,5828,21,360,10,11,allow
52177,21079,54277,21079,316,136,180,6,5,3,3,allow
9445,443,7220,443,6094,771,5323,17,25,9,8,allow
64041,80,63585,80,314,192,122,6,15,4,2,allow
40709,443,9964,443,5565,1382,4183,22,158,11,11,allow
49196,53,18490,53,230,91,139,3,47,2,1,allow
49293,5223,22335,5223,202,142,60,2,15,1,1,allow
49746,53,11363,53,236,94,142,2,29,1,1,allow
51174,80,58764,80,1658,1344,314,10,15,5,5,allow
10963,53,53121,53,177,86,91,2,30,1,1,allow
65313,53,20235,53,802,288,514,8,75,4,4,allow
57354,53,26026,53,177,94,83,2,29,1,1,allow
55048,53,48265,53,215,94,121,2,29,1,1,allow
49432,53,40864,53,338,118,220,2,29,1,1,allow
57273,53,29269,53,177,94,83,2,30,1,1,allow
53791,53,19031,53,102,102,0,1,30,1,0,allow
52758,53,52758,53,197,90,107,2,30,1,1,allow
51166,53,27662,53,168,78,90,2,30,1,1,allow
55218,53,56966,53,402,142,260,2,30,1,1,allow
56994,53,35888,53,177,94,83,2,30,1,1,allow
54553,53,37407,53,102,102,0,1,30,1,0,allow
55305,53,21908,53,94,94,0,1,30,1,0,allow
36502,53,33412,53,168,78,90,2,30,1,1,allow
45186,443,63714,443,5959,169,5790,10,121,3,7,allow
32971,443,64078,443,12597,6029,6568,36,267,15,21,allow
46351,53,46351,53,262,106,156,2,31,1,1,allow
53929,60741,10876,60741,320,140,180,6,6,3,3,allow
49455,53,42395,53,1750,184,1566,6,85,3,3,allow
49766,53,54774,53,234,102,132,2,30,1,1,allow
60438,53,64563,53,78,78,0,1,30,1,0,allow
58863,443,30901,443,4546411,95150,4451261,4312,109,1197,3115,allow
37513,443,37513,443,4347,1440,2907,19,30,11,8,allow
56558,443,56558,443,4656,1749,2907,19,27,11,8,allow
19253,53,19253,53,414,268,146,3,32,2,1,allow
55786,53,55786,53,247,98,149,2,32,1,1,allow
52052,80,13756,80,2308,1541,767,11,18,7,4,allow
57273,53,15438,53,177,94,83,2,30,1,1,allow
59182,53,59092,53,168,78,90,2,30,1,1,allow
32860,53,58856,53,168,78,90,2,30,1,1,allow
56922,53,64459,53,168,86,82,2,30,1,1,allow
20270,3478,6426,3478,443,294,149,2,300,1,1,allow
37437,443,24632,443,4809,818,3991,15,15,8,7,allow
52159,16297,7644,16297,70,70,0,2,8,2,0,allow
50212,1688,56560,1688,70,70,0,2,8,2,0,allow
51989,80,41304,80,4166,1708,2458,14,16,7,7,allow
45057,443,6642,443,7536,1915,5621,31,20,17,14,allow
50387,80,54775,80,8105,3187,4918,18,24,9,9,allow
64631,53,53048,53,226,102,124,2,30,1,1,allow
61637,53,21621,53,86,86,0,1,30,1,0,allow
55445,53,8991,53,102,102,0,1,30,1,0,allow
56994,53,19050,53,177,94,83,2,30,1,1,allow
50265,53606,10997,53606,528,528,0,9,1200,9,0,allow
51811,443,43399,443,4007,2063,1944,12,122,6,6,allow
50545,443,51366,443,9654,1771,7883,27,186,14,13,allow
55435,443,60769,443,684908,25994,658914,762,141,263,499,allow
57408,53,58963,53,195,102,93,2,33,1,1,allow
15450,53,15450,53,216,82,134,2,33,1,1,allow
52127,44198,61078,44198,70,70,0,1,5,1,0,allow
49367,443,60799,443,22639,7456,15183,32,16,17,15,allow
50634,53,32177,53,218,86,132,2,30,1,1,allow
44099,443,23895,443,8049289,98432,7950857,6501,125,717,5784,allow
55160,443,10978,443,333522,14341,319181,347,129,109,238,allow
49219,80,41190,80,2010,664,1346,11,84,7,4,allow
64764,53,35102,53,211,102,109,2,30,1,1,allow
50426,53,48591,53,889,404,485,10,30,5,5,allow
56126,53,21706,53,177,94,83,2,30,1,1,allow
49702,53,29408,53,771,102,669,2,31,1,1,allow
44886,443,1331,443,7775,2973,4802,36,57,19,17,allow
54986,53,53684,53,164,78,86,2,30,1,1,allow
36291,53,42350,53,199,94,105,2,31,1,1,allow
59605,443,24489,443,4507,1525,2982,24,148,13,11,allow
65116,445,0,0,66,66,0,1,0,1,0,drop
50493,15503,0,0,146,146,0,1,0,1,0,deny
64968,445,0,0,70,70,0,1,0,1,0,drop
54189,64147,0,0,66,66,0,1,0,1,0,deny
42558,64147,0,0,62,62,0,1,0,1,0,deny
65115,445,0,0,66,66,0,1,0,1,0,drop
58021,22114,0,0,62,62,0,1,0,1,0,deny
56326,56205,0,0,66,66,0,1,0,1,0,deny
59153,35440,0,0,66,66,0,1,0,1,0,deny
53327,445,0,0,70,70,0,1,0,1,0,drop
5617,64147,0,0,145,145,0,1,0,1,0,deny
64963,445,0,0,70,70,0,1,0,1,0,drop
24292,48817,0,0,148,148,0,1,0,1,0,deny
7891,25174,0,0,66,66,0,1,0,1,0,deny
53317,445,0,0,70,70,0,1,0,1,0,drop
53316,445,0,0,70,70,0,1,0,1,0,drop
50946,44847,0,0,66,66,0,1,0,1,0,deny
47342,20541,0,0,66,66,0,1,0,1,0,deny
65103,445,0,0,66,66,0,1,0,1,0,drop
60308,37965,0,0,66,66,0,1,0,1,0,deny
53692,44512,0,0,66,66,0,1,0,1,0,deny
61000,15503,0,0,146,146,0,1,0,1,0,deny
12318,41864,0,0,139,139,0,1,0,1,0,deny
56202,15503,0,0,146,146,0,1,0,1,0,deny
12616,23,0,0,60,60,0,1,0,1,0,deny
59326,57470,0,0,74,74,0,1,0,1,0,deny
56604,17372,0,0,66,66,0,1,0,1,0,deny
11030,17372,0,0,62,62,0,1,0,1,0,deny
42030,25,0,0,74,74,0,1,0,1,0,deny
3090,1,0,0,66,66,0,1,0,1,0,deny
63873,44847,0,0,66,66,0,1,0,1,0,deny
56219,22114,0,0,66,66,0,1,0,1,0,deny
46275,64147,0,0,62,62,0,1,0,1,0,deny
443,14591,0,0,131,131,0,1,0,1,0,deny
993,58185,0,0,129,129,0,1,0,1,0,deny
65096,445,0,0,66,66,0,1,0,1,0,drop
53302,445,0,0,70,70,0,1,0,1,0,drop
64950,445,0,0,70,70,0,1,0,1,0,drop
45964,2225,0,0,60,60,0,1,0,1,0,deny
61730,25320,0,0,66,66,0,1,0,1,0,deny
55429,25174,0,0,66,66,0,1,0,1,0,deny
58646,44847,0,0,62,62,0,1,0,1,0,deny
64947,445,0,0,70,70,0,1,0,1,0,drop
12616,23,0,0,60,60,0,1,0,1,0,deny
65093,445,0,0,66,66,0,1,0,1,0,drop
64772,64147,0,0,66,66,0,1,0,1,0,deny
55069,44847,0,0,66,66,0,1,0,1,0,deny
62392,15503,0,0,146,146,0,1,0,1,0,deny
56679,5900,0,0,60,60,0,1,0,1,0,deny
65085,445,0,0,66,66,0,1,0,1,0,drop
65078,445,0,0,66,66,0,1,0,1,0,drop
7360,14914,0,0,157,157,0,1,0,1,0,deny
64942,445,0,0,70,70,0,1,0,1,0,drop
54007,50265,0,0,66,66,0,1,0,1,0,deny
64941,445,0,0,70,70,0,1,0,1,0,drop
4138,55777,0,0,66,66,0,1,0,1,0,deny
64939,445,0,0,70,70,0,1,0,1,0,drop
54758,35993,0,0,62,62,0,1,0,1,0,deny
14869,44847,0,0,62,62,0,1,0,1,0,deny
56205,51505,0,0,66,66,0,1,0,1,0,deny
55893,45711,0,0,78,78,0,1,0,1,0,deny
31539,37965,0,0,62,62,0,1,0,1,0,deny
53294,445,0,0,70,70,0,1,0,1,0,drop
53292,445,0,0,70,70,0,1,0,1,0,drop
53291,445,0,0,70,70,0,1,0,1,0,drop
65063,445,0,0,66,66,0,1,0,1,0,drop
65065,445,0,0,66,66,0,1,0,1,0,drop
65069,445,0,0,66,66,0,1,0,1,0,drop
65066,445,0,0,66,66,0,1,0,1,0,drop
65070,445,0,0,66,66,0,1,0,1,0,drop
65068,445,0,0,66,66,0,1,0,1,0,drop
65071,445,0,0,66,66,0,1,0,1,0,drop
65067,445,0,0,66,66,0,1,0,1,0,drop
58421,30188,0,0,66,66,0,1,0,1,0,deny
8560,50584,0,0,66,66,0,1,0,1,0,deny
64932,445,0,0,70,70,0,1,0,1,0,drop
14208,51221,0,0,66,66,0,1,0,1,0,deny
13528,51221,0,0,62,62,0,1,0,1,0,deny
38053,50584,0,0,62,62,0,1,0,1,0,deny
64930,445,0,0,70,70,0,1,0,1,0,drop
6126,25174,0,0,62,62,0,1,0,1,0,deny
54280,3385,0,0,60,60,0,1,0,1,0,deny
32307,22114,0,0,146,146,0,1,0,1,0,deny
11337,15503,0,0,62,62,0,1,0,1,0,deny
52430,22114,0,0,62,62,0,1,0,1,0,deny
64929,445,0,0,70,70,0,1,0,1,0,drop
57420,22114,0,0,62,62,0,1,0,1,0,deny
64928,445,0,0,70,70,0,1,0,1,0,drop
53289,445,0,0,70,70,0,1,0,1,0,drop
53287,445,0,0,70,70,0,1,0,1,0,drop
53283,445,0,0,70,70,0,1,0,1,0,drop
53277,445,0,0,70,70,0,1,0,1,0,drop
64927,445,0,0,70,70,0,1,0,1,0,drop
51769,17,0,0,60,60,0,1,0,1,0,deny
64921,445,0,0,70,70,0,1,0,1,0,drop
64922,445,0,0,70,70,0,1,0,1,0,drop
17262,25174,0,0,62,62,0,1,0,1,0,deny
59214,57866,0,0,66,66,0,1,0,1,0,deny
65050,445,0,0,66,66,0,1,0,1,0,drop
65049,445,0,0,66,66,0,1,0,1,0,drop
65047,445,0,0,66,66,0,1,0,1,0,drop
993,49276,0,0,129,129,0,1,0,1,0,deny
53669,23,0,0,60,60,0,1,0,1,0,deny
51533,44847,0,0,66,66,0,1,0,1,0,deny
64909,445,0,0,70,70,0,1,0,1,0,drop
64908,445,0,0,70,70,0,1,0,1,0,drop
64904,445,0,0,70,70,0,1,0,1,0,drop
55899,57470,0,0,78,78,0,1,0,1,0,deny
64898,445,0,0,70,70,0,1,0,1,0,drop
62197,22114,0,0,66,66,0,1,0,1,0,deny
60000,1879,0,0,145,145,0,1,0,1,0,deny
64899,445,0,0,70,70,0,1,0,1,0,drop
53270,445,0,0,70,70,0,1,0,1,0,drop
52280,44847,0,0,66,66,0,1,0,1,0,deny
53265,445,0,0,70,70,0,1,0,1,0,drop
53263,445,0,0,70,70,0,1,0,1,0,drop
53259,445,0,0,70,70,0,1,0,1,0,drop
62575,12207,0,0,66,66,0,1,0,1,0,deny
53160,25174,0,0,62,62,0,1,0,1,0,deny
64324,37807,0,0,146,146,0,1,0,1,0,deny
60606,3389,0,0,60,60,0,1,0,1,0,deny
19875,30170,0,0,145,145,0,1,0,1,0,deny
55312,64147,0,0,66,66,0,1,0,1,0,deny
12878,25174,0,0,146,146,0,1,0,1,0,deny
29178,35440,0,0,62,62,0,1,0,1,0,deny
38330,44847,0,0,66,66,0,1,0,1,0,deny
64733,35440,0,0,62,62,0,1,0,1,0,deny
45964,55559,0,0,60,60,0,1,0,1,0,deny
53381,25174,0,0,66,66,0,1,0,1,0,deny
22220,25174,0,0,62,62,0,1,0,1,0,deny
64887,445,0,0,70,70,0,1,0,1,0,drop
56400,35440,0,0,66,66,0,1,0,1,0,deny
5060,37965,0,0,66,66,0,1,0,1,0,deny
49485,56972,0,0,66,66,0,1,0,1,0,deny
55605,53,56113,53,196,100,96,2,30,1,1,allow
39682,443,54017,443,4439,862,3577,16,160,9,7,allow
60996,443,58632,443,6043,1568,4475,11,120,4,7,allow
55703,13836,63794,13836,70,70,0,1,5,1,0,allow
52124,11296,48870,11296,66,66,0,1,5,1,0,allow
52154,4635,63801,4635,70,70,0,2,8,2,0,allow
30960,45751,20805,45751,66,66,0,1,3600,1,0,allow
51595,443,49515,443,10614,5312,5302,25,91,14,11,allow
37654,443,34226,443,12531,5566,6965,34,46,20,14,allow
46863,15000,49470,15000,130,70,60,2,5,1,1,allow
62055,443,14508,443,11694,4947,6747,34,48,19,15,allow
56099,53,33681,53,701,88,613,2,30,1,1,allow
56228,53,46587,53,711,87,624,2,30,1,1,allow
38658,443,22719,443,1294,864,430,12,81,7,5,allow
58149,443,24568,443,153,93,60,2,5,1,1,allow
50920,443,56379,443,3440,2371,1069,17,96,10,7,allow
62064,443,63626,443,11582,2503,9079,33,47,17,16,allow
57408,53,58813,53,190,97,93,2,30,1,1,allow
46792,443,1807,443,7298,2661,4637,21,18,11,10,allow
56374,53,54087,53,711,87,624,2,30,1,1,allow
50585,80,63970,80,1726,963,763,13,80,7,6,allow
37655,443,41125,443,9811,3415,6396,29,46,17,12,allow
37649,443,13055,443,32391,21443,10948,69,47,41,28,allow
47969,443,44705,443,10825,4667,6158,25,159,15,10,allow
58402,53,52417,53,578,286,292,9,15,5,4,allow
37453,443,30746,443,8891,1846,7045,27,147,14,13,allow
57368,53,6129,53,701,88,613,2,30,1,1,allow
37656,443,58778,443,9875,3479,6396,29,46,17,12,allow
52129,55550,34471,55550,66,66,0,1,5,1,0,allow
53976,443,65435,443,9921,2236,7685,35,32,17,18,allow
60487,1134,43276,1134,70,70,0,2,8,2,0,allow
59148,443,64998,443,26615,22329,4286,52,272,30,22,allow
49240,53,28241,53,198,101,97,2,30,1,1,allow
55830,53,42279,53,170,87,83,2,30,1,1,allow
61712,443,30612,443,7443,2692,4751,19,76,11,8,allow
43057,443,23412,443,7725,1980,5745,25,20,14,11,allow
41803,443,1948,443,11804,4009,7795,41,150,21,20,allow
30960,45758,64660,45758,462,462,0,8,3632,8,0,allow
60486,8999,61783,8999,70,70,0,2,8,2,0,allow
57248,443,46396,443,4113,1387,2726,15,36,8,7,allow
57246,8525,57246,8525,138,78,60,2,5,1,1,allow
58664,53,14984,53,192,90,102,2,30,1,1,allow
65316,53,63877,53,780,93,687,2,30,1,1,allow
56738,53,36120,53,264,87,177,4,37,2,2,allow
55601,53,41824,53,815,95,720,2,30,1,1,allow
55850,53,58369,53,816,97,719,2,30,1,1,allow
50408,53,36344,53,182,93,89,2,31,1,1,allow
62188,443,50318,443,6973,2413,4560,22,148,11,11,allow
6882,5406,43769,5406,654,150,504,3,1200,1,2,allow
50579,53,55360,53,174,89,85,2,31,1,1,allow
49708,53,5780,53,172,88,84,2,31,1,1,allow
64125,53,8672,53,198,101,97,2,31,1,1,allow
55308,443,11904,443,14364,4095,10269,33,404,13,20,allow
56249,443,29498,443,80340,72269,8071,106,122,65,41,allow
51662,443,4972,443,7532,3051,4481,13,121,6,7,allow
50584,34393,36839,34393,509,150,359,2,1200,1,1,allow
56848,53,54786,53,764,99,665,2,31,1,1,allow
61528,443,29665,443,138544,7073,131471,165,144,59,106,allow
39617,80,39617,80,419378,16035,403343,506,132,226,280,allow
37014,25174,0,0,66,66,0,1,0,1,0,deny
9504,25174,0,0,146,146,0,1,0,1,0,deny
53250,445,0,0,70,70,0,1,0,1,0,drop
53252,445,0,0,70,70,0,1,0,1,0,drop
53247,445,0,0,70,70,0,1,0,1,0,drop
43747,22114,0,0,62,62,0,1,0,1,0,deny
62250,23117,0,0,66,66,0,1,0,1,0,deny
65038,445,0,0,66,66,0,1,0,1,0,drop
61785,64147,0,0,66,66,0,1,0,1,0,deny
51783,50584,0,0,62,62,0,1,0,1,0,deny
40845,64147,0,0,62,62,0,1,0,1,0,deny
64883,445,0,0,70,70,0,1,0,1,0,drop
54502,443,10226,443,6750,1755,4995,16,103,9,7,allow
65529,53,12629,53,199,102,97,2,30,1,1,allow
45364,443,12194,443,9276,2422,6854,25,186,14,11,allow
54518,25174,0,0,62,62,0,1,0,1,0,deny
50708,22114,0,0,62,62,0,1,0,1,0,deny
48350,57470,0,0,74,74,0,1,0,1,0,deny
64872,445,0,0,70,70,0,1,0,1,0,drop
64874,445,0,0,70,70,0,1,0,1,0,drop
64871,445,0,0,70,70,0,1,0,1,0,drop
53245,445,0,0,70,70,0,1,0,1,0,drop
46879,37807,0,0,146,146,0,1,0,1,0,deny
45941,23386,0,0,60,60,0,1,0,1,0,deny
64869,445,0,0,70,70,0,1,0,1,0,drop
53244,445,0,0,70,70,0,1,0,1,0,drop
64867,445,0,0,70,70,0,1,0,1,0,drop
55477,22114,0,0,146,146,0,1,0,1,0,deny
65332,56205,0,0,66,66,0,1,0,1,0,deny
54011,44847,0,0,66,66,0,1,0,1,0,deny
51930,57470,0,0,66,66,0,1,0,1,0,deny
2780,23117,0,0,66,66,0,1,0,1,0,deny
40120,23,0,0,60,60,0,1,0,1,0,deny
5826,26467,0,0,62,62,0,1,0,1,0,deny
10390,26467,0,0,66,66,0,1,0,1,0,deny
65023,445,0,0,66,66,0,1,0,1,0,drop
65019,445,0,0,66,66,0,1,0,1,0,drop
37887,22114,0,0,66,66,0,1,0,1,0,deny
443,14591,0,0,60,60,0,1,0,1,0,deny
4111,25174,0,0,62,62,0,1,0,1,0,deny
23719,22114,0,0,62,62,0,1,0,1,0,deny
68,67,0,0,346,346,0,1,0,1,0,deny
64860,445,0,0,70,70,0,1,0,1,0,drop
53233,445,0,0,70,70,0,1,0,1,0,drop
53230,445,0,0,70,70,0,1,0,1,0,drop
56738,53,8511,53,264,87,177,4,37,2,2,allow
52155,63867,51864,63867,70,70,0,2,7,2,0,allow
64801,53,57986,53,211,102,109,2,29,1,1,allow
49240,53,11212,53,199,102,97,2,29,1,1,allow
49271,53,54358,53,186,102,84,2,30,1,1,allow
52125,80,43801,80,2178,1003,1175,10,15,6,4,allow
57235,15187,23276,15187,1269359015,948477220,320881795,1036116,9283,747520,288596,allow
50410,443,7615,443,14049,602,13447,19,35,6,13,allow
43495,5223,54062,5223,139,139,0,2,6,2,0,allow
64030,24096,24415,24096,442,320,122,7,17,5,2,allow
34331,53,34331,53,404,259,145,3,32,2,1,allow
35073,443,44227,443,6201,1790,4411,24,330,13,11,allow
38708,443,36955,443,90166,3481,86685,96,15,31,65,allow
62914,993,49276,993,9285,4057,5228,80,45,39,41,allow
62056,443,37684,443,13784,6865,6919,38,47,21,17,allow
37785,80,22917,80,2293,1576,717,12,15,6,6,allow
41592,443,47156,443,2913,1752,1161,15,15,9,6,allow
57691,53,57691,53,247,98,149,2,32,1,1,allow
64899,53,42372,53,767,102,665,2,29,1,1,allow
52156,18238,49104,18238,70,70,0,2,7,2,0,allow
52157,23002,39596,23002,70,70,0,2,7,2,0,allow
52158,3841,65016,3841,70,70,0,2,7,2,0,allow
40839,53,42784,53,78,78,0,1,29,1,0,allow
53910,1024,45263,1024,70,70,0,1,4,1,0,allow
49240,53,18179,53,199,102,97,2,30,1,1,allow
65282,53,39898,53,193,102,91,2,30,1,1,allow
51815,443,62038,443,9061,3443,5618,64,121,27,37,allow
55830,53,20748,53,177,94,83,2,30,1,1,allow
59604,443,43036,443,4507,1525,2982,24,147,13,11,allow
27366,5222,55342,5222,3833,1007,2826,27,68,11,16,allow
62911,993,63006,993,8753,4199,4554,76,54,41,35,allow
49240,53,19807,53,330,101,229,4,47,2,2,allow
49271,53,62549,53,178,94,84,2,30,1,1,allow
44401,53,44401,53,197,90,107,2,30,1,1,allow
20341,53,20341,53,225,90,135,2,30,1,1,allow
55683,53,63904,53,391,134,257,2,30,1,1,allow
51647,443,26913,443,6400,1830,4570,26,316,13,13,allow
41484,443,26840,443,433834,12764,421070,452,32,156,296,allow
49922,53,18616,53,583,105,478,4,42,2,2,allow
35202,443,16914,443,10848,4083,6765,37,16,21,16,allow
35012,80,6218,80,1295,572,723,12,15,7,5,allow
50472,443,48641,443,251744,9600,242144,302,23,129,173,allow
57208,53,43799,53,184,86,98,2,30,1,1,allow
62061,443,61994,443,53531,5139,48392,75,47,34,41,allow
55706,33677,37931,33677,210,140,70,4,14,3,1,allow
53853,443,28816,443,3692,2154,1538,25,81,12,13,allow
50577,80,14735,80,469212,19981,449231,601,134,276,325,allow
33108,22,33108,22,7930,3351,4579,56,38,27,29,allow
62916,993,58185,993,8832,3647,5185,77,41,35,42,allow
65529,53,2543,53,199,102,97,2,30,1,1,allow
61044,53,61044,53,180,82,98,2,30,1,1,allow
64610,53,2406,53,292,102,190,2,30,1,1,allow
56231,53,14277,53,268,94,174,2,30,1,1,allow
57161,53,62554,53,196,94,102,2,30,1,1,allow
50683,443,31278,443,12362,1650,10712,33,300,14,19,allow
65196,53,20787,53,164,86,78,2,30,1,1,allow
62909,993,50101,993,8033,4241,3792,67,54,42,25,allow
50080,5223,34413,5223,10876,5991,4885,39,93,22,17,allow
65282,53,16283,53,193,102,91,2,30,1,1,allow
49442,53,12597,53,326,110,216,2,30,1,1,allow
65057,53,20625,53,397,102,295,2,30,1,1,allow
48496,443,6861,443,2661,1558,1103,18,807,7,11,allow
56840,53,4523,53,242,110,132,2,30,1,1,allow
45979,80,24142,80,1638,1324,314,10,15,5,5,allow
37653,443,30565,443,9605,2939,6666,29,46,17,12,allow
60488,27615,36232,27615,70,70,0,2,8,2,0,allow
52126,56057,8315,56057,70,70,0,1,5,1,0,allow
55543,3389,55543,3389,3488,1774,1714,17,32,9,8,allow
60485,13314,64825,13314,70,70,0,2,8,2,0,allow
56799,443,37236,443,7511,2237,5274,17,16,9,8,allow
52128,21294,45027,21294,70,70,0,1,4,1,0,allow
62920,993,31712,993,7974,4175,3799,65,32,40,25,allow
49163,443,41945,443,2529,1230,1299,17,16,9,8,allow
65465,53,17852,53,755,102,653,2,29,1,1,allow
56738,53,23984,53,264,87,177,4,37,2,2,allow
56998,53,58740,53,177,94,83,2,29,1,1,allow
52308,53,36287,53,70,70,0,1,29,1,0,allow
65462,53,17722,53,102,102,0,1,30,1,0,allow
55988,53,26621,53,353,94,259,2,30,1,1,allow
60944,443,4014,443,5081,896,4185,16,70,8,8,allow
40932,443,9497,443,10803,4485,6318,36,345,19,17,allow
42854,443,46516,443,4268,2836,1432,25,19,13,12,allow
22659,53,22659,53,247,98,149,2,32,1,1,allow
52077,53,26834,53,199,94,105,2,30,1,1,allow
53913,28402,8057,28402,70,70,0,1,4,1,0,allow
55039,53,9278,53,177,94,83,2,30,1,1,allow
55039,53,21186,53,177,94,83,2,30,1,1,allow
13859,53,13859,53,215,98,117,2,30,1,1,allow
64823,53,48646,53,210,102,108,2,30,1,1,allow
55830,53,13004,53,177,94,83,2,30,1,1,allow
49709,80,19787,80,1702,1388,314,10,15,5,5,allow
65130,53,36063,53,266,110,156,2,30,1,1,allow
55830,53,38726,53,177,94,83,2,29,1,1,allow
56185,53,59066,53,216,94,122,2,30,1,1,allow
64220,53,21263,53,265,110,155,2,30,1,1,allow
59399,53,32458,53,232,94,138,2,30,1,1,allow
31126,53,31126,53,240,98,142,2,30,1,1,allow
56326,53,62646,53,177,94,83,2,30,1,1,allow
64125,53,22287,53,199,102,97,2,31,1,1,allow
58345,123,37586,123,184,94,90,2,30,1,1,allow
65343,53,9995,53,197,102,95,2,30,1,1,allow
65082,53,20499,53,183,94,89,2,31,1,1,allow
51813,443,19561,443,3182,1568,1614,8,121,4,4,allow
55293,53,52510,53,230,110,120,2,30,1,1,allow
65100,53,63534,53,199,102,97,2,30,1,1,allow
41139,443,57233,443,9152383,160511,8991872,8428,252,2261,6167,allow
61800,3389,61800,3389,3429,1474,1955,16,16,8,8,allow
35247,80,59441,80,1614,1300,314,10,15,5,5,allow
41444,80,42580,80,1000,577,423,10,200,6,4,allow
56439,80,9837,80,17128,1499,15629,24,25,9,15,allow
49701,443,3982,443,28497,1646,26851,31,138,9,22,allow
64912,53,63953,53,356,118,238,2,30,1,1,allow
43853,443,27275,443,6156,4764,1392,17,231,11,6,allow
32869,53,32869,53,197,90,107,2,30,1,1,allow
40453,443,22159,443,114,114,0,2,120,2,0,allow
65218,53,61017,53,193,102,91,2,31,1,1,allow
27777,80,27777,80,12281469,369857,11911612,13837,31,5536,8301,allow
34310,80,6005,80,1614,1300,314,10,15,5,5,allow
44894,443,39327,443,1849,1130,719,17,36,9,8,allow
50640,80,59027,80,2374,936,1438,13,45,7,6,allow
62908,993,3979,993,8772,3614,5158,77,54,35,42,allow
64426,53,20042,53,289,101,188,4,51,2,2,allow
49582,53,29592,53,168,78,90,2,30,1,1,allow
54613,53,0,0,86,86,0,1,30,1,0,allow
58771,53,58771,53,226,106,120,2,30,1,1,allow
12567,53,12567,53,231,90,141,2,30,1,1,allow
52125,49224,3384,49224,70,70,0,1,5,1,0,allow
62066,443,55561,443,11816,3175,8641,32,46,16,16,allow
62915,993,36226,993,8257,4187,4070,70,43,42,28,allow
65343,53,45711,53,197,102,95,2,30,1,1,allow
57442,53,59819,53,411,110,301,2,30,1,1,allow
51221,45722,40795,45722,481,150,331,2,1200,1,1,allow
36588,5223,46105,5223,4336,1518,2818,23,3005,14,9,allow
55423,53,31871,53,177,94,83,2,31,1,1,allow
64259,53,65307,53,211,78,133,2,31,1,1,allow
49515,53,61596,53,195,102,93,2,31,1,1,allow
49516,53,19547,53,183,94,89,2,31,1,1,allow
61163,443,25794,443,8637,5348,3289,37,738,15,22,allow
44847,20009,63949,20009,502,150,352,2,1200,1,1,allow
37965,52608,29898,52608,1577,594,983,20,2766,10,10,allow
38945,443,48637,443,20511,4206,16305,24,134,7,17,allow
65355,53,61445,53,741,94,647,2,30,1,1,allow
65100,53,16934,53,199,102,97,2,30,1,1,allow
38731,443,59272,443,13181,5856,7325,23,135,11,12,allow
10151,10016,24460,10016,460,150,310,2,1200,1,1,allow
30188,13384,3738,13384,501,150,351,2,1200,1,1,allow
49659,443,27992,443,11455,2804,8651,59,121,28,31,allow
52152,58114,40189,58114,70,70,0,2,8,2,0,allow
51987,443,55315,443,134,60,74,3,5,2,1,allow
50128,443,52903,443,15069,5689,9380,51,35,27,24,allow
59284,443,33120,443,10243,3289,6954,41,26,21,20,allow
45564,443,62998,443,4851,848,4003,16,16,9,7,allow
51157,443,53397,443,2791,1800,991,26,186,15,11,allow
50408,53,10616,53,183,94,89,2,30,1,1,allow
20253,53,20253,53,404,259,145,3,33,2,1,allow
5048,53,5048,53,247,98,149,2,34,1,1,allow
19850,53,19850,53,404,259,145,3,32,2,1,allow
54978,80,11814,80,1448,539,909,17,32,9,8,allow
49860,53,46004,53,212,102,110,2,30,1,1,allow
60484,52001,52870,52001,320,140,180,6,8,3,3,allow
46202,443,10482,443,19149,2846,16303,41,25,20,21,allow
58058,53,0,0,86,86,0,1,30,1,0,allow
53226,445,0,0,70,70,0,1,0,1,0,drop
53223,445,0,0,70,70,0,1,0,1,0,drop
64363,22114,0,0,66,66,0,1,0,1,0,deny
60899,25174,0,0,66,66,0,1,0,1,0,deny
33814,22114,0,0,62,62,0,1,0,1,0,deny
65014,445,0,0,66,66,0,1,0,1,0,drop
59874,22114,0,0,66,66,0,1,0,1,0,deny
27922,25174,0,0,62,62,0,1,0,1,0,deny
57348,25174,0,0,62,62,0,1,0,1,0,deny
3764,9694,0,0,66,66,0,1,0,1,0,deny
60605,3389,0,0,60,60,0,1,0,1,0,deny
9212,51505,0,0,62,62,0,1,0,1,0,deny
62194,50584,0,0,62,62,0,1,0,1,0,deny
39583,37965,0,0,66,66,0,1,0,1,0,deny
12909,47807,0,0,148,148,0,1,0,1,0,deny
50052,65008,0,0,60,60,0,1,0,1,0,deny
65006,445,0,0,66,66,0,1,0,1,0,drop
65009,445,0,0,66,66,0,1,0,1,0,drop
65008,445,0,0,66,66,0,1,0,1,0,drop
65005,445,0,0,66,66,0,1,0,1,0,drop
64999,445,0,0,66,66,0,1,0,1,0,drop
65002,445,0,0,66,66,0,1,0,1,0,drop
65000,445,0,0,66,66,0,1,0,1,0,drop
56528,64147,0,0,62,62,0,1,0,1,0,deny
64853,445,0,0,70,70,0,1,0,1,0,drop
28649,43890,0,0,66,66,0,1,0,1,0,deny
64850,445,0,0,70,70,0,1,0,1,0,drop
39063,44847,0,0,66,66,0,1,0,1,0,deny
53220,445,0,0,70,70,0,1,0,1,0,drop
31066,57470,0,0,74,74,0,1,0,1,0,deny
53215,445,0,0,70,70,0,1,0,1,0,drop
53214,445,0,0,70,70,0,1,0,1,0,drop
53211,445,0,0,70,70,0,1,0,1,0,drop
55155,2767,0,0,66,66,0,1,0,1,0,deny
42722,56448,0,0,70,70,0,1,0,1,0,deny
64846,445,0,0,70,70,0,1,0,1,0,drop
52459,3399,0,0,60,60,0,1,0,1,0,deny
50394,25174,0,0,62,62,0,1,0,1,0,deny
43888,64147,0,0,62,62,0,1,0,1,0,deny
64845,445,0,0,70,70,0,1,0,1,0,drop
1280,25174,0,0,66,66,0,1,0,1,0,deny
443,56513,0,0,78,78,0,1,0,1,0,deny
59436,22114,0,0,66,66,0,1,0,1,0,deny
19298,30188,0,0,62,62,0,1,0,1,0,deny
64841,445,0,0,70,70,0,1,0,1,0,drop
50637,36237,0,0,66,66,0,1,0,1,0,deny
53206,445,0,0,70,70,0,1,0,1,0,drop
53204,445,0,0,70,70,0,1,0,1,0,drop
53203,445,0,0,70,70,0,1,0,1,0,drop
47771,25174,0,0,146,146,0,1,0,1,0,deny
64993,445,0,0,66,66,0,1,0,1,0,drop
53202,445,0,0,70,70,0,1,0,1,0,drop
64840,445,0,0,70,70,0,1,0,1,0,drop
64991,445,0,0,66,66,0,1,0,1,0,drop
64988,445,0,0,66,66,0,1,0,1,0,drop
64987,445,0,0,66,66,0,1,0,1,0,drop
64985,445,0,0,66,66,0,1,0,1,0,drop
5912,22114,0,0,62,62,0,1,0,1,0,deny
1660,8696,0,0,62,62,0,1,0,1,0,deny
51455,53733,0,0,62,62,0,1,0,1,0,deny
60579,25174,0,0,62,62,0,1,0,1,0,deny
10312,23117,0,0,62,62,0,1,0,1,0,deny
64835,445,0,0,70,70,0,1,0,1,0,drop
48839,37807,0,0,62,62,0,1,0,1,0,deny
17004,64147,0,0,66,66,0,1,0,1,0,deny
53197,445,0,0,70,70,0,1,0,1,0,drop
33589,23,0,0,60,60,0,1,0,1,0,deny
20953,23,0,0,60,60,0,1,0,1,0,deny
6247,51221,0,0,62,62,0,1,0,1,0,deny
10381,22114,0,0,62,62,0,1,0,1,0,deny
53193,445,0,0,70,70,0,1,0,1,0,drop
53191,445,0,0,70,70,0,1,0,1,0,drop
52625,25174,0,0,62,62,0,1,0,1,0,deny
29512,30188,0,0,66,66,0,1,0,1,0,deny
2049,32480,0,0,66,66,0,1,0,1,0,deny
61761,44847,0,0,66,66,0,1,0,1,0,deny
56213,26467,0,0,66,66,0,1,0,1,0,deny
4748,64147,0,0,66,66,0,1,0,1,0,deny
45964,2225,0,0,60,60,0,1,0,1,0,deny
64975,445,0,0,66,66,0,1,0,1,0,deny
13588,15503,0,0,62,62,0,1,0,1,0,deny
47561,26467,0,0,62,62,0,1,0,1,0,deny
64822,445,0,0,70,70,0,1,0,1,0,drop
21993,25174,0,0,62,62,0,1,0,1,0,deny
63136,25174,0,0,62,62,0,1,0,1,0,deny
1143,25174,0,0,62,62,0,1,0,1,0,deny
64967,445,0,0,66,66,0,1,0,1,0,drop
53176,445,0,0,70,70,0,1,0,1,0,drop
60180,31573,0,0,62,62,0,1,0,1,0,deny
64819,445,0,0,70,70,0,1,0,1,0,drop
2864,25174,0,0,66,66,0,1,0,1,0,deny
443,14591,0,0,60,60,0,1,0,1,0,deny
443,14591,0,0,85,85,0,1,0,1,0,deny
443,14591,0,0,100,100,0,1,0,1,0,deny
993,3979,0,0,129,129,0,1,0,1,0,deny
2932,44847,0,0,66,66,0,1,0,1,0,deny
64965,445,0,0,66,66,0,1,0,1,0,drop
55893,45711,0,0,78,78,0,1,0,1,0,deny
51430,25174,0,0,62,62,0,1,0,1,0,deny
20682,57470,0,0,62,62,0,1,0,1,0,deny
57585,51221,0,0,62,62,0,1,0,1,0,deny
64815,445,0,0,70,70,0,1,0,1,0,drop
15347,55108,0,0,148,148,0,1,0,1,0,deny
64958,445,0,0,66,66,0,1,0,1,0,drop
50052,65010,0,0,60,60,0,1,0,1,0,deny
64813,445,0,0,70,70,0,1,0,1,0,drop
64954,445,0,0,66,66,0,1,0,1,0,drop
24351,57470,0,0,62,62,0,1,0,1,0,deny
0,0,0,0,244,244,0,2,0,2,0,allow
64811,445,0,0,70,70,0,1,0,1,0,drop
53120,25174,0,0,62,62,0,1,0,1,0,deny
18415,37965,0,0,62,62,0,1,0,1,0,deny
59937,18375,0,0,62,62,0,1,0,1,0,deny
52462,25174,0,0,66,66,0,1,0,1,0,deny
62339,25174,0,0,66,66,0,1,0,1,0,deny
54914,51505,0,0,62,62,0,1,0,1,0,deny
63867,35993,0,0,66,66,0,1,0,1,0,deny
59048,57470,0,0,66,66,0,1,0,1,0,deny
68,67,0,0,594,594,0,1,0,1,0,deny
53166,445,0,0,70,70,0,1,0,1,0,drop
53165,445,0,0,70,70,0,1,0,1,0,drop
53162,445,0,0,70,70,0,1,0,1,0,drop
64940,445,0,0,66,66,0,1,0,1,0,drop
64939,445,0,0,66,66,0,1,0,1,0,drop
64937,445,0,0,66,66,0,1,0,1,0,drop
64941,445,0,0,66,66,0,1,0,1,0,drop
64936,445,0,0,66,66,0,1,0,1,0,drop
64938,445,0,0,66,66,0,1,0,1,0,drop
64934,445,0,0,66,66,0,1,0,1,0,drop
64933,445,0,0,66,66,0,1,0,1,0,drop
33886,52255,0,0,162,162,0,1,0,1,0,deny
30729,22114,0,0,62,62,0,1,0,1,0,deny
64804,445,0,0,70,70,0,1,0,1,0,drop
59060,50584,0,0,62,62,0,1,0,1,0,deny
64802,445,0,0,70,70,0,1,0,1,0,drop
51615,25174,0,0,62,62,0,1,0,1,0,deny
64801,445,0,0,70,70,0,1,0,1,0,drop
10192,25174,0,0,66,66,0,1,0,1,0,deny
64800,445,0,0,70,70,0,1,0,1,0,drop
64799,445,0,0,70,70,0,1,0,1,0,drop
50236,25174,0,0,62,62,0,1,0,1,0,deny
64793,445,0,0,70,70,0,1,0,1,0,drop
64795,445,0,0,70,70,0,1,0,1,0,drop
2346,25174,0,0,62,62,0,1,0,1,0,deny
36456,25174,0,0,146,146,0,1,0,1,0,deny
53160,445,0,0,70,70,0,1,0,1,0,drop
53157,445,0,0,70,70,0,1,0,1,0,drop
53155,445,0,0,70,70,0,1,0,1,0,drop
53144,445,0,0,70,70,0,1,0,1,0,drop
55735,50584,0,0,62,62,0,1,0,1,0,deny
26425,22114,0,0,146,146,0,1,0,1,0,deny
23843,26467,0,0,62,62,0,1,0,1,0,deny
63398,25174,0,0,66,66,0,1,0,1,0,deny
54976,15503,0,0,62,62,0,1,0,1,0,deny
64921,445,0,0,66,66,0,1,0,1,0,drop
64920,445,0,0,66,66,0,1,0,1,0,drop
64918,445,0,0,66,66,0,1,0,1,0,drop
60527,35440,0,0,66,66,0,1,0,1,0,deny
64781,445,0,0,70,70,0,1,0,1,0,drop
64780,445,0,0,70,70,0,1,0,1,0,drop
80,18811,0,0,60,60,0,1,0,1,0,deny
64775,445,0,0,70,70,0,1,0,1,0,drop
64770,445,0,0,70,70,0,1,0,1,0,drop
64771,445,0,0,70,70,0,1,0,1,0,drop
49336,25174,0,0,66,66,0,1,0,1,0,deny
57578,51221,0,0,66,66,0,1,0,1,0,deny
37522,22114,0,0,62,62,0,1,0,1,0,deny
9505,443,9745,443,3613,433,3180,11,16,6,5,allow
49068,443,37354,443,98965,16634,82331,187,30,82,105,allow
50411,8080,50411,8080,1626,798,828,11,61,6,5,allow
56088,53,17141,53,774,101,673,2,30,1,1,allow
56582,53,45513,53,98,98,0,1,30,1,0,allow
64426,53,47787,53,289,101,188,4,50,2,2,allow
50592,443,1677,443,9646,3396,6250,23,79,12,11,allow
9513,443,25594,443,3615,435,3180,11,16,6,5,allow
52160,49212,45447,49212,316,136,180,6,6,3,3,allow
56611,53,8939,53,91,91,0,1,30,1,0,allow
62052,443,44827,443,11674,2699,8975,27,48,14,13,allow
52147,30265,24438,30265,70,70,0,2,8,2,0,allow
65343,53,12324,53,194,99,95,2,30,1,1,allow
41892,443,2330,443,2594,1280,1314,17,17,9,8,allow
41890,443,5361,443,7014,1958,5056,31,18,19,12,allow
65082,53,15912,53,182,93,89,2,31,1,1,allow
50109,53,61948,53,768,99,669,2,30,1,1,allow
54998,53,17431,53,711,87,624,2,30,1,1,allow
55797,53,14709,53,735,88,647,2,30,1,1,allow
59959,80,18461,80,1052,612,440,10,16,5,5,allow
64886,53,27053,53,295,101,194,4,31,2,2,allow
19054,3389,19054,3389,3564,1850,1714,18,35,10,8,allow
34779,443,25876,443,34914,5279,29635,47,543,18,29,allow
53975,443,8391,443,9782,1996,7786,30,31,14,16,allow
45390,80,63396,80,16713,1698,15015,31,32,17,14,allow
54819,3389,54819,3389,3327,1438,1889,15,17,8,7,allow
38635,443,21019,443,4089,1965,2124,25,83,13,12,allow
55714,18904,51148,18904,320,140,180,6,6,3,3,allow
34354,443,64555,443,3603,562,3041,10,15,6,4,allow
9518,443,46388,443,3613,433,3180,11,16,6,5,allow
52776,443,19615,443,10091,2314,7777,33,17,18,15,allow
52121,58933,11142,58933,66,66,0,1,5,1,0,allow
49932,53,49932,53,404,259,145,3,32,2,1,allow
27316,443,39777,443,9439,1890,7549,29,67,14,15,allow
51930,80,17993,80,1669,865,804,13,76,8,5,allow
56712,53,57306,53,170,87,83,2,31,1,1,allow
50520,80,14281,80,1615,793,822,13,91,7,6,allow
49516,53,27772,53,182,93,89,2,31,1,1,allow
34338,443,58177,443,4542,2358,2184,20,20,11,9,allow
49339,443,48962,443,3191,2313,878,17,42,10,7,allow
55434,53,17321,53,1335,87,1248,4,38,2,2,allow
52151,30692,2893,30692,70,70,0,2,8,2,0,allow
55423,53,7848,53,170,87,83,2,30,1,1,allow
53905,50130,9021,50130,552,306,246,9,16,5,4,allow
50623,443,54546,443,13392,11220,2172,31,53,19,12,allow
55569,443,6204,443,8049,1560,6489,19,151,9,10,allow
51814,443,41543,443,6133,1655,4478,12,120,5,7,allow
50408,53,52200,53,182,93,89,2,30,1,1,allow
51807,443,44757,443,3561,1098,2463,10,121,5,5,allow
65228,53,60799,53,267,93,174,4,47,2,2,allow
61527,443,62594,443,17161,1619,15542,18,143,4,14,allow
56640,53,60510,53,733,93,640,2,31,1,1,allow
51806,443,40388,443,3182,1568,1614,8,121,4,4,allow
37567,443,40594,443,149229,139639,9590,226,256,124,102,allow
55195,443,24998,443,3543,1855,1688,20,122,10,10,allow
44131,443,6596,443,6582,1943,4639,14,122,7,7,allow
64842,53,17214,53,802,104,698,2,31,1,1,allow
55790,53,7477,53,170,87,83,2,31,1,1,allow
55163,443,13789,443,2329,505,1824,14,124,7,7,allow
58102,443,20475,443,14197,9283,4914,28,122,15,13,allow
19473,6881,31231,6881,490,149,341,2,1200,1,1,allow
49256,53,34162,53,174,89,85,2,31,1,1,allow
56273,53,26440,53,182,93,89,2,31,1,1,allow
58383,53,25867,53,357,87,270,2,31,1,1,allow
54979,53,3280,53,97,97,0,1,61,1,0,allow
56830,53,57872,53,190,97,93,2,31,1,1,allow
56524,443,60258,443,759397,22470,736927,766,108,270,496,allow
54444,443,16103,443,6275,3787,2488,17,147,8,9,allow
54403,443,27679,443,3486,924,2562,13,122,6,7,allow
57470,16414,19962,16414,726,726,0,12,1200,12,0,allow
30960,45750,9630,45750,66,66,0,1,3600,1,0,allow
14447,25174,0,0,62,62,0,1,0,1,0,deny
26651,25174,0,0,62,62,0,1,0,1,0,deny
53142,445,0,0,70,70,0,1,0,1,0,drop
14447,25174,0,0,146,146,0,1,0,1,0,deny
58608,62413,0,0,66,66,0,1,0,1,0,deny
49754,35440,0,0,62,62,0,1,0,1,0,deny
53138,445,0,0,70,70,0,1,0,1,0,drop
53133,445,0,0,70,70,0,1,0,1,0,drop
53132,445,0,0,70,70,0,1,0,1,0,drop
39393,22114,0,0,146,146,0,1,0,1,0,deny
61002,26314,0,0,143,143,0,1,0,1,0,deny
64759,445,0,0,70,70,0,1,0,1,0,drop
63538,80,37199,80,578,518,60,2,5,1,1,allow
54145,7000,54145,7000,3370,1595,1775,16,15,9,7,allow
65266,53,11513,53,754,94,660,2,30,1,1,allow
23844,26467,0,0,62,62,0,1,0,1,0,deny
52112,22114,0,0,66,66,0,1,0,1,0,deny
53123,445,0,0,70,70,0,1,0,1,0,drop
53120,445,0,0,70,70,0,1,0,1,0,drop
53119,445,0,0,70,70,0,1,0,1,0,drop
56388,22114,0,0,66,66,0,1,0,1,0,deny
59966,37965,0,0,66,66,0,1,0,1,0,deny
58897,23,0,0,60,60,0,1,0,1,0,deny
18116,37807,0,0,62,62,0,1,0,1,0,deny
64755,445,0,0,70,70,0,1,0,1,0,drop
64908,445,0,0,66,66,0,1,0,1,0,drop
11754,25174,0,0,62,62,0,1,0,1,0,deny
19209,62413,0,0,146,146,0,1,0,1,0,deny
1024,25174,0,0,62,62,0,1,0,1,0,deny
49370,11392,0,0,62,62,0,1,0,1,0,deny
12348,50265,0,0,62,62,0,1,0,1,0,deny
64744,445,0,0,70,70,0,1,0,1,0,drop
64746,445,0,0,70,70,0,1,0,1,0,drop
64743,445,0,0,70,70,0,1,0,1,0,drop
46116,57470,0,0,74,74,0,1,0,1,0,deny
64740,445,0,0,70,70,0,1,0,1,0,drop
64739,445,0,0,70,70,0,1,0,1,0,drop
1794,22114,0,0,146,146,0,1,0,1,0,deny
53117,445,0,0,70,70,0,1,0,1,0,drop
38549,22114,0,0,62,62,0,1,0,1,0,deny
51754,18375,0,0,66,66,0,1,0,1,0,deny
53116,445,0,0,70,70,0,1,0,1,0,drop
7619,50584,0,0,62,62,0,1,0,1,0,deny
55079,25174,0,0,62,62,0,1,0,1,0,deny
18570,2323,0,0,60,60,0,1,0,1,0,deny
7435,62609,0,0,148,148,0,1,0,1,0,deny
64892,445,0,0,66,66,0,1,0,1,0,drop
64890,445,0,0,66,66,0,1,0,1,0,drop
55406,25174,0,0,66,66,0,1,0,1,0,deny
37826,23,0,0,60,60,0,1,0,1,0,deny
31066,57470,0,0,74,74,0,1,0,1,0,deny
8760,22114,0,0,66,66,0,1,0,1,0,deny
55620,30188,0,0,66,66,0,1,0,1,0,deny
64733,445,0,0,70,70,0,1,0,1,0,drop
64989,50265,0,0,66,66,0,1,0,1,0,deny
52827,25174,0,0,62,62,0,1,0,1,0,deny
25579,23,0,0,60,60,0,1,0,1,0,deny
12596,53,12596,53,197,90,107,2,30,1,1,allow
45412,53,45412,53,220,90,130,2,30,1,1,allow
58748,443,1980,443,522925,36953,485972,799,229,304,495,allow
60801,40010,50650,40010,316,136,180,6,6,3,3,allow
52150,37603,39264,37603,70,70,0,2,7,2,0,allow
52123,46261,33776,46261,70,70,0,1,4,1,0,allow
52120,42751,45034,42751,70,70,0,1,5,1,0,allow
54573,80,38100,80,2091,823,1268,12,45,7,5,allow
49991,53,62734,53,257,102,155,2,29,1,1,allow
50433,53,63561,53,193,102,91,2,29,1,1,allow
55760,443,34599,443,4344,2974,1370,22,94,12,10,allow
46542,443,1363,443,5916,1144,4772,20,17,11,9,allow
61808,443,61318,443,8189,3146,5043,26,30,14,12,allow
50081,443,6983,443,18754,5240,13514,31,16,15,16,allow
53907,45622,15618,45622,70,70,0,1,4,1,0,allow
59250,443,54786,443,12632,3678,8954,42,27,23,19,allow
50129,443,27980,443,29436,9695,19741,54,34,30,24,allow
58894,443,56665,443,354,294,60,2,4,1,1,allow
64040,12226,50739,12226,70,70,0,1,4,1,0,allow
52098,80,42506,80,1955,913,1042,10,15,6,4,allow
53901,44425,38536,44425,1686,890,796,10,15,6,4,allow
65228,53,63836,53,267,93,174,4,46,2,2,allow
64674,53,13295,53,183,94,89,2,29,1,1,allow
53119,53,39459,53,326,102,224,2,29,1,1,allow
54818,3389,54818,3389,3409,1454,1955,16,16,8,8,allow
64986,53,51778,53,734,94,640,2,29,1,1,allow
57106,53,23546,53,214,94,120,2,29,1,1,allow
41008,53,32302,53,168,78,90,2,29,1,1,allow
64488,53,18852,53,291,102,189,2,29,1,1,allow
65196,53,56319,53,172,94,78,2,29,1,1,allow
64674,53,50248,53,183,94,89,2,29,1,1,allow
50148,53,50148,53,198,90,108,2,29,1,1,allow
50433,53,29987,53,193,102,91,2,30,1,1,allow
50559,53,33553,53,178,94,84,2,29,1,1,allow
55340,53,25572,53,324,110,214,2,29,1,1,allow
65365,53,21509,53,178,94,84,2,29,1,1,allow
49708,53,32399,53,178,94,84,2,30,1,1,allow
55417,53,4838,53,199,102,97,2,30,1,1,allow
49364,53,30235,53,183,94,89,2,30,1,1,allow
46484,22,46484,22,7922,3413,4509,55,38,26,29,allow
64270,53,47275,53,455,102,353,4,33,2,2,allow
56712,53,17239,53,177,94,83,2,30,1,1,allow
65104,53,20417,53,198,94,104,2,30,1,1,allow
49364,53,20144,53,183,94,89,2,30,1,1,allow
64705,53,6395,53,213,102,111,2,30,1,1,allow
56611,53,54736,53,181,94,87,2,32,1,1,allow
41482,443,54813,443,1062197,37438,1024759,1129,31,416,713,allow
50376,443,64568,443,7738,879,6859,19,27,10,9,allow
65343,53,45519,53,328,99,229,4,45,2,2,allow
55843,53,63569,53,177,94,83,2,30,1,1,allow
9510,443,20445,443,3615,435,3180,11,15,6,5,allow
49518,53,62825,53,266,110,156,2,30,1,1,allow
55423,53,51640,53,177,94,83,2,30,1,1,allow
49413,53,49413,53,225,90,135,2,30,1,1,allow
64258,53,3209,53,260,86,174,2,30,1,1,allow
55487,53,39202,53,195,102,93,2,30,1,1,allow
56997,53,32024,53,273,102,171,2,30,1,1,allow
64125,53,26967,53,199,102,97,2,30,1,1,allow
64718,53,58761,53,266,110,156,2,30,1,1,allow
26940,53,26940,53,197,90,107,2,30,1,1,allow
50579,53,23674,53,179,94,85,2,30,1,1,allow
40216,443,24772,443,10196,2175,8021,25,186,14,11,allow
49932,53,55615,53,195,102,93,2,30,1,1,allow
56712,53,47464,53,177,94,83,2,30,1,1,allow
55417,53,14562,53,199,102,97,2,30,1,1,allow
50404,8080,50404,8080,11938,4533,7405,33,98,20,13,allow
55944,53,13576,53,194,94,100,2,30,1,1,allow
65324,53,23853,53,748,94,654,2,30,1,1,allow
40781,443,52827,443,448,78,370,7,20,2,5,allow
57260,53,31217,53,211,102,109,2,30,1,1,allow
58000,17,58000,17,66,66,0,1,30,1,0,allow
36712,53,0,0,139,70,69,2,30,1,1,allow
49312,53,27461,53,772,102,670,2,30,1,1,allow
49708,53,64935,53,178,94,84,2,30,1,1,allow
52122,43073,59163,43073,70,70,0,1,5,1,0,allow
56532,53,29846,53,291,88,203,4,50,2,2,allow
51852,443,17719,443,1382291,55962,1326329,1491,24,582,909,allow
59522,443,54778,443,8743,2676,6067,30,25,16,14,allow
55217,443,55217,443,3239,740,2499,15,40,8,7,allow
58418,443,64364,443,15305,3334,11971,45,198,21,24,allow
45376,80,8854,80,2259,1068,1191,12,31,8,4,allow
65228,53,34659,53,267,93,174,4,46,2,2,allow
35311,80,30298,80,947,376,571,8,14,5,3,allow
53246,5222,38090,5222,10577,3496,7081,68,616,36,32,allow
32100,53,32100,53,200,90,110,2,29,1,1,allow
60482,2924,18303,2924,320,140,180,6,7,3,3,allow
64674,53,62663,53,183,94,89,2,29,1,1,allow
60877,443,6098,443,8536,2392,6144,29,45,17,12,allow
3851,53,3851,53,235,90,145,2,33,1,1,allow
49515,53,58908,53,195,102,93,2,29,1,1,allow
46324,443,40837,443,24465,3945,20520,39,18,18,21,allow
44718,80,25526,80,4336,2408,1928,18,21,10,8,allow
56738,53,54145,53,264,87,177,4,36,2,2,allow
50424,53,64071,53,195,102,93,2,29,1,1,allow
63877,53,63877,53,247,98,149,2,32,1,1,allow
52149,52188,59594,52188,70,70,0,2,8,2,0,allow
64897,53,12641,53,266,110,156,2,30,1,1,allow
51716,5223,22569,5223,4524,1489,3035,26,1327,15,11,allow
51385,443,10522,443,8388,760,7628,20,145,6,14,allow
60873,443,24507,443,10707,2969,7738,32,47,18,14,allow
65269,53,18855,53,226,102,124,2,30,1,1,allow
56830,53,55667,53,195,102,93,2,30,1,1,allow
58473,443,15678,443,3120,1862,1258,18,15,11,7,allow
55423,53,64857,53,177,94,83,2,30,1,1,allow
60367,53,22365,53,233,110,123,2,30,1,1,allow
58396,80,29243,80,1088,599,489,13,315,7,6,allow
56326,53,18129,53,177,94,83,2,29,1,1,allow
52221,53,60196,53,164,78,86,2,29,1,1,allow
10034,53,10034,53,215,98,117,2,29,1,1,allow
50424,53,47336,53,195,102,93,2,30,1,1,allow
11906,53,11906,53,220,90,130,2,30,1,1,allow
51197,443,47968,443,3211,781,2430,17,135,8,9,allow
64125,53,18557,53,199,102,97,2,30,1,1,allow
55843,53,38678,53,177,94,83,2,30,1,1,allow
65331,53,20706,53,767,102,665,2,29,1,1,allow
49575,53,46030,53,775,102,673,2,29,1,1,allow
45395,53,0,0,86,86,0,1,30,1,0,allow
55291,53,55867,53,243,94,149,2,31,1,1,allow
49516,53,32390,53,183,94,89,2,31,1,1,allow
64886,53,36555,53,199,102,97,2,30,1,1,allow
65092,53,7341,53,197,102,95,2,30,1,1,allow
55908,53,13210,53,389,110,279,2,30,1,1,allow
49752,53,13383,53,199,86,113,2,31,1,1,allow
49852,53,14933,53,230,102,128,2,31,1,1,allow
50378,443,14135,443,7738,879,6859,19,27,10,9,allow
64987,53,8755,53,357,107,250,4,36,2,2,allow
9500,443,23639,443,3614,434,3180,11,15,6,5,allow
62499,443,53888,443,1332,876,456,11,26,6,5,allow
49482,53,61985,53,460,84,376,4,46,2,2,allow
63672,53,63672,53,198,90,108,2,30,1,1,allow
4773,53,4773,53,197,90,107,2,30,1,1,allow
49516,53,40491,53,183,94,89,2,30,1,1,allow
49926,53,10749,53,266,110,156,2,30,1,1,allow
57505,443,24632,443,3640,606,3034,13,120,6,7,allow
65287,53,18878,53,180,94,86,2,31,1,1,allow
50675,80,44462,80,1658,1247,411,8,15,5,3,allow
50377,443,39949,443,7738,879,6859,19,27,10,9,allow
49297,80,62329,80,16249,1328,14921,28,45,14,14,allow
56582,53,45398,53,196,102,94,2,33,1,1,allow
55702,80,29070,80,70,70,0,1,5,1,0,allow
49183,53,29082,53,451,91,360,4,36,2,2,allow
52089,443,10472,443,15525,1642,13883,32,16,16,16,allow
9506,443,29564,443,3614,434,3180,11,15,6,5,allow
64426,53,6048,53,289,101,188,4,50,2,2,allow
22078,53,22078,53,229,98,131,2,30,1,1,allow
65413,53,65505,53,266,110,156,2,30,1,1,allow
65082,53,43263,53,183,94,89,2,30,1,1,allow
65098,53,11310,53,260,94,166,2,30,1,1,allow
56427,53,1277,53,178,94,84,2,30,1,1,allow
9520,443,43478,443,3614,434,3180,11,15,6,5,allow
52148,29104,12286,29104,70,70,0,2,8,2,0,allow
52119,49239,52121,49239,160,70,90,2,5,1,1,allow
50624,80,47844,80,12701,9788,2913,29,52,16,13,allow
49708,53,16944,53,178,94,84,2,30,1,1,allow
30353,53,30353,53,200,90,110,2,30,1,1,allow
48070,53,48070,53,197,90,107,2,30,1,1,allow
55487,53,11679,53,195,102,93,2,30,1,1,allow
34517,53,34517,53,200,82,118,2,30,1,1,allow
59002,53,19057,53,238,94,144,2,30,1,1,allow
59045,53,10960,53,231,110,121,2,30,1,1,allow
33281,53,7345,53,86,86,0,1,30,1,0,allow
64576,443,9952,443,7069,1210,5859,13,120,6,7,allow
55163,53,20116,53,197,102,95,2,31,1,1,allow
64958,53,42023,53,197,102,95,2,31,1,1,allow
57470,29633,40389,29633,1660,677,983,20,1595,10,10,allow
54550,443,8260,443,3296,1329,1967,14,135,7,7,allow
52118,33515,33825,33515,70,70,0,1,5,1,0,allow
50593,80,24582,80,2365,1068,1297,13,79,7,6,allow
65228,53,51061,53,267,93,174,4,46,2,2,allow
65218,53,49451,53,193,102,91,2,30,1,1,allow
55866,53,10182,53,257,94,163,2,30,1,1,allow
49932,53,14546,53,195,102,93,2,30,1,1,allow
49727,53,64244,53,280,110,170,2,31,1,1,allow
49942,53,37670,53,196,94,102,2,31,1,1,allow
49709,53,49112,53,466,93,373,4,50,2,2,allow
62498,443,43471,443,14786,3978,10808,32,26,15,17,allow
50583,80,63777,80,2226,1077,1149,13,79,7,6,allow
53900,45682,23799,45682,492,306,186,8,15,5,3,allow
64037,18592,48496,18592,70,70,0,1,5,1,0,allow
50578,80,29631,80,1791,900,891,14,79,7,7,allow
51466,443,58507,443,7638,1758,5880,24,17,13,11,allow
49256,53,11555,53,179,94,85,2,30,1,1,allow
15986,8000,55850,8000,212,150,62,2,30,1,1,allow
55812,53,26314,53,215,94,121,2,30,1,1,allow
65493,53,48274,53,266,110,156,2,30,1,1,allow
65257,53,51798,53,266,110,156,2,30,1,1,allow
53107,445,0,0,70,70,0,1,0,1,0,drop
53106,445,0,0,70,70,0,1,0,1,0,drop
53104,445,0,0,70,70,0,1,0,1,0,drop
53102,445,0,0,70,70,0,1,0,1,0,drop
64887,445,0,0,66,66,0,1,0,1,0,drop
56534,60043,0,0,145,145,0,1,0,1,0,deny
64725,445,0,0,70,70,0,1,0,1,0,drop
6712,5060,0,0,410,410,0,1,0,1,0,deny
49393,30188,0,0,66,66,0,1,0,1,0,deny
64723,445,0,0,70,70,0,1,0,1,0,drop
12226,37965,0,0,62,62,0,1,0,1,0,deny
39941,2767,0,0,62,62,0,1,0,1,0,deny
58504,57470,0,0,62,62,0,1,0,1,0,deny
64873,445,0,0,66,66,0,1,0,1,0,drop
64879,445,0,0,66,66,0,1,0,1,0,drop
64876,445,0,0,66,66,0,1,0,1,0,drop
64882,445,0,0,66,66,0,1,0,1,0,drop
64878,445,0,0,66,66,0,1,0,1,0,drop
64874,445,0,0,66,66,0,1,0,1,0,drop
64881,445,0,0,66,66,0,1,0,1,0,drop
42228,51050,0,0,66,66,0,1,0,1,0,deny
5831,22114,0,0,62,62,0,1,0,1,0,deny
53090,445,0,0,70,70,0,1,0,1,0,drop
54666,36237,0,0,62,62,0,1,0,1,0,deny
63334,37807,0,0,66,66,0,1,0,1,0,deny
53086,445,0,0,70,70,0,1,0,1,0,drop
53085,445,0,0,70,70,0,1,0,1,0,drop
53083,445,0,0,70,70,0,1,0,1,0,drop
64719,445,0,0,70,70,0,1,0,1,0,drop
64717,445,0,0,70,70,0,1,0,1,0,drop
10126,57470,0,0,62,62,0,1,0,1,0,deny
57782,57470,0,0,66,66,0,1,0,1,0,deny
39570,62413,0,0,146,146,0,1,0,1,0,deny
443,46223,0,0,66,66,0,1,0,1,0,deny
59326,57470,0,0,74,74,0,1,0,1,0,deny
49160,44512,0,0,146,146,0,1,0,1,0,deny
64713,445,0,0,70,70,0,1,0,1,0,drop
56562,44847,0,0,66,66,0,1,0,1,0,deny
64712,445,0,0,70,70,0,1,0,1,0,drop
53077,445,0,0,70,70,0,1,0,1,0,drop
53078,445,0,0,70,70,0,1,0,1,0,drop
53076,445,0,0,70,70,0,1,0,1,0,drop
64863,445,0,0,66,66,0,1,0,1,0,drop
3559,51050,0,0,146,146,0,1,0,1,0,deny
53074,445,0,0,70,70,0,1,0,1,0,drop
64862,445,0,0,66,66,0,1,0,1,0,drop
16119,57470,0,0,145,145,0,1,0,1,0,deny
62550,51505,0,0,62,62,0,1,0,1,0,deny
64858,445,0,0,66,66,0,1,0,1,0,drop
64860,445,0,0,66,66,0,1,0,1,0,drop
64856,445,0,0,66,66,0,1,0,1,0,drop
31281,30188,0,0,62,62,0,1,0,1,0,deny
17289,25174,0,0,146,146,0,1,0,1,0,deny
64707,445,0,0,70,70,0,1,0,1,0,drop
6832,51505,0,0,66,66,0,1,0,1,0,deny
51413,54751,0,0,136,136,0,1,0,1,0,deny
28305,25773,0,0,148,148,0,1,0,1,0,reset-both
64847,22114,0,0,66,66,0,1,0,1,0,deny
40155,25174,0,0,66,66,0,1,0,1,0,deny
61382,25174,0,0,62,62,0,1,0,1,0,deny
6881,6881,0,0,62,62,0,1,0,1,0,deny
53068,445,0,0,70,70,0,1,0,1,0,drop
38755,22114,0,0,66,66,0,1,0,1,0,deny
53061,445,0,0,70,70,0,1,0,1,0,drop
53060,445,0,0,70,70,0,1,0,1,0,drop
22547,48817,0,0,72,72,0,1,0,1,0,deny
50077,443,55619,443,1786,172,1614,7,0,3,4,allow
62400,35993,0,0,66,66,0,1,0,1,0,deny
15333,60043,0,0,62,62,0,1,0,1,0,deny
56639,48817,0,0,66,66,0,1,0,1,0,deny
45964,2228,0,0,60,60,0,1,0,1,0,deny
53071,25174,0,0,66,66,0,1,0,1,0,deny
3524,25174,0,0,66,66,0,1,0,1,0,deny
64846,445,0,0,66,66,0,1,0,1,0,drop
61898,50584,0,0,66,66,0,1,0,1,0,deny
19330,25174,0,0,146,146,0,1,0,1,0,deny
15499,22114,0,0,146,146,0,1,0,1,0,deny
64694,445,0,0,70,70,0,1,0,1,0,drop
49160,46824,0,0,146,146,0,1,0,1,0,deny
13285,29892,0,0,145,145,0,1,0,1,0,deny
25565,42779,0,0,60,60,0,1,0,1,0,deny
36154,47807,0,0,146,146,0,1,0,1,0,deny
60337,30188,0,0,66,66,0,1,0,1,0,deny
59803,22114,0,0,62,62,0,1,0,1,0,deny
62043,25174,0,0,62,62,0,1,0,1,0,deny
64691,445,0,0,70,70,0,1,0,1,0,drop
64838,445,0,0,66,66,0,1,0,1,0,drop
53048,445,0,0,70,70,0,1,0,1,0,drop
44334,26467,0,0,62,62,0,1,0,1,0,deny
60049,25174,0,0,66,66,0,1,0,1,0,deny
64835,445,0,0,66,66,0,1,0,1,0,drop
54280,3385,0,0,60,60,0,1,0,1,0,deny
51414,50584,0,0,66,66,0,1,0,1,0,deny
3478,45401,0,0,109,109,0,1,0,1,0,deny
64686,445,0,0,70,70,0,1,0,1,0,drop
64685,445,0,0,70,70,0,1,0,1,0,drop
64828,445,0,0,66,66,0,1,0,1,0,drop
27055,25174,0,0,62,62,0,1,0,1,0,deny
57293,25174,0,0,146,146,0,1,0,1,0,deny
64683,445,0,0,70,70,0,1,0,1,0,drop
25009,35440,0,0,66,66,0,1,0,1,0,deny
64819,445,0,0,66,66,0,1,0,1,0,drop
49514,52255,0,0,162,162,0,1,0,1,0,deny
32132,25174,0,0,62,62,0,1,0,1,0,deny
61406,1,0,0,78,78,0,1,0,1,0,deny
20619,25174,0,0,66,66,0,1,0,1,0,deny
52640,64147,0,0,62,62,0,1,0,1,0,deny
6486,64147,0,0,66,66,0,1,0,1,0,deny
54189,22114,0,0,66,66,0,1,0,1,0,deny
53036,445,0,0,70,70,0,1,0,1,0,drop
58079,50584,0,0,66,66,0,1,0,1,0,deny
64676,445,0,0,70,70,0,1,0,1,0,drop
10144,62609,0,0,148,148,0,1,0,1,0,deny
53038,445,0,0,70,70,0,1,0,1,0,drop
53034,445,0,0,70,70,0,1,0,1,0,drop
64812,445,0,0,66,66,0,1,0,1,0,drop
64809,445,0,0,66,66,0,1,0,1,0,drop
64808,445,0,0,66,66,0,1,0,1,0,drop
64811,445,0,0,66,66,0,1,0,1,0,drop
64804,445,0,0,66,66,0,1,0,1,0,drop
64807,445,0,0,66,66,0,1,0,1,0,drop
64805,445,0,0,66,66,0,1,0,1,0,drop
64806,445,0,0,66,66,0,1,0,1,0,drop
54542,25604,0,0,66,66,0,1,0,1,0,deny
64674,445,0,0,70,70,0,1,0,1,0,drop
25457,25604,0,0,62,62,0,1,0,1,0,deny
16052,25174,0,0,146,146,0,1,0,1,0,deny
6122,23,0,0,60,60,0,1,0,1,0,deny
34932,38608,0,0,62,62,0,1,0,1,0,deny
64673,445,0,0,70,70,0,1,0,1,0,drop
30583,25174,0,0,66,66,0,1,0,1,0,deny
64672,445,0,0,70,70,0,1,0,1,0,drop
64671,445,0,0,70,70,0,1,0,1,0,drop
57013,53,60365,53,172,88,84,2,30,1,1,allow
65176,53,35365,53,182,93,89,2,30,1,1,allow
56070,53,35943,53,770,101,669,2,30,1,1,allow
53437,443,53437,443,4198,2498,1700,25,102,12,13,allow
53250,443,53250,443,1464,757,707,18,121,9,9,allow
48173,443,63016,443,4342,2152,2190,19,255,10,9,allow
64788,53,47380,53,168,86,82,2,30,1,1,allow
56414,53,17231,53,88,88,0,1,30,1,0,allow
64622,53,5676,53,738,86,652,2,30,1,1,allow
53251,443,53251,443,1404,697,707,17,121,8,9,allow
61797,23,61797,23,60,60,0,1,5,1,0,allow
50320,80,20341,80,50565,32661,17904,77,167,39,38,allow
50595,80,62524,80,2049,1065,984,15,78,8,7,allow
55985,53,19393,53,738,86,652,2,30,1,1,allow
56273,53,59580,53,182,93,89,2,30,1,1,allow
39932,80,45032,80,3472,2124,1348,14,21,8,6,allow
49332,443,62500,443,27727,1971,25756,51,80,21,30,allow
53249,443,53249,443,1404,697,707,17,121,8,9,allow
57395,53,14755,53,262,88,174,4,59,2,2,allow
56878,53,24786,53,168,86,82,2,31,1,1,allow
56018,53,52062,53,762,97,665,2,30,1,1,allow
56540,443,45404,443,103117,6206,96911,127,106,54,73,allow
53248,443,53248,443,1588,817,771,20,121,10,10,allow
48174,443,2102,443,3889,1992,1897,19,255,10,9,allow
54144,7000,54144,7000,3018,1627,1391,16,15,9,7,allow
26941,443,39877,443,8466,3146,5320,30,20,15,15,allow
49932,53,48698,53,190,97,93,2,30,1,1,allow
57887,53,44516,53,174,81,93,2,30,1,1,allow
50622,80,45334,80,11907,10409,1498,28,52,16,12,allow
49333,443,11751,443,30571,1990,28581,53,80,21,32,allow
50285,443,10190,443,18009,7378,10631,58,62,33,25,allow
36883,80,30047,80,114410,3755,110655,128,38,47,81,allow
65422,443,52517,443,2494,1643,851,17,23,9,8,allow
57356,53,43032,53,780,93,687,2,30,1,1,allow
56415,53,6839,53,198,101,97,2,30,1,1,allow
57287,53,44650,53,752,93,659,2,30,1,1,allow
54652,53,54652,53,216,98,118,2,30,1,1,allow
44355,80,33572,80,26085,2508,23577,52,38,29,23,allow
42020,80,16578,80,42657,2962,39695,68,38,36,32,allow
53213,443,51742,443,8451,2320,6131,25,104,13,12,allow
50588,80,47890,80,9116,7610,1506,22,78,12,10,allow
9416,443,41034,443,6090,773,5317,17,25,9,8,allow
59007,443,65066,443,2608,1523,1085,19,15,10,9,allow
53233,443,53233,443,4114,2535,1579,25,139,13,12,allow
50621,80,31852,80,11975,10368,1607,27,52,16,11,allow
53246,443,53246,443,1419,788,631,15,121,8,7,allow
50665,443,26812,443,374,192,182,7,28,4,3,allow
26989,80,26989,80,256062,8754,247308,297,18,124,173,allow
52115,10012,62951,10012,66,66,0,1,5,1,0,allow
34043,443,15753,443,7280,4154,3126,30,735,16,14,allow
53247,443,53247,443,1528,757,771,19,121,9,10,allow
65218,53,51807,53,186,95,91,2,30,1,1,allow
52164,443,52164,443,20480,2066,18414,37,17,19,18,allow
11295,40040,53425,40040,213,89,124,4,54,2,2,allow
45908,33330,45908,33330,124,60,64,3,5,2,1,allow
58369,53,5499,53,174,81,93,2,30,1,1,allow
41889,443,23289,443,6516,1722,4794,26,17,15,11,allow
56289,53,51620,53,749,89,660,2,30,1,1,allow
7275,13487,0,0,66,66,0,1,91,1,0,allow
6881,51413,17965,51413,150,150,0,1,1200,1,0,allow
55370,53,18357,53,747,93,654,2,31,1,1,allow
55970,53,19238,53,760,97,663,2,31,1,1,allow
55284,443,12539,443,2895,726,2169,10,121,5,5,allow
50479,443,34516,443,5491,2608,2883,17,122,8,9,allow
56964,53,51072,53,174,89,85,2,31,1,1,allow
55492,53,58378,53,760,96,664,2,31,1,1,allow
56217,53,54817,53,182,93,89,2,31,1,1,allow
51566,443,53596,443,3051,990,2061,14,135,7,7,allow
55566,443,9542,443,8426,4752,3674,37,122,18,19,allow
44513,443,46778,443,3698,1302,2396,13,136,6,7,allow
34170,80,19669,80,1298,473,825,16,392,5,11,allow
55163,53,35742,53,194,99,95,2,31,1,1,allow
49695,53,13184,53,772,103,669,2,31,1,1,allow
64958,53,26216,53,194,99,95,2,31,1,1,allow
65287,53,9876,53,176,90,86,2,31,1,1,allow
56562,53,48636,53,182,93,89,2,31,1,1,allow
57129,53,40985,53,793,101,692,2,31,1,1,allow
6355,25174,0,0,146,146,0,1,0,1,0,deny
64665,445,0,0,70,70,0,1,0,1,0,drop
64666,445,0,0,70,70,0,1,0,1,0,drop
55439,37965,0,0,66,66,0,1,0,1,0,deny
49418,22114,0,0,66,66,0,1,0,1,0,deny
54473,37807,0,0,66,66,0,1,0,1,0,deny
53032,445,0,0,70,70,0,1,0,1,0,drop
53028,445,0,0,70,70,0,1,0,1,0,drop
53026,445,0,0,70,70,0,1,0,1,0,drop
53021,445,0,0,70,70,0,1,0,1,0,drop
64653,445,0,0,70,70,0,1,0,1,0,drop
64652,445,0,0,70,70,0,1,0,1,0,drop
64650,445,0,0,70,70,0,1,0,1,0,drop
64792,445,0,0,66,66,0,1,0,1,0,drop
64790,445,0,0,66,66,0,1,0,1,0,drop
64789,445,0,0,66,66,0,1,0,1,0,drop
64642,445,0,0,70,70,0,1,0,1,0,drop
64643,445,0,0,70,70,0,1,0,1,0,drop
23218,62413,0,0,66,66,0,1,0,1,0,deny
43260,41615,0,0,145,145,0,1,0,1,0,deny
58101,46314,0,0,72,72,0,1,0,1,0,deny
53015,445,0,0,70,70,0,1,0,1,0,drop
37308,43890,0,0,62,62,0,1,0,1,0,deny
64808,27098,0,0,66,66,0,1,0,1,0,deny
62580,23,0,0,60,60,0,1,0,1,0,deny
53010,445,0,0,70,70,0,1,0,1,0,drop
53007,445,0,0,70,70,0,1,0,1,0,drop
53004,445,0,0,70,70,0,1,0,1,0,drop
55985,44847,0,0,62,62,0,1,0,1,0,deny
11228,25174,0,0,66,66,0,1,0,1,0,deny
36339,50584,0,0,146,146,0,1,0,1,0,deny
13021,25174,0,0,146,146,0,1,0,1,0,deny
59032,25174,0,0,66,66,0,1,0,1,0,deny
64631,445,0,0,70,70,0,1,0,1,0,drop
13418,22,0,0,60,60,0,1,0,1,0,deny
61550,5529,0,0,145,145,0,1,0,1,0,deny
11235,30188,0,0,66,66,0,1,0,1,0,deny
52231,50934,0,0,62,62,0,1,0,1,0,deny
29884,25174,0,0,62,62,0,1,0,1,0,deny
34112,44847,0,0,62,62,0,1,0,1,0,deny
50765,22114,0,0,66,66,0,1,0,1,0,deny
52996,445,0,0,70,70,0,1,0,1,0,drop
52994,445,0,0,70,70,0,1,0,1,0,drop
52990,445,0,0,70,70,0,1,0,1,0,drop
6121,51505,0,0,66,66,0,1,0,1,0,deny
64627,445,0,0,70,70,0,1,0,1,0,drop
44919,26467,0,0,62,62,0,1,0,1,0,deny
1480,12447,0,0,66,66,0,1,0,1,0,deny
5213,44847,0,0,62,62,0,1,0,1,0,deny
64778,445,0,0,66,66,0,1,0,1,0,drop
61057,25174,0,0,62,62,0,1,0,1,0,deny
64617,445,0,0,70,70,0,1,0,1,0,drop
64618,445,0,0,70,70,0,1,0,1,0,drop
64615,445,0,0,70,70,0,1,0,1,0,drop
55451,56205,0,0,66,66,0,1,0,1,0,deny
65231,50584,0,0,62,62,0,1,0,1,0,deny
47403,57470,0,0,109,109,0,1,0,1,0,deny
64613,445,0,0,70,70,0,1,0,1,0,drop
64611,445,0,0,70,70,0,1,0,1,0,drop
59097,2767,0,0,66,66,0,1,0,1,0,deny
59807,53,15491,53,263,94,169,2,30,1,1,allow
52098,443,38562,443,3015,2037,978,15,15,9,6,allow
53433,443,53433,443,15095,2556,12539,37,102,15,22,allow
49874,53,62950,53,196,94,102,2,30,1,1,allow
46751,53,46751,53,220,90,130,2,30,1,1,allow
64788,53,23511,53,168,86,82,2,30,1,1,allow
38626,443,25389,443,97751,9140,88611,115,82,39,76,allow
22075,53,22075,53,404,259,145,3,33,2,1,allow
53167,22083,1777,22083,70,70,0,2,8,2,0,allow
64038,28187,42501,28187,70,70,0,1,4,1,0,allow
57999,80,9823,80,5434,3724,1710,26,76,14,12,allow
54530,443,34587,443,6202,3033,3169,28,167,13,15,allow
49256,53,36401,53,179,94,85,2,29,1,1,allow
49729,53,55522,53,210,102,108,2,30,1,1,allow
55790,53,39330,53,177,94,83,2,30,1,1,allow
38562,443,38562,443,4611,1704,2907,19,28,11,8,allow
50385,80,53379,80,28942,2526,26416,39,25,16,23,allow
55179,443,6638,443,5839,1984,3855,19,18,11,8,allow
64426,53,39298,53,669,200,469,6,49,3,3,allow
60985,443,55270,443,11535,4866,6669,34,50,20,14,allow
35017,443,23449,443,826,362,464,13,30,6,7,allow
53245,443,53245,443,1220,659,561,13,120,7,6,allow
37646,443,54992,443,11821,3643,8178,30,45,17,13,allow
53282,443,7574,443,604924,37384,567540,846,154,315,531,allow
40335,443,28601,443,4397,2104,2293,29,85,11,18,allow
49934,53,18444,53,478,107,371,4,39,2,2,allow
64032,12343,46737,12343,630,508,122,9,15,7,2,allow
60483,57723,53854,57723,320,140,180,6,6,3,3,allow
52146,18174,42084,18174,70,70,0,2,7,2,0,allow
53435,443,53435,443,2503,1457,1046,21,102,10,11,allow
56427,53,25251,53,178,94,84,2,29,1,1,allow
49532,53,58267,53,334,92,242,4,49,2,2,allow
56534,53,14913,53,177,94,83,2,29,1,1,allow
64886,53,49173,53,199,102,97,2,29,1,1,allow
56830,53,25316,53,195,102,93,2,29,1,1,allow
64886,53,44785,53,199,102,97,2,29,1,1,allow
56081,53,46764,53,186,102,84,2,29,1,1,allow
56712,53,4358,53,177,94,83,2,30,1,1,allow
65176,53,65083,53,183,94,89,2,30,1,1,allow
55991,53,30604,53,183,94,89,2,30,1,1,allow
51994,80,37899,80,366,240,126,7,26,5,2,allow
52148,80,52148,80,62796,1961,60835,72,141,26,46,allow
58832,443,61522,443,274798,9459,265339,343,201,136,207,allow
65488,53,3940,53,266,110,156,2,30,1,1,allow
57013,53,17393,53,178,94,84,2,30,1,1,allow
55700,53,12317,53,337,110,227,2,30,1,1,allow
55588,53,33689,53,168,86,82,2,31,1,1,allow
52153,12673,40206,12673,316,136,180,6,6,3,3,allow
33525,53,64644,53,179,86,93,2,30,1,1,allow
59019,53,48512,53,179,86,93,2,30,1,1,allow
64324,53,5232,53,344,105,239,4,33,2,2,allow
65460,53,23650,53,184,94,90,2,30,1,1,allow
54710,443,54710,443,32709,8467,24242,54,20,29,25,allow
52143,33283,63927,33283,70,70,0,2,8,2,0,allow
56661,53,2934,53,288,93,195,4,32,2,2,allow
52005,80,9480,80,46046,2705,43341,60,15,29,31,allow
37629,443,33990,443,172,172,0,2,5,2,0,allow
45694,80,47472,80,154671,9533,145138,227,38,121,106,allow
60797,28080,55300,28080,70,70,0,1,5,1,0,allow
65249,53,14438,53,1579,94,1485,4,36,2,2,allow
52114,64853,36038,64853,70,70,0,1,5,1,0,allow
60872,443,60963,443,10306,3254,7052,32,47,18,14,allow
53122,80,53122,80,19237,829,18408,29,15,13,16,allow
38627,443,6493,443,32864,2590,30274,41,82,14,27,allow
24566,53,24566,53,216,90,126,2,30,1,1,allow
49980,53,10608,53,503,103,400,4,47,2,2,allow
13003,3389,13003,3389,3424,1710,1714,16,33,8,8,allow
56937,8200,55532,8200,78,78,0,1,30,1,0,allow
64110,53,20636,53,215,102,113,2,30,1,1,allow
49358,443,12762,443,137147,82203,54944,174,105,103,71,allow
49776,53,49776,53,256,114,142,2,30,1,1,allow
56565,53,34463,53,164,86,78,2,30,1,1,allow
1876,53,51383,53,404,261,143,3,30,2,1,allow
56830,53,56847,53,195,102,93,2,30,1,1,allow
50378,53,48801,53,184,94,90,2,30,1,1,allow
53466,443,35377,443,7866,2625,5241,25,120,11,14,allow
49225,443,22877,443,11707,2326,9381,28,19,14,14,allow
49422,53,49422,53,247,98,149,2,32,1,1,allow
56661,53,16607,53,288,93,195,4,32,2,2,allow
47042,80,50684,80,1122,682,440,11,15,6,5,allow
60984,443,58411,443,12163,4876,7287,35,50,20,15,allow
38619,443,65221,443,469799,14616,455183,474,129,155,319,allow
57254,443,6263,443,3948,1290,2658,13,120,6,7,allow
51973,80,57539,80,426,240,186,8,26,5,3,allow
56556,443,40496,443,8908,1849,7059,31,105,17,14,allow
41474,443,57047,443,2767442,82304,2685138,2961,85,1088,1873,allow
31089,53,31089,53,197,90,107,2,30,1,1,allow
56406,53,15140,53,213,102,111,2,30,1,1,allow
57183,53,32090,53,178,94,84,2,30,1,1,allow
52176,443,22865,443,8048,1360,6688,24,23,12,12,allow
50620,80,32710,80,16709,10372,6337,31,52,16,15,allow
50586,80,48187,80,6718,3126,3592,16,78,8,8,allow
50596,80,46998,80,1598,937,661,13,78,7,6,allow
50579,80,47300,80,1827,989,838,13,78,7,6,allow
50590,80,16341,80,1507,951,556,13,78,7,6,allow
56661,53,21967,53,288,93,195,4,32,2,2,allow
52144,15208,25879,15208,70,70,0,2,8,2,0,allow
52003,80,9765,80,88807,5957,82850,113,15,54,59,allow
53434,443,53434,443,2511,1464,1047,21,102,10,11,allow
50668,80,30546,80,24370,5713,18657,37,26,17,20,allow
64865,53,49871,53,305,97,208,4,53,2,2,allow
57395,53,40276,53,262,88,174,4,58,2,2,allow
55524,53,55524,53,197,90,107,2,29,1,1,allow
58414,53,7367,53,245,118,127,2,29,1,1,allow
54961,53,50012,53,211,102,109,2,29,1,1,allow
53911,1025,4663,1025,70,70,0,1,4,1,0,allow
55690,443,36462,443,914,444,470,14,29,7,7,allow
56534,53,47047,53,177,94,83,2,29,1,1,allow
65092,53,28213,53,197,102,95,2,29,1,1,allow
65087,53,28763,53,229,94,135,2,30,1,1,allow
44176,443,60900,443,3327,1940,1387,19,22,10,9,allow
41473,443,44182,443,4987881,144889,4842992,5257,85,1888,3369,allow
53897,46913,50139,46913,552,306,246,9,15,5,4,allow
62497,443,15059,443,10393,7059,3334,27,26,15,12,allow
41283,53,41283,53,247,98,149,2,31,1,1,allow
55790,53,54535,53,177,94,83,2,30,1,1,allow
49656,443,43316,443,19544,4428,15116,79,119,39,40,allow
65482,53,62841,53,374,91,283,4,33,2,2,allow
57395,53,64683,53,262,88,174,4,58,2,2,allow
52116,64692,3805,64692,70,70,0,1,5,1,0,allow
59748,53,55446,53,230,110,120,2,29,1,1,allow
56415,53,33684,53,199,102,97,2,29,1,1,allow
59582,53,61781,53,256,102,154,2,29,1,1,allow
55626,53,3780,53,319,126,193,2,29,1,1,allow
51971,80,56168,80,426,240,186,8,26,5,3,allow
53715,53,53715,53,216,98,118,2,29,1,1,allow
52149,80,52149,80,2928,694,2234,13,141,6,7,allow
65266,53,53450,53,233,102,131,2,29,1,1,allow
56081,53,27644,53,186,102,84,2,29,1,1,allow
64058,53,58322,53,280,110,170,2,30,1,1,allow
56415,53,13196,53,199,102,97,2,29,1,1,allow
57177,443,54507,443,1610,771,839,22,120,11,11,allow
65176,53,64926,53,183,94,89,2,29,1,1,allow
64424,53,20113,53,194,94,100,2,30,1,1,allow
49165,53,42494,53,257,126,131,2,30,1,1,allow
58555,443,6848,443,15546,2361,13185,39,123,18,21,allow
50051,53,51528,53,766,102,664,2,30,1,1,allow
55991,53,7983,53,183,94,89,2,30,1,1,allow
53438,443,53438,443,2511,1465,1046,21,102,10,11,allow
33876,53,33876,53,404,259,145,3,32,2,1,allow
64749,53,28339,53,199,94,105,2,33,1,1,allow
55230,53,65301,53,467,96,371,4,44,2,2,allow
57984,80,44496,80,5474,3658,1816,27,76,14,13,allow
64237,53,55167,53,199,86,113,2,30,1,1,allow
65161,53,65161,53,256,114,142,2,30,1,1,allow
56415,53,9528,53,199,102,97,2,30,1,1,allow
33651,53,33651,53,197,90,107,2,30,1,1,allow
49218,53,31585,53,179,86,93,2,30,1,1,allow
55914,53,21562,53,212,102,110,2,30,1,1,allow
55163,53,9459,53,197,102,95,2,30,1,1,allow
46658,53,46658,53,216,98,118,2,30,1,1,allow
55792,53,55035,53,199,102,97,2,30,1,1,allow
49790,53,8407,53,229,110,119,2,30,1,1,allow
55790,53,27986,53,177,94,83,2,30,1,1,allow
64958,53,60361,53,197,102,95,2,30,1,1,allow
41810,443,22241,443,7474,2385,5089,15,121,7,8,allow
53548,443,18610,443,6812,1127,5685,24,255,11,13,allow
52117,20600,3356,20600,70,70,0,1,5,1,0,allow
62045,443,52563,443,10467,4259,6208,65,56,38,27,allow
64407,53,28727,53,291,94,197,2,30,1,1,allow
49759,53,39321,53,201,86,115,2,30,1,1,allow
65184,53,30460,53,225,102,123,2,30,1,1,allow
56273,53,28560,53,183,94,89,2,30,1,1,allow
65287,53,16028,53,180,94,86,2,30,1,1,allow
56068,53,21388,53,214,102,112,2,30,1,1,allow
53436,443,53436,443,2505,1460,1045,21,102,10,11,allow
37924,80,11096,80,214,140,74,4,15,3,1,allow
51972,80,30646,80,426,240,186,8,26,5,3,allow
54143,7000,54143,7000,770727,19843,750884,802,16,295,507,allow
49430,443,49430,443,4377,1470,2907,19,30,11,8,allow
57395,53,28814,53,262,88,174,4,59,2,2,allow
64922,53,12906,53,255,102,153,2,30,1,1,allow
64530,53,5563,53,264,110,154,2,30,1,1,allow
56565,53,24401,53,164,86,78,2,30,1,1,allow
56911,53,22477,53,211,78,133,2,30,1,1,allow
57013,53,1233,53,178,94,84,2,30,1,1,allow
49256,53,62875,53,179,94,85,2,30,1,1,allow
49932,53,43257,53,195,102,93,2,30,1,1,allow
51463,53,6551,53,417,86,331,2,31,1,1,allow
56217,53,61344,53,183,94,89,2,31,1,1,allow
50109,53,52643,53,198,110,88,2,31,1,1,allow
49334,53,44213,53,194,102,92,2,31,1,1,allow
64467,53,16595,53,184,94,90,2,31,1,1,allow
57183,53,6659,53,178,94,84,2,31,1,1,allow
55163,53,4604,53,197,102,95,2,31,1,1,allow
56195,53,13348,53,194,94,100,2,30,1,1,allow
56648,53,16460,53,199,102,97,2,31,1,1,allow
64995,53,32873,53,210,110,100,2,31,1,1,allow
56622,53,41480,53,179,94,85,2,31,1,1,allow
46440,443,14076,443,8465,3202,5263,23,120,10,13,allow
53246,443,25270,443,6574,1935,4639,14,121,7,7,allow
36972,443,35947,443,7557,3602,3955,20,150,12,8,allow
56964,53,57920,53,179,94,85,2,30,1,1,allow
64467,53,4748,53,184,94,90,2,30,1,1,allow
55633,53,30545,53,195,102,93,2,30,1,1,allow
49993,53,3383,53,211,102,109,2,30,1,1,allow
39890,123,28941,123,184,94,90,2,30,1,1,allow
65059,53,30320,53,168,86,82,2,31,1,1,allow
56878,53,49284,53,168,86,82,2,31,1,1,allow
56225,53,55911,53,183,94,89,2,31,1,1,allow
56414,53,33736,53,178,94,84,2,31,1,1,allow
21133,51413,27138,51413,460,150,310,2,1199,1,1,allow
43261,53,43261,53,247,98,149,2,34,1,1,allow
57432,53,57432,53,247,98,149,2,34,1,1,allow
65218,53,25461,53,833,290,543,8,88,4,4,allow
60886,443,45692,443,12652,6172,6480,44,16,26,18,allow
37628,443,18772,443,70,70,0,2,5,2,0,allow
9486,443,47731,443,3642,421,3221,12,16,6,6,allow
41475,443,20491,443,1251209,30056,1221153,1238,85,386,852,allow
59488,80,65175,80,1114,534,580,12,16,7,5,allow
61387,43890,0,0,66,66,0,1,0,1,0,deny
28436,22114,0,0,146,146,0,1,0,1,0,deny
52989,445,0,0,70,70,0,1,0,1,0,drop
22542,30188,0,0,62,62,0,1,0,1,0,deny
52988,445,0,0,70,70,0,1,0,1,0,drop
64727,25174,0,0,66,66,0,1,0,1,0,deny
59153,35440,0,0,66,66,0,1,0,1,0,deny
47632,25174,0,0,62,62,0,1,0,1,0,deny
7891,25174,0,0,66,66,0,1,0,1,0,deny
9329,2323,0,0,60,60,0,1,0,1,0,deny
64763,445,0,0,66,66,0,1,0,1,0,drop
64765,445,0,0,66,66,0,1,0,1,0,drop
64605,445,0,0,70,70,0,1,0,1,0,drop
25889,11446,0,0,66,66,0,1,0,1,0,deny
51042,22114,0,0,66,66,0,1,0,1,0,deny
50946,44847,0,0,66,66,0,1,0,1,0,deny
14489,25174,0,0,146,146,0,1,0,1,0,deny
64343,6004,0,0,66,66,0,1,0,1,0,deny
47342,20541,0,0,66,66,0,1,0,1,0,deny
59326,57470,0,0,74,74,0,1,0,1,0,deny
52977,445,0,0,70,70,0,1,0,1,0,drop
52978,445,0,0,70,70,0,1,0,1,0,drop
52974,445,0,0,70,70,0,1,0,1,0,drop
52976,445,0,0,70,70,0,1,0,1,0,drop
63743,25174,0,0,62,62,0,1,0,1,0,deny
3090,1,0,0,66,66,0,1,0,1,0,deny
64597,445,0,0,70,70,0,1,0,1,0,drop
31619,51221,0,0,62,62,0,1,0,1,0,deny
34166,22114,0,0,146,146,0,1,0,1,0,deny
64596,445,0,0,70,70,0,1,0,1,0,drop
64758,445,0,0,66,66,0,1,0,1,0,drop
54142,20541,0,0,62,62,0,1,0,1,0,deny
64751,445,0,0,66,66,0,1,0,1,0,drop
64746,445,0,0,66,66,0,1,0,1,0,drop
64749,445,0,0,66,66,0,1,0,1,0,drop
64748,445,0,0,66,66,0,1,0,1,0,drop
64744,445,0,0,66,66,0,1,0,1,0,drop
64745,445,0,0,66,66,0,1,0,1,0,drop
64742,445,0,0,66,66,0,1,0,1,0,drop
64591,445,0,0,70,70,0,1,0,1,0,drop
52962,445,0,0,70,70,0,1,0,1,0,drop
64589,445,0,0,70,70,0,1,0,1,0,drop
2919,37965,0,0,62,62,0,1,0,1,0,deny
60308,37965,0,0,66,66,0,1,0,1,0,deny
26921,26467,0,0,62,62,0,1,0,1,0,deny
52959,445,0,0,70,70,0,1,0,1,0,drop
52958,445,0,0,70,70,0,1,0,1,0,drop
52955,445,0,0,70,70,0,1,0,1,0,drop
46275,64147,0,0,62,62,0,1,0,1,0,deny
64772,64147,0,0,66,66,0,1,0,1,0,deny
61730,25320,0,0,66,66,0,1,0,1,0,deny
55069,44847,0,0,66,66,0,1,0,1,0,deny
25619,25174,0,0,146,146,0,1,0,1,0,deny
64585,445,0,0,70,70,0,1,0,1,0,drop
59782,26467,0,0,62,62,0,1,0,1,0,deny
56826,22114,0,0,66,66,0,1,0,1,0,deny
36858,50265,0,0,146,146,0,1,0,1,0,deny
14208,51221,0,0,66,66,0,1,0,1,0,deny
64583,445,0,0,70,70,0,1,0,1,0,drop
27841,35894,0,0,62,62,0,1,0,1,0,deny
13528,51221,0,0,62,62,0,1,0,1,0,deny
4138,55777,0,0,66,66,0,1,0,1,0,deny
65025,57866,0,0,62,62,0,1,0,1,0,deny
31845,55777,0,0,62,62,0,1,0,1,0,deny
52951,445,0,0,70,70,0,1,0,1,0,drop
52949,445,0,0,70,70,0,1,0,1,0,drop
52950,445,0,0,70,70,0,1,0,1,0,drop
64737,445,0,0,66,66,0,1,0,1,0,drop
52946,445,0,0,70,70,0,1,0,1,0,drop
49929,26467,0,0,66,66,0,1,0,1,0,deny
64733,445,0,0,66,66,0,1,0,1,0,drop
3981,23117,0,0,66,66,0,1,0,1,0,deny
36548,25174,0,0,146,146,0,1,0,1,0,deny
60479,25174,0,0,66,66,0,1,0,1,0,deny
64730,445,0,0,66,66,0,1,0,1,0,drop
64729,445,0,0,66,66,0,1,0,1,0,drop
64579,445,0,0,70,70,0,1,0,1,0,drop
64727,445,0,0,66,66,0,1,0,1,0,drop
5955,55160,0,0,74,74,0,1,0,1,0,deny
443,56513,0,0,78,78,0,1,0,1,0,deny
17280,22114,0,0,62,62,0,1,0,1,0,deny
26879,37965,0,0,62,62,0,1,0,1,0,deny
443,54154,0,0,60,60,0,1,0,1,0,deny
64295,26467,0,0,66,66,0,1,0,1,0,deny
52941,445,0,0,70,70,0,1,0,1,0,drop
443,28553,0,0,74,74,0,1,0,1,0,deny
52932,445,0,0,70,70,0,1,0,1,0,drop
52931,445,0,0,70,70,0,1,0,1,0,drop
64016,25174,0,0,62,62,0,1,0,1,0,deny
52430,22114,0,0,62,62,0,1,0,1,0,deny
57420,22114,0,0,62,62,0,1,0,1,0,deny
56614,25174,0,0,66,66,0,1,0,1,0,deny
55587,43890,0,0,66,66,0,1,0,1,0,deny
64566,445,0,0,70,70,0,1,0,1,0,drop
64716,445,0,0,66,66,0,1,0,1,0,drop
35356,25174,0,0,146,146,0,1,0,1,0,deny
59214,57866,0,0,66,66,0,1,0,1,0,deny
26802,50584,0,0,62,62,0,1,0,1,0,deny
64563,445,0,0,70,70,0,1,0,1,0,drop
57131,35776,0,0,145,145,0,1,0,1,0,deny
18113,22114,0,0,146,146,0,1,0,1,0,deny
53097,25174,0,0,62,62,0,1,0,1,0,deny
56406,22114,0,0,62,62,0,1,0,1,0,deny
64708,445,0,0,66,66,0,1,0,1,0,drop
28570,25174,0,0,146,146,0,1,0,1,0,deny
52918,445,0,0,70,70,0,1,0,1,0,drop
15701,37965,0,0,146,146,0,1,0,1,0,deny
56387,25174,0,0,62,62,0,1,0,1,0,deny
62575,12207,0,0,66,66,0,1,0,1,0,deny
63587,22114,0,0,146,146,0,1,0,1,0,deny
55312,64147,0,0,66,66,0,1,0,1,0,deny
64705,445,0,0,66,66,0,1,0,1,0,drop
64559,445,0,0,70,70,0,1,0,1,0,drop
64557,445,0,0,70,70,0,1,0,1,0,drop
8999,8055,0,0,146,146,0,1,0,1,0,deny
53161,51221,0,0,66,66,0,1,0,1,0,deny
38330,44847,0,0,66,66,0,1,0,1,0,deny
64555,445,0,0,70,70,0,1,0,1,0,drop
53381,25174,0,0,66,66,0,1,0,1,0,deny
61660,64097,0,0,62,62,0,1,0,1,0,deny
64698,445,0,0,66,66,0,1,0,1,0,drop
4232,50584,0,0,66,66,0,1,0,1,0,deny
58007,62413,0,0,66,66,0,1,0,1,0,deny
64689,445,0,0,66,66,0,1,0,1,0,drop
15806,11392,0,0,66,66,0,1,0,1,0,deny
49684,80,60336,80,13889,4084,9805,27,16,13,14,allow
52108,20175,4699,20175,66,66,0,1,5,1,0,allow
37642,443,20516,443,69348,4180,65168,86,45,37,49,allow
60389,80,65223,80,2499,531,1968,11,125,6,5,allow
56480,80,24972,80,289731,8487,281244,294,136,104,190,allow
56482,80,53743,80,180583,6825,173758,188,136,68,120,allow
44977,443,32272,443,4848,1030,3818,16,26,9,7,allow
56922,53,43765,53,86,86,0,1,30,1,0,allow
60388,80,7152,80,2424,529,1895,11,125,6,5,allow
50375,443,2479,443,5419,705,4714,16,25,8,8,allow
50367,443,43632,443,1630,916,714,12,25,7,5,allow
50366,443,19959,443,1755,986,769,13,25,8,5,allow
55390,443,55390,443,164571,13257,151314,206,19,95,111,allow
65073,80,65073,80,169702,10513,159189,187,23,72,115,allow
56481,80,14814,80,71347,4788,66559,83,136,34,49,allow
58874,443,22621,443,4738,1023,3715,18,66,10,8,allow
64473,7000,64473,7000,3434,1595,1839,17,15,9,8,allow
45079,443,33534,443,7298,2661,4637,21,18,11,10,allow
49627,53,55437,53,760,97,663,2,30,1,1,allow
64051,19548,46632,19548,66,66,0,2,8,2,0,allow
52142,54954,50454,54954,70,70,0,2,8,2,0,allow
64056,51266,62758,51266,66,66,0,2,8,2,0,allow
37640,443,4915,443,11442,3116,8326,32,46,19,13,allow
60498,443,60498,443,8233,948,7285,18,30,10,8,allow
36951,443,31916,443,70,70,0,1,5,1,0,allow
37632,443,56701,443,11338,2980,8358,31,46,18,13,allow
56478,80,51578,80,73400,4542,68858,87,136,37,50,allow
41895,443,48920,443,282,60,222,5,14,2,3,allow
51979,80,40174,80,366,240,126,7,25,5,2,allow
60478,30889,28285,30889,1303,903,400,12,16,7,5,allow
55991,53,53761,53,182,93,89,2,30,1,1,allow
64945,53,11913,53,760,97,663,2,30,1,1,allow
56483,80,37968,80,82266,4947,77319,94,136,37,57,allow
50604,443,49840,443,7470,2479,4991,20,135,9,11,allow
51980,80,2288,80,366,240,126,7,25,5,2,allow
49951,80,49951,80,24361943,451235,23910708,22804,63,6533,16271,allow
34346,443,57407,443,3497,1845,1652,18,15,9,9,allow
54142,7000,54142,7000,4067,1750,2317,16,16,9,7,allow
43357,443,31552,443,6392,1099,5293,18,33,10,8,allow
53906,12051,58772,12051,164,70,94,2,5,1,1,allow
57183,53,27398,53,172,88,84,2,30,1,1,allow
52109,60841,45067,60841,156,66,90,2,5,1,1,allow
52110,35411,30183,35411,66,66,0,1,5,1,0,allow
49328,443,21805,443,74569,3173,71396,97,80,36,61,allow
64432,53,46411,53,168,86,82,2,30,1,1,allow
56622,53,20942,53,174,89,85,2,31,1,1,allow
55594,53,44459,53,752,93,659,2,31,1,1,allow
50022,53,60834,53,174,89,85,2,31,1,1,allow
56258,53,50751,53,772,103,669,2,30,1,1,allow
64467,53,11977,53,184,94,90,2,30,1,1,allow
64702,53,11324,53,760,97,663,2,31,1,1,allow
64580,53,16498,53,176,90,86,2,31,1,1,allow
56125,53,8463,53,168,86,82,2,31,1,1,allow
56239,53,24103,53,176,90,86,2,31,1,1,allow
56648,53,6533,53,198,101,97,2,31,1,1,allow
57040,53,44476,53,174,89,85,2,31,1,1,allow
56153,53,6546,53,742,88,654,2,31,1,1,allow
54340,443,13340,443,3176,752,2424,10,121,5,5,allow
63601,443,6476,443,26835,2611,24224,36,121,14,22,allow
54329,443,7872,443,7827,2416,5411,18,136,8,10,allow
46525,5228,57899,5228,1410,933,477,11,3601,6,5,allow
64995,53,18804,53,204,104,100,2,31,1,1,allow
56198,53,15932,53,789,110,679,2,31,1,1,allow
64839,53,19060,53,208,106,102,2,31,1,1,allow
56143,53,31546,53,748,106,642,2,31,1,1,allow
60896,53,29321,53,168,78,90,2,31,1,1,allow
56820,53,32969,53,186,95,91,2,31,1,1,allow
55662,53,51499,53,753,93,660,2,31,1,1,allow
57836,443,52669,443,15844,1691,14153,18,138,5,13,allow
65412,53,28937,53,782,105,677,2,31,1,1,allow
56827,53,43714,53,190,97,93,2,31,1,1,allow
65409,53,26325,53,753,93,660,2,31,1,1,allow
65531,53,43079,53,186,95,91,2,31,1,1,allow
56792,53,2003,53,782,105,677,2,31,1,1,allow
56928,53,48986,53,172,88,84,2,31,1,1,allow
50550,443,16736,443,4551,2140,2411,14,135,6,8,allow
51683,5228,43500,5228,9476,2759,6717,27,3601,15,12,allow
56468,53,40699,53,1421,97,1324,4,55,2,2,allow
57440,53,36326,53,198,101,97,2,31,1,1,allow
40458,53,17783,53,168,78,90,2,31,1,1,allow
49900,443,9178,443,6300,2644,3656,16,121,8,8,allow
57470,39541,8082,39541,792,792,0,13,1200,13,0,allow
49485,56972,0,0,66,66,0,1,0,1,0,deny
37014,25174,0,0,66,66,0,1,0,1,0,deny
57251,37965,0,0,62,62,0,1,0,1,0,deny
48978,25174,0,0,66,66,0,1,0,1,0,deny
42981,44847,0,0,62,62,0,1,0,1,0,deny
62250,23117,0,0,66,66,0,1,0,1,0,deny
64548,445,0,0,70,70,0,1,0,1,0,drop
59282,51050,0,0,62,62,0,1,0,1,0,deny
64546,445,0,0,70,70,0,1,0,1,0,drop
52907,445,0,0,70,70,0,1,0,1,0,drop
52906,445,0,0,70,70,0,1,0,1,0,drop
64675,445,0,0,66,66,0,1,0,1,0,drop
64678,445,0,0,66,66,0,1,0,1,0,drop
64679,445,0,0,66,66,0,1,0,1,0,drop
64681,445,0,0,66,66,0,1,0,1,0,drop
64683,445,0,0,66,66,0,1,0,1,0,drop
64682,445,0,0,66,66,0,1,0,1,0,drop
64680,445,0,0,66,66,0,1,0,1,0,drop
64677,445,0,0,66,66,0,1,0,1,0,drop
48676,53395,0,0,60,60,0,1,0,1,0,deny
44285,25174,0,0,146,146,0,1,0,1,0,deny
60113,22114,0,0,66,66,0,1,0,1,0,deny
59303,21247,0,0,62,62,0,1,0,1,0,deny
64545,445,0,0,70,70,0,1,0,1,0,drop
26884,37965,0,0,66,66,0,1,0,1,0,deny
64544,445,0,0,70,70,0,1,0,1,0,drop
64543,445,0,0,70,70,0,1,0,1,0,drop
49689,22114,0,0,62,62,0,1,0,1,0,deny
64539,445,0,0,70,70,0,1,0,1,0,drop
64538,445,0,0,70,70,0,1,0,1,0,drop
12830,25174,0,0,62,62,0,1,0,1,0,deny
51930,57470,0,0,66,66,0,1,0,1,0,deny
7588,1962,0,0,60,60,0,1,0,1,0,deny
2780,23117,0,0,66,66,0,1,0,1,0,deny
54011,44847,0,0,66,66,0,1,0,1,0,deny
64525,445,0,0,70,70,0,1,0,1,0,drop
64524,445,0,0,70,70,0,1,0,1,0,drop
64520,445,0,0,70,70,0,1,0,1,0,drop
52904,445,0,0,70,70,0,1,0,1,0,drop
52903,445,0,0,70,70,0,1,0,1,0,drop
52891,445,0,0,70,70,0,1,0,1,0,drop
52889,445,0,0,70,70,0,1,0,1,0,drop
3764,9694,0,0,66,66,0,1,0,1,0,deny
64515,445,0,0,70,70,0,1,0,1,0,drop
64514,445,0,0,70,70,0,1,0,1,0,drop
16620,25174,0,0,62,62,0,1,0,1,0,deny
64662,445,0,0,66,66,0,1,0,1,0,drop
64661,445,0,0,66,66,0,1,0,1,0,drop
64660,445,0,0,66,66,0,1,0,1,0,drop
4111,25174,0,0,62,62,0,1,0,1,0,deny
38053,50584,0,0,62,62,0,1,0,1,0,deny
57550,50584,0,0,66,66,0,1,0,1,0,deny
64363,22114,0,0,66,66,0,1,0,1,0,deny
19594,23117,0,0,66,66,0,1,0,1,0,deny
58266,443,20650,443,5619,1387,4232,18,205,10,8,allow
50527,53,64659,53,969,86,883,2,30,1,1,allow
29268,53,40863,53,220,78,142,2,30,1,1,allow
50202,53,17431,53,166,86,80,2,30,1,1,allow
48372,8100,19668,8100,234,234,0,4,11,4,0,allow
53902,55298,56516,55298,70,70,0,1,4,1,0,allow
55792,53,52460,53,199,102,97,2,29,1,1,allow
57183,53,22943,53,178,94,84,2,29,1,1,allow
56562,53,61427,53,183,94,89,2,30,1,1,allow
38624,443,30332,443,6385,1090,5295,18,33,10,8,allow
56562,53,42626,53,183,94,89,2,30,1,1,allow
33906,80,51887,80,1248,660,588,8,15,4,4,allow
64031,25933,32039,25933,436,254,182,7,14,4,3,allow
40865,8100,38607,8100,234,234,0,4,11,4,0,allow
41313,53,41313,53,404,259,145,3,32,2,1,allow
40651,443,45721,443,41517,28432,13085,89,601,47,42,allow
53904,1024,55644,1024,70,70,0,1,4,1,0,allow
41472,443,61400,443,680618,28384,652234,828,84,356,472,allow
53903,51339,10537,51339,70,70,0,1,4,1,0,allow
14442,443,28353,443,2601,1455,1146,18,15,8,10,allow
57605,443,60913,443,2614,1689,925,18,20,10,8,allow
59254,443,5881,443,8332,1024,7308,21,25,11,10,allow
52113,19619,19801,19619,70,70,0,1,4,1,0,allow
55404,53,35517,53,326,102,224,2,29,1,1,allow
57419,53,24851,53,326,110,216,2,29,1,1,allow
55633,53,59677,53,195,102,93,2,30,1,1,allow
49826,53,41958,53,279,95,184,4,59,2,2,allow
57013,53,50114,53,178,94,84,2,29,1,1,allow
49808,53,25125,53,268,102,166,2,29,1,1,allow
56535,443,1772,443,185925,12445,173480,210,105,82,128,allow
62917,993,58803,993,9056,4223,4833,82,35,42,40,allow
49227,2710,36226,2710,70,70,0,2,8,2,0,allow
37999,49152,14143,49152,156,156,0,3,8,3,0,allow
60869,443,60836,443,10630,3315,7315,27,46,15,12,allow
56013,443,56013,443,4599,1692,2907,19,26,11,8,allow
51967,80,56439,80,426,240,186,8,25,5,3,allow
51975,80,44833,80,426,240,186,8,25,5,3,allow
41471,443,22977,443,1973617,48070,1925547,1945,84,606,1339,allow
57440,53,5992,53,199,102,97,2,30,1,1,allow
55900,53,13889,53,194,102,92,2,30,1,1,allow
56835,53,43767,53,213,102,111,2,30,1,1,allow
40597,443,45954,443,11101,4498,6603,35,430,20,15,allow
54787,443,54787,443,18160,6539,11621,37,19,22,15,allow
58392,53,58392,53,404,259,145,3,33,2,1,allow
53128,443,20598,443,14603,4208,10395,39,48,20,19,allow
51480,3027,51480,3027,156,156,0,3,8,3,0,allow
58879,443,43164,443,10439,1785,8654,25,85,10,15,allow
51579,443,8189,443,1522,1210,312,9,28,4,5,allow
52140,53155,1111,53155,70,70,0,2,8,2,0,allow
50369,443,20659,443,8048,1189,6859,19,25,10,9,allow
60868,443,49136,443,9660,2402,7258,27,46,15,12,allow
51962,80,39391,80,422,240,182,8,25,5,3,allow
58004,80,58289,80,14922,10566,4356,39,75,20,19,allow
35811,443,26946,443,13562,3104,10458,38,201,22,16,allow
46512,443,4517,443,22641,10532,12109,62,200,35,27,allow
56494,80,51723,80,44136,2908,41228,56,135,25,31,allow
56488,80,17378,80,64702,3709,60993,76,135,30,46,allow
49750,5223,50752,5223,46785,27735,19050,232,5491,123,109,allow
56225,53,43887,53,183,94,89,2,30,1,1,allow
43862,443,61828,443,6600,1174,5426,23,62,13,10,allow
49773,53,20298,53,994,86,908,2,30,1,1,allow
51968,80,1754,80,366,240,126,7,25,5,2,allow
56827,53,56181,53,195,102,93,2,30,1,1,allow
51976,80,64058,80,366,240,126,7,25,5,2,allow
33462,53,33462,53,256,114,142,2,30,1,1,allow
55991,53,41227,53,183,94,89,2,30,1,1,allow
64904,53,1451,53,211,102,109,2,30,1,1,allow
50202,53,23143,53,166,86,80,2,30,1,1,allow
65059,53,35510,53,168,86,82,2,30,1,1,allow
48856,53,0,0,86,86,0,1,30,1,0,allow
40403,53,40667,53,199,94,105,2,30,1,1,allow
57002,53,39237,53,211,94,117,2,30,1,1,allow
50109,53,42164,53,198,110,88,2,30,1,1,allow
56532,443,14584,443,198167,11702,186465,220,105,84,136,allow
56125,53,57582,53,168,86,82,2,30,1,1,allow
41176,443,1178,443,31541,25324,6217,49,91,29,20,allow
64432,53,45713,53,168,86,82,2,30,1,1,allow
35809,443,51066,443,13084,2704,10380,36,201,21,15,allow
56356,53,61835,53,184,102,82,2,30,1,1,allow
65070,80,65070,80,145038,9857,135181,162,23,62,100,allow
50337,53,50337,53,260,106,154,2,30,1,1,allow
56683,443,65170,443,268,120,148,5,11,3,2,allow
51969,80,59733,80,366,240,126,7,25,5,2,allow
53892,25933,31211,25933,552,306,246,9,15,5,4,allow
51974,80,51357,80,426,240,186,8,25,5,3,allow
51977,80,40997,80,366,240,126,7,25,5,2,allow
57994,80,57049,80,2494,1540,954,21,75,11,10,allow
65071,80,65071,80,296372,11959,284413,311,23,113,198,allow
65067,80,65067,80,342198,13793,328405,355,23,126,229,allow
64030,53,64891,53,222,78,144,2,30,1,1,allow
56622,53,24570,53,179,94,85,2,30,1,1,allow
35117,443,10765,443,8866,4928,3938,26,121,13,13,allow
57996,80,13904,80,5411,3618,1793,27,75,14,13,allow
49296,53,40688,53,322,98,224,4,32,2,2,allow
42342,443,63705,443,494,198,296,8,17,4,4,allow
58001,80,18559,80,20532,14664,5868,47,75,24,23,allow
58003,80,63884,80,14987,10571,4416,40,75,20,20,allow
62041,443,33913,443,29329,6712,22617,54,60,23,31,allow
58681,443,24073,443,22576,10533,12043,61,200,35,26,allow
35742,443,2430,443,5612,1251,4361,22,65,12,10,allow
51970,80,32175,80,366,240,126,7,25,5,2,allow
51964,80,61928,80,306,120,186,6,25,3,3,allow
56487,80,45530,80,42070,2703,39367,53,135,22,31,allow
56491,80,30431,80,37154,2381,34773,50,135,23,27,allow
65109,53,18311,53,753,94,659,2,30,1,1,allow
48209,53,48209,53,628,82,546,2,30,1,1,allow
5431,53,64205,53,220,78,142,2,30,1,1,allow
49681,443,34762,443,7383,2461,4922,18,135,8,10,allow
51985,80,32955,80,1479,822,657,11,25,7,4,allow
1294,53,1294,53,216,82,134,2,32,1,1,allow
37627,443,10583,443,70,70,0,2,5,2,0,allow
9461,443,60064,443,2581,1602,979,17,20,9,8,allow
58000,80,21507,80,48253,13664,34589,66,75,25,41,allow
57995,80,53962,80,4065,2650,1415,25,75,13,12,allow
34331,443,59493,443,9415,3998,5417,23,301,11,12,allow
50380,443,13367,443,306,180,126,6,25,4,2,allow
51961,80,32070,80,26804,11349,15455,45,26,25,20,allow
58008,80,56721,80,2549,1595,954,21,75,11,10,allow
35338,443,31577,443,571121,38361,532760,718,69,342,376,allow
56531,443,49300,443,215863,14423,201440,245,105,95,150,allow
50336,80,50336,80,2143,676,1467,12,25,7,5,allow
56534,443,29507,443,265430,17951,247479,305,105,122,183,allow
60497,443,60497,443,12727,948,11779,21,30,10,11,allow
51993,80,56681,80,482,300,182,9,25,6,3,allow
51991,80,57002,80,482,300,182,9,25,6,3,allow
47834,443,47834,443,4716,1809,2907,19,26,11,8,allow
33150,53,63816,53,816,228,588,8,29,4,4,allow
49330,443,57448,443,137414,6004,131410,170,80,59,111,allow
64615,53,56632,53,395,89,306,4,32,2,2,allow
60601,443,55669,443,6180,926,5254,18,36,10,8,allow
56562,53,4746,53,183,94,89,2,29,1,1,allow
38000,49152,22175,49152,156,156,0,3,8,3,0,allow
64055,45105,11907,45105,66,66,0,2,7,2,0,allow
56217,53,16338,53,183,94,89,2,29,1,1,allow
64053,47783,54848,47783,66,66,0,2,7,2,0,allow
56004,443,46384,443,130,70,60,3,4,2,1,allow
55404,443,49426,443,70,70,0,1,5,1,0,allow
50374,443,56948,443,5359,705,4654,15,25,8,7,allow
64432,53,49029,53,168,86,82,2,30,1,1,allow
50373,443,34130,443,5422,707,4715,16,25,8,8,allow
56484,80,16261,80,97842,4441,93401,109,135,41,68,allow
56489,80,59923,80,118508,4979,113529,128,135,48,80,allow
56486,80,1722,80,46682,3447,43235,61,135,27,34,allow
56492,80,31421,80,74105,3416,70689,84,135,32,52,allow
62921,993,3682,993,8856,4253,4603,79,27,42,37,allow
56477,80,20829,80,95037,3407,91630,103,135,38,65,allow
65287,53,49493,53,180,94,86,2,30,1,1,allow
56217,53,53375,53,183,94,89,2,30,1,1,allow
50022,53,3051,53,179,94,85,2,30,1,1,allow
44846,53,44846,53,86,86,0,1,30,1,0,allow
49631,53,24676,53,184,102,82,2,30,1,1,allow
56333,53,59595,53,209,110,99,2,31,1,1,allow
57130,443,51431,443,10724,3758,6966,38,403,13,25,allow
38011,443,62208,443,14337,3375,10962,47,121,23,24,allow
37427,443,40807,443,26069,12062,14007,46,123,21,25,allow
14697,8000,41154,8000,274,150,124,4,60,2,2,allow
49334,53,34104,53,194,102,92,2,30,1,1,allow
64958,53,14759,53,197,102,95,2,30,1,1,allow
56733,53,5625,53,183,94,89,2,30,1,1,allow
64995,53,14595,53,210,110,100,2,30,1,1,allow
65240,53,39958,53,199,94,105,2,30,1,1,allow
64580,53,3526,53,180,94,86,2,30,1,1,allow
57440,53,58703,53,199,102,97,2,30,1,1,allow
59833,53,25424,53,195,94,101,2,30,1,1,allow
56922,53,63628,53,168,86,82,2,31,1,1,allow
51963,80,35774,80,422,240,182,8,25,5,3,allow
56485,80,57235,80,46400,3639,42761,59,135,25,34,allow
51978,80,26908,80,4612,3409,1203,14,25,9,5,allow
37222,443,57670,443,4713,895,3818,18,16,10,8,allow
56495,80,7502,80,32396,2695,29701,46,135,22,24,allow
56493,80,12499,80,65864,3286,62578,76,135,30,46,allow
55337,443,55337,443,7710,3932,3778,23,18,14,9,allow
54636,443,3394,443,311000,8576,302424,319,175,103,216,allow
49826,53,26730,53,650,286,364,8,84,4,4,allow
56837,53,1718,53,227,110,117,2,30,1,1,allow
64340,53,7157,53,266,110,156,2,30,1,1,allow
65136,53,36348,53,438,180,258,6,30,3,3,allow
56648,53,49574,53,199,102,97,2,30,1,1,allow
56622,53,6660,53,340,107,233,4,30,2,2,allow
56572,53,50763,53,438,180,258,6,30,3,3,allow
61948,53,63047,53,205,86,119,2,30,1,1,allow
28679,3389,28679,3389,3910,1805,2105,20,19,12,8,allow
59248,443,51315,443,8332,1024,7308,21,25,11,10,allow
37630,443,19874,443,10000,2634,7366,28,46,16,12,allow
35810,443,44672,443,13706,3115,10591,40,201,22,18,allow
45397,443,38399,443,970804,44459,926345,1113,200,446,667,allow
51965,80,11220,80,306,120,186,6,25,3,3,allow
60871,443,24250,443,8338,3198,5140,28,46,16,12,allow
64587,443,60822,443,24686,1935,22751,36,18,17,19,allow
65072,80,65072,80,250600,11390,239210,268,23,98,170,allow
33640,53,0,0,139,70,69,2,30,1,1,allow
34062,443,2265,443,3208,2015,1193,19,34,11,8,allow
55290,53,19726,53,198,94,104,2,30,1,1,allow
49818,53,62354,53,751,94,657,2,30,1,1,allow
55570,53,7060,53,889,404,485,10,30,5,5,allow
55995,53,56863,53,182,94,88,2,30,1,1,allow
49815,53,3379,53,789,110,679,2,31,1,1,allow
56536,443,5996,443,210110,14803,195307,246,105,103,143,allow
56533,443,15782,443,306579,19447,287132,335,105,129,206,allow
42672,443,42672,443,4378,1471,2907,19,30,11,8,allow
58005,80,36908,80,14927,10571,4356,39,75,20,19,allow
50368,443,46131,443,8048,1189,6859,19,25,10,9,allow
62924,993,52929,993,9376,4359,5017,86,19,44,42,allow
51966,80,49895,80,366,240,126,7,25,5,2,allow
56490,80,11731,80,43084,3056,40028,60,135,27,33,allow
64946,53,5511,53,452,118,334,2,30,1,1,allow
64580,53,18330,53,180,94,86,2,30,1,1,allow
49561,53,14887,53,211,94,117,2,30,1,1,allow
49381,53,1330,53,209,110,99,2,30,1,1,allow
49295,53,60068,53,172,94,78,2,30,1,1,allow
56356,53,24415,53,184,102,82,2,30,1,1,allow
57440,53,28373,53,199,102,97,2,30,1,1,allow
49257,53,41185,53,166,86,80,2,30,1,1,allow
49492,53,44432,53,199,102,97,2,30,1,1,allow
44846,53,44846,53,653,349,304,5,30,3,2,allow
65107,53,32581,53,266,110,156,2,30,1,1,allow
50250,53,63565,53,178,94,84,2,31,1,1,allow
57040,53,36140,53,179,94,85,2,31,1,1,allow
49532,53,28306,53,730,102,628,2,31,1,1,allow
63463,443,46376,443,3182,1568,1614,8,120,4,4,allow
52520,443,9446,443,4463,1215,3248,16,121,8,8,allow
41098,443,2984,443,3384,762,2622,15,135,7,8,allow
50265,58840,23141,58840,132,132,0,3,1200,3,0,allow
49538,53,45151,53,748,94,654,2,30,1,1,allow
55900,53,53468,53,194,102,92,2,30,1,1,allow
49889,53,48150,53,197,102,95,2,31,1,1,allow
56239,53,30874,53,180,94,86,2,31,1,1,allow
50523,53,7142,53,168,86,82,2,31,1,1,allow
64422,53,12114,53,180,94,86,2,31,1,1,allow
60191,53,31189,53,196,94,102,2,31,1,1,allow
49492,53,34957,53,199,102,97,2,31,1,1,allow
57204,53,62909,53,195,102,93,2,31,1,1,allow
44974,443,22658,443,17760,13913,3847,54,167,25,29,allow
63464,443,53137,443,5614,2964,2650,19,120,9,10,allow
62066,443,9765,443,3150,831,2319,13,135,6,7,allow
38721,443,64394,443,10216,3380,6836,26,120,12,14,allow
6881,35179,42052,35179,228,118,110,2,1199,1,1,allow
49660,443,16842,443,3721,1477,2244,15,121,8,7,allow
53212,443,49183,443,4681,2403,2278,19,135,10,9,allow
50265,25490,26928,25490,1766,1332,434,22,1200,15,7,allow
50265,5554,7404,5554,472,150,322,2,1200,1,1,allow
6881,50239,58874,50239,3514,1874,1640,15,1200,8,7,allow
64116,53,6578,53,267,94,173,4,59,2,2,allow
49631,53,37899,53,184,102,82,2,30,1,1,allow
64229,53,36573,53,266,110,156,2,31,1,1,allow
57281,443,25432,443,212477,8324,204153,232,122,79,153,allow
55106,443,7279,443,3411,887,2524,12,120,6,6,allow
50265,49754,28018,49754,402,132,270,6,1209,3,3,allow
55555,53,4576,53,194,102,92,2,31,1,1,allow
55996,443,19878,443,5323,2482,2841,31,19,15,16,allow
36628,80,65040,80,78,78,0,1,5,1,0,allow
64580,53,58707,53,425,90,335,4,43,2,2,allow
53917,35885,30826,35885,70,70,0,2,8,2,0,allow
56473,80,3557,80,48910,2361,46549,63,135,29,34,allow
34416,443,60300,443,10255,2803,7452,35,26,18,17,allow
65280,53,19530,53,166,86,80,2,31,1,1,allow
64033,29834,16078,29834,70,70,0,1,5,1,0,allow
5588,5588,0,0,3562,1936,1626,48,195,24,24,allow
60899,25174,0,0,66,66,0,1,0,1,0,deny
57348,25174,0,0,62,62,0,1,0,1,0,deny
49993,37965,0,0,66,66,0,1,0,1,0,deny
27922,25174,0,0,62,62,0,1,0,1,0,deny
52886,445,0,0,70,70,0,1,0,1,0,drop
9212,51505,0,0,62,62,0,1,0,1,0,deny
52885,445,0,0,70,70,0,1,0,1,0,drop
52881,445,0,0,70,70,0,1,0,1,0,drop
52876,445,0,0,70,70,0,1,0,1,0,drop
45218,25174,0,0,62,62,0,1,0,1,0,deny
64503,445,0,0,70,70,0,1,0,1,0,drop
26311,23,0,0,60,60,0,1,0,1,0,deny
28649,43890,0,0,66,66,0,1,0,1,0,deny
10003,64147,0,0,62,62,0,1,0,1,0,deny
11136,19910,0,0,62,62,0,1,0,1,0,deny
55155,2767,0,0,66,66,0,1,0,1,0,deny
17262,25174,0,0,62,62,0,1,0,1,0,deny
6666,3389,0,0,60,60,0,1,0,1,0,deny
1280,25174,0,0,66,66,0,1,0,1,0,deny
59810,6004,0,0,66,66,0,1,0,1,0,deny
35058,23,0,0,60,60,0,1,0,1,0,deny
27046,51505,0,0,66,66,0,1,0,1,0,deny
64499,445,0,0,70,70,0,1,0,1,0,drop
59436,22114,0,0,66,66,0,1,0,1,0,deny
52869,445,0,0,70,70,0,1,0,1,0,drop
52867,445,0,0,70,70,0,1,0,1,0,drop
52866,445,0,0,70,70,0,1,0,1,0,drop
65389,26467,0,0,62,62,0,1,0,1,0,deny
2332,35440,0,0,62,62,0,1,0,1,0,deny
62579,57866,0,0,62,62,0,1,0,1,0,deny
26698,25174,0,0,66,66,0,1,0,1,0,deny
64490,445,0,0,70,70,0,1,0,1,0,drop
64489,445,0,0,70,70,0,1,0,1,0,drop
64487,445,0,0,70,70,0,1,0,1,0,drop
64551,2310,0,0,143,143,0,1,0,1,0,deny
33973,50265,0,0,62,62,0,1,0,1,0,deny
64651,445,0,0,66,66,0,1,0,1,0,drop
2049,32480,0,0,66,66,0,1,0,1,0,deny
64486,445,0,0,70,70,0,1,0,1,0,drop
53160,25174,0,0,62,62,0,1,0,1,0,deny
64483,445,0,0,70,70,0,1,0,1,0,drop
50394,25174,0,0,62,62,0,1,0,1,0,deny
39063,44847,0,0,66,66,0,1,0,1,0,deny
5912,22114,0,0,62,62,0,1,0,1,0,deny
61465,22114,0,0,62,62,0,1,0,1,0,deny
14331,23,0,0,60,60,0,1,0,1,0,deny
22220,25174,0,0,62,62,0,1,0,1,0,deny
52861,445,0,0,70,70,0,1,0,1,0,drop
25237,25174,0,0,146,146,0,1,0,1,0,deny
52859,445,0,0,70,70,0,1,0,1,0,drop
31609,25174,0,0,62,62,0,1,0,1,0,deny
6889,11119,0,0,143,143,0,1,0,1,0,deny
56528,64147,0,0,62,62,0,1,0,1,0,deny
64476,445,0,0,70,70,0,1,0,1,0,drop
9512,443,14359,443,3614,434,3180,11,1,6,5,allow
17004,64147,0,0,66,66,0,1,0,1,0,deny
7686,25174,0,0,146,146,0,1,0,1,0,deny
64632,445,0,0,66,66,0,1,0,1,0,drop
64633,445,0,0,66,66,0,1,0,1,0,drop
60159,22114,0,0,62,62,0,1,0,1,0,deny
54518,25174,0,0,62,62,0,1,0,1,0,deny
36302,25174,0,0,146,146,0,1,0,1,0,deny
15319,51505,0,0,66,66,0,1,0,1,0,deny
64469,445,0,0,70,70,0,1,0,1,0,drop
38859,22114,0,0,66,66,0,1,0,1,0,deny
50708,22114,0,0,62,62,0,1,0,1,0,deny
52851,445,0,0,70,70,0,1,0,1,0,drop
52849,445,0,0,70,70,0,1,0,1,0,drop
52850,445,0,0,70,70,0,1,0,1,0,drop
52841,445,0,0,70,70,0,1,0,1,0,drop
64468,445,0,0,70,70,0,1,0,1,0,drop
2278,25174,0,0,146,146,0,1,0,1,0,deny
27995,22114,0,0,146,146,0,1,0,1,0,deny
1143,25174,0,0,62,62,0,1,0,1,0,deny
64024,22114,0,0,62,62,0,1,0,1,0,deny
51635,50265,0,0,66,66,0,1,0,1,0,deny
64629,445,0,0,66,66,0,1,0,1,0,drop
1117,37965,0,0,62,62,0,1,0,1,0,deny
2864,25174,0,0,66,66,0,1,0,1,0,deny
64462,445,0,0,70,70,0,1,0,1,0,drop
64624,445,0,0,66,66,0,1,0,1,0,drop
64622,445,0,0,66,66,0,1,0,1,0,drop
64623,445,0,0,66,66,0,1,0,1,0,drop
64618,445,0,0,66,66,0,1,0,1,0,drop
64617,445,0,0,66,66,0,1,0,1,0,drop
64614,445,0,0,66,66,0,1,0,1,0,drop
64612,445,0,0,66,66,0,1,0,1,0,drop
64461,445,0,0,70,70,0,1,0,1,0,drop
45964,2225,0,0,60,60,0,1,0,1,0,deny
52834,445,0,0,70,70,0,1,0,1,0,drop
17101,25174,0,0,66,66,0,1,0,1,0,deny
50615,80,48256,80,190675,79205,111470,237,41,104,133,allow
52831,445,0,0,70,70,0,1,0,1,0,drop
52830,445,0,0,70,70,0,1,0,1,0,drop
52827,445,0,0,70,70,0,1,0,1,0,drop
64457,445,0,0,70,70,0,1,0,1,0,drop
50052,65008,0,0,60,60,0,1,0,1,0,deny
2938,64147,0,0,62,62,0,1,0,1,0,deny
2064,22114,0,0,146,146,0,1,0,1,0,deny
64455,445,0,0,70,70,0,1,0,1,0,drop
7288,25174,0,0,62,62,0,1,0,1,0,deny
23719,22114,0,0,62,62,0,1,0,1,0,deny
443,46569,0,0,66,66,0,1,0,1,0,deny
443,46080,0,0,66,66,0,1,0,1,0,deny
0,0,0,0,600,306,294,6,0,3,3,allow
11228,23,0,0,60,60,0,1,0,1,0,deny
56999,25174,0,0,62,62,0,1,0,1,0,deny
16168,23,0,0,60,60,0,1,0,1,0,deny
52823,445,0,0,70,70,0,1,0,1,0,drop
52822,445,0,0,70,70,0,1,0,1,0,drop
52821,445,0,0,70,70,0,1,0,1,0,drop
55146,1433,0,0,60,60,0,1,0,1,0,deny
64605,445,0,0,66,66,0,1,0,1,0,drop
52818,445,0,0,70,70,0,1,0,1,0,drop
64451,445,0,0,70,70,0,1,0,1,0,deny
64603,445,0,0,66,66,0,1,0,1,0,drop
59048,57470,0,0,66,66,0,1,0,1,0,deny
24351,57470,0,0,62,62,0,1,0,1,0,deny
22783,64147,0,0,62,62,0,1,0,1,0,deny
63867,35993,0,0,66,66,0,1,0,1,0,deny
12694,22114,0,0,66,66,0,1,0,1,0,deny
64601,445,0,0,66,66,0,1,0,1,0,drop
64602,445,0,0,66,66,0,1,0,1,0,drop
6587,22114,0,0,146,146,0,1,0,1,0,deny
64599,445,0,0,66,66,0,1,0,1,0,drop
2707,37,0,0,60,60,0,1,0,1,0,deny
59523,37965,0,0,62,62,0,1,0,1,0,deny
40108,23,0,0,60,60,0,1,0,1,0,deny
52813,445,0,0,70,70,0,1,0,1,0,drop
52806,445,0,0,70,70,0,1,0,1,0,drop
52804,445,0,0,70,70,0,1,0,1,0,drop
22528,25174,0,0,62,62,0,1,0,1,0,deny
49834,23,0,0,60,60,0,1,0,1,0,deny
64438,445,0,0,70,70,0,1,0,1,0,drop
15585,64147,0,0,66,66,0,1,0,1,0,deny
53563,35440,0,0,66,66,0,1,0,1,0,deny
22036,44847,0,0,62,62,0,1,0,1,0,deny
64680,22114,0,0,146,146,0,1,0,1,0,deny
19875,30170,0,0,145,145,0,1,0,1,0,deny
64586,445,0,0,66,66,0,1,0,1,0,drop
1660,8696,0,0,62,62,0,1,0,1,0,deny
51544,50584,0,0,62,62,0,1,0,1,0,deny
64435,445,0,0,70,70,0,1,0,1,0,drop
10312,23117,0,0,62,62,0,1,0,1,0,deny
60527,35440,0,0,66,66,0,1,0,1,0,deny
1130,37965,0,0,145,145,0,1,0,1,0,deny
49336,25174,0,0,66,66,0,1,0,1,0,deny
57578,51221,0,0,66,66,0,1,0,1,0,deny
57585,51221,0,0,62,62,0,1,0,1,0,deny
37522,22114,0,0,62,62,0,1,0,1,0,deny
64579,445,0,0,66,66,0,1,0,1,0,drop
56770,53,63283,53,208,106,102,2,30,1,1,allow
51099,80,52841,80,3422,1962,1460,33,131,18,15,allow
38468,53,0,0,82,82,0,2,40,2,0,allow
52102,19604,31294,19604,66,66,0,1,5,1,0,allow
59644,443,54066,443,8362065,55143,8306922,6375,152,332,6043,allow
50293,80,34278,80,134242,13446,120796,154,161,58,96,allow
50328,80,59408,80,55878,5841,50037,70,94,29,41,allow
49889,53,17299,53,194,99,95,2,30,1,1,allow
55216,53,63091,53,174,89,85,2,30,1,1,allow
60857,443,19971,443,18385,7771,10614,47,48,27,20,allow
52104,51756,50928,51756,66,66,0,1,5,1,0,allow
52106,41632,33294,41632,66,66,0,1,5,1,0,allow
9483,80,46807,80,1579,421,1158,9,15,4,5,allow
49826,53,60102,53,466,192,274,6,83,3,3,allow
60006,443,38577,443,185169,75281,109888,426,111,209,217,allow
50298,80,48126,80,166956,16834,150122,187,161,72,115,allow
56479,80,1802,80,460182,11717,448465,462,135,162,300,allow
53894,2944,38557,2944,70,70,0,1,5,1,0,allow
61583,80,61583,80,12301,1642,10659,20,20,9,11,allow
64664,80,64664,80,1921,1472,449,10,20,6,4,allow
65280,53,4153,53,164,84,80,2,31,1,1,allow
49492,53,11177,53,198,101,97,2,31,1,1,allow
55955,53,2221,53,814,110,704,2,30,1,1,allow
58931,443,42670,443,1413,876,537,12,28,6,6,allow
51135,443,24290,443,6678,1212,5466,22,256,12,10,allow
58932,443,14070,443,1413,876,537,12,28,6,6,allow
51658,80,20246,80,44842,2446,42396,73,255,34,39,allow
41734,443,42617,443,153,93,60,2,5,1,1,allow
51997,443,19517,443,2648,1797,851,19,22,11,8,allow
64034,17935,37819,17935,66,66,0,1,5,1,0,allow
9482,443,2770,443,5657,487,5170,14,15,7,7,allow
2267,53,13184,53,826,826,0,8,44,8,0,allow
51996,443,3596,443,2648,1797,851,19,22,11,8,allow
61123,80,61123,80,21678,2120,19558,33,20,16,17,allow
52141,1033,19443,1033,316,136,180,6,7,3,3,allow
51098,80,4123,80,3378,1918,1460,33,131,18,15,allow
36953,443,22801,443,70,70,0,1,5,1,0,allow
57422,53,50721,53,747,90,657,2,30,1,1,allow
51899,80,55362,80,1758,989,769,13,76,8,5,allow
56678,53,61385,53,760,97,663,2,30,1,1,allow
49815,53,0,0,166,73,93,2,30,1,1,allow
56064,53,20414,53,710,89,621,2,30,1,1,allow
56333,53,63639,53,202,103,99,2,31,1,1,allow
53896,48027,30657,48027,70,70,0,1,5,1,0,allow
51652,80,52729,80,32942,2548,30394,58,255,28,30,allow
50116,22,50116,22,184,120,64,4,10,3,1,allow
50297,80,4817,80,145266,14613,130653,165,161,63,102,allow
51097,80,51452,80,3374,1914,1460,33,131,18,15,allow
53124,80,20707,80,4198,3534,664,13,19,8,5,allow
49683,80,8217,80,1548,847,701,10,15,5,5,allow
61908,7000,61908,7000,4131,1750,2381,17,15,9,8,allow
53886,49618,46889,49618,492,306,186,8,16,5,3,allow
49791,53,6212,53,777,87,690,2,30,1,1,allow
44925,443,50958,443,153,93,60,2,5,1,1,allow
49257,53,65016,53,164,84,80,2,30,1,1,allow
50250,53,19188,53,172,88,84,2,30,1,1,allow
56770,443,57005,443,124,64,60,2,16,1,1,allow
64422,53,42337,53,176,90,86,2,30,1,1,allow
55687,53,59046,53,186,95,91,2,31,1,1,allow
64937,53,42639,53,204,104,100,2,31,1,1,allow
55418,53,39604,53,168,86,82,2,31,1,1,allow
54339,443,11466,443,3149,769,2380,10,120,5,5,allow
57204,53,25182,53,190,97,93,2,30,1,1,allow
64116,53,5820,53,184,94,90,2,31,1,1,allow
25808,53,25808,53,218,99,119,2,31,1,1,allow
65466,53,3496,53,733,86,647,2,31,1,1,allow
50403,53,23748,53,168,86,82,2,31,1,1,allow
56955,53,57810,53,182,93,89,2,31,1,1,allow
65186,53,43195,53,733,85,648,2,31,1,1,allow
37694,5228,64819,5228,6930,1665,5265,18,3601,9,9,allow
55352,53,6913,53,216,110,106,2,31,1,1,allow
55332,53,16316,53,206,105,101,2,31,1,1,allow
56314,53,18925,53,733,86,647,2,31,1,1,allow
49972,53,57217,53,216,110,106,2,31,1,1,allow
55555,53,39560,53,188,96,92,2,31,1,1,allow
49296,53,29013,53,186,95,91,2,31,1,1,allow
55022,53,10600,53,190,97,93,2,31,1,1,allow
58905,443,41213,443,13055,5677,7378,29,122,15,14,allow
58717,443,32923,443,280,140,140,5,130,3,2,allow
57407,53,20489,53,755,94,661,2,31,1,1,allow
55707,53,37897,53,170,87,83,2,31,1,1,allow
56422,53,35743,53,190,97,93,2,31,1,1,allow
49546,53,57576,53,208,106,102,2,31,1,1,allow
64299,53,27762,53,164,84,80,2,31,1,1,allow
49210,53,34070,53,182,93,89,2,31,1,1,allow
64856,53,10911,53,755,93,662,2,31,1,1,allow
38102,5228,57941,5228,4235,1797,2438,38,4443,13,25,allow
35556,443,35556,443,7201,1167,6034,16,131,8,8,allow
47276,443,16535,443,7613,2230,5383,22,360,11,11,allow
55007,53,10621,53,164,84,80,2,31,1,1,allow
56036,53,20624,53,762,98,664,2,31,1,1,allow
49982,53,52781,53,206,105,101,2,31,1,1,allow
64615,53,39093,53,190,97,93,2,31,1,1,allow
65065,53,49362,53,754,94,660,2,31,1,1,allow
37299,443,19605,443,10790,5444,5346,21,122,10,11,allow
56312,53,11008,53,190,97,93,2,31,1,1,allow
54054,5228,24551,5228,8767,2486,6281,45,6062,24,21,allow
39735,443,13542,443,280,140,140,5,130,3,2,allow
6881,6881,62439,6881,502,150,352,2,1200,1,1,allow
6882,3800,7427,3800,150,150,0,2,1201,2,0,allow
47561,26467,0,0,62,62,0,1,0,1,0,deny
52790,445,0,0,70,70,0,1,0,1,0,drop
58608,62413,0,0,66,66,0,1,0,1,0,deny
8508,23,0,0,60,60,0,1,0,1,0,deny
45941,23386,0,0,60,60,0,1,0,1,0,deny
45941,23386,0,0,60,60,0,1,0,1,0,deny
42231,57470,0,0,78,78,0,1,0,1,0,deny
64430,445,0,0,70,70,0,1,0,1,0,drop
64429,445,0,0,70,70,0,1,0,1,0,drop
55425,37965,0,0,66,66,0,1,0,1,0,deny
1847,64147,0,0,62,62,0,1,0,1,0,deny
64576,445,0,0,66,66,0,1,0,1,0,drop
51046,53,51046,53,244,106,138,2,30,1,1,allow
53885,50379,49864,50379,492,306,186,8,15,5,3,allow
53887,6881,31498,6881,552,306,246,9,15,5,4,allow
59052,53,59052,53,235,90,145,2,32,1,1,allow
51015,80,51015,80,1905,1456,449,10,20,6,4,allow
64878,53,35842,53,511,92,419,4,45,2,2,allow
49237,53,49518,53,216,110,106,2,30,1,1,allow
55808,53,53764,53,730,102,628,2,30,1,1,allow
60666,123,38509,123,184,94,90,2,30,1,1,allow
56638,443,50177,443,44984,28294,16690,77,40,40,37,allow
50356,80,58294,80,1578,756,822,13,34,7,6,allow
52139,38259,57318,38259,70,70,0,2,7,2,0,allow
53895,36849,47178,36849,70,70,0,1,4,1,0,allow
45295,443,2561,443,6864,1633,5231,20,315,10,10,allow
57498,443,57498,443,4546,1639,2907,19,27,11,8,allow
56474,80,38347,80,8790,1387,7403,17,134,9,8,allow
56476,80,31067,80,5342,1304,4038,14,134,8,6,allow
56472,80,20215,80,45108,2309,42799,60,134,28,32,allow
55995,53,15590,53,182,94,88,2,29,1,1,allow
64029,38651,25596,38651,70,70,0,1,4,1,0,allow
64422,53,60156,53,180,94,86,2,29,1,1,allow
52107,11191,10065,11191,70,70,0,1,4,1,0,allow
47073,7275,39561,7275,416,210,206,7,15,4,3,allow
55187,53,45900,53,172,94,78,2,29,1,1,allow
58273,53,40385,53,202,86,116,2,30,1,1,allow
64741,53,9431,53,715,94,621,2,29,1,1,allow
49295,53,61148,53,164,86,78,2,29,1,1,allow
49257,53,51275,53,166,86,80,2,29,1,1,allow
57204,53,62842,53,195,102,93,2,29,1,1,allow
55187,53,40713,53,172,94,78,2,30,1,1,allow
50523,53,12561,53,168,86,82,2,29,1,1,allow
60021,443,37470,443,346221,14712,331509,474,107,211,263,allow
60027,443,20291,443,8216,2269,5947,42,106,25,17,allow
62937,80,62937,80,1918,1469,449,10,20,6,4,allow
52218,80,52218,80,1921,1472,449,10,20,6,4,allow
61422,80,46677,80,214,140,74,4,41,3,1,allow
49167,80,49167,80,1915,1466,449,10,20,6,4,allow
54634,443,32455,443,225732,7330,218402,246,174,86,160,allow
64633,53,20577,53,255,102,153,2,30,1,1,allow
49417,53,32052,53,211,110,101,2,30,1,1,allow
57033,53,53118,53,216,110,106,2,30,1,1,allow
57129,53,59540,53,265,94,171,2,30,1,1,allow
56928,53,10586,53,178,94,84,2,30,1,1,allow
55332,53,34862,53,211,110,101,2,30,1,1,allow
50025,53,41046,53,369,150,219,2,30,1,1,allow
38706,443,10577,443,90545,3481,87064,96,16,31,65,allow
60007,443,8441,443,7040,1933,5107,32,110,19,13,allow
40042,80,40042,80,1919,1470,449,10,20,6,4,allow
55709,30217,33191,30217,70,70,0,2,8,2,0,allow
57312,53,15531,53,212,110,102,2,30,1,1,allow
61430,80,6930,80,214,140,74,4,41,3,1,allow
61423,80,2681,80,214,140,74,4,41,3,1,allow
48646,80,48646,80,1916,1467,449,10,20,6,4,allow
52248,443,56929,443,190,70,120,4,15,2,2,allow
58720,443,50201,443,32598,22046,10552,83,60,49,34,allow
35921,443,62122,443,9667,4709,4958,27,88,14,13,allow
52138,25621,30366,25621,70,70,0,2,8,2,0,allow
64052,38119,11965,38119,312,132,180,6,6,3,3,allow
56950,53,63422,53,211,102,109,2,30,1,1,allow
61864,80,52616,80,9747,537,9210,14,16,6,8,allow
51650,80,8862,80,2681,1044,1637,22,255,12,10,allow
57425,53,41826,53,168,86,82,2,30,1,1,allow
49237,53,48024,53,216,110,106,2,30,1,1,allow
49257,53,43950,53,579,181,398,6,84,3,3,allow
44871,53,32671,53,168,78,90,2,30,1,1,allow
64228,53,55912,53,266,110,156,2,30,1,1,allow
49305,53,20734,53,571,181,390,6,73,3,3,allow
55216,53,56986,53,179,94,85,2,30,1,1,allow
49592,53,33191,53,177,94,83,2,30,1,1,allow
65171,53,41753,53,752,110,642,2,30,1,1,allow
49624,53,59918,53,293,126,167,2,30,1,1,allow
49261,53,20112,53,453,186,267,6,30,3,3,allow
56239,53,14198,53,180,94,86,2,30,1,1,allow
56955,53,15071,53,183,94,89,2,30,1,1,allow
57425,53,32563,53,168,86,82,2,30,1,1,allow
56929,53,55156,53,784,94,690,2,30,1,1,allow
55352,53,47404,53,216,110,106,2,30,1,1,allow
56333,53,40833,53,209,110,99,2,30,1,1,allow
65204,443,43176,443,1786,172,1614,7,120,3,4,allow
57022,53,55045,53,369,150,219,2,30,1,1,allow
49615,53,23958,53,199,102,97,2,30,1,1,allow
39827,53,39827,53,247,98,149,2,33,1,1,allow
61427,80,27068,80,214,140,74,4,41,3,1,allow
61425,80,54723,80,214,140,74,4,41,3,1,allow
61424,80,26157,80,214,140,74,4,41,3,1,allow
38707,443,59526,443,774099,15769,758330,743,16,223,520,allow
50629,80,50629,80,6210,2976,3234,16,20,9,7,allow
50319,53,7677,53,814,110,704,2,30,1,1,allow
49408,53,3483,53,252,102,150,2,30,1,1,allow
49417,53,14090,53,211,110,101,2,30,1,1,allow
56770,53,41386,53,212,110,102,2,30,1,1,allow
56827,53,18397,53,195,102,93,2,30,1,1,allow
64023,12954,37073,12954,504,382,122,8,15,6,2,allow
49991,80,45821,80,2668,543,2125,12,28,6,6,allow
35060,80,35060,80,1918,1469,449,10,20,6,4,allow
58394,53,41554,53,274,94,180,2,30,1,1,allow
64839,53,42360,53,212,110,102,2,30,1,1,allow
55216,53,52646,53,179,94,85,2,30,1,1,allow
55923,53,7980,53,177,94,83,2,30,1,1,allow
55923,53,53051,53,177,94,83,2,30,1,1,allow
64243,53,38194,53,257,102,155,2,30,1,1,allow
56125,53,3352,53,168,86,82,2,30,1,1,allow
64737,53,22713,53,285,94,191,2,31,1,1,allow
43639,443,43639,443,4683,1776,2907,19,29,11,8,allow
57905,80,48820,80,12974,3246,9728,29,29,16,13,allow
57983,443,38369,443,7966,3102,4864,18,75,10,8,allow
52105,1024,64532,1024,70,70,0,1,4,1,0,allow
56632,53,56632,53,235,90,145,2,33,1,1,allow
64054,54778,50482,54778,312,132,180,6,6,3,3,allow
64467,53,41082,53,548,194,354,6,63,3,3,allow
52136,42939,50885,42939,70,70,0,2,8,2,0,allow
2267,53,49774,53,826,826,0,8,44,8,0,allow
64422,53,39408,53,180,94,86,2,31,1,1,allow
61426,80,34225,80,214,140,74,4,41,3,1,allow
60867,443,23930,443,14125,3827,10298,33,45,18,15,allow
45882,443,31867,443,6617,1852,4765,23,132,13,10,allow
53695,443,14454,443,4045,439,3606,11,15,5,6,allow
61429,80,5078,80,214,140,74,4,41,3,1,allow
36351,80,36351,80,1920,1471,449,10,20,6,4,allow
49969,53,54536,53,356,105,251,4,49,2,2,allow
56475,80,2240,80,36057,2080,33977,45,134,19,26,allow
56125,53,44434,53,168,86,82,2,29,1,1,allow
49889,53,36232,53,197,102,95,2,29,1,1,allow
44299,80,44299,80,1915,1466,449,10,20,6,4,allow
52137,1026,43020,1026,196,136,60,4,8,3,1,allow
40105,80,32685,80,9656,3195,6461,19,23,12,7,allow
33196,443,16510,443,6989,5073,1916,24,111,14,10,allow
60011,443,4713,443,11061,2230,8831,40,109,23,17,allow
53899,45682,35205,45682,70,70,0,1,4,1,0,allow
56827,53,30639,53,195,102,93,2,29,1,1,allow
53898,12172,38766,12172,70,70,0,1,4,1,0,allow
58177,443,64098,443,810,340,470,13,34,6,7,allow
58982,5222,15289,5222,16545,8556,7989,69,69,30,39,allow
55057,53,53863,53,211,110,101,2,30,1,1,allow
59402,53,5852,53,203,86,117,2,30,1,1,allow
55372,53,41205,53,271,93,178,4,43,2,2,allow
64995,53,32224,53,210,110,100,2,30,1,1,allow
61428,80,48945,80,214,140,74,4,41,3,1,allow
64937,53,47101,53,210,110,100,2,30,1,1,allow
47928,443,47928,443,4564,1657,2907,19,27,11,8,allow
56360,53,26019,53,184,102,82,2,30,1,1,allow
34692,80,34692,80,3530,2851,679,13,20,8,5,allow
60037,443,34987,443,376301,13445,362856,452,102,198,254,allow
50027,53,20964,53,264,110,154,2,30,1,1,allow
57033,53,22099,53,216,110,106,2,30,1,1,allow
37492,53,45298,53,199,94,105,2,30,1,1,allow
55739,53,43741,53,215,102,113,2,30,1,1,allow
55057,53,26203,53,211,110,101,2,30,1,1,allow
56648,53,44024,53,199,102,97,2,30,1,1,allow
49615,53,57263,53,199,102,97,2,30,1,1,allow
64324,53,8144,53,179,94,85,2,30,1,1,allow
56955,53,64522,53,183,94,89,2,30,1,1,allow
55352,53,35227,53,216,110,106,2,30,1,1,allow
55991,53,9133,53,199,102,97,2,30,1,1,allow
49176,53,17276,53,264,110,154,2,30,1,1,allow
55887,443,44668,443,3954,778,3176,17,121,8,9,allow
55352,53,46162,53,216,110,106,2,30,1,1,allow
55216,53,32573,53,179,94,85,2,30,1,1,allow
55022,53,7516,53,195,102,93,2,30,1,1,allow
55837,53,32132,53,195,102,93,2,30,1,1,allow
55991,53,22499,53,199,102,97,2,30,1,1,allow
55068,443,46144,443,5611,3720,1891,28,54,16,12,allow
61421,80,3203,80,214,140,74,4,41,3,1,allow
35917,443,52534,443,13480,8545,4935,35,94,19,16,allow
55892,80,55892,80,1917,1468,449,10,20,6,4,allow
4296,53,43153,53,217,86,131,2,30,1,1,allow
49592,53,47137,53,177,94,83,2,30,1,1,allow
49333,53,61415,53,392,102,290,2,30,1,1,allow
64191,53,17402,53,264,110,154,2,30,1,1,allow
55687,53,38089,53,193,102,91,2,30,1,1,allow
49615,53,49539,53,199,102,97,2,30,1,1,allow
55555,53,24469,53,194,102,92,2,30,1,1,allow
64026,80,47805,80,314,192,122,6,15,4,2,allow
52213,80,42925,80,5022,1422,3600,16,135,8,8,allow
52103,7172,60174,7172,70,70,0,1,5,1,0,allow
64942,53,56338,53,803,390,413,9,71,5,4,allow
61431,80,8546,80,214,140,74,4,41,3,1,allow
58738,443,24230,443,12382,9652,2730,43,58,26,17,allow
56529,80,56529,80,1915,1466,449,10,20,6,4,allow
60030,443,28456,443,711172,27430,683742,812,104,342,470,allow
53889,19002,16357,19002,552,306,246,9,15,5,4,allow
64116,53,45149,53,267,94,173,4,59,2,2,allow
65531,53,44923,53,193,102,91,2,30,1,1,allow
56820,53,40391,53,193,102,91,2,30,1,1,allow
56360,53,60818,53,184,102,82,2,30,1,1,allow
40290,53,7159,53,168,78,90,2,30,1,1,allow
64731,53,48863,53,779,86,693,2,30,1,1,allow
49739,53,37326,53,757,102,655,2,30,1,1,allow
56113,53,45666,53,211,102,109,2,30,1,1,allow
50007,53,39028,53,216,110,106,2,30,1,1,allow
56239,53,49542,53,180,94,86,2,30,1,1,allow
50007,53,43367,53,216,110,106,2,30,1,1,allow
64251,53,54906,53,451,118,333,2,30,1,1,allow
52661,53,0,0,86,86,0,1,30,1,0,allow
53120,80,53120,80,26927,1133,25794,36,15,16,20,allow
36402,80,36402,80,1917,1468,449,10,20,6,4,allow
40471,80,40471,80,1917,1468,449,10,20,6,4,allow
60864,80,22050,80,10629,1104,9525,23,46,12,11,allow
36306,80,36306,80,1917,1468,449,10,20,6,4,allow
44673,80,44673,80,1916,1467,449,10,20,6,4,allow
60008,443,9561,443,7060,1850,5210,35,110,21,14,allow
65416,53,16237,53,213,102,111,2,30,1,1,allow
50007,53,59429,53,216,110,106,2,30,1,1,allow
63638,53,10182,53,286,78,208,2,30,1,1,allow
56362,53,52775,53,453,186,267,6,30,3,3,allow
55332,53,52188,53,211,110,101,2,30,1,1,allow
56312,53,62526,53,195,102,93,2,30,1,1,allow
55610,53,39164,53,199,102,97,2,30,1,1,allow
16776,53,16776,53,197,90,107,2,30,1,1,allow
56596,53,50700,53,199,102,97,2,30,1,1,allow
57204,53,65520,53,195,102,93,2,30,1,1,allow
55332,53,45716,53,211,110,101,2,30,1,1,allow
55638,53,1033,53,78,78,0,1,30,1,0,allow
49402,53,15984,53,185,102,83,2,31,1,1,allow
56312,53,52964,53,195,102,93,2,31,1,1,allow
49492,53,41002,53,199,102,97,2,31,1,1,allow
49262,443,12479,443,4353,1227,3126,12,135,6,6,allow
39277,443,14513,443,6891,1421,5470,20,127,12,8,allow
55707,53,31512,53,177,94,83,2,30,1,1,allow
65143,53,8081,53,199,102,97,2,30,1,1,allow
62524,53,62524,53,212,90,122,2,30,1,1,allow
49972,53,10685,53,216,110,106,2,31,1,1,allow
64116,53,50037,53,184,94,90,2,31,1,1,allow
55620,53,6956,53,178,94,84,2,31,1,1,allow
63993,53,47498,53,338,110,228,2,31,1,1,allow
49841,53,34208,53,264,110,154,2,31,1,1,allow
57312,53,30289,53,212,110,102,2,31,1,1,allow
34658,80,20483,80,6094,954,5140,15,3601,8,7,allow
56422,53,25062,53,195,102,93,2,31,1,1,allow
57132,53,52410,53,216,110,106,2,31,1,1,allow
64929,53,16910,53,168,86,82,2,31,1,1,allow
49296,53,53194,53,193,102,91,2,31,1,1,allow
47376,443,12829,443,2944,778,2166,10,120,5,5,allow
60569,443,44105,443,10385,4932,5453,21,135,9,12,allow
33156,3478,41500,3478,338,110,228,2,300,1,1,allow
57470,8621,39581,8621,469,150,319,2,1199,1,1,allow
64615,53,57777,53,195,102,93,2,31,1,1,allow
37222,443,49931,443,2394,1365,1029,18,275,9,9,allow
46046,443,33761,443,11019,4673,6346,32,423,17,15,allow
32900,443,53581,443,14739,1296,13443,30,306,9,21,allow
28592,53,28592,53,216,90,126,2,31,1,1,allow
55195,443,41833,443,907774,32911,874863,898,460,195,703,allow
37965,17336,18530,17336,481,150,331,2,1199,1,1,allow
39566,443,50145,443,9748,5209,4539,22,121,11,11,allow
52145,36670,58227,36670,316,136,180,6,6,3,3,allow
64047,16221,34665,16221,66,66,0,2,8,2,0,allow
64048,44918,64560,44918,66,66,0,2,8,2,0,allow
52135,46475,48450,46475,70,70,0,2,8,2,0,allow
50684,80,2387,80,132,132,0,2,8,2,0,allow
52099,28401,35047,28401,70,70,0,1,5,1,0,allow
49889,53,3966,53,310,99,211,4,40,2,2,allow
51103,443,36898,443,20280,13177,7103,82,1176,46,36,allow
55372,53,7749,53,271,93,178,4,43,2,2,allow
49826,53,43562,53,466,192,274,6,83,3,3,allow
56910,53,59135,53,211,78,133,2,30,1,1,allow
64427,445,0,0,70,70,0,1,0,1,0,drop
64568,445,0,0,66,66,0,1,0,1,0,drop
42490,1433,0,0,60,60,0,1,0,1,0,deny
53207,50584,0,0,66,66,0,1,0,1,0,deny
64567,445,0,0,66,66,0,1,0,1,0,drop
54221,57470,0,0,66,66,0,1,0,1,0,deny
35194,57470,0,0,74,74,0,1,0,1,0,deny
60180,31573,0,0,62,62,0,1,0,1,0,deny
56388,22114,0,0,66,66,0,1,0,1,0,deny
64418,445,0,0,70,70,0,1,0,1,0,drop
23844,26467,0,0,62,62,0,1,0,1,0,deny
64416,445,0,0,70,70,0,1,0,1,0,drop
23843,26467,0,0,62,62,0,1,0,1,0,deny
52782,445,0,0,70,70,0,1,0,1,0,drop
52778,445,0,0,70,70,0,1,0,1,0,drop
52779,445,0,0,70,70,0,1,0,1,0,drop
64415,445,0,0,70,70,0,1,0,1,0,drop
64553,445,0,0,66,66,0,1,0,1,0,drop
64552,445,0,0,66,66,0,1,0,1,0,drop
64548,445,0,0,66,66,0,1,0,1,0,drop
64554,445,0,0,66,66,0,1,0,1,0,drop
64551,445,0,0,66,66,0,1,0,1,0,drop
64549,445,0,0,66,66,0,1,0,1,0,drop
64547,445,0,0,66,66,0,1,0,1,0,drop
64550,445,0,0,66,66,0,1,0,1,0,drop
64414,445,0,0,70,70,0,1,0,1,0,drop
64413,445,0,0,70,70,0,1,0,1,0,drop
53373,64147,0,0,62,62,0,1,0,1,0,deny
64407,445,0,0,70,70,0,1,0,1,0,drop
64410,445,0,0,70,70,0,1,0,1,0,drop
53413,35440,0,0,146,146,0,1,0,1,0,deny
28476,25174,0,0,146,146,0,1,0,1,0,deny
59528,50584,0,0,146,146,0,1,0,1,0,deny
51754,18375,0,0,66,66,0,1,0,1,0,deny
64077,25174,0,0,62,62,0,1,0,1,0,deny
44886,23,0,0,60,60,0,1,0,1,0,deny
55620,30188,0,0,66,66,0,1,0,1,0,deny
64395,445,0,0,70,70,0,1,0,1,0,drop
64394,445,0,0,70,70,0,1,0,1,0,drop
64389,445,0,0,70,70,0,1,0,1,0,drop
58715,64097,0,0,62,62,0,1,0,1,0,deny
48706,23393,0,0,60,60,0,1,0,1,0,deny
54883,51505,0,0,66,66,0,1,0,1,0,deny
64385,445,0,0,70,70,0,1,0,1,0,drop
64384,445,0,0,70,70,0,1,0,1,0,drop
5228,3434,0,0,345,345,0,1,0,1,0,deny
7048,25174,0,0,62,62,0,1,0,1,0,deny
52772,445,0,0,70,70,0,1,0,1,0,drop
52770,445,0,0,70,70,0,1,0,1,0,drop
52768,445,0,0,70,70,0,1,0,1,0,drop
52762,445,0,0,70,70,0,1,0,1,0,drop
55406,25174,0,0,66,66,0,1,0,1,0,deny
53015,64147,0,0,62,62,0,1,0,1,0,deny
55713,25174,0,0,146,146,0,1,0,1,0,deny
64531,445,0,0,66,66,0,1,0,1,0,drop
64532,445,0,0,66,66,0,1,0,1,0,drop
64534,445,0,0,66,66,0,1,0,1,0,drop
30650,25174,0,0,62,62,0,1,0,1,0,deny
12348,50265,0,0,62,62,0,1,0,1,0,deny
64989,50265,0,0,66,66,0,1,0,1,0,deny
13062,52274,0,0,66,66,0,1,0,1,0,deny
30697,57866,0,0,62,62,0,1,0,1,0,deny
1024,25174,0,0,146,146,0,1,0,1,0,deny
59096,57866,0,0,66,66,0,1,0,1,0,deny
38549,22114,0,0,62,62,0,1,0,1,0,deny
58143,57866,0,0,66,66,0,1,0,1,0,deny
49393,30188,0,0,66,66,0,1,0,1,0,deny
52759,445,0,0,70,70,0,1,0,1,0,drop
64373,445,0,0,70,70,0,1,0,1,0,drop
39941,2767,0,0,62,62,0,1,0,1,0,deny
63213,57866,0,0,66,66,0,1,0,1,0,deny
52750,445,0,0,70,70,0,1,0,1,0,drop
52749,445,0,0,70,70,0,1,0,1,0,drop
52748,445,0,0,70,70,0,1,0,1,0,drop
60311,30627,0,0,66,66,0,1,0,1,0,deny
1024,44847,0,0,62,62,0,1,0,1,0,deny
65233,23117,0,0,62,62,0,1,0,1,0,deny
10082,64147,0,0,62,62,0,1,0,1,0,deny
49630,22,49630,22,295,126,169,4,1,2,2,deny
64369,445,0,0,70,70,0,1,0,1,0,drop
443,22238,0,0,112,112,0,1,0,1,0,deny
46808,25174,0,0,62,62,0,1,0,1,0,deny
1024,64147,0,0,62,62,0,1,0,1,0,deny
25237,25174,0,0,62,62,0,1,0,1,0,deny
64358,445,0,0,70,70,0,1,0,1,0,drop
64359,445,0,0,70,70,0,1,0,1,0,drop
52739,445,0,0,70,70,0,1,0,1,0,drop
64360,445,0,0,70,70,0,1,0,1,0,drop
52740,445,0,0,70,70,0,1,0,1,0,drop
52734,445,0,0,70,70,0,1,0,1,0,drop
37011,25174,0,0,62,62,0,1,0,1,0,deny
58627,64097,0,0,62,62,0,1,0,1,0,deny
64356,445,0,0,70,70,0,1,0,1,0,drop
50084,26672,0,0,62,62,0,1,0,1,0,deny
35657,48637,0,0,62,62,0,1,0,1,0,deny
64353,445,0,0,70,70,0,1,0,1,0,drop
64519,445,0,0,66,66,0,1,0,1,0,drop
45013,50584,0,0,146,146,0,1,0,1,0,deny
61369,64147,0,0,66,66,0,1,0,1,0,deny
58338,3353,0,0,60,60,0,1,0,1,0,deny
6832,51505,0,0,66,66,0,1,0,1,0,deny
52733,445,0,0,70,70,0,1,0,1,0,drop
52731,445,0,0,70,70,0,1,0,1,0,drop
64346,445,0,0,70,70,0,1,0,1,0,drop
40254,25174,0,0,146,146,0,1,0,1,0,deny
62400,35993,0,0,66,66,0,1,0,1,0,deny
64505,445,0,0,66,66,0,1,0,1,0,drop
64507,445,0,0,66,66,0,1,0,1,0,drop
43679,44847,0,0,62,62,0,1,0,1,0,deny
2437,23117,0,0,62,62,0,1,0,1,0,deny
64339,445,0,0,70,70,0,1,0,1,0,drop
46604,57866,0,0,66,66,0,1,0,1,0,deny
53071,25174,0,0,66,66,0,1,0,1,0,deny
64336,445,0,0,70,70,0,1,0,1,0,drop
45964,2225,0,0,60,60,0,1,0,1,0,deny
58716,9694,0,0,62,62,0,1,0,1,0,deny
3524,25174,0,0,66,66,0,1,0,1,0,deny
61898,50584,0,0,66,66,0,1,0,1,0,deny
56578,25174,0,0,66,66,0,1,0,1,0,deny
19204,57866,0,0,66,66,0,1,0,1,0,deny
52720,445,0,0,70,70,0,1,0,1,0,drop
52719,445,0,0,70,70,0,1,0,1,0,drop
52718,445,0,0,70,70,0,1,0,1,0,drop
52711,445,0,0,70,70,0,1,0,1,0,drop
57471,62413,0,0,66,66,0,1,0,1,0,deny
3800,48817,0,0,146,146,0,1,0,1,0,deny
51414,22,0,0,60,60,0,1,0,1,0,deny
59803,22114,0,0,62,62,0,1,0,1,0,deny
64498,445,0,0,66,66,0,1,0,1,0,drop
64333,445,0,0,70,70,0,1,0,1,0,drop
7905,22114,0,0,66,66,0,1,0,1,0,deny
64331,445,0,0,70,70,0,1,0,1,0,drop
7619,50584,0,0,62,62,0,1,0,1,0,deny
0,0,0,0,600,306,294,6,0,3,3,allow
12545,25174,0,0,62,62,0,1,0,1,0,deny
50593,64147,0,0,66,66,0,1,0,1,0,deny
64494,445,0,0,66,66,0,1,0,1,0,drop
64493,445,0,0,66,66,0,1,0,1,0,drop
64492,445,0,0,66,66,0,1,0,1,0,drop
64491,445,0,0,66,66,0,1,0,1,0,drop
64488,445,0,0,66,66,0,1,0,1,0,drop
64486,445,0,0,66,66,0,1,0,1,0,drop
64483,445,0,0,66,66,0,1,0,1,0,drop
55116,7574,0,0,62,62,0,1,0,1,0,deny
52706,445,0,0,70,70,0,1,0,1,0,drop
64327,445,0,0,70,70,0,1,0,1,0,drop
52703,445,0,0,70,70,0,1,0,1,0,drop
52701,445,0,0,70,70,0,1,0,1,0,drop
52699,445,0,0,70,70,0,1,0,1,0,drop
51414,50584,0,0,66,66,0,1,0,1,0,deny
15333,60043,0,0,62,62,0,1,0,1,0,deny
52492,37965,0,0,66,66,0,1,0,1,0,deny
36561,2767,0,0,62,62,0,1,0,1,0,deny
64326,445,0,0,70,70,0,1,0,1,0,drop
52699,25174,0,0,66,66,0,1,0,1,0,deny
1865,25174,0,0,62,62,0,1,0,1,0,deny
42796,22114,0,0,62,62,0,1,0,1,0,deny
63786,25174,0,0,66,66,0,1,0,1,0,deny
64321,445,0,0,70,70,0,1,0,1,0,drop
52696,445,0,0,70,70,0,1,0,1,0,drop
52695,445,0,0,70,70,0,1,0,1,0,drop
52691,445,0,0,70,70,0,1,0,1,0,drop
443,59493,0,0,60,60,0,1,0,1,0,deny
20619,25174,0,0,66,66,0,1,0,1,0,deny
64476,445,0,0,66,66,0,1,0,1,0,drop
52690,445,0,0,70,70,0,1,0,1,0,drop
26531,37965,0,0,62,62,0,1,0,1,0,deny
64474,445,0,0,66,66,0,1,0,1,0,drop
23940,41615,0,0,146,146,0,1,0,1,0,deny
55082,25174,0,0,66,66,0,1,0,1,0,deny
58091,51505,0,0,66,66,0,1,0,1,0,deny
64472,445,0,0,66,66,0,1,0,1,0,drop
64470,445,0,0,66,66,0,1,0,1,0,drop
43076,23,0,0,60,60,0,1,0,1,0,deny
49036,44847,0,0,62,62,0,1,0,1,0,deny
63173,36237,0,0,66,66,0,1,0,1,0,deny
64469,445,0,0,66,66,0,1,0,1,0,drop
54140,17372,0,0,66,66,0,1,0,1,0,deny
24311,22617,0,0,60,60,0,1,0,1,0,deny
58021,22114,0,0,66,66,0,1,0,1,0,deny
36551,23,0,0,60,60,0,1,0,1,0,deny
22571,51505,0,0,66,66,0,1,0,1,0,deny
56496,53,60823,53,186,95,91,2,30,1,1,allow
56596,53,26887,53,198,101,97,2,30,1,1,allow
9280,443,36215,443,4612,830,3782,16,27,9,7,allow
60481,40075,20355,40075,70,70,0,1,5,1,0,allow
61441,443,10709,443,7832,1143,6689,19,31,9,10,allow
47038,443,65328,443,2809,1884,925,19,24,11,8,allow
57312,53,16678,53,1385,85,1300,4,42,2,2,allow
53893,11344,38662,11344,70,70,0,1,5,1,0,allow
5588,5588,0,0,3562,1936,1626,48,193,24,24,allow
47438,80,47438,80,2886,1481,1405,10,15,6,4,allow
35088,443,54099,443,800,452,348,12,94,7,5,allow
34340,443,16904,443,3497,1845,1652,18,16,9,9,allow
56062,53,16578,53,744,89,655,2,31,1,1,allow
55963,53,27489,53,755,93,662,2,30,1,1,allow
47747,443,43132,443,4187,1350,2837,18,321,8,10,allow
9294,443,62511,443,6356,979,5377,19,27,10,9,allow
59392,443,2075,443,105190,30835,74355,372,589,169,203,allow
52131,28980,48915,28980,70,70,0,2,8,2,0,allow
52133,15015,56839,15015,70,70,0,2,8,2,0,allow
53915,1026,52746,1026,70,70,0,2,8,2,0,allow
37027,443,52306,443,90706,5324,85382,128,262,66,62,allow
65140,53,64543,53,198,101,97,2,30,1,1,allow
41151,443,41151,443,4713,1806,2907,19,30,11,8,allow
57794,53,57794,53,825,99,726,2,30,1,1,allow
46216,443,9972,443,161,101,60,2,5,1,1,allow
60479,53928,56520,53928,70,70,0,1,5,1,0,allow
59404,443,36010,443,11018,5022,5996,84,588,43,41,allow
42783,443,65446,443,13510,5888,7622,65,86,33,32,allow
39038,443,14810,443,3970,2230,1740,17,114,10,7,allow
56752,443,27500,443,11771,2624,9147,50,20,25,25,allow
51073,443,23186,443,7343,2672,4671,20,76,12,8,allow
60982,443,39893,443,18274,7660,10614,46,48,26,20,allow
32346,53,32346,53,194,87,107,2,30,1,1,allow
50421,53,19651,53,762,98,664,2,30,1,1,allow
64324,53,12173,53,174,89,85,2,30,1,1,allow
55563,53,57917,53,763,101,662,2,30,1,1,allow
34914,53,34914,53,825,99,726,2,30,1,1,allow
33812,443,2950,443,16120,8754,7366,36,327,21,15,allow
51449,443,58167,443,21779,7983,13796,44,97,25,19,allow
57132,53,28118,53,216,110,106,2,31,1,1,allow
55841,53,55031,53,265,86,179,4,59,2,2,allow
41000,443,31779,443,10675,5079,5596,88,588,47,41,allow
40906,443,50326,443,8138,2333,5805,26,106,14,12,allow
37031,443,21372,443,43818,31519,12299,85,259,49,36,allow
54805,443,42817,443,19635,9923,9712,165,588,72,93,allow
59405,443,49077,443,10726,4848,5878,79,588,40,39,allow
59570,443,28825,443,24203,14278,9925,168,320,74,94,allow
35542,23,35542,23,124,60,64,2,5,1,1,allow
54872,53,11458,53,578,286,292,9,15,5,4,allow
57211,443,58131,443,25881,12394,13487,221,579,105,116,allow
52130,1035,4806,1035,70,70,0,2,8,2,0,allow
58857,443,61452,443,674,130,544,11,129,3,8,allow
55372,53,64639,53,271,93,178,4,43,2,2,allow
49394,443,40363,443,7129,1853,5276,27,316,13,14,allow
57312,53,43620,53,208,106,102,2,30,1,1,allow
52775,123,25733,123,184,94,90,2,30,1,1,allow
65045,53,47072,53,755,94,661,2,30,1,1,allow
65481,53,28484,53,168,86,82,2,31,1,1,allow
37965,46405,21208,46405,1217,594,623,16,1764,10,6,allow
443,60746,0,0,60,60,0,1,90,1,0,allow
55941,53,18127,53,184,94,90,2,30,1,1,allow
50293,53,25447,53,740,93,647,2,31,1,1,allow
56028,53,49252,53,770,102,668,2,31,1,1,allow
64929,53,46254,53,168,86,82,2,31,1,1,allow
56586,53,7577,53,754,94,660,2,31,1,1,allow
49953,53,38496,53,757,98,659,2,31,1,1,allow
56293,53,53120,53,164,84,80,2,31,1,1,allow
56697,53,7977,53,711,87,624,2,31,1,1,allow
62763,443,43714,443,7755,4481,3274,17,135,9,8,allow
48817,48489,48817,48489,480,149,331,2,1200,1,1,allow
56437,53,21787,53,731,91,640,2,31,1,1,allow
56199,53,15227,53,256,93,163,2,31,1,1,allow
56965,53,30276,53,182,93,89,2,31,1,1,allow
55376,53,64673,53,198,101,97,2,31,1,1,allow
64403,53,35591,53,186,95,91,2,31,1,1,allow
49611,53,60181,53,170,87,83,2,31,1,1,allow
57969,53,57969,53,194,87,107,2,31,1,1,allow
49699,53,23875,53,202,103,99,2,31,1,1,allow
43394,53,50886,53,168,78,90,2,31,1,1,allow
48589,443,15567,443,15400,9133,6267,40,272,22,18,allow
56696,53,25639,53,757,98,659,2,31,1,1,allow
57450,53,43406,53,916,86,830,2,31,1,1,allow
56207,53,7940,53,761,100,661,2,31,1,1,allow
64543,53,58923,53,761,100,661,2,31,1,1,allow
49764,53,33834,53,198,101,97,2,31,1,1,allow
55218,80,61870,80,2568,1705,863,12,186,7,5,allow
43480,443,57887,443,58423,25600,32823,86,138,40,46,allow
43268,443,16959,443,8954,2755,6199,23,143,10,13,allow
55620,53,33396,53,172,88,84,2,31,1,1,allow
56054,53,43314,53,740,93,647,2,31,1,1,allow
50444,53,27303,53,256,93,163,2,31,1,1,allow
65447,53,45832,53,756,95,661,2,31,1,1,allow
56447,53,59083,53,758,96,662,2,31,1,1,allow
57007,53,30076,53,182,93,89,2,31,1,1,allow
64950,53,22680,53,182,93,89,2,31,1,1,allow
57352,53,8029,53,192,98,94,2,31,1,1,allow
64677,53,37767,53,182,93,89,2,31,1,1,allow
59559,443,47582,443,3255,1089,2166,10,122,5,5,allow
36229,62413,0,0,146,146,0,1,0,1,0,deny
18655,44847,0,0,66,66,0,1,0,1,0,deny
52685,445,0,0,70,70,0,1,0,1,0,drop
6881,6881,0,0,62,62,0,1,0,1,0,deny
64308,445,0,0,70,70,0,1,0,1,0,drop
52680,445,0,0,70,70,0,1,0,1,0,drop
52679,445,0,0,70,70,0,1,0,1,0,drop
12226,37965,0,0,62,62,0,1,0,1,0,deny
55439,37965,0,0,66,66,0,1,0,1,0,deny
8889,64500,0,0,60,60,0,1,0,1,0,deny
64305,445,0,0,70,70,0,1,0,1,0,drop
10547,57470,0,0,62,62,0,1,0,1,0,deny
44040,443,39447,443,11774,5465,6309,75,585,38,37,allow
60477,30889,23604,30889,70,70,0,1,5,1,0,allow
49418,22114,0,0,66,66,0,1,0,1,0,deny
64457,445,0,0,66,66,0,1,0,1,0,drop
26962,26467,0,0,66,66,0,1,0,1,0,deny
19175,50584,0,0,146,146,0,1,0,1,0,deny
35937,25174,0,0,66,66,0,1,0,1,0,deny
37308,43890,0,0,62,62,0,1,0,1,0,deny
43207,26467,0,0,62,62,0,1,0,1,0,deny
64450,445,0,0,66,66,0,1,0,1,0,drop
64300,445,0,0,70,70,0,1,0,1,0,drop
52662,445,0,0,70,70,0,1,0,1,0,drop
64299,445,0,0,70,70,0,1,0,1,0,drop
45461,25174,0,0,62,62,0,1,0,1,0,deny
23218,62413,0,0,66,66,0,1,0,1,0,deny
64297,445,0,0,70,70,0,1,0,1,0,drop
64448,445,0,0,66,66,0,1,0,1,0,drop
56793,56205,0,0,66,66,0,1,0,1,0,deny
59032,25174,0,0,66,66,0,1,0,1,0,deny
443,21255,0,0,66,66,0,1,0,1,0,deny
49546,53,5497,53,212,110,102,2,30,1,1,allow
56293,53,25636,53,166,86,80,2,30,1,1,allow
52182,443,4685,443,237151,13019,224132,251,42,90,161,allow
34053,443,6934,443,5987,1678,4309,21,199,12,9,allow
49738,53,39292,53,228,86,142,2,29,1,1,allow
50069,53,45809,53,764,102,662,2,29,1,1,allow
44543,443,30865,443,13478,2683,10795,36,104,19,17,allow
49611,53,44019,53,177,94,83,2,30,1,1,allow
50658,80,54358,80,5018,4314,704,11,30,6,5,allow
34059,80,37168,80,1151,711,440,10,15,5,5,allow
65471,53,5865,53,441,90,351,4,48,2,2,allow
53890,23310,38031,23310,70,70,0,1,4,1,0,allow
64045,7426,45943,7426,66,66,0,2,7,2,0,allow
52100,54130,1109,54130,70,70,0,1,4,1,0,allow
56730,443,7897,443,347884,9284,338600,360,31,125,235,allow
60800,40010,5284,40010,316,136,180,6,5,3,3,allow
55372,53,13857,53,271,93,178,4,42,2,2,allow
53275,443,20326,443,364,142,222,6,10,3,3,allow
18963,80,18963,80,1501,652,849,9,15,5,4,allow
57396,443,32290,443,152,78,74,2,4,1,1,allow
9312,443,24938,443,4618,840,3778,16,26,9,7,allow
63974,53,39548,53,212,102,110,2,29,1,1,allow
57312,53,15136,53,212,110,102,2,29,1,1,allow
65143,53,22648,53,822,102,720,2,29,1,1,allow
1848,53,1848,53,832,106,726,2,29,1,1,allow
49972,53,25100,53,328,110,218,4,57,2,2,allow
55514,53,45295,53,779,86,693,2,29,1,1,allow
57235,53,60743,53,757,102,655,2,29,1,1,allow
12230,53,12230,53,216,90,126,2,29,1,1,allow
65140,53,46396,53,199,102,97,2,29,1,1,allow
55007,53,23960,53,166,86,80,2,29,1,1,allow
55991,53,2664,53,199,102,97,2,30,1,1,allow
49982,53,16411,53,211,110,101,2,30,1,1,allow
55610,53,5256,53,822,102,720,2,29,1,1,allow
56909,53,4449,53,260,86,174,2,30,1,1,allow
56333,53,31573,53,209,110,99,2,30,1,1,allow
49210,53,10205,53,183,94,89,2,30,1,1,allow
55707,53,50329,53,177,94,83,2,29,1,1,allow
39416,443,62311,443,11188,5277,5911,95,587,44,51,allow
48287,443,53104,443,416,210,206,7,96,4,3,allow
60402,80,24295,80,1135,736,399,7,95,4,3,allow
55469,53,31769,53,193,102,91,2,30,1,1,allow
64314,53,48605,53,264,110,154,2,30,1,1,allow
55941,53,54126,53,184,94,90,2,30,1,1,allow
65511,443,62661,443,430254,12640,417614,442,16,155,287,allow
58431,443,11477,443,5771,3201,2570,22,161,10,12,allow
9299,443,15796,443,4216,771,3445,16,26,9,7,allow
60476,55100,33461,55100,70,70,0,1,5,1,0,allow
38772,443,61255,443,410,210,200,7,86,4,3,allow
9279,443,53983,443,4275,760,3515,15,27,8,7,allow
9307,443,6375,443,4458,1022,3436,16,26,9,7,allow
49385,53,7961,53,214,102,112,2,30,1,1,allow
55599,53,58938,53,258,118,140,2,30,1,1,allow
50096,53,56974,53,733,94,639,2,30,1,1,allow
52096,55854,62191,55854,70,70,0,1,5,1,0,allow
9300,443,62109,443,4216,771,3445,16,26,9,7,allow
55555,53,26797,53,194,102,92,2,30,1,1,allow
9322,443,10424,443,4106,703,3403,15,26,8,7,allow
56689,443,17106,443,4857,3938,919,18,81,11,7,allow
55707,53,50594,53,177,94,83,2,30,1,1,allow
56550,123,27975,123,184,94,90,2,30,1,1,allow
64793,53,53457,53,184,94,90,2,30,1,1,allow
65009,53,23695,53,152,78,74,2,30,1,1,allow
55469,53,3156,53,193,102,91,2,30,1,1,allow
49982,53,19488,53,211,110,101,2,30,1,1,allow
64908,53,55022,53,232,94,138,2,30,1,1,allow
56551,53,16307,53,458,188,270,6,30,3,3,allow
49210,53,44765,53,183,94,89,2,30,1,1,allow
56757,53,22580,53,322,118,204,2,30,1,1,allow
49874,53,37266,53,173,94,79,2,30,1,1,allow
49699,53,53158,53,209,110,99,2,30,1,1,allow
55376,53,17349,53,199,102,97,2,30,1,1,allow
43750,443,22954,443,248384,70243,178141,544,588,246,298,allow
41011,443,63172,443,175097,9838,165259,244,106,120,124,allow
49767,53,45579,53,341,102,239,4,37,2,2,allow
9311,443,26204,443,4082,958,3124,14,26,8,6,allow
9313,443,38695,443,4618,840,3778,16,26,9,7,allow
64813,7000,64813,7000,1300,676,624,14,15,7,7,allow
65510,443,47071,443,92101,4799,87302,107,16,43,64,allow
50403,53,33399,53,168,86,82,2,30,1,1,allow
56422,53,30231,53,195,102,93,2,30,1,1,allow
59962,53,13839,53,316,94,222,2,30,1,1,allow
65498,53,49564,53,749,94,655,2,30,1,1,allow
55941,53,34210,53,184,94,90,2,30,1,1,allow
39345,80,26537,80,918,461,457,9,16,6,3,allow
48286,443,64439,443,9590,3002,6588,25,96,14,11,allow
61314,443,62611,443,3320,2053,1267,27,318,14,13,allow
41583,443,3597,443,4168,2503,1665,20,255,11,9,allow
49568,443,58538,443,7180,4959,2221,34,81,18,16,allow
49402,53,17640,53,177,94,83,2,30,1,1,allow
55620,53,62411,53,178,94,84,2,30,1,1,allow
56496,53,41605,53,193,102,91,2,30,1,1,allow
56955,53,35942,53,183,94,89,2,30,1,1,allow
56652,53,11062,53,177,94,83,2,30,1,1,allow
65277,53,40483,53,167,86,81,2,30,1,1,allow
65102,53,35796,53,183,94,89,2,30,1,1,allow
50066,443,28197,443,7144,2505,4639,14,120,7,7,allow
50075,443,63297,443,4701,2758,1943,41,93,22,19,allow
55841,53,44587,53,265,86,179,4,58,2,2,allow
57385,443,20044,443,8747,3323,5424,45,110,25,20,allow
57443,443,31881,443,8287,2469,5818,31,18,14,17,allow
49546,53,2512,53,357,106,251,4,36,2,2,allow
51242,80,19033,80,3506,2280,1226,24,50,13,11,allow
56313,443,7717,443,37465,18615,18850,299,588,135,164,allow
55838,443,50460,443,11446,4102,7344,32,20,16,16,allow
58461,443,33796,443,6100,1233,4867,21,17,11,10,allow
53166,39564,27898,39564,70,70,0,2,8,2,0,allow
60020,443,30222,443,495428,22440,472988,692,106,316,376,allow
9302,443,20327,443,4216,771,3445,16,26,9,7,allow
52134,18470,2197,18470,70,70,0,2,7,2,0,allow
64049,1029,38472,1029,66,66,0,2,7,2,0,allow
52097,23279,1789,23279,70,70,0,1,5,1,0,allow
53716,443,22368,443,7055,1261,5794,21,82,10,11,allow
52132,55014,54625,55014,70,70,0,2,7,2,0,allow
53916,23505,33630,23505,70,70,0,2,7,2,0,allow
50079,443,3173,443,32829,8718,24111,41,17,18,23,allow
64299,53,26079,53,268,84,184,4,42,2,2,allow
57511,123,47594,123,184,94,90,2,29,1,1,allow
55687,53,45230,53,193,102,91,2,29,1,1,allow
9298,443,38844,443,4216,771,3445,16,26,9,7,allow
33401,51505,0,0,66,66,0,1,0,1,0,deny
60976,22114,0,0,66,66,0,1,0,1,0,deny
52091,11392,0,0,66,66,0,1,0,1,0,deny
52231,50934,0,0,62,62,0,1,0,1,0,deny
30304,26467,0,0,62,62,0,1,0,1,0,deny
64441,445,0,0,66,66,0,1,0,1,0,drop
55553,53,13806,53,199,94,105,2,29,1,1,allow
5588,5588,0,0,3498,1872,1626,48,193,24,24,allow
65264,53,51558,53,198,94,104,2,29,1,1,allow
64937,53,29678,53,210,110,100,2,29,1,1,allow
58763,53,58763,53,228,90,138,2,29,1,1,allow
64299,53,64888,53,166,86,80,2,29,1,1,allow
64324,53,40799,53,179,94,85,2,29,1,1,allow
55837,53,36982,53,195,102,93,2,29,1,1,allow
55687,53,12551,53,193,102,91,2,29,1,1,allow
53754,53,53754,53,257,114,143,2,30,1,1,allow
55022,53,15240,53,195,102,93,2,30,1,1,allow
49296,53,40772,53,193,102,91,2,30,1,1,allow
65140,53,14372,53,199,102,97,2,30,1,1,allow
64299,53,64359,53,166,86,80,2,30,1,1,allow
16071,53,16071,53,832,106,726,2,30,1,1,allow
64615,53,10268,53,195,102,93,2,30,1,1,allow
56422,53,39106,53,195,102,93,2,30,1,1,allow
55376,53,1208,53,199,102,97,2,30,1,1,allow
65481,53,17512,53,168,86,82,2,30,1,1,allow
64403,53,23409,53,193,102,91,2,30,1,1,allow
56574,53,9941,53,275,94,181,2,30,1,1,allow
56037,53,29985,53,168,94,74,2,31,1,1,allow
50122,53,55627,53,811,94,717,2,31,1,1,allow
64716,53,43003,53,195,102,93,2,31,1,1,allow
56664,443,64784,443,9160636,285656,8874980,9685,189,3160,6525,allow
50584,51413,3341,51413,475,150,325,2,1200,1,1,allow
4544,3478,63036,3478,338,110,228,2,299,1,1,allow
8916,443,25420,443,7685,1016,6669,29,413,11,18,allow
47674,443,2134,443,7576,2983,4593,33,42,18,15,allow
55085,80,12175,80,306,180,126,6,85,4,2,allow
55841,53,22596,53,265,86,179,4,59,2,2,allow
59762,53,43399,53,401,86,315,2,30,1,1,allow
65277,53,55975,53,167,86,81,2,30,1,1,allow
56596,53,51860,53,199,102,97,2,30,1,1,allow
53900,53,54773,53,270,168,102,3,30,2,1,allow
56496,53,56369,53,193,102,91,2,30,1,1,allow
65102,53,65408,53,183,94,89,2,30,1,1,allow
57335,443,56068,443,56199,3856,52343,81,216,39,42,allow
49210,53,33969,53,410,93,317,4,30,2,2,allow
64198,53,39637,53,321,102,219,2,30,1,1,allow
55254,53,52828,53,287,102,185,2,30,1,1,allow
49410,53,14771,53,167,86,81,2,30,1,1,allow
57352,53,35179,53,196,102,94,2,30,1,1,allow
49410,53,35309,53,167,86,81,2,31,1,1,allow
65481,53,51485,53,168,86,82,2,31,1,1,allow
54117,443,30153,443,661695,28430,633265,779,118,335,444,allow
50073,443,27421,443,22729,6539,16190,54,93,27,27,allow
35128,443,23671,443,9120,5103,4017,38,587,22,16,allow
37655,443,5274,443,17842,11204,6638,43,174,24,19,allow
51824,443,65512,443,10841,6594,4247,75,585,37,38,allow
53165,18504,45814,18504,70,70,0,2,8,2,0,allow
9297,443,46735,443,4216,771,3445,16,26,9,7,allow
51667,25826,2987,25826,9440,9440,0,11,30,11,0,allow
49972,53,55153,53,216,110,106,2,30,1,1,allow
65124,53,53068,53,243,102,141,2,30,1,1,allow
55418,53,32806,53,168,86,82,2,30,1,1,allow
50191,53,9113,53,734,94,640,2,30,1,1,allow
55941,53,27410,53,184,94,90,2,30,1,1,allow
49699,53,49094,53,209,110,99,2,30,1,1,allow
62578,53,27363,53,343,168,175,3,30,2,1,allow
65440,53,2075,53,189,102,87,2,30,1,1,allow
51104,443,47911,443,5220,3063,2157,14,135,7,7,allow
42611,443,22505,443,5559,1639,3920,21,186,12,9,allow
37569,443,62296,443,97539,6936,90603,160,597,74,86,allow
49281,443,26289,443,7655,2377,5278,20,135,11,9,allow
9291,443,14472,443,3944,902,3042,14,26,8,6,allow
61811,443,37922,443,214,140,74,4,15,3,1,allow
9277,443,3010,443,4230,760,3470,14,27,8,6,allow
50470,53,11331,53,770,102,668,2,30,1,1,allow
56149,53,56149,53,832,106,726,2,30,1,1,allow
65085,53,45076,53,258,102,156,2,30,1,1,allow
53182,443,14179,443,16255,8279,7976,42,422,21,21,allow
54757,443,1080,443,6954,1758,5196,29,361,15,14,allow
49764,53,36622,53,199,102,97,2,31,1,1,allow
65140,53,62512,53,199,102,97,2,31,1,1,allow
45355,443,7242,443,410,210,200,7,92,4,3,allow
52098,29067,64917,29067,70,70,0,1,5,1,0,allow
36414,80,15964,80,5046,4132,914,31,15,16,15,allow
9310,443,7475,443,4458,1022,3436,16,26,9,7,allow
27153,80,27153,80,6397,947,5450,15,18,8,7,allow
55841,53,32658,53,265,86,179,4,58,2,2,allow
49546,53,28213,53,212,110,102,2,30,1,1,allow
64937,53,12503,53,210,110,100,2,30,1,1,allow
57132,53,39108,53,216,110,106,2,30,1,1,allow
55467,53,65023,53,198,94,104,2,30,1,1,allow
64929,53,59059,53,168,86,82,2,30,1,1,allow
56652,53,9807,53,177,94,83,2,30,1,1,allow
65009,53,11589,53,152,78,74,2,30,1,1,allow
64959,53,50159,53,173,94,79,2,30,1,1,allow
44847,42103,11973,42103,502,150,352,2,1200,1,1,allow
56995,53,4474,53,167,86,81,2,30,1,1,allow
56293,53,1963,53,166,86,80,2,30,1,1,allow
57431,53,4214,53,733,94,639,2,30,1,1,allow
65440,53,49659,53,181,94,87,2,30,1,1,allow
64959,53,35711,53,173,94,79,2,30,1,1,allow
56731,53,12750,53,165,86,79,2,30,1,1,allow
45473,53,13745,53,168,78,90,2,31,1,1,allow
42993,443,7986,443,10692,4532,6160,31,134,16,15,allow
56496,53,28777,53,193,102,91,2,30,1,1,allow
43570,53,0,0,86,86,0,1,30,1,0,allow
11964,53,13321,53,268,94,174,2,30,1,1,allow
56965,53,26904,53,183,94,89,2,30,1,1,allow
56364,53,33489,53,308,94,214,2,30,1,1,allow
64677,53,58771,53,183,94,89,2,30,1,1,allow
56995,53,60804,53,167,86,81,2,30,1,1,allow
56396,53,48729,53,338,110,228,2,30,1,1,allow
56026,53,14279,53,189,102,87,2,30,1,1,allow
56472,53,36068,53,167,86,81,2,31,1,1,allow
49978,53,17082,53,195,102,93,2,31,1,1,allow
49978,53,55753,53,195,102,93,2,30,1,1,allow
56026,53,37730,53,181,94,87,2,31,1,1,allow
58070,443,16488,443,5041,2002,3039,14,120,7,7,allow
45822,443,11470,443,4201,2089,2112,11,120,6,5,allow
46857,443,55410,443,280,140,140,5,129,3,2,allow
55877,64536,41597,64536,469,150,319,2,1200,1,1,allow
57377,443,22825,443,11247,3991,7256,30,149,14,16,allow
58602,443,31018,443,3182,1568,1614,8,121,4,4,allow
64636,53,17069,53,166,86,80,2,31,1,1,allow
49487,53,26714,53,183,94,89,2,31,1,1,allow
55227,53,15557,53,183,102,81,2,31,1,1,allow
59068,443,48115,443,11182,6150,5032,65,1775,41,24,allow
53553,53,53553,53,229,98,131,2,30,1,1,allow
49646,53,51164,53,353,118,235,2,30,1,1,allow
35691,123,42659,123,184,94,90,2,30,1,1,allow
41073,53,41073,53,197,90,107,2,30,1,1,allow
39267,123,6756,123,184,94,90,2,30,1,1,allow
55620,53,36114,53,178,94,84,2,31,1,1,allow
64677,53,61310,53,183,94,89,2,31,1,1,allow
56491,53,20777,53,165,86,79,2,31,1,1,allow
65168,53,7392,53,185,102,83,2,31,1,1,allow
56731,53,43957,53,173,94,79,2,31,1,1,allow
55376,53,7206,53,199,102,97,2,31,1,1,allow
49348,53,24608,53,194,102,92,2,31,1,1,allow
64929,53,8681,53,168,86,82,2,31,1,1,allow
57352,53,29825,53,196,102,94,2,31,1,1,allow
57132,53,11896,53,216,110,106,2,31,1,1,allow
49699,53,28371,53,209,110,99,2,31,1,1,allow
49487,53,10311,53,183,94,89,2,31,1,1,allow
49359,80,26843,80,60,60,0,2,154,2,0,allow
54124,443,47726,443,13210,3034,10176,47,153,19,28,allow
53031,443,28915,443,2399,1799,600,15,120,10,5,allow
65375,53,14200,53,196,94,102,2,31,1,1,allow
37850,443,54127,443,3595,1468,2127,13,135,6,7,allow
41325,443,52651,443,9669,2488,7181,26,149,11,15,allow
53910,1024,52372,1024,70,70,0,2,8,2,0,allow
42263,443,45775,443,224,164,60,3,5,2,1,allow
51628,443,50977,443,5678,3121,2557,39,256,18,21,allow
55022,53,45433,53,195,102,93,2,30,1,1,allow
52127,44198,39130,44198,70,70,0,2,8,2,0,allow
52128,21294,46936,21294,70,70,0,2,8,2,0,allow
53883,24830,60159,24830,164,70,94,2,5,1,1,allow
41587,5222,51042,5222,208,60,148,4,14,2,2,allow
40439,443,42690,443,8126,1627,6499,29,165,16,13,allow
50077,443,29789,443,8172,1833,6339,25,93,14,11,allow
50078,443,13152,443,12035,9784,2251,41,92,22,19,allow
56472,53,13780,53,167,86,81,2,31,1,1,allow
57075,53,41557,53,443,182,261,6,31,3,3,allow
53888,39204,51033,39204,70,70,0,1,5,1,0,allow
36400,443,31590,443,53365,28404,24961,565,753,302,263,allow
54125,443,18046,443,170665,9296,161369,227,116,102,125,allow
53347,443,16972,443,21456,6153,15303,120,491,46,74,allow
55556,53,8408,53,183,94,89,2,30,1,1,allow
50288,53,30921,53,764,102,662,2,30,1,1,allow
65286,53,2453,53,369,102,267,2,30,1,1,allow
49611,53,24146,53,177,94,83,2,30,1,1,allow
64693,53,60951,53,766,102,664,2,30,1,1,allow
43390,53,0,0,184,86,98,2,30,1,1,allow
56965,53,44831,53,183,94,89,2,30,1,1,allow
6666,138,0,0,60,60,0,1,0,1,0,deny
9552,57470,0,0,62,62,0,1,0,1,0,deny
4111,25174,0,0,146,146,0,1,0,1,0,deny
64437,445,0,0,66,66,0,1,0,1,0,drop
50765,22114,0,0,66,66,0,1,0,1,0,deny
64290,445,0,0,70,70,0,1,0,1,0,drop
51578,44847,0,0,66,66,0,1,0,1,0,deny
52358,30188,0,0,66,66,0,1,0,1,0,deny
64288,445,0,0,70,70,0,1,0,1,0,drop
1480,12447,0,0,66,66,0,1,0,1,0,deny
6881,6881,0,0,146,146,0,1,0,1,0,deny
61057,25174,0,0,62,62,0,1,0,1,0,deny
1035,57470,0,0,72,72,0,1,0,1,0,deny
64287,445,0,0,70,70,0,1,0,1,0,drop
59493,44847,0,0,66,66,0,1,0,1,0,deny
46116,57470,0,0,74,74,0,1,0,1,0,deny
64286,445,0,0,70,70,0,1,0,1,0,drop
64285,445,0,0,70,70,0,1,0,1,0,drop
11136,15503,0,0,62,62,0,1,0,1,0,deny
64280,445,0,0,70,70,0,1,0,1,0,drop
64279,445,0,0,70,70,0,1,0,1,0,drop
52655,445,0,0,70,70,0,1,0,1,0,drop
52650,445,0,0,70,70,0,1,0,1,0,drop
52651,445,0,0,70,70,0,1,0,1,0,drop
6881,6881,0,0,62,62,0,1,0,1,0,deny
64422,445,0,0,66,66,0,1,0,1,0,drop
64420,445,0,0,66,66,0,1,0,1,0,drop
64423,445,0,0,66,66,0,1,0,1,0,drop
64424,445,0,0,66,66,0,1,0,1,0,drop
64421,445,0,0,66,66,0,1,0,1,0,drop
64419,445,0,0,66,66,0,1,0,1,0,drop
64418,445,0,0,66,66,0,1,0,1,0,drop
64417,445,0,0,66,66,0,1,0,1,0,drop
59097,2767,0,0,66,66,0,1,0,1,0,deny
61387,43890,0,0,66,66,0,1,0,1,0,deny
56326,56205,0,0,66,66,0,1,0,1,0,deny
59736,51505,0,0,146,146,0,1,0,1,0,deny
64727,25174,0,0,66,66,0,1,0,1,0,deny
64267,445,0,0,70,70,0,1,0,1,0,drop
64266,445,0,0,70,70,0,1,0,1,0,drop
64264,445,0,0,70,70,0,1,0,1,0,drop
22490,25174,0,0,62,62,0,1,0,1,0,deny
64256,445,0,0,70,70,0,1,0,1,0,drop
64257,445,0,0,70,70,0,1,0,1,0,drop
26265,37965,0,0,66,66,0,1,0,1,0,deny
23091,11119,0,0,148,148,0,1,0,1,0,deny
47632,25174,0,0,62,62,0,1,0,1,0,deny
52647,445,0,0,70,70,0,1,0,1,0,drop
52641,445,0,0,70,70,0,1,0,1,0,drop
52637,445,0,0,70,70,0,1,0,1,0,drop
52636,445,0,0,70,70,0,1,0,1,0,drop
34932,38608,0,0,62,62,0,1,0,1,0,deny
64343,6004,0,0,66,66,0,1,0,1,0,deny
6843,42873,0,0,62,62,0,1,0,1,0,deny
49160,57470,0,0,146,146,0,1,0,1,0,deny
2707,37,0,0,60,60,0,1,0,1,0,deny
64404,445,0,0,66,66,0,1,0,1,0,drop
64403,445,0,0,66,66,0,1,0,1,0,drop
64402,445,0,0,66,66,0,1,0,1,0,drop
63743,25174,0,0,62,62,0,1,0,1,0,deny
64245,445,0,0,70,70,0,1,0,1,0,drop
1024,25174,0,0,62,62,0,1,0,1,0,deny
25889,11446,0,0,66,66,0,1,0,1,0,deny
22948,26467,0,0,62,62,0,1,0,1,0,deny
52630,445,0,0,70,70,0,1,0,1,0,drop
51062,1433,0,0,60,60,0,1,0,1,0,deny
52625,445,0,0,70,70,0,1,0,1,0,drop
52626,445,0,0,70,70,0,1,0,1,0,drop
52622,445,0,0,70,70,0,1,0,1,0,drop
64587,43890,0,0,62,62,0,1,0,1,0,deny
55985,44847,0,0,62,62,0,1,0,1,0,deny
50328,22114,0,0,62,62,0,1,0,1,0,deny
64241,445,0,0,70,70,0,1,0,1,0,drop
1620,53567,0,0,62,62,0,1,0,1,0,deny
54236,36829,0,0,62,62,0,1,0,1,0,deny
64230,445,0,0,70,70,0,1,0,1,0,drop
64231,445,0,0,70,70,0,1,0,1,0,drop
64229,445,0,0,70,70,0,1,0,1,0,drop
55600,22,0,0,60,60,0,1,0,1,0,deny
56826,22114,0,0,66,66,0,1,0,1,0,deny
64228,445,0,0,70,70,0,1,0,1,0,drop
25067,22114,0,0,146,146,0,1,0,1,0,deny
64225,445,0,0,70,70,0,1,0,1,0,drop
58646,44847,0,0,66,66,0,1,0,1,0,deny
52613,445,0,0,70,70,0,1,0,1,0,drop
52612,445,0,0,70,70,0,1,0,1,0,drop
52607,445,0,0,70,70,0,1,0,1,0,drop
55429,25174,0,0,66,66,0,1,0,1,0,deny
44154,22114,0,0,62,62,0,1,0,1,0,deny
64393,445,0,0,66,66,0,1,0,1,0,drop
45452,443,54388,443,16362,3716,12646,79,601,38,41,allow
16158,50584,0,0,66,66,0,1,0,1,0,deny
54758,35993,0,0,66,66,0,1,0,1,0,deny
55341,39004,0,0,74,74,0,1,0,1,0,deny
56205,51505,0,0,66,66,0,1,0,1,0,deny
60479,25174,0,0,66,66,0,1,0,1,0,deny
49841,1433,0,0,60,60,0,1,0,1,0,deny
2427,25174,0,0,146,146,0,1,0,1,0,deny
49929,26467,0,0,66,66,0,1,0,1,0,deny
64219,445,0,0,70,70,0,1,0,1,0,drop
45964,2225,0,0,60,60,0,1,0,1,0,deny
52605,445,0,0,70,70,0,1,0,1,0,drop
52166,26467,0,0,66,66,0,1,0,1,0,deny
64295,26467,0,0,66,66,0,1,0,1,0,deny
52603,445,0,0,70,70,0,1,0,1,0,drop
28192,50584,0,0,66,66,0,1,0,1,0,deny
13285,29892,0,0,145,145,0,1,0,1,0,deny
59782,26467,0,0,62,62,0,1,0,1,0,deny
52459,33890,0,0,60,60,0,1,0,1,0,deny
0,0,0,0,480,244,236,4,0,2,2,allow
48271,25174,0,0,146,146,0,1,0,1,0,deny
58022,8010,0,0,60,60,0,1,0,1,0,deny
6882,55839,0,0,146,146,0,1,0,1,0,deny
6126,25174,0,0,66,66,0,1,0,1,0,deny
64211,445,0,0,70,70,0,1,0,1,0,drop
64376,445,0,0,66,66,0,1,0,1,0,drop
64375,445,0,0,66,66,0,1,0,1,0,drop
64016,25174,0,0,62,62,0,1,0,1,0,deny
31539,37965,0,0,62,62,0,1,0,1,0,deny
64210,445,0,0,70,70,0,1,0,1,0,drop
56872,21247,0,0,70,70,0,1,0,1,0,deny
45964,2228,0,0,60,60,0,1,0,1,0,deny
56614,25174,0,0,66,66,0,1,0,1,0,deny
55587,43890,0,0,66,66,0,1,0,1,0,deny
52593,445,0,0,70,70,0,1,0,1,0,drop
52594,445,0,0,70,70,0,1,0,1,0,drop
52590,445,0,0,70,70,0,1,0,1,0,drop
52584,445,0,0,70,70,0,1,0,1,0,drop
64205,445,0,0,70,70,0,1,0,1,0,drop
64203,445,0,0,70,70,0,1,0,1,0,drop
62189,64147,0,0,62,62,0,1,0,1,0,deny
64369,445,0,0,66,66,0,1,0,1,0,drop
26921,26467,0,0,62,62,0,1,0,1,0,deny
63855,25174,0,0,62,62,0,1,0,1,0,deny
64366,445,0,0,66,66,0,1,0,1,0,drop
64364,445,0,0,66,66,0,1,0,1,0,drop
64357,445,0,0,66,66,0,1,0,1,0,drop
64361,445,0,0,66,66,0,1,0,1,0,drop
64355,445,0,0,66,66,0,1,0,1,0,drop
64356,445,0,0,66,66,0,1,0,1,0,drop
64353,445,0,0,66,66,0,1,0,1,0,drop
64199,445,0,0,70,70,0,1,0,1,0,drop
54883,60043,0,0,62,62,0,1,0,1,0,deny
8889,52294,0,0,60,60,0,1,0,1,0,deny
57131,35776,0,0,145,145,0,1,0,1,0,deny
6842,42873,0,0,62,62,0,1,0,1,0,deny
52578,445,0,0,70,70,0,1,0,1,0,drop
51414,22,0,0,60,60,0,1,0,1,0,deny
57991,22114,0,0,66,66,0,1,0,1,0,deny
52575,445,0,0,70,70,0,1,0,1,0,drop
52572,445,0,0,70,70,0,1,0,1,0,drop
52573,445,0,0,70,70,0,1,0,1,0,drop
64198,445,0,0,70,70,0,1,0,1,0,drop
29178,35440,0,0,66,66,0,1,0,1,0,deny
31619,51221,0,0,62,62,0,1,0,1,0,deny
53161,51221,0,0,66,66,0,1,0,1,0,deny
61550,5529,0,0,145,145,0,1,0,1,0,deny
64733,35440,0,0,66,66,0,1,0,1,0,deny
58007,62413,0,0,66,66,0,1,0,1,0,deny
51232,23,0,0,60,60,0,1,0,1,0,deny
49653,80,62428,80,372,192,180,7,42,4,3,allow
49659,80,54132,80,1937,885,1052,13,42,7,6,allow
49635,80,43715,80,318,192,126,6,42,4,2,allow
49618,80,5688,80,314,192,122,6,42,4,2,allow
49655,80,40166,80,499,192,307,6,42,4,2,allow
62912,443,19185,443,10829,2227,8602,35,47,20,15,allow
52094,55986,33027,55986,66,66,0,1,5,1,0,allow
49646,80,33279,80,318,192,126,6,42,4,2,allow
50827,443,49837,443,7298,2661,4637,21,17,11,10,allow
50999,443,57620,443,6765,1108,5657,17,18,10,7,allow
43326,443,43455,443,8065,2689,5376,27,315,14,13,allow
56472,53,9100,53,166,85,81,2,31,1,1,allow
49978,53,13448,53,190,97,93,2,30,1,1,allow
49619,80,12609,80,318,192,126,6,42,4,2,allow
49487,53,6709,53,182,93,89,2,30,1,1,allow
55538,53,15605,53,168,86,82,2,30,1,1,allow
49407,80,43999,80,4878,1570,3308,19,165,10,9,allow
64716,53,37975,53,190,97,93,2,31,1,1,allow
49616,80,21429,80,314,192,122,6,42,4,2,allow
49622,80,33304,80,454,262,192,8,42,5,3,allow
49634,80,5183,80,318,192,126,6,42,4,2,allow
49617,80,31416,80,314,192,122,6,42,4,2,allow
52124,11296,17277,11296,70,70,0,2,8,2,0,allow
50998,443,9197,443,6765,1108,5657,17,18,10,7,allow
52129,55550,12680,55550,70,70,0,2,8,2,0,allow
52095,48896,29371,48896,66,66,0,1,5,1,0,allow
55700,443,30597,443,10286,1326,8960,25,1017,8,17,allow
34320,443,18156,443,5823,1597,4226,21,19,11,10,allow
49891,53,30480,53,788,108,680,2,31,1,1,allow
49348,53,25745,53,188,96,92,2,31,1,1,allow
55703,13836,54739,13836,70,70,0,2,8,2,0,allow
65516,53,4200,53,290,94,196,4,41,2,2,allow
46215,443,1828,443,161,101,60,2,5,1,1,allow
49569,80,41314,80,454,262,192,8,44,5,3,allow
49621,80,15641,80,318,192,126,6,42,4,2,allow
49563,80,12092,80,318,192,126,6,45,4,2,allow
49620,80,21542,80,318,192,126,6,42,4,2,allow
49652,80,63583,80,372,192,180,7,42,4,3,allow
49647,80,48193,80,318,192,126,6,42,4,2,allow
49556,80,42311,80,7002,5717,1285,15,45,9,6,allow
49623,80,12161,80,454,262,192,8,42,5,3,allow
49671,80,23759,80,2122,1018,1104,13,41,7,6,allow
51987,80,37675,80,2175,1532,643,10,22,7,3,allow
56543,53,18371,53,756,95,661,2,30,1,1,allow
62030,53,0,0,229,85,144,2,31,1,1,allow
49332,443,44143,443,142684,5997,136687,134,48,31,103,allow
8282,17435,17967,17435,73,73,0,1,30,1,0,allow
56314,53,2805,53,182,93,89,2,30,1,1,allow
39626,443,37265,443,5518,1323,4195,25,271,14,11,allow
58249,443,60364,443,4220,2048,2172,11,122,6,5,allow
65239,53,46235,53,198,101,97,2,31,1,1,allow
19008,31652,0,0,74,74,0,1,91,1,0,allow
43411,443,13391,443,2895,726,2169,10,121,5,5,allow
40009,443,48154,443,21785,5577,16208,35,362,16,19,allow
56575,53,50705,53,732,89,643,2,31,1,1,allow
62007,24184,0,0,66,66,0,1,91,1,0,allow
42076,443,12944,443,4295,2123,2172,11,121,6,5,allow
48737,443,47925,443,5220,2290,2930,15,121,7,8,allow
56925,53,7944,53,192,98,94,2,30,1,1,allow
55106,53,52896,53,184,94,90,2,31,1,1,allow
56612,53,25509,53,274,87,187,4,31,2,2,allow
26661,53,26661,53,217,87,130,2,31,1,1,allow
56592,53,10104,53,200,102,98,2,31,1,1,allow
53288,443,63225,443,4448,1654,2794,13,121,6,7,allow
48817,41768,48817,41768,511,152,359,2,1200,1,1,allow
64306,53,29347,53,216,110,106,2,31,1,1,allow
48810,443,34983,443,6478,2684,3794,18,122,8,10,allow
40204,40014,35119,40014,141,79,62,2,31,1,1,allow
49154,443,24167,443,3163100,158133,3004967,3863,264,1464,2399,allow
15503,50321,53712,50321,490,149,341,2,1200,1,1,allow
3981,23117,0,0,66,66,0,1,0,1,0,deny
64193,445,0,0,70,70,0,1,0,1,0,drop
5060,37965,0,0,66,66,0,1,0,1,0,deny
4232,50584,0,0,66,66,0,1,0,1,0,deny
52569,445,0,0,70,70,0,1,0,1,0,drop
52565,445,0,0,70,70,0,1,0,1,0,drop
52564,445,0,0,70,70,0,1,0,1,0,drop
48978,25174,0,0,66,66,0,1,0,1,0,deny
64347,445,0,0,66,66,0,1,0,1,0,drop
6881,6881,0,0,146,146,0,1,0,1,0,deny
3103,50584,0,0,62,62,0,1,0,1,0,deny
52562,445,0,0,70,70,0,1,0,1,0,drop
29145,8168,0,0,62,62,0,1,0,1,0,deny
1253,25174,0,0,146,146,0,1,0,1,0,deny
64344,445,0,0,66,66,0,1,0,1,0,drop
45964,9666,0,0,60,60,0,1,0,1,0,deny
1108,47807,0,0,159,159,0,1,0,1,0,deny
51783,50584,0,0,66,66,0,1,0,1,0,deny
49593,80,60078,80,7098,5692,1406,17,41,9,8,allow
60011,443,31949,443,6053,2582,3471,30,80,15,15,allow
49600,80,7933,80,312,192,120,6,41,4,2,allow
49569,53,19473,53,198,102,96,2,30,1,1,allow
57232,53,10597,53,821,102,719,2,30,1,1,allow
35194,57470,0,0,74,74,0,1,0,1,0,deny
64341,445,0,0,66,66,0,1,0,1,0,drop
64342,445,0,0,66,66,0,1,0,1,0,drop
43260,41615,0,0,145,145,0,1,0,1,0,deny
44856,51505,0,0,62,62,0,1,0,1,0,deny
64340,445,0,0,66,66,0,1,0,1,0,drop
55408,64147,0,0,66,66,0,1,0,1,0,deny
63741,50584,0,0,62,62,0,1,0,1,0,deny
56406,22114,0,0,62,62,0,1,0,1,0,deny
45535,25174,0,0,62,62,0,1,0,1,0,deny
35207,22114,0,0,146,146,0,1,0,1,0,deny
49689,22114,0,0,62,62,0,1,0,1,0,deny
6943,21162,0,0,100,100,0,1,0,1,0,deny
64180,445,0,0,70,70,0,1,0,1,0,drop
6943,1970,0,0,100,100,0,1,0,1,0,deny
6943,52290,0,0,100,100,0,1,0,1,0,deny
6943,14984,0,0,100,100,0,1,0,1,0,deny
52558,445,0,0,70,70,0,1,0,1,0,drop
6943,59353,0,0,100,100,0,1,0,1,0,deny
6943,57099,0,0,100,100,0,1,0,1,0,deny
12830,25174,0,0,62,62,0,1,0,1,0,deny
46532,17372,0,0,145,145,0,1,0,1,0,deny
52553,445,0,0,70,70,0,1,0,1,0,drop
52549,445,0,0,70,70,0,1,0,1,0,drop
64177,445,0,0,70,70,0,1,0,1,0,drop
51728,44847,0,0,62,62,0,1,0,1,0,deny
37887,22114,0,0,66,66,0,1,0,1,0,deny
64329,445,0,0,66,66,0,1,0,1,0,drop
33556,25174,0,0,62,62,0,1,0,1,0,deny
43815,50584,0,0,62,62,0,1,0,1,0,deny
55106,53,41822,53,177,94,83,2,30,1,1,allow
64306,53,23219,53,216,110,106,2,30,1,1,allow
51000,443,65422,443,6544,939,5605,17,17,10,7,allow
43864,443,38853,443,4922,2860,2062,25,39,14,11,allow
54118,443,28446,443,115373,6904,108469,171,117,87,84,allow
53913,28402,62039,28402,70,70,0,2,7,2,0,allow
65516,53,26663,53,290,94,196,4,40,2,2,allow
38633,443,38633,443,4378,1471,2907,19,29,11,8,allow
56782,53,44895,53,197,102,95,2,30,1,1,allow
51230,443,29300,443,33489,19602,13887,98,43,51,47,allow
49657,443,35292,443,2800,1557,1243,33,53,19,14,allow
53884,48754,22273,48754,70,70,0,1,4,1,0,allow
64025,26826,1858,26826,70,70,0,1,4,1,0,allow
39378,443,56513,443,494,342,152,4,5,2,2,allow
60786,443,40740,443,12106,2192,9914,38,38,19,19,allow
64022,60918,60664,60918,70,70,0,1,4,1,0,allow
50824,80,46115,80,36051,11695,24356,109,265,55,54,allow
35098,443,17186,443,7703,1606,6097,23,80,13,10,allow
49644,80,40102,80,318,192,126,6,41,4,2,allow
49874,53,61806,53,165,86,79,2,29,1,1,allow
65041,53,3296,53,200,94,106,2,29,1,1,allow
65501,53,16521,53,443,182,261,6,29,3,3,allow
55556,53,62239,53,183,94,89,2,29,1,1,allow
56037,53,56792,53,168,94,74,2,29,1,1,allow
54979,53,30018,53,207,97,110,3,64,2,1,allow
55106,53,22662,53,184,94,90,2,30,1,1,allow
49663,80,43225,80,8935,3175,5760,17,41,8,9,allow
49633,80,21073,80,318,192,126,6,41,4,2,allow
49564,80,48576,80,318,192,126,6,45,4,2,allow
37711,443,32947,443,8060,2166,5894,23,255,12,11,allow
50376,53,42212,53,819,102,717,2,30,1,1,allow
42053,443,49116,443,2351,1546,805,20,40,11,9,allow
56925,53,48692,53,196,102,94,2,30,1,1,allow
57007,53,5847,53,183,94,89,2,30,1,1,allow
49764,53,54622,53,199,102,97,2,30,1,1,allow
49480,80,65349,80,6811,3791,3020,23,115,13,10,allow
55538,53,6885,53,168,86,82,2,30,1,1,allow
49679,80,26556,80,7256,1682,5574,14,40,6,8,allow
55707,53,54526,53,811,94,717,2,30,1,1,allow
49666,80,13546,80,7270,3119,4151,14,41,7,7,allow
65351,53,49727,53,228,110,118,2,30,1,1,allow
49606,80,25049,80,454,262,192,8,41,5,3,allow
49594,80,30490,80,25430,15577,9853,37,41,19,18,allow
52126,56057,15046,56057,70,70,0,2,8,2,0,allow
40204,40029,46066,40029,148,86,62,2,30,1,1,allow
58424,443,34481,443,6020,2493,3527,29,80,14,15,allow
54627,443,30890,443,182017,6621,175396,189,181,55,134,allow
51599,443,24581,443,25546,5284,20262,48,149,26,22,allow
55700,26957,2984,26957,70,70,0,1,5,1,0,allow
54635,443,11319,443,11955,1861,10094,30,172,14,16,allow
49664,80,19625,80,7561,3181,4380,16,41,8,8,allow
35214,8635,35214,8635,138,78,60,2,5,1,1,allow
36404,80,8914,80,534,460,74,6,15,5,1,allow
49679,443,62696,443,7938,1721,6217,25,172,12,13,allow
49277,80,11702,80,13670,11470,2200,39,231,20,19,allow
49668,80,43673,80,318,192,126,6,41,4,2,allow
65516,53,20089,53,506,204,302,6,57,3,3,allow
54625,53,52244,53,168,78,90,2,30,1,1,allow
49575,80,43723,80,318,192,126,6,43,4,2,allow
49584,80,44285,80,318,192,126,6,42,4,2,allow
65481,53,60374,53,168,86,82,2,30,1,1,allow
56965,53,39310,53,183,94,89,2,30,1,1,allow
56491,53,2856,53,165,86,79,2,30,1,1,allow
38211,443,38211,443,4653,1746,2907,19,26,11,8,allow
64403,53,33316,53,193,102,91,2,30,1,1,allow
49487,53,55528,53,183,94,89,2,30,1,1,allow
64950,53,55366,53,183,94,89,2,30,1,1,allow
56314,53,10977,53,183,94,89,2,30,1,1,allow
49764,53,50844,53,199,102,97,2,30,1,1,allow
55947,53,4712,53,94,94,0,1,30,1,0,allow
57007,53,38539,53,183,94,89,2,30,1,1,allow
56592,53,38145,53,200,102,98,2,30,1,1,allow
64636,53,38894,53,182,102,80,2,30,1,1,allow
57232,53,8301,53,198,102,96,2,30,1,1,allow
37698,443,12829,443,1781,1062,719,16,275,8,8,allow
65239,53,27517,53,199,102,97,2,30,1,1,allow
56925,53,20388,53,196,102,94,2,30,1,1,allow
60863,443,21124,443,24452,12758,11694,39,129,23,16,allow
51819,80,5456,80,5368,946,4422,16,77,9,7,allow
49665,80,35482,80,8457,3062,5395,16,41,7,9,allow
49604,80,21319,80,454,262,192,8,41,5,3,allow
49607,80,52438,80,378,192,186,7,41,4,3,allow
49643,80,57400,80,312,192,120,6,41,4,2,allow
49649,80,26716,80,378,192,186,7,41,4,3,allow
61594,53,61594,53,235,90,145,2,33,1,1,allow
52093,40828,29609,40828,160,70,90,2,5,1,1,allow
50827,80,8180,80,35970,11674,24296,108,265,55,53,allow
49673,80,41313,80,318,192,126,6,41,4,2,allow
56791,53,55367,53,250,87,163,4,58,2,2,allow
60824,53,60824,53,220,90,130,2,30,1,1,allow
49569,53,26958,53,821,102,719,2,30,1,1,allow
50825,80,41226,80,35970,11674,24296,108,265,55,53,allow
53163,32834,49682,32834,70,70,0,1,5,1,0,allow
51263,443,57364,443,162,102,60,2,5,1,1,allow
49682,443,37715,443,9766,1633,8133,27,172,13,14,allow
42993,443,2255,443,14451,3012,11439,33,32,18,15,allow
35078,443,15189,443,7222,1768,5454,22,81,13,9,allow
49567,80,10114,80,2855,1388,1467,12,44,7,5,allow
55639,53,59060,53,196,102,94,2,30,1,1,allow
64893,53,6270,53,326,134,192,2,30,1,1,allow
55452,53,61292,53,184,94,90,2,30,1,1,allow
55084,443,30495,443,6936,819,6117,20,85,11,9,allow
46413,443,45352,443,8106,4839,3267,61,449,32,29,allow
37991,443,2941,443,9566,2592,6974,29,134,16,13,allow
54127,443,25652,443,148422,10568,137854,223,115,114,109,allow
43347,443,49384,443,9118,1699,7419,24,131,14,10,allow
58736,53,58736,53,235,90,145,2,32,1,1,allow
51372,80,40252,80,882,527,355,10,255,6,4,allow
54126,443,11328,443,147104,9481,137623,217,115,111,106,allow
65427,53,25865,53,677,188,489,6,57,3,3,allow
38460,443,18587,443,14768,3347,11421,69,1902,32,37,allow
50074,443,37111,443,1625,838,787,18,92,10,8,allow
51464,443,62248,443,7269,1978,5291,28,39,14,14,allow
53539,443,34866,443,2385,1462,923,18,200,10,8,allow
65516,53,41111,53,290,94,196,4,40,2,2,allow
56782,53,33216,53,197,102,95,2,33,1,1,allow
40288,80,46706,80,1195,763,432,10,32,6,4,allow
33047,443,1345,443,204,70,134,4,25,2,2,allow
59533,443,28553,443,448,78,370,6,24,1,5,allow
49645,80,12574,80,318,192,126,6,41,4,2,allow
49614,80,63774,80,374,192,182,7,41,4,3,allow
49599,80,35878,80,312,192,120,6,41,4,2,allow
49651,80,24642,80,318,192,126,6,41,4,2,allow
49642,80,32526,80,312,192,120,6,41,4,2,allow
49609,80,50781,80,318,192,126,6,41,4,2,allow
51829,80,1041,80,1484,928,556,13,76,8,5,allow
49608,80,48854,80,318,192,126,6,41,4,2,allow
49667,80,7772,80,27534,4859,22675,34,41,14,20,allow
49560,80,60008,80,318,192,126,6,45,4,2,allow
49672,80,15007,80,3749,2453,1296,15,41,9,6,allow
49662,80,35388,80,6753,3135,3618,17,41,8,9,allow
49592,80,33337,80,4173,2324,1849,14,42,8,6,allow
56596,53,55954,53,199,102,97,2,29,1,1,allow
64403,53,2916,53,193,102,91,2,29,1,1,allow
56312,53,29568,53,195,102,93,2,29,1,1,allow
49603,80,3315,80,378,192,186,7,41,4,3,allow
49548,53,2066,53,263,102,161,2,29,1,1,allow
56314,53,50014,53,183,94,89,2,30,1,1,allow
55538,53,33092,53,250,86,164,4,30,2,2,allow
58346,53,2203,53,209,102,107,2,30,1,1,allow
60187,53,13355,53,168,78,90,2,30,1,1,allow
64581,53,40086,53,214,110,104,2,30,1,1,allow
55818,443,58281,443,5100,2001,3099,15,119,7,8,allow
56791,53,43251,53,250,87,163,4,58,2,2,allow
49348,53,2617,53,194,102,92,2,30,1,1,allow
64076,53,25451,53,255,102,153,2,30,1,1,allow
49477,53,4842,53,178,94,84,2,31,1,1,allow
49466,53,63344,53,807,94,713,2,30,1,1,allow
42155,443,26461,443,70,70,0,1,5,1,0,allow
58095,80,30247,80,4468,1145,3323,15,16,9,6,allow
49648,80,25450,80,318,192,126,6,41,4,2,allow
49576,80,3769,80,318,192,126,6,43,4,2,allow
49605,80,22223,80,454,262,192,8,41,5,3,allow
49582,80,49496,80,25980,10637,15343,40,42,17,23,allow
49624,80,29847,80,3314,1478,1836,16,41,9,7,allow
49611,80,38044,80,378,192,186,7,41,4,3,allow
49610,80,55235,80,378,192,186,7,41,4,3,allow
49601,80,15488,80,378,192,186,7,41,4,3,allow
50376,53,40722,53,196,102,94,2,30,1,1,allow
55639,53,11030,53,819,102,717,2,30,1,1,allow
49611,53,5356,53,177,94,83,2,30,1,1,allow
55692,53,51127,53,198,102,96,2,30,1,1,allow
40476,443,53143,443,17360,5578,11782,71,281,39,32,allow
50826,80,48832,80,35970,11674,24296,108,265,55,53,allow
50823,80,36399,80,35970,11674,24296,108,265,55,53,allow
49580,443,38727,443,442,262,180,8,42,5,3,allow
49596,80,27800,80,312,192,120,6,41,4,2,allow
49598,80,32079,80,372,192,180,7,41,4,3,allow
49597,80,58897,80,372,192,180,7,41,4,3,allow
54967,80,54666,80,1848,851,997,10,515,6,4,allow
49650,80,5839,80,318,192,126,6,41,4,2,allow
49602,80,16412,80,378,192,186,7,41,4,3,allow
64950,53,1692,53,183,94,89,2,30,1,1,allow
65168,53,17811,53,185,102,83,2,30,1,1,allow
57007,53,22368,53,183,94,89,2,30,1,1,allow
54943,443,33087,443,7118,2618,4500,21,30,12,9,allow
55106,53,58487,53,177,94,83,2,30,1,1,allow
55538,53,2707,53,168,86,82,2,30,1,1,allow
57231,53,57692,53,168,86,82,2,32,1,1,allow
52125,49224,18364,49224,70,70,0,2,8,2,0,allow
49732,80,36115,80,5236,1070,4166,13,145,6,7,allow
49613,80,63557,80,374,192,182,7,41,4,3,allow
49615,80,42615,80,374,192,182,7,41,4,3,allow
9472,443,45589,443,5699,505,5194,14,15,7,7,allow
49562,80,14517,80,318,192,126,6,45,4,2,allow
49612,80,44677,80,378,192,186,7,41,4,3,allow
56314,53,22045,53,183,94,89,2,30,1,1,allow
55227,53,7352,53,183,102,81,2,30,1,1,allow
56293,53,53658,53,166,86,80,2,30,1,1,allow
49477,53,20665,53,178,94,84,2,30,1,1,allow
64716,53,1067,53,195,102,93,2,30,1,1,allow
49635,53,16265,53,458,188,270,6,30,3,3,allow
55021,443,43787,443,6724,3642,3082,18,133,10,8,allow
55692,53,9187,53,198,102,96,2,31,1,1,allow
33340,443,55389,443,3598,1118,2480,14,120,7,7,allow
64306,53,34963,53,216,110,106,2,31,1,1,allow
65212,53,6232,53,196,102,94,2,31,1,1,allow
53035,443,43721,443,3473,881,2592,13,121,6,7,allow
64086,443,16892,443,3289,1031,2258,13,121,6,7,allow
64716,53,18562,53,195,102,93,2,31,1,1,allow
55032,53,18500,53,458,188,270,6,31,3,3,allow
56612,53,30112,53,274,87,187,4,31,2,2,allow
49591,53,7823,53,402,118,284,2,30,1,1,allow
56226,53,8376,53,284,96,188,4,31,2,2,allow
64987,53,57288,53,196,102,94,2,31,1,1,allow
56612,53,25011,53,274,87,187,4,31,2,2,allow
38851,443,9016,443,5993,2348,3645,15,120,8,7,allow
46159,443,16876,443,4168,1128,3040,14,121,7,7,allow
55631,443,58192,443,6897,2509,4388,16,121,8,8,allow
8915,443,26790,443,7182,1016,6166,28,412,11,17,allow
56490,443,62341,443,11756,4004,7752,26,121,12,14,allow
41365,443,33138,443,27475,5634,21841,76,145,35,41,allow
55697,53,64657,53,193,102,91,2,31,1,1,allow
43596,80,25616,80,1947,1182,765,10,515,6,4,allow
49782,443,62911,443,70,70,0,1,5,1,0,allow
49658,443,46695,443,11880,2839,9041,30,48,16,14,allow
46412,53,4555,53,164,78,86,2,31,1,1,allow
9267,80,6787,80,318,192,126,6,27,4,2,allow
51535,443,59853,443,122,62,60,2,16,1,1,allow
50023,53,26218,53,166,86,80,2,31,1,1,allow
54965,80,28312,80,3419,2046,1373,12,515,7,5,allow
52091,4789,61902,4789,70,70,0,1,5,1,0,allow
55661,53,42015,53,213,102,111,2,30,1,1,allow
56925,53,23020,53,196,102,94,2,30,1,1,allow
55718,27025,38370,27025,1778,1386,392,8,30,4,4,allow
56082,53,20820,53,184,94,90,2,30,1,1,allow
64632,53,26914,53,224,94,130,2,30,1,1,allow
57300,53,58923,53,184,94,90,2,31,1,1,allow
57550,50584,0,0,66,66,0,1,0,1,0,deny
36258,23,0,0,60,60,0,1,0,1,0,deny
64172,445,0,0,70,70,0,1,0,1,0,drop
35626,22114,0,0,62,62,0,1,0,1,0,deny
27679,37965,0,0,62,62,0,1,0,1,0,deny
64171,445,0,0,70,70,0,1,0,1,0,drop
2707,37,0,0,60,60,0,1,0,1,0,deny
50106,30317,0,0,62,62,0,1,0,1,0,deny
28156,50584,0,0,146,146,0,1,0,1,0,deny
64321,445,0,0,66,66,0,1,0,1,0,drop
62799,25174,0,0,62,62,0,1,0,1,0,deny
52534,445,0,0,70,70,0,1,0,1,0,drop
64169,445,0,0,70,70,0,1,0,1,0,drop
36258,23,0,0,60,60,0,1,0,1,0,deny
36258,23,0,0,60,60,0,1,0,1,0,deny
62194,50584,0,0,66,66,0,1,0,1,0,deny
39583,37965,0,0,66,66,0,1,0,1,0,deny
45218,25174,0,0,62,62,0,1,0,1,0,deny
54917,60043,0,0,66,66,0,1,0,1,0,deny
64318,445,0,0,66,66,0,1,0,1,0,drop
63116,22114,0,0,146,146,0,1,0,1,0,deny
38776,25174,0,0,146,146,0,1,0,1,0,deny
26802,50584,0,0,62,62,0,1,0,1,0,deny
42722,56448,0,0,74,74,0,1,0,1,0,deny
64312,445,0,0,66,66,0,1,0,1,0,drop
64162,445,0,0,70,70,0,1,0,1,0,drop
443,63113,0,0,100,100,0,1,0,1,0,deny
64303,445,0,0,66,66,0,1,0,1,0,drop
64160,445,0,0,70,70,0,1,0,1,0,drop
27046,51505,0,0,66,66,0,1,0,1,0,deny
1041,25174,0,0,146,146,0,1,0,1,0,deny
52494,36237,0,0,146,146,0,1,0,1,0,deny
26698,25174,0,0,66,66,0,1,0,1,0,deny
64159,445,0,0,70,70,0,1,0,1,0,drop
20586,25174,0,0,62,62,0,1,0,1,0,deny
64158,445,0,0,70,70,0,1,0,1,0,drop
64157,445,0,0,70,70,0,1,0,1,0,drop
65159,37965,0,0,74,74,0,1,0,1,0,deny
64151,445,0,0,70,70,0,1,0,1,0,drop
64152,445,0,0,70,70,0,1,0,1,0,drop
6666,443,0,0,60,60,0,1,0,1,0,deny
39195,25174,0,0,146,146,0,1,0,1,0,deny
22856,22114,0,0,62,62,0,1,0,1,0,deny
2707,37,0,0,60,60,0,1,0,1,0,deny
61465,22114,0,0,62,62,0,1,0,1,0,deny
52526,445,0,0,70,70,0,1,0,1,0,drop
52523,445,0,0,70,70,0,1,0,1,0,drop
52522,445,0,0,70,70,0,1,0,1,0,drop
30303,30303,0,0,181,181,0,1,0,1,0,deny
64291,445,0,0,66,66,0,1,0,1,0,drop
64295,445,0,0,66,66,0,1,0,1,0,drop
64296,445,0,0,66,66,0,1,0,1,0,drop
64294,445,0,0,66,66,0,1,0,1,0,drop
64289,445,0,0,66,66,0,1,0,1,0,drop
64290,445,0,0,66,66,0,1,0,1,0,drop
64292,445,0,0,66,66,0,1,0,1,0,drop
64288,445,0,0,66,66,0,1,0,1,0,drop
52537,57866,0,0,62,62,0,1,0,1,0,deny
64139,445,0,0,70,70,0,1,0,1,0,drop
64138,445,0,0,70,70,0,1,0,1,0,deny
42981,44847,0,0,62,62,0,1,0,1,0,deny
64135,445,0,0,70,70,0,1,0,1,0,drop
51455,53733,0,0,66,66,0,1,0,1,0,deny
64129,445,0,0,70,70,0,1,0,1,0,drop
64128,445,0,0,70,70,0,1,0,1,0,drop
60579,25174,0,0,66,66,0,1,0,1,0,deny
15819,3389,0,0,60,60,0,1,0,1,0,deny
31609,25174,0,0,62,62,0,1,0,1,0,deny
51425,37450,0,0,62,62,0,1,0,1,0,deny
32171,50265,0,0,145,145,0,1,0,1,0,deny
61185,54532,0,0,62,62,0,1,0,1,0,deny
26263,8168,0,0,62,62,0,1,0,1,0,deny
52625,25174,0,0,66,66,0,1,0,1,0,deny
15319,51505,0,0,66,66,0,1,0,1,0,deny
52518,445,0,0,70,70,0,1,0,1,0,drop
52515,445,0,0,70,70,0,1,0,1,0,drop
52509,445,0,0,70,70,0,1,0,1,0,drop
52506,445,0,0,70,70,0,1,0,1,0,drop
50512,1212,0,0,145,145,0,1,0,1,0,deny
31172,22114,0,0,62,62,0,1,0,1,0,deny
22679,2323,0,0,60,60,0,1,0,1,0,deny
6929,35440,0,0,62,62,0,1,0,1,0,deny
38859,22114,0,0,66,66,0,1,0,1,0,deny
64276,445,0,0,66,66,0,1,0,1,0,drop
64273,445,0,0,66,66,0,1,0,1,0,drop
64274,445,0,0,66,66,0,1,0,1,0,drop
64117,445,0,0,70,70,0,1,0,1,0,drop
59734,5900,0,0,60,60,0,1,0,1,0,deny
6666,2222,0,0,60,60,0,1,0,1,0,deny
63136,25174,0,0,66,66,0,1,0,1,0,deny
52502,445,0,0,70,70,0,1,0,1,0,drop
52498,445,0,0,70,70,0,1,0,1,0,drop
52497,445,0,0,70,70,0,1,0,1,0,drop
52496,445,0,0,70,70,0,1,0,1,0,drop
5790,43890,0,0,62,62,0,1,0,1,0,deny
17101,25174,0,0,66,66,0,1,0,1,0,deny
64113,445,0,0,70,70,0,1,0,1,0,drop
10704,25174,0,0,62,62,0,1,0,1,0,deny
10909,30975,0,0,148,148,0,1,0,1,0,deny
51635,50265,0,0,66,66,0,1,0,1,0,deny
33973,50265,0,0,62,62,0,1,0,1,0,deny
64102,445,0,0,70,70,0,1,0,1,0,drop
64101,445,0,0,70,70,0,1,0,1,0,drop
64104,445,0,0,70,70,0,1,0,1,0,drop
13588,15503,0,0,62,62,0,1,0,1,0,deny
64100,445,0,0,70,70,0,1,0,1,0,drop
5955,55160,0,0,74,74,0,1,0,1,0,deny
64097,445,0,0,70,70,0,1,0,1,0,drop
0,0,0,0,70,70,0,1,0,1,0,deny
52485,445,0,0,70,70,0,1,0,1,0,drop
52482,445,0,0,70,70,0,1,0,1,0,drop
52480,445,0,0,70,70,0,1,0,1,0,drop
56999,25174,0,0,62,62,0,1,0,1,0,deny
64263,445,0,0,66,66,0,1,0,1,0,drop
1026,64147,0,0,145,145,0,1,0,1,0,deny
59937,18375,0,0,66,66,0,1,0,1,0,deny
9087,37965,0,0,62,62,0,1,0,1,0,deny
64090,445,0,0,70,70,0,1,0,1,0,drop
30729,22114,0,0,66,66,0,1,0,1,0,deny
52477,445,0,0,70,70,0,1,0,1,0,drop
27110,22114,0,0,60,60,0,1,0,1,0,deny
52474,445,0,0,70,70,0,1,0,1,0,drop
59060,50584,0,0,66,66,0,1,0,1,0,deny
33886,65504,0,0,162,162,0,1,0,1,0,deny
64083,445,0,0,70,70,0,1,0,1,0,drop
54914,51505,0,0,66,66,0,1,0,1,0,deny
51615,25174,0,0,66,66,0,1,0,1,0,deny
14777,25174,0,0,62,62,0,1,0,1,0,deny
64080,445,0,0,70,70,0,1,0,1,0,drop
59692,57470,0,0,78,78,0,1,0,1,0,deny
64246,445,0,0,66,66,0,1,0,1,0,drop
64248,445,0,0,66,66,0,1,0,1,0,drop
22528,25174,0,0,62,62,0,1,0,1,0,deny
50236,25174,0,0,66,66,0,1,0,1,0,deny
53563,35440,0,0,66,66,0,1,0,1,0,deny
2346,25174,0,0,66,66,0,1,0,1,0,deny
15585,64147,0,0,66,66,0,1,0,1,0,deny
64077,445,0,0,70,70,0,1,0,1,0,drop
22036,44847,0,0,62,62,0,1,0,1,0,deny
2938,64147,0,0,62,62,0,1,0,1,0,deny
64075,445,0,0,70,70,0,1,0,1,0,drop
52460,445,0,0,70,70,0,1,0,1,0,drop
52462,445,0,0,70,70,0,1,0,1,0,drop
52461,445,0,0,70,70,0,1,0,1,0,drop
52454,445,0,0,70,70,0,1,0,1,0,drop
60261,25174,0,0,66,66,0,1,0,1,0,deny
54976,15503,0,0,66,66,0,1,0,1,0,deny
64239,445,0,0,66,66,0,1,0,1,0,drop
57300,53,43157,53,184,94,90,2,30,1,1,allow
26944,443,13934,443,6861,2224,4637,19,19,9,10,allow
56226,53,12248,53,284,96,188,4,33,2,2,allow
49328,443,48321,443,77821,4380,73441,82,53,23,59,allow
64987,53,14036,53,192,98,94,2,30,1,1,allow
40422,53,0,0,82,82,0,1,30,1,0,allow
55348,53,40546,53,184,80,104,2,30,1,1,allow
64835,53,7153,53,174,89,85,2,30,1,1,allow
46830,80,6947,80,1764,751,1013,10,16,6,4,allow
33933,80,56054,80,1988,1072,916,12,515,7,5,allow
49213,443,9169,443,157994,4952,153042,186,255,68,118,allow
34326,443,28311,443,5692,1597,4095,19,18,11,8,allow
55551,53,54639,53,788,108,680,2,30,1,1,allow
50023,53,38403,53,164,84,80,2,31,1,1,allow
46963,443,17005,443,70,70,0,1,5,1,0,allow
51574,443,46080,443,400,70,330,6,25,1,5,allow
49622,443,38378,443,11139,3031,8108,30,176,14,16,allow
65212,53,35167,53,192,98,94,2,31,1,1,allow
58528,443,58528,443,4672,1765,2907,19,29,11,8,allow
52568,80,52568,80,16474,1881,14593,28,143,12,16,allow
45482,80,16084,80,1130,624,506,11,15,5,6,allow
56337,53,29643,53,268,89,179,4,45,2,2,allow
53164,48198,7411,48198,320,140,180,6,7,3,3,allow
52121,58933,17101,58933,70,70,0,2,8,2,0,allow
56202,53,48899,53,749,94,655,2,30,1,1,allow
55452,53,54913,53,184,94,90,2,30,1,1,allow
50236,443,50711,443,6661,1489,5172,26,270,13,13,allow
54054,443,10549,443,34629391,1109219,33520172,36863,278,12240,24623,allow
41603,443,56421,443,16028,3246,12782,37,272,19,18,allow
51576,443,46569,443,400,70,330,6,25,1,5,allow
55697,53,39982,53,186,95,91,2,31,1,1,allow
49331,443,35944,443,78663,4968,73695,85,47,24,61,allow
49327,443,21395,443,116686,4968,111718,116,53,31,85,allow
9270,80,20221,80,318,192,126,6,26,4,2,allow
55692,53,35310,53,196,100,96,2,30,1,1,allow
55222,53,19882,53,178,91,87,2,30,1,1,allow
55927,53,11810,53,711,87,624,2,30,1,1,allow
40544,53,0,0,82,82,0,1,30,1,0,allow
30960,45755,44633,45755,462,462,0,8,3631,8,0,allow
64974,53,44237,53,212,108,104,2,31,1,1,allow
57301,53,33321,53,170,87,83,2,31,1,1,allow
49234,53,17547,53,166,85,81,2,31,1,1,allow
48817,29614,48817,29614,506,152,354,2,1201,1,1,allow
49477,53,35970,53,172,88,84,2,30,1,1,allow
50095,53,54067,53,146,75,71,2,31,1,1,allow
56489,443,54085,443,75930,4291,71639,90,120,32,58,allow
58795,443,24808,443,10273,2573,7700,24,305,8,16,allow
57596,443,20240,443,8154,1791,6363,21,187,11,10,allow
55726,27015,8012,27015,628,462,166,4,31,2,2,allow
48817,23944,48817,23944,513,152,361,2,1201,1,1,allow
39434,5228,17809,5228,3505,2006,1499,30,3744,15,15,allow
64071,445,0,0,70,70,0,1,0,1,0,drop
6881,6881,0,0,146,146,0,1,0,1,0,deny
64236,445,0,0,66,66,0,1,0,1,0,drop
64229,445,0,0,66,66,0,1,0,1,0,drop
64235,445,0,0,66,66,0,1,0,1,0,drop
64232,445,0,0,66,66,0,1,0,1,0,drop
64233,445,0,0,66,66,0,1,0,1,0,drop
64227,445,0,0,66,66,0,1,0,1,0,drop
64226,445,0,0,66,66,0,1,0,1,0,drop
64070,445,0,0,70,70,0,1,0,1,0,drop
63545,25174,0,0,62,62,0,1,0,1,0,deny
52450,445,0,0,70,70,0,1,0,1,0,drop
52447,445,0,0,70,70,0,1,0,1,0,drop
52445,445,0,0,70,70,0,1,0,1,0,drop
52443,445,0,0,70,70,0,1,0,1,0,drop
56127,37965,0,0,62,62,0,1,0,1,0,deny
58900,37807,0,0,62,62,0,1,0,1,0,deny
35194,57470,0,0,74,74,0,1,0,1,0,deny
37672,5223,1351,5223,110,110,0,1,5,1,0,allow
52572,80,52572,80,1680,696,984,11,142,6,5,allow
51398,53,51398,53,197,90,107,2,30,1,1,allow
64835,53,59630,53,179,94,85,2,30,1,1,allow
64065,445,0,0,70,70,0,1,0,1,0,drop
54221,57470,0,0,66,66,0,1,0,1,0,deny
1537,22114,0,0,62,62,0,1,0,1,0,deny
37592,36829,0,0,146,146,0,1,0,1,0,deny
52112,22114,0,0,66,66,0,1,0,1,0,deny
52437,445,0,0,70,70,0,1,0,1,0,drop
52438,445,0,0,70,70,0,1,0,1,0,drop
52435,445,0,0,70,70,0,1,0,1,0,drop
18116,37807,0,0,66,66,0,1,0,1,0,deny
64220,445,0,0,66,66,0,1,0,1,0,drop
52434,445,0,0,70,70,0,1,0,1,0,drop
64216,445,0,0,66,66,0,1,0,1,0,drop
41861,5223,49797,5223,5169,1103,4066,26,214,10,16,allow
48798,443,34647,443,55560,11338,44222,90,23,41,49,allow
52097,443,17045,443,7246,3017,4229,21,15,11,10,allow
50669,443,61553,443,2985,1505,1480,16,20,9,7,allow
59485,80,39693,80,882,527,355,10,255,6,4,allow
56592,53,12698,53,200,102,98,2,29,1,1,allow
49367,53,30708,53,389,94,295,4,55,2,2,allow
64040,12226,39321,12226,66,66,0,2,7,2,0,allow
40204,40005,24841,40005,148,86,62,2,30,1,1,allow
64483,53,37576,53,300,90,210,4,30,2,2,allow
38863,443,38863,443,36313,5931,30382,72,108,36,36,allow
62722,443,49389,443,3491257,62261,3428996,3146,155,768,2378,allow
55452,53,8362,53,184,94,90,2,29,1,1,allow
65239,53,58774,53,199,102,97,2,29,1,1,allow
55692,53,4863,53,198,102,96,2,29,1,1,allow
56354,53,44261,53,182,102,80,2,29,1,1,allow
64452,53,37833,53,322,102,220,2,29,1,1,allow
55106,53,60018,53,184,94,90,2,29,1,1,allow
53907,45622,50876,45622,70,70,0,2,7,2,0,allow
49978,53,38632,53,195,102,93,2,29,1,1,allow
64462,53,49415,53,179,94,85,2,30,1,1,allow
55697,53,51781,53,193,102,91,2,30,1,1,allow
49397,53,53029,53,373,98,275,4,43,2,2,allow
56337,53,25650,53,268,89,179,4,45,2,2,allow
34787,443,34308,443,13074,2439,10635,46,279,22,24,allow
52867,53,61685,53,184,86,98,2,30,1,1,allow
56878,53,29099,53,94,94,0,1,30,1,0,allow
49234,53,44202,53,167,86,81,2,30,1,1,allow
55828,53,56117,53,177,94,83,2,30,1,1,allow
49556,53,62658,53,300,100,200,4,44,2,2,allow
55702,80,56730,80,70,70,0,2,8,2,0,allow
60912,443,25198,443,9959,2430,7529,27,46,16,11,allow
59486,80,17490,80,882,527,355,10,255,6,4,allow
56612,53,15256,53,274,87,187,4,30,2,2,allow
56773,443,51568,443,7941,1952,5989,20,15,11,9,allow
50621,443,42624,443,10905,4352,6553,30,18,18,12,allow
42811,443,38598,443,2766,1907,859,17,25,10,7,allow
59821,80,19887,80,1052,612,440,10,15,5,5,allow
56337,53,46173,53,268,89,179,4,45,2,2,allow
52119,49239,18789,49239,258,70,188,4,8,2,2,allow
57300,53,21469,53,184,94,90,2,30,1,1,allow
52122,43073,9475,43073,70,70,0,2,8,2,0,allow
65470,53,21136,53,226,94,132,2,30,1,1,allow
55222,53,4063,53,181,94,87,2,30,1,1,allow
60988,443,42425,443,8019,3298,4721,30,40,17,13,allow
64671,53,7191,53,294,102,192,2,30,1,1,allow
56873,53,25069,53,184,94,90,2,30,1,1,allow
37319,443,50657,443,70,70,0,1,5,1,0,allow
55452,53,7661,53,184,94,90,2,30,1,1,allow
41322,443,6156,443,994089,30018,964071,1058,350,373,685,allow
40249,443,14843,443,70,70,0,1,5,1,0,allow
51304,443,20155,443,7134,3081,4053,24,121,11,13,allow
52571,80,52571,80,10947,876,10071,21,142,9,12,allow
55208,443,24176,443,7224,114,7110,9,122,2,7,allow
56029,53,2806,53,346,94,252,2,30,1,1,allow
64987,53,4145,53,196,102,94,2,30,1,1,allow
56774,443,5880,443,7889,1900,5989,20,15,11,9,allow
37321,443,3162,443,70,70,0,1,5,1,0,allow
56675,80,35224,80,156,156,0,3,8,3,0,allow
52100,443,58970,443,190,70,120,4,15,2,2,allow
51576,443,34580,443,3323,2023,1300,17,255,9,8,allow
64356,53,40978,53,243,94,149,2,30,1,1,allow
50030,53,18076,53,209,110,99,2,30,1,1,allow
51033,443,39133,443,14697,3801,10896,52,120,24,28,allow
37675,53,37675,53,197,90,107,2,30,1,1,allow
46190,80,10092,80,5443,2529,2914,14,515,8,6,allow
52573,80,52573,80,3487,696,2791,13,142,6,7,allow
10063,443,38761,443,822903,35544,787359,1068,153,463,605,allow
64420,53,21949,53,362,94,268,2,30,1,1,allow
56592,53,24895,53,200,102,98,2,30,1,1,allow
52780,443,29664,443,122,62,60,2,15,1,1,allow
53085,443,17021,443,16024,3168,12856,56,76,31,25,allow
38922,443,18971,443,346170,16091,330079,454,16,225,229,allow
52247,443,52247,443,948720,23674,925046,988,26,349,639,allow
49348,53,28507,53,312,96,216,4,35,2,2,allow
52088,35605,27322,35605,70,70,0,1,5,1,0,allow
57906,80,15891,80,318,192,126,6,26,4,2,allow
62721,443,47170,443,5718309,117049,5601260,5287,155,1390,3897,allow
50672,80,6037,80,1718,1247,471,9,14,5,4,allow
65425,53,21278,53,473,94,379,4,36,2,2,allow
58831,443,40650,443,9378,2858,6520,48,196,21,27,allow
60798,40010,54476,40010,316,136,180,6,6,3,3,allow
52123,46261,34015,46261,70,70,0,2,7,2,0,allow
47051,443,3373,443,3304,2161,1143,21,16,11,10,allow
37320,443,60186,443,70,70,0,1,5,1,0,allow
39888,443,38398,443,1964,1171,793,20,25,11,9,allow
56226,53,44944,53,284,96,188,4,33,2,2,allow
64677,53,11788,53,334,93,241,4,50,2,2,allow
50023,53,49657,53,166,86,80,2,29,1,1,allow
55222,53,13241,53,181,94,87,2,29,1,1,allow
55222,53,63142,53,181,94,87,2,29,1,1,allow
64581,53,16875,53,214,110,104,2,29,1,1,allow
56497,53,23071,53,214,110,104,2,30,1,1,allow
46056,443,52673,443,80200,69062,11138,193,89,100,93,allow
50473,123,38470,123,184,94,90,2,30,1,1,allow
57352,53,7772,53,196,102,94,2,29,1,1,allow
44256,3389,44256,3389,4145,1976,2169,22,18,13,9,allow
55966,53,61391,53,86,86,0,1,29,1,0,allow
57590,80,57590,80,1165239,13055,1152184,977,149,193,784,allow
56082,53,33966,53,807,94,713,2,29,1,1,allow
61113,27045,31501,27045,1680,1386,294,7,30,4,3,allow
56497,53,5207,53,214,110,104,2,30,1,1,allow
34316,53,37625,53,168,78,90,2,29,1,1,allow
49466,53,52804,53,184,94,90,2,29,1,1,allow
56472,53,54930,53,167,86,81,2,30,1,1,allow
65444,53,41449,53,227,110,117,2,29,1,1,allow
49202,53,57613,53,226,86,140,2,30,1,1,allow
57065,53,13982,53,182,102,80,2,29,1,1,allow
64835,53,38888,53,179,94,85,2,30,1,1,allow
63943,53,31455,53,254,110,144,2,30,1,1,allow
59638,53,40619,53,714,454,260,2,30,1,1,allow
49886,53,51424,53,311,102,209,2,30,1,1,allow
64974,53,31114,53,214,110,104,2,30,1,1,allow
65031,53,34987,53,184,94,90,2,30,1,1,allow
49267,53,44367,53,184,94,90,2,31,1,1,allow
57470,1337,44694,1337,594,594,0,10,1199,10,0,allow
64974,53,53114,53,214,110,104,2,30,1,1,allow
50023,53,60476,53,166,86,80,2,31,1,1,allow
64602,53,49677,53,184,94,90,2,30,1,1,allow
64181,53,18587,53,194,102,92,2,31,1,1,allow
6881,12676,29408,12676,509,150,359,2,1199,1,1,allow
57470,35988,31535,35988,132,132,0,3,1199,3,0,allow
51221,57073,10928,57073,481,150,331,2,1200,1,1,allow
35052,443,8505,443,4652,3109,1543,25,95,14,11,allow
57266,443,58500,443,10174,2163,8011,25,81,14,11,allow
55106,53,36714,53,314,94,220,4,33,2,2,allow
56772,443,38284,443,7889,1900,5989,20,15,11,9,allow
55884,53,55884,53,197,90,107,2,30,1,1,allow
64835,53,41380,53,179,94,85,2,30,1,1,allow
39622,53,25768,53,168,78,90,2,30,1,1,allow
55828,53,14283,53,177,94,83,2,30,1,1,allow
64433,53,21792,53,257,94,163,2,30,1,1,allow
53036,443,2888,443,3039,1089,1950,9,120,5,4,allow
55031,5222,39174,5222,6192,3767,2425,53,64,29,24,allow
60684,80,43634,80,1737,796,941,12,16,7,5,allow
56676,80,29076,80,78,78,0,2,6,2,0,allow
32945,80,47829,80,234,234,0,4,12,4,0,allow
49046,5222,3706,5222,6910,3381,3529,50,323,26,24,allow
49477,53,9524,53,271,88,183,4,59,2,2,allow
55369,53,62193,53,376,94,282,2,30,1,1,allow
64225,53,35755,53,322,118,204,2,30,1,1,allow
56937,53,62951,53,181,94,87,2,30,1,1,allow
40204,40016,39697,40016,140,78,62,2,30,1,1,allow
56937,53,52000,53,181,94,87,2,33,1,1,allow
52120,42751,65345,42751,70,70,0,2,8,2,0,allow
52089,16543,15795,16543,70,70,0,1,5,1,0,allow
56337,53,7280,53,268,89,179,4,44,2,2,allow
52570,80,52570,80,3886,696,3190,13,142,6,7,allow
48872,443,20108,443,8143,3033,5110,26,18,14,12,allow
65212,53,45804,53,196,102,94,2,30,1,1,allow
54962,53,47568,53,241,102,139,2,31,1,1,allow
49849,53,37502,53,196,102,94,2,31,1,1,allow
55697,53,14156,53,193,102,91,2,31,1,1,allow
31683,53,31683,53,197,90,107,2,30,1,1,allow
20953,53,20953,53,295,90,205,2,30,1,1,allow
48817,45919,48817,45919,334,158,176,2,1200,1,1,allow
61833,443,42241,443,3429,784,2645,18,135,8,10,allow
55804,80,55804,80,424,198,226,7,143,4,3,allow
10151,40231,24979,40231,481,150,331,2,1200,1,1,allow
65031,53,49062,53,184,94,90,2,31,1,1,allow
50020,443,25948,443,9175,2213,6962,37,121,19,18,allow
60217,443,8028,443,6075,3806,2269,18,120,10,8,allow
57470,1337,52453,1337,594,594,0,10,1199,10,0,allow
64462,53,60220,53,329,94,235,4,31,2,2,allow
55763,8060,47887,8060,70,70,0,1,5,1,0,allow
43546,443,49269,443,5948,1664,4284,21,247,12,9,allow
50666,80,35544,80,2937,1241,1696,12,22,7,5,allow
35423,443,35423,443,4555,1648,2907,20,29,12,8,allow
49772,53,54364,53,181,94,87,2,31,1,1,allow
41243,443,21826,443,3697,2379,1318,26,16,14,12,allow
46507,443,10914,443,7068,2016,5052,32,18,17,15,allow
50364,443,37739,443,1727,926,801,15,30,7,8,allow
50384,80,18722,80,2537,783,1754,13,20,7,6,allow
46715,443,4396,443,2945,779,2166,10,121,5,5,allow
47454,443,6613,443,21782,2823,18959,42,16,20,22,allow
52253,443,52253,443,429263,14390,414873,449,24,159,290,allow
49706,53,17646,53,296,102,194,4,42,2,2,allow
53911,1025,45349,1025,130,70,60,3,6,2,1,allow
64038,28187,34899,28187,66,66,0,2,8,2,0,allow
64306,53,2693,53,216,110,106,2,30,1,1,allow
64214,445,0,0,66,66,0,1,0,1,0,drop
64212,445,0,0,66,66,0,1,0,1,0,drop
30303,30303,0,0,181,181,0,1,0,1,0,deny
64211,445,0,0,66,66,0,1,0,1,0,drop
2427,25174,0,0,62,62,0,1,0,1,0,deny
49370,11392,0,0,66,66,0,1,0,1,0,deny
64052,445,0,0,70,70,0,1,0,1,0,drop
52430,445,0,0,70,70,0,1,0,1,0,drop
64049,445,0,0,70,70,0,1,0,1,0,drop
6881,6881,0,0,146,146,0,1,0,1,0,deny
55079,25174,0,0,66,66,0,1,0,1,0,deny
30644,25174,0,0,62,62,0,1,0,1,0,deny
52420,445,0,0,70,70,0,1,0,1,0,drop
52415,445,0,0,70,70,0,1,0,1,0,drop
58715,64097,0,0,62,62,0,1,0,1,0,deny
61635,37965,0,0,66,66,0,1,0,1,0,deny
54883,51505,0,0,66,66,0,1,0,1,0,deny
59587,25174,0,0,62,62,0,1,0,1,0,deny
25063,64147,0,0,62,62,0,1,0,1,0,deny
64200,445,0,0,66,66,0,1,0,1,0,drop
7041,37965,0,0,62,62,0,1,0,1,0,deny
50235,5900,0,0,60,60,0,1,0,1,0,deny
46116,57470,0,0,74,74,0,1,0,1,0,deny
64045,445,0,0,70,70,0,1,0,1,0,drop
51966,25174,0,0,62,62,0,1,0,1,0,deny
30697,57866,0,0,62,62,0,1,0,1,0,deny
64043,445,0,0,70,70,0,1,0,1,0,drop
64041,445,0,0,70,70,0,1,0,1,0,drop
59096,57866,0,0,66,66,0,1,0,1,0,deny
58143,57866,0,0,66,66,0,1,0,1,0,deny
64192,445,0,0,66,66,0,1,0,1,0,drop
60869,48817,0,0,62,62,0,1,0,1,0,deny
52406,445,0,0,70,70,0,1,0,1,0,drop
63213,57866,0,0,66,66,0,1,0,1,0,deny
41898,22114,0,0,146,146,0,1,0,1,0,deny
64190,445,0,0,66,66,0,1,0,1,0,drop
54666,36237,0,0,66,66,0,1,0,1,0,deny
48706,23393,0,0,60,60,0,1,0,1,0,deny
39959,23117,0,0,146,146,0,1,0,1,0,deny
64034,445,0,0,70,70,0,1,0,1,0,drop
28110,22,0,0,60,60,0,1,0,1,0,deny
64183,445,0,0,66,66,0,1,0,1,0,drop
64032,445,0,0,70,70,0,1,0,1,0,drop
5830,22114,0,0,66,66,0,1,0,1,0,deny
1024,44847,0,0,62,62,0,1,0,1,0,deny
64172,445,0,0,66,66,0,1,0,1,0,drop
42030,25,0,0,74,74,0,1,0,1,0,deny
64031,445,0,0,70,70,0,1,0,1,0,drop
25202,25174,0,0,62,62,0,1,0,1,0,deny
4793,50584,0,0,62,62,0,1,0,1,0,deny
64030,445,0,0,70,70,0,1,0,1,0,drop
57164,50584,0,0,62,62,0,1,0,1,0,deny
37011,25174,0,0,62,62,0,1,0,1,0,deny
64029,445,0,0,70,70,0,1,0,1,0,drop
64023,445,0,0,70,70,0,1,0,1,0,drop
64024,445,0,0,70,70,0,1,0,1,0,drop
25523,35974,0,0,62,62,0,1,0,1,0,deny
29291,40108,0,0,150,150,0,1,0,1,0,deny
29291,62609,0,0,150,150,0,1,0,1,0,deny
48839,37807,0,0,146,146,0,1,0,1,0,deny
29291,48983,0,0,150,150,0,1,0,1,0,deny
18086,25174,0,0,62,62,0,1,0,1,0,deny
62550,51505,0,0,66,66,0,1,0,1,0,deny
52398,445,0,0,70,70,0,1,0,1,0,drop
52397,445,0,0,70,70,0,1,0,1,0,drop
52395,445,0,0,70,70,0,1,0,1,0,drop
27969,25174,0,0,62,62,0,1,0,1,0,deny
64011,445,0,0,70,70,0,1,0,1,0,drop
64010,445,0,0,70,70,0,1,0,1,0,drop
64160,445,0,0,66,66,0,1,0,1,0,drop
64164,445,0,0,66,66,0,1,0,1,0,drop
64163,445,0,0,66,66,0,1,0,1,0,drop
64166,445,0,0,66,66,0,1,0,1,0,drop
64167,445,0,0,66,66,0,1,0,1,0,drop
64165,445,0,0,66,66,0,1,0,1,0,drop
64161,445,0,0,66,66,0,1,0,1,0,drop
64159,445,0,0,66,66,0,1,0,1,0,drop
64007,445,0,0,70,70,0,1,0,1,0,drop
53015,64147,0,0,62,62,0,1,0,1,0,deny
64001,445,0,0,70,70,0,1,0,1,0,drop
64000,445,0,0,70,70,0,1,0,1,0,drop
61369,64147,0,0,66,66,0,1,0,1,0,deny
34811,56205,0,0,62,62,0,1,0,1,0,deny
61382,25174,0,0,66,66,0,1,0,1,0,deny
6889,8970,0,0,143,143,0,1,0,1,0,reset-both
48125,7558,0,0,60,60,0,1,0,1,0,deny
5222,64493,0,0,1514,1514,0,1,0,1,0,deny
38755,22114,0,0,66,66,0,1,0,1,0,deny
63032,22114,0,0,66,66,0,1,0,1,0,deny
43679,44847,0,0,62,62,0,1,0,1,0,deny
52389,445,0,0,70,70,0,1,0,1,0,drop
52387,445,0,0,70,70,0,1,0,1,0,drop
52386,445,0,0,70,70,0,1,0,1,0,drop
52378,445,0,0,70,70,0,1,0,1,0,drop
46604,57866,0,0,66,66,0,1,0,1,0,deny
63989,445,0,0,70,70,0,1,0,1,0,drop
58716,9694,0,0,62,62,0,1,0,1,0,deny
64144,445,0,0,66,66,0,1,0,1,0,drop
64145,445,0,0,66,66,0,1,0,1,0,drop
64146,445,0,0,66,66,0,1,0,1,0,drop
58926,25174,0,0,146,146,0,1,0,1,0,deny
19204,57866,0,0,66,66,0,1,0,1,0,deny
56578,25174,0,0,66,66,0,1,0,1,0,deny
28385,50584,0,0,62,62,0,1,0,1,0,deny
7905,22114,0,0,66,66,0,1,0,1,0,deny
62242,44512,0,0,66,66,0,1,0,1,0,deny
57471,62413,0,0,66,66,0,1,0,1,0,deny
52374,445,0,0,70,70,0,1,0,1,0,drop
19882,22114,0,0,146,146,0,1,0,1,0,deny
63985,445,0,0,70,70,0,1,0,1,0,drop
52373,445,0,0,70,70,0,1,0,1,0,drop
52371,445,0,0,70,70,0,1,0,1,0,drop
52369,445,0,0,70,70,0,1,0,1,0,drop
39661,23,0,0,60,60,0,1,0,1,0,deny
45964,2225,0,0,60,60,0,1,0,1,0,deny
63975,445,0,0,70,70,0,1,0,1,0,drop
63973,445,0,0,70,70,0,1,0,1,0,drop
63974,445,0,0,70,70,0,1,0,1,0,drop
55056,44512,0,0,62,62,0,1,0,1,0,deny
46808,25174,0,0,62,62,0,1,0,1,0,deny
63972,445,0,0,70,70,0,1,0,1,0,drop
36561,2767,0,0,62,62,0,1,0,1,0,deny
63969,445,0,0,70,70,0,1,0,1,0,drop
1024,64147,0,0,62,62,0,1,0,1,0,deny
50593,64147,0,0,66,66,0,1,0,1,0,deny
52699,25174,0,0,66,66,0,1,0,1,0,deny
32132,25174,0,0,66,66,0,1,0,1,0,deny
27055,25174,0,0,146,146,0,1,0,1,0,deny
52357,445,0,0,70,70,0,1,0,1,0,drop
52354,445,0,0,70,70,0,1,0,1,0,drop
52352,445,0,0,70,70,0,1,0,1,0,drop
27038,51505,0,0,62,62,0,1,0,1,0,deny
63786,25174,0,0,66,66,0,1,0,1,0,deny
49514,65504,0,0,162,162,0,1,0,1,0,deny
58744,1433,0,0,60,60,0,1,0,1,0,deny
51413,1,0,0,72,72,0,1,0,1,0,deny
51966,25174,0,0,146,146,0,1,0,1,0,deny
26531,25174,0,0,62,62,0,1,0,1,0,deny
64132,445,0,0,66,66,0,1,0,1,0,drop
19875,30170,0,0,145,145,0,1,0,1,0,deny
10072,25174,0,0,146,146,0,1,0,1,0,deny
63963,445,0,0,70,70,0,1,0,1,0,drop
55082,25174,0,0,66,66,0,1,0,1,0,deny
43345,51505,0,0,146,146,0,1,0,1,0,deny
10082,64147,0,0,62,62,0,1,0,1,0,deny
49651,37965,0,0,74,74,0,1,0,1,0,deny
11552,44847,0,0,146,146,0,1,0,1,0,deny
29016,25174,0,0,146,146,0,1,0,1,0,deny
8889,25033,0,0,60,60,0,1,0,1,0,deny
50321,48817,0,0,143,143,0,1,0,1,0,deny
52349,445,0,0,70,70,0,1,0,1,0,drop
443,21745,0,0,66,66,0,1,0,1,0,deny
63173,36237,0,0,66,66,0,1,0,1,0,deny
63955,445,0,0,70,70,0,1,0,1,0,drop
49036,44847,0,0,62,62,0,1,0,1,0,deny
52348,445,0,0,70,70,0,1,0,1,0,drop
63953,445,0,0,70,70,0,1,0,1,0,drop
22571,51505,0,0,66,66,0,1,0,1,0,deny
57761,30317,0,0,66,66,0,1,0,1,0,deny
18655,44847,0,0,66,66,0,1,0,1,0,deny
49250,53,20588,53,731,85,646,2,30,1,1,allow
64602,53,34002,53,184,94,90,2,30,1,1,allow
56491,53,1431,53,711,87,624,2,30,1,1,allow
65031,53,50837,53,184,94,90,2,30,1,1,allow
9243,80,7873,80,318,192,126,6,26,4,2,allow
56485,80,20851,80,569,365,204,6,16,3,3,allow
52115,10012,9221,10012,70,70,0,2,8,2,0,allow
48984,15000,36697,15000,130,70,60,2,5,1,1,allow
64462,53,6951,53,174,89,85,2,30,1,1,allow
50861,3389,50861,3389,4241,2521,1720,18,32,10,8,allow
9244,80,12299,80,318,192,126,6,26,4,2,allow
9260,80,58390,80,318,192,126,6,26,4,2,allow
49556,53,40428,53,300,100,200,4,44,2,2,allow
49365,80,10585,80,2361,1586,775,11,166,7,4,allow
59271,443,60275,443,26414,4349,22065,41,149,17,24,allow
55687,53,17643,53,731,85,646,2,31,1,1,allow
63834,27037,35809,27037,1130,924,206,5,30,3,2,allow
49267,53,65415,53,184,94,90,2,30,1,1,allow
50898,80,8835,80,21445,1605,19840,36,255,19,17,allow
58842,443,11917,443,8912,1537,7375,27,638,10,17,allow
9264,80,28949,80,318,192,126,6,26,4,2,allow
35939,443,12067,443,9111,2919,6192,27,19,14,13,allow
9469,80,38587,80,1641,483,1158,10,15,5,5,allow
53680,443,32656,443,7035,2364,4671,18,75,10,8,allow
40906,8434,40906,8434,156,156,0,3,8,3,0,allow
53260,443,37700,443,572,292,280,9,33,5,4,allow
55858,80,7371,80,104399,8436,95963,122,21,49,73,allow
41906,443,20652,443,181961,40579,141382,247,238,101,146,allow
54445,443,28246,443,2782,1778,1004,20,33,10,10,allow
65318,53,17829,53,184,94,90,2,31,1,1,allow
9262,80,26310,80,378,192,186,7,26,4,3,allow
9468,80,22561,80,1835,421,1414,9,15,4,5,allow
9263,80,41010,80,318,192,126,6,26,4,2,allow
50353,80,65364,80,8007,830,7177,17,30,8,9,allow
51656,53,51656,53,198,89,109,2,30,1,1,allow
48655,80,39370,80,956,541,415,11,315,6,5,allow
56248,53,47475,53,767,102,665,2,30,1,1,allow
56873,53,29966,53,184,94,90,2,30,1,1,allow
55503,53,13265,53,200,102,98,2,30,1,1,allow
57237,53,56776,53,701,88,613,2,30,1,1,allow
51401,443,31981,443,6537,3702,2835,34,170,17,17,allow
47087,443,29605,443,7187,2550,4637,20,18,10,10,allow
49706,53,30583,53,296,102,194,4,41,2,2,allow
58835,443,12321,443,9823,2600,7223,46,195,23,23,allow
49364,80,47748,80,2168,1031,1137,8,166,5,3,allow
53906,12051,34312,12051,258,70,188,4,9,2,2,allow
64181,53,25731,53,188,96,92,2,31,1,1,allow
54446,443,54881,443,2782,1778,1004,20,33,10,10,allow
49675,5900,49675,5900,124,60,64,2,5,1,1,allow
56281,443,8565,443,22352,9825,12527,111,370,55,56,allow
9261,80,32507,80,378,192,186,7,26,4,3,allow
9259,80,48036,80,318,192,126,6,26,4,2,allow
9265,80,10244,80,318,192,126,6,26,4,2,allow
9245,80,28513,80,378,192,186,7,26,4,3,allow
49772,53,60667,53,178,91,87,2,30,1,1,allow
49849,53,14013,53,192,98,94,2,31,1,1,allow
56519,53,63557,53,166,85,81,2,31,1,1,allow
49986,18242,0,0,66,66,0,1,90,1,0,allow
41254,443,60907,443,12757,4053,8704,39,522,14,25,allow
19473,28867,41961,28867,480,149,331,2,1200,1,1,allow
43185,443,5462,443,6951,1333,5618,26,271,14,12,allow
49564,53,46836,53,186,95,91,2,31,1,1,allow
53476,443,9051,443,3182,1568,1614,8,121,4,4,allow
52982,25174,0,0,146,146,0,1,0,1,0,deny
44334,26467,0,0,62,62,0,1,0,1,0,deny
57434,50584,0,0,146,146,0,1,0,1,0,deny
58091,51505,0,0,66,66,0,1,0,1,0,deny
64118,445,0,0,66,66,0,1,0,1,0,drop
64116,445,0,0,66,66,0,1,0,1,0,drop
63948,445,0,0,70,70,0,1,0,1,0,drop
63947,445,0,0,70,70,0,1,0,1,0,drop
54473,37807,0,0,66,66,0,1,0,1,0,deny
63364,57470,0,0,62,62,0,1,0,1,0,deny
2543,25174,0,0,62,62,0,1,0,1,0,deny
52339,445,0,0,70,70,0,1,0,1,0,drop
65318,53,18281,53,184,94,90,2,30,1,1,allow
60474,8999,5230,8999,70,70,0,1,5,1,0,allow
52334,445,0,0,70,70,0,1,0,1,0,drop
52332,445,0,0,70,70,0,1,0,1,0,drop
52327,445,0,0,70,70,0,1,0,1,0,drop
26881,25174,0,0,62,62,0,1,0,1,0,deny
38581,22114,0,0,62,62,0,1,0,1,0,deny
63943,445,0,0,70,70,0,1,0,1,0,drop
22636,30188,0,0,62,62,0,1,0,1,0,deny
64114,445,0,0,66,66,0,1,0,1,0,drop
45461,25174,0,0,62,62,0,1,0,1,0,deny
36151,22,0,0,60,60,0,1,0,1,0,deny
63941,445,0,0,70,70,0,1,0,1,0,drop
34146,1433,0,0,60,60,0,1,0,1,0,deny
64100,445,0,0,66,66,0,1,0,1,0,drop
64102,445,0,0,66,66,0,1,0,1,0,drop
64101,445,0,0,66,66,0,1,0,1,0,drop
64106,445,0,0,66,66,0,1,0,1,0,drop
64103,445,0,0,66,66,0,1,0,1,0,drop
64105,445,0,0,66,66,0,1,0,1,0,drop
64097,445,0,0,66,66,0,1,0,1,0,drop
60793,53733,0,0,66,66,0,1,0,1,0,deny
2437,23117,0,0,62,62,0,1,0,1,0,deny
52323,445,0,0,70,70,0,1,0,1,0,drop
11228,25174,0,0,66,66,0,1,0,1,0,deny
2437,23117,0,0,146,146,0,1,0,1,0,deny
48266,80,46749,80,130,70,60,2,15,1,1,allow
42107,443,39392,443,13704,2379,11325,47,279,22,25,allow
59685,443,54976,443,7747,1533,6214,27,31,13,14,allow
46438,53,32231,53,222,78,144,2,30,1,1,allow
54695,80,64600,80,2001,1107,894,13,150,7,6,allow
55707,26816,41675,26816,320,140,180,6,6,3,3,allow
37368,80,60512,80,554,258,296,9,13,5,4,allow
56769,443,25443,443,7941,1952,5989,20,15,11,9,allow
9253,443,42267,443,6135,770,5365,17,26,9,8,allow
50667,80,4915,80,3778,2082,1696,12,21,7,5,allow
49655,443,10531,443,31956,13344,18612,64,65,36,28,allow
33202,80,39571,80,1114,534,580,12,15,7,5,allow
49556,53,1572,53,300,100,200,4,43,2,2,allow
49368,443,28033,443,5224,1560,3664,15,165,9,6,allow
64037,18592,23660,18592,66,66,0,2,7,2,0,allow
64862,53,23535,53,223,94,129,2,29,1,1,allow
64462,53,14604,53,179,94,85,2,29,1,1,allow
57301,53,42748,53,177,94,83,2,29,1,1,allow
56771,443,16357,443,7941,1952,5989,20,15,11,9,allow
57300,53,9339,53,184,94,90,2,29,1,1,allow
37680,443,37680,443,4592,1685,2907,19,29,11,8,allow
49234,53,62807,53,167,86,81,2,29,1,1,allow
57301,53,40888,53,177,94,83,2,29,1,1,allow
4650,53,4650,53,300,90,210,2,29,1,1,allow
55503,53,12220,53,200,102,98,2,30,1,1,allow
65148,53,60062,53,498,204,294,6,29,3,3,allow
65078,53,48280,53,339,110,229,2,29,1,1,allow
49772,53,62355,53,181,94,87,2,29,1,1,allow
56873,53,37492,53,184,94,90,2,30,1,1,allow
64037,53,2722,53,215,94,121,2,29,1,1,allow
64602,53,19507,53,184,94,90,2,30,1,1,allow
38279,80,49834,80,122,62,60,2,15,1,1,allow
58152,443,52749,443,5584,1168,4416,19,17,11,8,allow
37671,53,37671,53,180,82,98,2,30,1,1,allow
49518,53,40851,53,167,86,81,2,30,1,1,allow
49849,53,11014,53,196,102,94,2,30,1,1,allow
52117,20600,30733,20600,70,70,0,2,8,2,0,allow
49518,53,65191,53,167,86,81,2,30,1,1,allow
52086,27156,8001,27156,136,136,0,3,14,3,0,allow
9257,443,25692,443,6327,833,5494,19,26,10,9,allow
39831,443,37659,443,7656,4286,3370,38,86,19,19,allow
47825,443,54151,443,932130,36511,895619,1142,167,465,677,allow
60797,28080,22385,28080,70,70,0,2,8,2,0,allow
56770,443,17971,443,7889,1900,5989,20,15,11,9,allow
9250,443,1319,443,6331,837,5494,19,26,10,9,allow
36008,80,27818,80,1614,1300,314,10,15,5,5,allow
54353,443,50678,443,9976,3230,6746,22,56,13,9,allow
9237,80,59192,80,378,192,186,7,26,4,3,allow
49693,53,17140,53,196,94,102,2,30,1,1,allow
64942,53,4876,53,284,102,182,4,37,2,2,allow
46503,443,50192,443,6492,1764,4728,56,996,20,36,allow
55503,53,55222,53,200,102,98,2,30,1,1,allow
49631,443,24213,443,6304,1793,4511,29,255,15,14,allow
56731,443,8891,443,7828,2313,5515,31,64,17,14,allow
49210,443,19575,443,9530,2183,7347,45,256,21,24,allow
64738,53,34025,53,402,118,284,2,30,1,1,allow
56843,53,63293,53,177,94,83,2,30,1,1,allow
50095,53,10662,53,168,86,82,2,30,1,1,allow
57301,53,28379,53,177,94,83,2,30,1,1,allow
49267,53,55947,53,184,94,90,2,30,1,1,allow
38402,443,34859,443,8119,1962,6157,24,360,11,13,allow
50095,53,20934,53,168,86,82,2,30,1,1,allow
55807,80,55807,80,424,198,226,7,142,4,3,allow
55806,80,55806,80,424,198,226,7,142,4,3,allow
9249,443,2759,443,6132,767,5365,17,26,9,8,allow
9239,80,63339,80,318,192,126,6,26,4,2,allow
52114,64853,12974,64853,70,70,0,2,8,2,0,allow
54162,443,34813,443,2680,1488,1192,19,41,10,9,allow
54160,443,65221,443,9464,1751,7713,29,48,13,16,allow
64181,53,43777,53,194,102,92,2,30,1,1,allow
49267,53,29003,53,184,94,90,2,30,1,1,allow
64388,53,41426,53,258,110,148,2,30,1,1,allow
56843,53,57824,53,177,94,83,2,30,1,1,allow
47725,443,52489,443,502,250,252,9,32,5,4,allow
60794,20010,2485,20010,70,70,0,1,5,1,0,allow
9234,80,38036,80,318,192,126,6,26,4,2,allow
37708,443,23854,443,8604,2228,6376,36,739,19,17,allow
33640,443,55083,443,10558,2530,8028,25,186,14,11,allow
51155,443,21340,443,54411,4588,49823,74,131,30,44,allow
49556,53,59272,53,300,100,200,4,44,2,2,allow
49626,443,38035,443,8266,1963,6303,28,175,14,14,allow
64974,53,23445,53,506,108,398,4,36,2,2,allow
52116,64692,45907,64692,70,70,0,2,8,2,0,allow
50365,80,49822,80,300,180,120,6,29,4,2,allow
55454,53,51580,53,168,86,82,2,33,1,1,allow
52087,52766,15525,52766,136,136,0,3,14,3,0,allow
44383,443,25298,443,14780,11289,3491,59,219,32,27,allow
45101,443,3854,443,7912,2739,5173,26,516,14,12,allow
62170,443,62170,443,28026,5723,22303,62,20,32,30,allow
9467,443,18809,443,5960,438,5522,16,15,6,10,allow
39127,6555,15189,6555,922,428,494,10,15,5,5,allow
34225,443,33698,443,256793,17776,239017,327,23,146,181,allow
50294,80,24616,80,1515,481,1034,11,15,6,5,allow
60995,443,11816,443,7583,2669,4914,31,17,16,15,allow
53964,443,36020,443,374,254,120,4,5,2,2,allow
46550,443,47907,443,3322,1760,1562,19,255,10,9,allow
33270,80,23251,80,1614,1300,314,10,15,5,5,allow
57341,53,40485,53,296,97,199,4,41,2,2,allow
41034,443,11072,443,6055,2800,3255,38,279,19,19,allow
49706,53,34052,53,296,102,194,4,41,2,2,allow
52118,33515,33207,33515,70,70,0,2,7,2,0,allow
9235,80,17442,80,318,192,126,6,26,4,2,allow
56672,80,18882,80,234,234,0,4,11,4,0,allow
50283,53,31898,53,767,102,665,2,29,1,1,allow
9238,80,17779,80,378,192,186,7,26,4,3,allow
48437,443,48848,443,934,420,514,15,30,7,8,allow
50095,53,59595,53,250,86,164,4,30,2,2,allow
65212,53,30386,53,196,102,94,2,30,1,1,allow
50629,443,10461,443,1048,1048,0,9,17,9,0,allow
49594,53,49594,53,199,90,109,2,30,1,1,allow
50638,443,50638,443,4544,1637,2907,19,26,11,8,allow
57807,443,57807,443,4434,1527,2907,19,29,11,8,allow
56873,53,11452,53,184,94,90,2,29,1,1,allow
57321,53,25115,53,498,204,294,6,29,3,3,allow
49179,53,18943,53,309,118,191,2,30,1,1,allow
6881,13487,50124,13487,228,118,110,2,1199,1,1,allow
56849,443,44408,443,7374,2085,5289,33,270,18,15,allow
64194,443,64194,443,27723,5572,22151,59,46,31,28,allow
60180,443,13880,443,3667,2243,1424,22,80,11,11,allow
9246,80,48818,80,318,192,126,6,26,4,2,allow
9251,443,22776,443,6132,767,5365,17,26,9,8,allow
55503,53,54842,53,200,102,98,2,30,1,1,allow
53950,123,31431,123,184,94,90,2,30,1,1,allow
49564,53,39263,53,193,102,91,2,30,1,1,allow
50116,80,62862,80,10094,1100,8994,20,33,10,10,allow
52085,29894,54507,29894,136,136,0,3,14,3,0,allow
54163,443,60868,443,2430,1416,1014,18,34,9,9,allow
53866,8999,60577,8999,372,186,186,6,15,3,3,allow
60711,443,10147,443,10569,3485,7084,27,515,15,12,allow
9256,443,44390,443,6327,833,5494,19,26,10,9,allow
53459,443,23457,443,88210,4564,83646,115,46,50,65,allow
65318,53,11252,53,184,94,90,2,30,1,1,allow
49234,53,17767,53,167,86,81,2,30,1,1,allow
58124,123,43315,123,184,94,90,2,30,1,1,allow
49577,53,36536,53,242,94,148,2,30,1,1,allow
59637,53,37515,53,273,94,179,2,30,1,1,allow
57987,443,16754,443,3264,1175,2089,14,120,7,7,allow
39817,443,13115,443,516080,28328,487752,660,95,305,355,allow
56628,443,8752,443,6654,3821,2833,60,3037,30,30,allow
64120,443,47176,443,3767437,87322,3680115,3675,52,1230,2445,allow
49665,53,16462,53,168,86,82,2,32,1,1,allow
50241,443,61373,443,27900,6291,21609,46,515,23,23,allow
9254,443,60082,443,6135,770,5365,17,26,9,8,allow
60059,53,45306,53,168,78,90,2,30,1,1,allow
65033,53,12694,53,214,94,120,2,30,1,1,allow
6881,25649,11591,25649,509,150,359,2,1200,1,1,allow
49849,53,61078,53,196,102,94,2,31,1,1,allow
63654,443,35757,443,9152483,314975,8837508,9599,206,3195,6404,allow
59189,443,26773,443,9050,4611,4439,37,222,20,17,allow
6881,6881,6157,6881,253,118,135,2,1200,1,1,allow
9289,443,57036,443,9051,3480,5571,31,23,17,14,allow
53902,55298,4313,55298,70,70,0,2,8,2,0,allow
53904,1024,57585,1024,70,70,0,2,8,2,0,allow
34680,9595,34680,9595,152,66,86,2,10,1,1,allow
38101,443,19198,443,350,210,140,6,15,4,2,allow
35430,443,18104,443,6267,1810,4457,25,18,14,11,allow
33688,80,62587,80,1638,1324,314,10,16,5,5,allow
53932,80,32355,80,1134,465,669,9,18,6,3,allow
63810,27064,25460,27064,1778,1386,392,8,31,4,4,allow
52113,19619,23788,19619,70,70,0,2,8,2,0,allow
56768,443,55318,443,7889,1900,5989,20,16,11,9,allow
56581,80,13177,80,1630,918,712,12,17,7,5,allow
40842,80,63836,80,1712,786,926,12,17,7,5,allow
9290,443,4925,443,8041,2882,5159,29,23,16,13,allow
9287,443,31377,443,5539,1486,4053,21,23,11,10,allow
49706,53,42213,53,296,102,194,4,41,2,2,allow
64942,53,36365,53,284,102,182,4,38,2,2,allow
52084,30863,5581,30863,70,70,0,1,5,1,0,allow
65031,53,9401,53,184,94,90,2,30,1,1,allow
49881,53,28896,53,213,102,111,2,30,1,1,allow
64602,53,4497,53,184,94,90,2,30,1,1,allow
57073,443,48824,443,7731,2016,5715,38,271,20,18,allow
65314,53,60905,53,402,118,284,2,30,1,1,allow
64181,53,17159,53,194,102,92,2,31,1,1,allow
1111,25174,0,0,62,62,0,1,0,1,0,deny
56793,56205,0,0,66,66,0,1,0,1,0,deny
52319,445,0,0,70,70,0,1,0,1,0,drop
52317,445,0,0,70,70,0,1,0,1,0,drop
52315,445,0,0,70,70,0,1,0,1,0,drop
60976,22114,0,0,66,66,0,1,0,1,0,deny
33401,51505,0,0,66,66,0,1,0,1,0,deny
63937,445,0,0,70,70,0,1,0,1,0,drop
34348,22114,0,0,146,146,0,1,0,1,0,deny
52091,11392,0,0,66,66,0,1,0,1,0,deny
34112,44847,0,0,66,66,0,1,0,1,0,deny
12545,25174,0,0,62,62,0,1,0,1,0,deny
64103,50265,0,0,66,66,0,1,0,1,0,deny
515,10214,0,0,62,62,0,1,0,1,0,deny
52313,445,0,0,70,70,0,1,0,1,0,drop
52311,445,0,0,70,70,0,1,0,1,0,drop
52307,445,0,0,70,70,0,1,0,1,0,drop
52358,30188,0,0,66,66,0,1,0,1,0,deny
61550,5529,0,0,145,145,0,1,0,1,0,deny
5213,44847,0,0,66,66,0,1,0,1,0,deny
64092,445,0,0,66,66,0,1,0,1,0,drop
45218,25174,0,0,146,146,0,1,0,1,0,deny
52306,445,0,0,70,70,0,1,0,1,0,drop
23119,41615,0,0,148,148,0,1,0,1,0,deny
59524,25174,0,0,62,62,0,1,0,1,0,deny
1035,57470,0,0,72,72,0,1,0,1,0,deny
64088,445,0,0,66,66,0,1,0,1,0,drop
33871,34476,0,0,137,137,0,1,0,1,0,deny
63062,11392,0,0,62,62,0,1,0,1,0,deny
44919,26467,0,0,62,62,0,1,0,1,0,deny
59493,44847,0,0,66,66,0,1,0,1,0,deny
64085,445,0,0,66,66,0,1,0,1,0,drop
64084,445,0,0,66,66,0,1,0,1,0,drop
12531,22114,0,0,62,62,0,1,0,1,0,deny
55451,56205,0,0,66,66,0,1,0,1,0,deny
41490,25174,0,0,146,146,0,1,0,1,0,deny
65231,50584,0,0,66,66,0,1,0,1,0,deny
63924,445,0,0,70,70,0,1,0,1,0,drop
45964,3111,0,0,60,60,0,1,0,1,0,deny
64082,445,0,0,66,66,0,1,0,1,0,drop
50512,24748,0,0,145,145,0,1,0,1,0,deny
46116,57470,0,0,74,74,0,1,0,1,0,deny
34485,81,0,0,60,60,0,1,0,1,0,deny
28795,37965,0,0,62,62,0,1,0,1,0,deny
1865,25174,0,0,62,62,0,1,0,1,0,deny
63921,445,0,0,70,70,0,1,0,1,0,drop
56326,56205,0,0,66,66,0,1,0,1,0,deny
58021,22114,0,0,66,66,0,1,0,1,0,deny
22542,30188,0,0,146,146,0,1,0,1,0,deny
42796,22114,0,0,62,62,0,1,0,1,0,deny
52305,445,0,0,70,70,0,1,0,1,0,drop
52292,445,0,0,70,70,0,1,0,1,0,drop
52291,445,0,0,70,70,0,1,0,1,0,drop
63916,445,0,0,70,70,0,1,0,1,0,drop
64072,445,0,0,66,66,0,1,0,1,0,drop
51042,22114,0,0,66,66,0,1,0,1,0,deny
63915,445,0,0,70,70,0,1,0,1,0,drop
63213,35440,0,0,146,146,0,1,0,1,0,deny
35524,34962,0,0,159,159,0,1,0,1,0,deny
63913,445,0,0,70,70,0,1,0,1,0,drop
63389,3389,63389,3389,293,223,70,4,0,3,1,reset-both
53904,443,54254,443,495,421,74,4,0,3,1,allow
24227,48817,0,0,160,160,0,1,0,1,0,deny
80,56289,0,0,578,578,0,1,0,1,0,deny
1024,25174,0,0,62,62,0,1,0,1,0,deny
64064,445,0,0,66,66,0,1,0,1,0,drop
52278,445,0,0,70,70,0,1,0,1,0,drop
54142,20541,0,0,66,66,0,1,0,1,0,deny
56949,22,0,0,60,60,0,1,0,1,0,deny
1918,25174,0,0,66,66,0,1,0,1,0,deny
64062,445,0,0,66,66,0,1,0,1,0,drop
63906,445,0,0,70,70,0,1,0,1,0,drop
6247,51221,0,0,62,62,0,1,0,1,0,deny
63904,445,0,0,70,70,0,1,0,1,0,drop
58022,88,0,0,60,60,0,1,0,1,0,deny
2383,37965,0,0,62,62,0,1,0,1,0,deny
57496,25174,0,0,62,62,0,1,0,1,0,deny
53073,32468,0,0,62,62,0,1,0,1,0,deny
64055,445,0,0,66,66,0,1,0,1,0,drop
63903,445,0,0,70,70,0,1,0,1,0,drop
64052,445,0,0,66,66,0,1,0,1,0,drop
63902,445,0,0,70,70,0,1,0,1,0,drop
63901,445,0,0,70,70,0,1,0,1,0,drop
63899,445,0,0,70,70,0,1,0,1,0,drop
63895,445,0,0,70,70,0,1,0,1,0,drop
55429,25174,0,0,66,66,0,1,0,1,0,deny
65025,57866,0,0,66,66,0,1,0,1,0,deny
54758,35993,0,0,66,66,0,1,0,1,0,deny
44154,22114,0,0,62,62,0,1,0,1,0,deny
58646,44847,0,0,66,66,0,1,0,1,0,deny
56205,51505,0,0,66,66,0,1,0,1,0,deny
63883,445,0,0,70,70,0,1,0,1,0,drop
63882,445,0,0,70,70,0,1,0,1,0,drop
63877,445,0,0,70,70,0,1,0,1,0,drop
63873,445,0,0,70,70,0,1,0,1,0,drop
63872,445,0,0,70,70,0,1,0,1,0,drop
52270,445,0,0,70,70,0,1,0,1,0,drop
52269,445,0,0,70,70,0,1,0,1,0,drop
52266,445,0,0,70,70,0,1,0,1,0,drop
45726,64147,0,0,62,62,0,1,0,1,0,deny
22574,44847,0,0,62,62,0,1,0,1,0,deny
64035,445,0,0,66,66,0,1,0,1,0,drop
64038,445,0,0,66,66,0,1,0,1,0,drop
64037,445,0,0,66,66,0,1,0,1,0,drop
64034,445,0,0,66,66,0,1,0,1,0,drop
64039,445,0,0,66,66,0,1,0,1,0,drop
64036,445,0,0,66,66,0,1,0,1,0,drop
64033,445,0,0,66,66,0,1,0,1,0,drop
5955,55160,0,0,74,74,0,1,0,1,0,deny
80,61486,0,0,66,66,0,1,0,1,0,deny
26879,37965,0,0,62,62,0,1,0,1,0,deny
63861,445,0,0,70,70,0,1,0,1,0,drop
6126,25174,0,0,66,66,0,1,0,1,0,deny
52264,445,0,0,70,70,0,1,0,1,0,drop
52263,445,0,0,70,70,0,1,0,1,0,drop
52254,445,0,0,70,70,0,1,0,1,0,drop
52253,445,0,0,70,70,0,1,0,1,0,drop
64017,445,0,0,66,66,0,1,0,1,0,drop
64019,445,0,0,66,66,0,1,0,1,0,drop
64016,445,0,0,66,66,0,1,0,1,0,drop
43025,23,0,0,60,60,0,1,0,1,0,deny
48301,25174,0,0,62,62,0,1,0,1,0,deny
10406,35440,0,0,146,146,0,1,0,1,0,deny
10910,57866,0,0,62,62,0,1,0,1,0,deny
63857,445,0,0,70,70,0,1,0,1,0,drop
54726,30041,0,0,62,62,0,1,0,1,0,deny
52247,445,0,0,70,70,0,1,0,1,0,drop
53097,25174,0,0,66,66,0,1,0,1,0,deny
52683,22114,0,0,62,62,0,1,0,1,0,deny
52240,445,0,0,70,70,0,1,0,1,0,drop
52236,445,0,0,70,70,0,1,0,1,0,drop
52238,445,0,0,70,70,0,1,0,1,0,drop
63855,25174,0,0,62,62,0,1,0,1,0,deny
56387,25174,0,0,66,66,0,1,0,1,0,deny
13235,44847,0,0,62,62,0,1,0,1,0,deny
39313,37965,0,0,62,62,0,1,0,1,0,deny
39453,15503,0,0,74,74,0,1,0,1,0,deny
45964,2228,0,0,60,60,0,1,0,1,0,deny
63846,445,0,0,70,70,0,1,0,1,0,drop
63848,445,0,0,70,70,0,1,0,1,0,drop
63847,445,0,0,70,70,0,1,0,1,0,drop
63843,445,0,0,70,70,0,1,0,1,0,drop
41463,20005,0,0,60,60,0,1,0,1,0,deny
63841,445,0,0,70,70,0,1,0,1,0,drop
35111,22114,0,0,66,66,0,1,0,1,0,deny
64733,35440,0,0,66,66,0,1,0,1,0,deny
51866,22114,0,0,62,62,0,1,0,1,0,deny
61660,64097,0,0,62,62,0,1,0,1,0,deny
28825,23,0,0,60,60,0,1,0,1,0,deny
52228,445,0,0,70,70,0,1,0,1,0,drop
52226,445,0,0,70,70,0,1,0,1,0,drop
29178,35440,0,0,66,66,0,1,0,1,0,deny
47178,53,0,0,82,82,0,2,40,2,0,allow
52108,20175,5769,20175,70,70,0,2,8,2,0,allow
52109,60841,37568,60841,258,70,188,4,8,2,2,allow
53454,443,37572,443,10416,3195,7221,32,46,18,14,allow
52472,443,52472,443,4400,1493,2907,19,31,11,8,allow
63385,443,63385,443,4659,1752,2907,19,30,11,8,allow
61792,443,46504,443,12526,7202,5324,28,99,15,13,allow
9448,443,19728,443,5691,503,5188,14,15,7,7,allow
52076,28895,29171,28895,66,66,0,1,5,1,0,allow
9451,443,45125,443,5699,505,5194,14,15,7,7,allow
40517,53,18726,53,284,79,205,2,30,1,1,allow
64850,53,13429,53,166,85,81,2,31,1,1,allow
38728,443,11034,443,560,280,280,9,27,5,4,allow
62249,443,58132,443,9251,6353,2898,25,120,13,12,allow
61433,443,33532,443,41274,18956,22318,90,171,43,47,allow
36828,80,12290,80,5189,2979,2210,19,136,12,7,allow
47613,53,0,0,82,82,0,1,30,1,0,allow
9460,80,52623,80,1641,483,1158,10,15,5,5,allow
53162,60352,6170,60352,70,70,0,1,5,1,0,allow
58872,443,51853,443,342665,10261,332404,369,90,117,252,allow
52106,41632,7529,41632,70,70,0,2,9,2,0,allow
53876,53380,47868,53380,70,70,0,1,5,1,0,allow
60518,80,21543,80,1915,797,1118,8,16,5,3,allow
52079,1024,39803,1024,66,66,0,1,5,1,0,allow
26227,23,26227,23,146,60,86,2,10,1,1,allow
54104,80,15819,80,214,140,74,4,15,3,1,allow
9454,443,57468,443,5699,505,5194,14,15,7,7,allow
52376,443,24814,443,33906,25094,8812,63,447,36,27,allow
21478,53,21478,53,625,79,546,2,30,1,1,allow
51661,443,59276,443,11558,3964,7594,37,17,15,22,allow
52110,35411,42303,35411,70,70,0,2,8,2,0,allow
50401,443,63156,443,256,136,120,5,9,3,2,allow
53878,55950,30797,55950,70,70,0,1,5,1,0,allow
53875,43611,37582,43611,70,70,0,1,5,1,0,allow
9450,443,24290,443,5691,503,5188,14,15,7,7,allow
9447,443,13084,443,5691,503,5188,14,15,7,7,allow
46570,443,45902,443,8897,2184,6713,24,516,13,11,allow
58953,443,9937,443,4051,2587,1464,18,16,9,9,allow
54314,53,25378,53,284,79,205,2,30,1,1,allow
56782,53,53429,53,194,99,95,2,30,1,1,allow
64942,53,24439,53,522,190,332,5,48,3,2,allow
30960,45763,2134,45763,330,330,0,6,3609,6,0,allow
30960,45752,44974,45752,462,462,0,8,3631,8,0,allow
58930,60038,0,0,66,66,0,1,91,1,0,allow
5060,37965,0,0,66,66,0,1,0,1,0,deny
15806,11392,0,0,66,66,0,1,0,1,0,deny
31539,37965,0,0,62,62,0,1,0,1,0,deny
63834,445,0,0,70,70,0,1,0,1,0,drop
13525,51505,0,0,62,62,0,1,0,1,0,deny
64005,445,0,0,66,66,0,1,0,1,0,drop
54796,22114,0,0,62,62,0,1,0,1,0,deny
3169,22114,0,0,62,62,0,1,0,1,0,deny
57251,37965,0,0,62,62,0,1,0,1,0,deny
51783,50584,0,0,66,66,0,1,0,1,0,deny
59282,51050,0,0,66,66,0,1,0,1,0,deny
58247,57866,0,0,66,66,0,1,0,1,0,deny
57599,80,57241,80,1526,972,554,10,75,6,4,allow
56388,443,22343,443,11093,2322,8771,40,17,23,17,allow
9458,443,4963,443,5695,505,5190,14,15,7,7,allow
64017,80,54075,80,314,192,122,6,15,4,2,allow
12942,10387,0,0,159,159,0,1,0,1,0,deny
56403,51505,0,0,62,62,0,1,0,1,0,deny
62217,37807,0,0,62,62,0,1,0,1,0,deny
63827,445,0,0,70,70,0,1,0,1,0,drop
41694,26296,0,0,145,145,0,1,0,1,0,deny
60113,22114,0,0,66,66,0,1,0,1,0,deny
63824,445,0,0,70,70,0,1,0,1,0,drop
26884,37965,0,0,66,66,0,1,0,1,0,deny
52221,445,0,0,70,70,0,1,0,1,0,drop
27081,10197,0,0,62,62,0,1,0,1,0,deny
59303,21247,0,0,66,66,0,1,0,1,0,deny
16057,51050,0,0,62,62,0,1,0,1,0,deny
60117,50934,0,0,62,62,0,1,0,1,0,deny
52220,445,0,0,70,70,0,1,0,1,0,drop
30332,48817,0,0,145,145,0,1,0,1,0,deny
63819,445,0,0,70,70,0,1,0,1,0,drop
42957,64147,0,0,145,145,0,1,0,1,0,deny
63817,445,0,0,70,70,0,1,0,1,0,drop
63988,445,0,0,66,66,0,1,0,1,0,drop
63989,445,0,0,66,66,0,1,0,1,0,drop
1036,64147,0,0,62,62,0,1,0,1,0,deny
44856,51505,0,0,62,62,0,1,0,1,0,deny
37887,22114,0,0,66,66,0,1,0,1,0,deny
63813,445,0,0,70,70,0,1,0,1,0,drop
44679,80,35749,80,3180,2317,863,12,11,7,5,allow
43815,50584,0,0,62,62,0,1,0,1,0,deny
64595,64147,0,0,62,62,0,1,0,1,0,deny
52210,445,0,0,70,70,0,1,0,1,0,drop
52206,445,0,0,70,70,0,1,0,1,0,drop
52204,445,0,0,70,70,0,1,0,1,0,drop
52198,445,0,0,70,70,0,1,0,1,0,drop
18750,57866,0,0,62,62,0,1,0,1,0,deny
63030,25174,0,0,62,62,0,1,0,1,0,deny
68,67,0,0,346,346,0,1,0,1,0,deny
34066,36829,0,0,146,146,0,1,0,1,0,deny
46734,50265,0,0,74,74,0,1,0,1,0,deny
63812,445,0,0,70,70,0,1,0,1,0,drop
63984,445,0,0,66,66,0,1,0,1,0,drop
16620,25174,0,0,62,62,0,1,0,1,0,deny
42722,56448,0,0,74,74,0,1,0,1,0,deny
1638,22114,0,0,62,62,0,1,0,1,0,deny
63979,445,0,0,66,66,0,1,0,1,0,drop
63976,445,0,0,66,66,0,1,0,1,0,drop
63967,445,0,0,66,66,0,1,0,1,0,drop
63972,445,0,0,66,66,0,1,0,1,0,drop
63971,445,0,0,66,66,0,1,0,1,0,drop
63968,445,0,0,66,66,0,1,0,1,0,drop
63969,445,0,0,66,66,0,1,0,1,0,drop
62194,50584,0,0,66,66,0,1,0,1,0,deny
39583,37965,0,0,66,66,0,1,0,1,0,deny
49993,37965,0,0,66,66,0,1,0,1,0,deny
47783,50432,0,0,62,62,0,1,0,1,0,deny
52196,445,0,0,70,70,0,1,0,1,0,drop
11382,43890,0,0,62,62,0,1,0,1,0,deny
46537,25174,0,0,62,62,0,1,0,1,0,deny
52191,445,0,0,70,70,0,1,0,1,0,drop
52187,445,0,0,70,70,0,1,0,1,0,drop
52189,445,0,0,70,70,0,1,0,1,0,drop
13518,25174,0,0,146,146,0,1,0,1,0,deny
63807,445,0,0,70,70,0,1,0,1,0,drop
11136,19910,0,0,62,62,0,1,0,1,0,deny
55931,53,3407,53,168,78,90,2,30,1,1,allow
64588,53,5541,53,264,102,162,2,30,1,1,allow
52359,443,35892,443,13972,2550,11422,29,954,11,18,allow
56470,28678,7618,28678,1806,1806,0,22,224,22,0,allow
57206,443,4994,443,1798,1223,575,13,28,8,5,allow
65318,53,63246,53,294,94,200,4,51,2,2,allow
56289,53,22157,53,351,110,241,2,29,1,1,allow
56767,443,38617,443,7941,1952,5989,20,15,11,9,allow
35978,443,55185,443,2959,793,2166,10,120,5,5,allow
61807,443,12289,443,6244,1855,4389,16,75,9,7,allow
55144,443,25818,443,6918,2826,4092,26,21,16,10,allow
52082,14804,24933,14804,70,70,0,1,4,1,0,allow
50864,80,3838,80,1888,1814,74,10,15,9,1,allow
56674,80,12315,80,156,156,0,3,8,3,0,allow
60929,28678,34471,28678,1806,1806,0,22,224,22,0,allow
49564,53,13171,53,193,102,91,2,29,1,1,allow
14441,443,20256,443,2629,1470,1159,18,15,8,10,allow
56853,53,24934,53,167,86,81,2,29,1,1,allow
55958,53,30538,53,275,86,189,2,29,1,1,allow
56519,53,20744,53,167,86,81,2,29,1,1,allow
56853,53,30375,53,167,86,81,2,29,1,1,allow
60708,53,53667,53,291,86,205,2,29,1,1,allow
56765,443,7248,443,7940,1951,5989,20,15,11,9,allow
58885,443,39873,443,354,294,60,2,15,1,1,allow
56766,443,55432,443,7888,1899,5989,20,15,11,9,allow
10007,443,53248,443,3811,1846,1965,20,330,9,11,allow
55346,53,15239,53,199,94,105,2,30,1,1,allow
65400,53,61482,53,211,102,109,2,30,1,1,allow
55805,80,55805,80,424,198,226,7,141,4,3,allow
52080,9554,43185,9554,70,70,0,1,5,1,0,allow
51243,80,3228,80,1451,949,502,12,46,7,5,allow
60607,53,60607,53,832,106,726,2,30,1,1,allow
60852,443,55582,443,7471,2914,4557,26,47,15,11,allow
64810,53,30848,53,257,126,131,2,30,1,1,allow
55360,80,13495,80,130,70,60,2,15,1,1,allow
37306,53,55019,53,168,78,90,2,30,1,1,allow
9449,443,11942,443,5693,499,5194,14,15,7,7,allow
49570,443,32958,443,6360,2483,3877,20,16,10,10,allow
54071,53,10458,53,207,86,121,2,30,1,1,allow
58316,443,4061,443,7493,1658,5835,22,255,12,10,allow
38705,443,49826,443,1248170,26899,1221271,1212,16,382,830,allow
56890,443,61166,443,6935,1415,5520,22,186,12,10,allow
49658,53,43401,53,211,102,109,2,30,1,1,allow
57343,443,46945,443,1607664,53945,1553719,1792,39,700,1092,allow
55337,443,21717,443,24341,15170,9171,78,461,39,39,allow
47637,443,16997,443,280,140,140,5,151,3,2,allow
35973,443,21497,443,4665045,113088,4551957,4511,421,1285,3226,allow
48778,80,16126,80,130,70,60,2,15,1,1,allow
33028,80,50046,80,130,70,60,2,15,1,1,allow
49207,443,35553,443,9852,2190,7662,49,257,22,27,allow
28036,443,58065,443,5780,4574,1206,20,16,11,9,allow
36829,443,57108,443,560,280,280,9,27,5,4,allow
38606,53,21514,53,168,78,90,2,30,1,1,allow
48817,50321,48817,50321,334,158,176,2,1203,1,1,allow
50265,443,33031,443,23684,13193,10491,84,63,44,40,allow
49836,53,59050,53,327,102,225,2,30,1,1,allow
65168,53,46023,53,239,94,145,2,30,1,1,allow
60862,443,5299,443,12604,6376,6228,27,133,16,11,allow
50286,443,48730,443,6414386,102255,6312131,5812,182,1634,4178,allow
48992,80,47525,80,1114,534,580,12,16,7,5,allow
22,44840,22,44840,1427,1170,257,8,15,4,4,allow
53903,51339,21513,51339,70,70,0,2,7,2,0,allow
39437,80,3186,80,2088,472,1616,15,155,3,12,allow
55103,53,23177,53,392,92,300,4,55,2,2,allow
56782,53,51814,53,197,102,95,2,33,1,1,allow
9459,443,54316,443,5695,505,5190,14,15,7,7,allow
49279,80,12266,80,254,128,126,5,15,3,2,allow
9453,443,40885,443,5693,499,5194,14,15,7,7,allow
9452,443,55218,443,5693,499,5194,14,15,7,7,allow
56519,53,14326,53,167,86,81,2,29,1,1,allow
21133,54508,26359,54508,323,150,173,2,1199,1,1,allow
57231,53,46027,53,168,86,82,2,30,1,1,allow
9457,443,13669,443,5316,488,4828,14,15,7,7,allow
57202,443,8164,443,1728,1153,575,12,28,7,5,allow
51613,443,47721,443,5052,2873,2179,26,15,14,12,allow
56519,53,28431,53,167,86,81,2,30,1,1,allow
52083,26607,58147,26607,70,70,0,1,4,1,0,allow
57203,443,49091,443,1798,1223,575,13,28,8,5,allow
56672,53,64193,53,177,94,83,2,30,1,1,allow
50442,80,50442,80,52791,4087,48704,66,24,26,40,allow
49564,53,61434,53,193,102,91,2,30,1,1,allow
54497,443,48697,443,8318,2068,6250,32,270,16,16,allow
52925,443,2164,443,114867,4243,110624,128,120,44,84,allow
64850,53,27196,53,167,86,81,2,30,1,1,allow
49661,53,62903,53,344,102,242,2,30,1,1,allow
60376,443,21896,443,9379,2092,7287,21,126,9,12,allow
54761,5228,49627,5228,12683,1205,11478,27,182,8,19,allow
35642,80,28559,80,1849,1015,834,11,150,6,5,allow
35136,443,3606,443,25542,17843,7699,58,59,34,24,allow
61279,443,14356,443,7424,3871,3553,26,160,12,14,allow
51598,443,10892,443,14194,4643,9551,34,30,19,15,allow
53159,58710,30090,58710,698,320,378,10,18,6,4,allow
59274,443,55424,443,8640,2329,6311,19,76,10,9,allow
35999,443,44617,443,670261,26523,643738,728,188,262,466,allow
58954,443,36028,443,5166,700,4466,16,15,7,9,allow
55363,53,15445,53,228,110,118,2,30,1,1,allow
65375,443,53764,443,2458316,102393,2355923,2942,241,1261,1681,allow
50040,53,62872,53,322,102,220,2,30,1,1,allow
64850,53,29250,53,167,86,81,2,30,1,1,allow
64962,53,48454,53,226,94,132,2,30,1,1,allow
56672,53,51134,53,177,94,83,2,30,1,1,allow
36430,443,61120,443,3777,1509,2268,18,120,9,9,allow
40781,443,17024,443,14327,1918,12409,37,270,17,20,allow
53865,64000,37089,64000,492,306,186,8,15,5,3,allow
44636,443,35730,443,6297,1831,4466,20,16,9,11,allow
53161,30013,56221,30013,70,70,0,1,5,1,0,allow
57584,443,14480,443,8937,3934,5003,18,120,9,9,allow
63355,443,59950,443,2870,343,2527,11,120,5,6,allow
55039,443,64407,443,10961,2666,8295,35,237,16,19,allow
56275,443,61048,443,513682,20015,493667,523,226,126,397,allow
50265,7205,64572,7205,1488,930,558,21,1200,12,9,allow
36628,80,54402,80,78,78,0,2,8,2,0,allow
53867,60272,36955,60272,70,70,0,1,5,1,0,allow
55294,3389,55294,3389,4470,2381,2089,23,19,13,10,allow
44162,80,44162,80,457843,10253,447590,452,26,152,300,allow
64593,53,46361,53,258,102,156,2,30,1,1,allow
52042,80,17014,80,70,70,0,2,8,2,0,allow
53871,43266,32431,43266,70,70,0,1,5,1,0,allow
56764,443,62218,443,8006,1986,6020,20,16,11,9,allow
56044,80,25395,80,1515,481,1034,11,16,6,5,allow
42927,443,28678,443,6921,1769,5152,22,24,13,9,allow
64033,29834,57709,29834,66,66,0,2,8,2,0,allow
53872,24710,13948,24710,70,70,0,1,5,1,0,allow
36278,7000,36278,7000,3578,1967,1611,16,16,8,8,allow
42162,80,42162,80,2941,1499,1442,10,16,6,4,allow
64850,53,55584,53,167,86,81,2,30,1,1,allow
59355,51505,0,0,66,66,0,1,0,1,0,deny
56323,57470,0,0,74,74,0,1,0,1,0,deny
37034,25174,0,0,62,62,0,1,0,1,0,deny
51726,64147,0,0,62,62,0,1,0,1,0,deny
2332,35440,0,0,66,66,0,1,0,1,0,deny
52184,445,0,0,70,70,0,1,0,1,0,drop
52183,445,0,0,70,70,0,1,0,1,0,drop
52179,445,0,0,70,70,0,1,0,1,0,drop
52503,50584,0,0,62,62,0,1,0,1,0,deny
10003,64147,0,0,62,62,0,1,0,1,0,deny
63962,445,0,0,66,66,0,1,0,1,0,drop
20586,25174,0,0,62,62,0,1,0,1,0,deny
52178,445,0,0,70,70,0,1,0,1,0,drop
58103,10197,0,0,66,66,0,1,0,1,0,deny
30800,25174,0,0,146,146,0,1,0,1,0,deny
63959,445,0,0,66,66,0,1,0,1,0,drop
63794,445,0,0,70,70,0,1,0,1,0,drop
63957,445,0,0,66,66,0,1,0,1,0,drop
63955,445,0,0,66,66,0,1,0,1,0,drop
59535,25174,0,0,62,62,0,1,0,1,0,deny
54173,23,0,0,60,60,0,1,0,1,0,deny
6666,138,0,0,60,60,0,1,0,1,0,deny
63953,445,0,0,66,66,0,1,0,1,0,drop
63791,445,0,0,70,70,0,1,0,1,0,drop
53902,443,2298,443,499,425,74,4,0,3,1,allow
44714,25174,0,0,146,146,0,1,0,1,0,deny
51455,53733,0,0,66,66,0,1,0,1,0,deny
52494,36237,0,0,62,62,0,1,0,1,0,deny
62579,57866,0,0,66,66,0,1,0,1,0,deny
37666,48817,0,0,146,146,0,1,0,1,0,deny
60579,25174,0,0,66,66,0,1,0,1,0,deny
52176,445,0,0,70,70,0,1,0,1,0,drop
1238,51505,0,0,62,62,0,1,0,1,0,deny
45941,23386,0,0,60,60,0,1,0,1,0,deny
52165,445,0,0,70,70,0,1,0,1,0,drop
52164,445,0,0,70,70,0,1,0,1,0,drop
63787,445,0,0,70,70,0,1,0,1,0,drop
65331,53,50741,53,732,89,643,2,0,1,1,allow
54754,50432,0,0,66,66,0,1,0,1,0,deny
50620,50584,0,0,62,62,0,1,0,1,0,deny
52625,25174,0,0,66,66,0,1,0,1,0,deny
63785,445,0,0,70,70,0,1,0,1,0,drop
60159,22114,0,0,66,66,0,1,0,1,0,deny
31172,22114,0,0,62,62,0,1,0,1,0,deny
63943,445,0,0,66,66,0,1,0,1,0,drop
63783,445,0,0,70,70,0,1,0,1,0,drop
6666,16010,0,0,60,60,0,1,0,1,0,deny
46512,63836,0,0,148,148,0,1,0,1,0,deny
64024,22114,0,0,66,66,0,1,0,1,0,deny
26527,25174,0,0,62,62,0,1,0,1,0,deny
53901,443,43794,443,499,425,74,4,0,3,1,allow
53903,443,40208,443,499,425,74,4,0,3,1,allow
53900,443,15989,443,499,425,74,4,0,3,1,allow
53897,443,53988,443,499,425,74,4,0,3,1,allow
53898,443,56204,443,499,425,74,4,0,3,1,allow
53899,443,57181,443,499,425,74,4,0,3,1,allow
53890,443,45559,443,499,425,74,4,0,3,1,allow
53895,443,53348,443,499,425,74,4,0,3,1,allow
53896,443,17824,443,499,425,74,4,0,3,1,allow
53894,443,56603,443,499,425,74,4,0,3,1,allow
53893,443,15377,443,499,425,74,4,0,3,1,allow
53885,443,38826,443,499,425,74,4,0,3,1,allow
53891,443,8709,443,499,425,74,4,0,3,1,allow
53892,443,6388,443,499,425,74,4,0,3,1,allow
53886,443,40309,443,499,425,74,4,0,3,1,allow
53887,443,39424,443,499,425,74,4,0,3,1,allow
53888,443,38577,443,499,425,74,4,0,3,1,allow
53889,443,11378,443,499,425,74,4,0,3,1,allow
63136,25174,0,0,66,66,0,1,0,1,0,deny
47424,25174,0,0,62,62,0,1,0,1,0,deny
63935,445,0,0,66,66,0,1,0,1,0,drop
52155,445,0,0,70,70,0,1,0,1,0,drop
63776,445,0,0,70,70,0,1,0,1,0,drop
56897,11446,0,0,62,62,0,1,0,1,0,deny
63932,445,0,0,66,66,0,1,0,1,0,drop
63774,445,0,0,70,70,0,1,0,1,0,drop
49918,26296,0,0,146,146,0,1,0,1,0,deny
10704,25174,0,0,62,62,0,1,0,1,0,deny
33556,25174,0,0,62,62,0,1,0,1,0,deny
36011,25174,0,0,66,66,0,1,0,1,0,deny
63773,445,0,0,70,70,0,1,0,1,0,drop
59018,22114,0,0,62,62,0,1,0,1,0,deny
6356,26467,0,0,62,62,0,1,0,1,0,deny
7288,25174,0,0,66,66,0,1,0,1,0,deny
63772,445,0,0,70,70,0,1,0,1,0,drop
63771,445,0,0,70,70,0,1,0,1,0,drop
63926,445,0,0,66,66,0,1,0,1,0,drop
5955,55160,0,0,74,74,0,1,0,1,0,deny
63766,445,0,0,70,70,0,1,0,1,0,drop
63765,445,0,0,70,70,0,1,0,1,0,drop
17982,11392,0,0,62,62,0,1,0,1,0,deny
54526,44847,0,0,62,62,0,1,0,1,0,deny
63918,445,0,0,66,66,0,1,0,1,0,drop
65389,26467,0,0,62,62,0,1,0,1,0,deny
62799,25174,0,0,62,62,0,1,0,1,0,deny
3064,44847,0,0,62,62,0,1,0,1,0,deny
54746,22114,0,0,146,146,0,1,0,1,0,deny
13285,29892,0,0,145,145,0,1,0,1,0,deny
0,0,0,0,400,204,196,4,0,2,2,allow
0,0,0,0,200,102,98,2,0,1,1,allow
0,0,0,0,600,306,294,6,0,3,3,allow
41462,2323,0,0,60,60,0,1,0,1,0,deny
63852,25174,0,0,146,146,0,1,0,1,0,deny
63753,445,0,0,70,70,0,1,0,1,0,drop
63752,445,0,0,70,70,0,1,0,1,0,drop
63749,445,0,0,70,70,0,1,0,1,0,drop
63743,445,0,0,70,70,0,1,0,1,0,drop
63742,445,0,0,70,70,0,1,0,1,0,drop
23939,41615,0,0,146,146,0,1,0,1,0,deny
59937,18375,0,0,66,66,0,1,0,1,0,deny
22783,64147,0,0,66,66,0,1,0,1,0,deny
52142,445,0,0,70,70,0,1,0,1,0,drop
52139,445,0,0,70,70,0,1,0,1,0,drop
52138,445,0,0,70,70,0,1,0,1,0,drop
1377,44847,0,0,62,62,0,1,0,1,0,deny
63901,445,0,0,66,66,0,1,0,1,0,drop
63905,445,0,0,66,66,0,1,0,1,0,drop
63908,445,0,0,66,66,0,1,0,1,0,drop
63907,445,0,0,66,66,0,1,0,1,0,drop
63902,445,0,0,66,66,0,1,0,1,0,drop
63904,445,0,0,66,66,0,1,0,1,0,drop
63903,445,0,0,66,66,0,1,0,1,0,drop
63900,445,0,0,66,66,0,1,0,1,0,drop
30729,22114,0,0,66,66,0,1,0,1,0,deny
59523,37965,0,0,62,62,0,1,0,1,0,deny
59060,50584,0,0,66,66,0,1,0,1,0,deny
52744,25174,0,0,62,62,0,1,0,1,0,deny
51615,25174,0,0,66,66,0,1,0,1,0,deny
14777,25174,0,0,62,62,0,1,0,1,0,deny
63731,445,0,0,70,70,0,1,0,1,0,drop
25532,35440,0,0,146,146,0,1,0,1,0,deny
15176,62413,0,0,62,62,0,1,0,1,0,deny
50236,25174,0,0,66,66,0,1,0,1,0,deny
52134,445,0,0,70,70,0,1,0,1,0,drop
52133,445,0,0,70,70,0,1,0,1,0,drop
52131,445,0,0,70,70,0,1,0,1,0,drop
52122,445,0,0,70,70,0,1,0,1,0,drop
48230,22114,0,0,146,146,0,1,0,1,0,deny
54914,51505,0,0,66,66,0,1,0,1,0,deny
10091,22114,0,0,62,62,0,1,0,1,0,deny
45964,2228,0,0,60,60,0,1,0,1,0,deny
59668,50584,0,0,62,62,0,1,0,1,0,deny
63886,445,0,0,66,66,0,1,0,1,0,drop
63885,445,0,0,66,66,0,1,0,1,0,drop
63884,445,0,0,66,66,0,1,0,1,0,drop
54976,15503,0,0,66,66,0,1,0,1,0,deny
13588,15503,0,0,62,62,0,1,0,1,0,deny
63727,445,0,0,70,70,0,1,0,1,0,drop
2346,25174,0,0,66,66,0,1,0,1,0,deny
443,63128,0,0,1514,1514,0,1,0,1,0,deny
52118,445,0,0,70,70,0,1,0,1,0,drop
50265,49893,64996,49893,480,149,331,2,1200,1,1,allow
50774,443,17270,443,4521,2256,2265,15,135,7,8,allow
36644,443,15948,443,9329,3935,5394,30,405,17,13,allow
49531,80,57829,80,78,78,0,1,5,1,0,allow
65421,443,16177,443,2494,1643,851,17,25,9,8,allow
52072,25595,16816,25595,66,66,0,1,5,1,0,allow
54941,80,51171,80,2513,567,1946,10,75,6,4,allow
59893,80,45322,80,130,70,60,2,15,1,1,allow
57410,53,64082,53,711,87,624,2,30,1,1,allow
58871,443,24562,443,405189,13572,391617,446,89,155,291,allow
9434,443,11212,443,5693,499,5194,14,15,7,7,allow
56082,53,58517,53,271,88,183,4,38,2,2,allow
53896,48027,7654,48027,70,70,0,2,8,2,0,allow
49158,443,4149,443,3655,1807,1848,17,15,9,8,allow
56467,53,49050,53,578,286,292,9,15,5,4,allow
56937,53,51825,53,178,91,87,2,30,1,1,allow
52104,51756,27820,51756,70,70,0,2,8,2,0,allow
54542,443,54542,443,150554,18764,131790,192,117,95,97,allow
46618,443,48794,443,9505,3214,6291,33,19,19,14,allow
39568,443,60001,443,4477,2605,1872,22,248,12,10,allow
55542,53,5716,53,170,87,83,2,30,1,1,allow
53862,36120,51667,36120,2254,1281,973,17,17,10,7,allow
45273,80,45273,80,18685,7141,11544,33,28,17,16,allow
62394,80,62394,80,29401,10036,19365,49,28,24,25,allow
9435,443,2463,443,5693,499,5194,14,15,7,7,allow
64117,53,64117,53,209,77,132,2,32,1,1,allow
57231,53,16422,53,168,86,82,2,31,1,1,allow
40806,443,37490,443,3287,2049,1238,12,31,7,5,allow
54942,80,32519,80,5696,703,4993,14,75,8,6,allow
63995,443,63995,443,4673,1766,2907,19,29,11,8,allow
46720,53,0,0,82,82,0,1,30,1,0,allow
47992,5228,27773,5228,2988,2036,952,16,3601,8,8,allow
54800,443,4050,443,9612,4324,5288,31,400,11,20,allow
49146,443,34396,443,3655,1807,1848,17,15,9,8,allow
56440,53,9792,53,711,87,624,2,31,1,1,allow
53894,2944,4121,2944,70,70,0,2,8,2,0,allow
17750,7579,37146,7579,490,149,341,2,1200,1,1,allow
52102,19604,10302,19604,70,70,0,2,8,2,0,allow
59952,80,58096,80,440081,8465,431616,424,24,137,287,allow
59000,443,15029,443,6362,1745,4617,25,18,13,12,allow
49341,443,6648,443,6882,1788,5094,15,16,9,6,allow
64034,17935,14010,17935,66,66,0,2,8,2,0,allow
9436,443,44079,443,5693,499,5194,14,15,7,7,allow
51076,443,8592,443,19880,4739,15141,58,187,26,32,allow
8282,25916,26002,25916,133,64,69,3,33,2,1,allow
57164,443,51715,443,522,78,444,8,22,2,6,allow
53870,24535,51626,24535,70,70,0,1,5,1,0,allow
59964,443,4370,443,48525,4928,43597,111,660,55,56,allow
53012,443,30523,443,4073,2039,2034,14,135,7,7,allow
45230,443,23452,443,33924,26047,7877,73,403,33,40,allow
48817,11602,48817,11602,152,152,0,1,1200,1,0,allow
48817,57451,48817,57451,152,152,0,1,1200,1,0,allow
56230,5228,8322,5228,2564,1546,1018,18,3600,9,9,allow
64691,25320,0,0,62,62,0,1,0,1,0,deny
63716,445,0,0,70,70,0,1,0,1,0,drop
63718,445,0,0,70,70,0,1,0,1,0,drop
63717,445,0,0,70,70,0,1,0,1,0,drop
55554,22114,0,0,146,146,0,1,0,1,0,deny
52117,445,0,0,70,70,0,1,0,1,0,drop
52110,445,0,0,70,70,0,1,0,1,0,drop
52109,445,0,0,70,70,0,1,0,1,0,drop
5228,3434,0,0,345,345,0,1,0,1,0,deny
63714,445,0,0,70,70,0,1,0,1,0,drop
63711,445,0,0,70,70,0,1,0,1,0,drop
51979,25174,0,0,66,66,0,1,0,1,0,deny
1847,64147,0,0,66,66,0,1,0,1,0,deny
59773,5900,0,0,60,60,0,1,0,1,0,deny
58022,8112,0,0,60,60,0,1,0,1,0,deny
41970,23,0,0,60,60,0,1,0,1,0,deny
6980,25604,0,0,100,100,0,1,0,1,0,deny
53207,50584,0,0,66,66,0,1,0,1,0,deny
57834,80,57834,80,2106,1657,449,10,20,6,4,allow
63704,445,0,0,70,70,0,1,0,1,0,drop
1537,22114,0,0,62,62,0,1,0,1,0,deny
52112,22114,0,0,66,66,0,1,0,1,0,deny
6881,6881,0,0,146,146,0,1,0,1,0,deny
52101,445,0,0,70,70,0,1,0,1,0,drop
52098,445,0,0,70,70,0,1,0,1,0,drop
52096,445,0,0,70,70,0,1,0,1,0,drop
5790,43890,0,0,62,62,0,1,0,1,0,deny
43260,41615,0,0,145,145,0,1,0,1,0,deny
63873,445,0,0,66,66,0,1,0,1,0,drop
56711,25174,0,0,62,62,0,1,0,1,0,deny
18116,37807,0,0,66,66,0,1,0,1,0,deny
38099,11392,0,0,62,62,0,1,0,1,0,deny
63697,445,0,0,70,70,0,1,0,1,0,drop
55425,37965,0,0,66,66,0,1,0,1,0,deny
49370,11392,0,0,66,66,0,1,0,1,0,deny
29884,25174,0,0,146,146,0,1,0,1,0,deny
63696,445,0,0,70,70,0,1,0,1,0,drop
34028,443,47575,443,7804,1583,6221,26,981,13,13,allow
58952,443,55046,443,5166,700,4466,16,15,7,9,allow
50041,443,48278,443,7924,1798,6126,26,15,14,12,allow
25833,53,31276,53,404,261,143,3,30,2,1,allow
32805,443,65246,443,438124,21529,416595,481,398,138,343,allow
30188,51419,27819,51419,502,150,352,2,1200,1,1,allow
64029,38651,56654,38651,66,66,0,2,7,2,0,allow
53898,12172,10905,12172,70,70,0,2,7,2,0,allow
53868,52706,53464,52706,70,70,0,1,4,1,0,allow
49781,53,35337,53,254,102,152,2,29,1,1,allow
50405,443,58184,443,612,280,332,10,26,5,5,allow
53873,52055,19487,52055,70,70,0,1,4,1,0,allow
54819,443,17467,443,70,70,0,1,4,1,0,allow
52078,15518,32282,15518,70,70,0,1,4,1,0,allow
60514,80,54084,80,1641,944,697,9,15,5,4,allow
50474,443,49167,443,17449456,390704,17058752,16816,383,4917,11899,allow
50584,51413,41920,51413,475,150,325,2,1200,1,1,allow
44680,80,65456,80,1658,922,736,10,17,6,4,allow
38704,443,15370,443,90097,3289,86808,93,15,28,65,allow
53899,45682,27773,45682,70,70,0,2,7,2,0,allow
52105,1024,36023,1024,70,70,0,2,7,2,0,allow
52077,51638,8361,51638,70,70,0,1,4,1,0,allow
54813,443,48795,443,1633,819,814,16,40,8,8,allow
56737,80,46127,80,194,128,66,4,25,3,1,allow
53869,17089,38908,17089,70,70,0,1,4,1,0,allow
55542,53,10496,53,177,94,83,2,29,1,1,allow
55130,27046,9695,27046,1798,1386,412,8,29,4,4,allow
34692,53,2143,53,271,102,169,2,30,1,1,allow
51913,443,46255,443,13337,10008,3329,47,185,23,24,allow
50671,80,18183,80,1658,1247,411,8,15,5,3,allow
56937,53,49569,53,181,94,87,2,33,1,1,allow
49773,80,31365,80,70,70,0,1,5,1,0,allow
28015,443,63063,443,6435,1089,5346,18,75,9,9,allow
28014,443,49655,443,6435,1089,5346,18,75,9,9,allow
28012,443,23129,443,6388,1112,5276,18,75,9,9,allow
50177,443,50177,443,5206,1389,3817,22,15,10,12,allow
53373,64147,0,0,66,66,0,1,0,1,0,deny
52093,445,0,0,70,70,0,1,0,1,0,drop
52090,445,0,0,70,70,0,1,0,1,0,drop
55951,30188,0,0,66,66,0,1,0,1,0,deny
30654,51221,0,0,72,72,0,1,0,1,0,deny
63690,445,0,0,70,70,0,1,0,1,0,drop
51077,443,6425,443,2997,1906,1091,29,186,17,12,allow
49558,53,42255,53,350,93,257,4,42,2,2,allow
46295,443,56188,443,7493,3793,3700,40,109,26,14,allow
56322,80,56322,80,27189,4515,22674,34,23,14,20,allow
56763,443,10844,443,8058,2038,6020,20,15,11,9,allow
33304,443,15471,443,1067,650,417,10,73,6,4,allow
41501,80,33952,80,306627,58973,247654,556,297,246,310,allow
36983,80,52569,80,130,70,60,2,15,1,1,allow
62353,80,60521,80,2895,771,2124,12,24,6,6,allow
34436,443,8261,443,9083,2087,6996,28,18,16,12,allow
65386,53,35268,53,197,102,95,2,33,1,1,allow
65507,53,1633,53,177,94,83,2,30,1,1,allow
55542,53,62446,53,177,94,83,2,30,1,1,allow
41640,8080,50397,8080,78,78,0,2,8,2,0,allow
53450,443,34036,443,10139,3656,6483,29,128,14,15,allow
49428,53,23705,53,200,94,106,2,30,1,1,allow
50484,443,37149,443,30475,26737,3738,62,26,35,27,allow
58966,443,39805,443,8209,2174,6035,25,210,12,13,allow
49994,80,9515,80,2618,591,2027,11,16,6,5,allow
57832,443,1165,443,91134,7506,83628,132,130,52,80,allow
48817,36292,48817,36292,519,158,361,2,1200,1,1,allow
65507,443,3045,443,453047,13340,439707,469,16,165,304,allow
50469,443,45578,443,19063941,342071,18721870,17124,384,4119,13005,allow
49996,80,14871,80,3007,604,2403,11,15,6,5,allow
56762,443,61918,443,8005,1985,6020,20,15,11,9,allow
49730,53,34301,53,539,100,439,4,54,2,2,allow
40587,53,36507,53,271,102,169,2,30,1,1,allow
57308,53,39831,53,302,110,192,2,30,1,1,allow
62246,443,21397,443,117314,4775,112539,144,120,51,93,allow
50656,80,17387,80,318,192,126,6,25,4,2,allow
56082,53,15374,53,271,88,183,4,37,2,2,allow
49634,53,57122,53,718,94,624,2,30,1,1,allow
55040,443,2837,443,8558,1869,6689,31,236,14,17,allow
37965,63728,43778,63728,1294,594,700,20,1781,10,10,allow
56483,443,20342,443,6463,3844,2619,39,135,21,18,allow
44847,9912,37796,9912,502,150,352,2,1200,1,1,allow
50462,443,22628,443,14264,4441,9823,74,386,38,36,allow
35991,443,8225,443,2509208,64544,2444664,2429,304,700,1729,allow
41336,443,51571,443,350,210,140,6,30,4,2,allow
48854,443,38265,443,2497156,63601,2433555,2465,17,852,1613,allow
52107,11191,13712,11191,70,70,0,2,7,2,0,allow
52075,37919,16771,37919,70,70,0,1,4,1,0,allow
52074,57947,9698,57947,70,70,0,1,5,1,0,allow
9433,443,31139,443,3299,441,2858,11,15,6,5,allow
56484,443,2923,443,1857,1218,639,18,135,11,7,allow
28013,443,29765,443,6130,1264,4866,18,75,9,9,allow
53895,36849,56387,36849,70,70,0,2,7,2,0,allow
56671,80,31736,80,234,234,0,4,12,4,0,allow
52252,443,52252,443,221672,9306,212366,249,21,97,152,allow
52073,16316,63189,16316,70,70,0,1,5,1,0,allow
49995,80,2817,80,2669,604,2065,11,16,6,5,allow
49993,443,14877,443,14857,1138,13719,26,17,10,16,allow
65508,443,2648,443,92884,4939,87945,111,16,45,66,allow
34215,443,33625,443,5341,1386,3955,19,649,11,8,allow
56736,80,11534,80,194,128,66,4,25,3,1,allow
41670,80,41670,80,3571,2892,679,13,23,8,5,allow
58715,80,58715,80,5140,4161,979,17,28,10,7,allow
38130,443,8733,443,717020,36766,680254,939,60,449,490,allow
65331,53,14108,53,308,102,206,2,30,1,1,allow
64687,53,30992,53,495,109,386,4,53,2,2,allow
56734,80,64954,80,194,128,66,4,25,3,1,allow
52020,80,52020,80,6764,5555,1209,20,28,12,8,allow
46456,443,58612,443,4921,2134,2787,21,95,10,11,allow
64458,53,4904,53,292,102,190,2,30,1,1,allow
55542,53,50778,53,177,94,83,2,30,1,1,allow
65293,53,50670,53,94,94,0,1,30,1,0,allow
10075,53,26138,53,229,86,143,2,30,1,1,allow
64981,27068,50495,27068,1680,1386,294,7,30,4,3,allow
52474,123,6683,123,184,94,90,2,30,1,1,allow
65507,53,62722,53,177,94,83,2,30,1,1,allow
33694,443,52274,443,18876,16514,2362,43,95,24,19,allow
50482,443,33515,443,6904692,144860,6759832,6483,140,1783,4700,allow
56735,80,63370,80,194,128,66,4,25,3,1,allow
50650,443,2408,443,9741,7503,2238,24,32,14,10,allow
52112,53559,37444,53559,316,136,180,6,6,3,3,allow
9421,443,1496,443,5699,505,5194,14,15,7,7,allow
48970,80,48970,80,24303,4898,19405,40,28,21,19,allow
42420,443,29433,443,8616,2683,5933,30,459,15,15,allow
55019,443,26461,443,6866,1983,4883,23,330,11,12,allow
54432,53,45895,53,168,78,90,2,30,1,1,allow
38649,443,32676,443,13463,5427,8036,24,121,11,13,allow
50634,80,58631,80,25670,13514,12156,46,36,21,25,allow
56082,53,31858,53,271,88,183,4,37,2,2,allow
49997,80,20317,80,2863,604,2259,11,15,6,5,allow
44992,80,44992,80,2091,1642,449,10,20,6,4,allow
38385,443,54542,443,5304,1112,4192,19,31,10,9,allow
60439,53,58321,53,70,70,0,1,30,1,0,allow
39236,80,55447,80,190,70,120,4,16,2,2,allow
49349,443,17096,443,5282,1090,4192,17,25,10,7,allow
54503,443,54503,443,157452,26878,130574,213,214,111,102,allow
33305,443,50193,443,1067,650,417,10,73,6,4,allow
52103,7172,64684,7172,70,70,0,2,7,2,0,allow
53160,39001,43902,39001,70,70,0,1,5,1,0,allow
52071,57491,38679,57491,70,70,0,1,5,1,0,allow
58950,443,1545,443,5108,700,4408,15,15,7,8,allow
50262,443,64245,443,11220,726,10494,18,75,8,10,allow
49498,53,33432,53,211,102,109,2,30,1,1,allow
56213,53,25430,53,168,78,90,2,30,1,1,allow
56274,53,38501,53,177,94,83,2,30,1,1,allow
57903,443,20952,443,4823,708,4115,19,240,6,13,allow
47636,443,43225,443,5921,1018,4903,21,150,11,10,allow
58685,443,52844,443,165763,5072,160691,181,120,61,120,allow
57470,1073,4669,1073,402,132,270,6,1209,3,3,allow
56082,53,50090,53,271,88,183,4,38,2,2,allow
52069,53446,32796,53446,70,70,0,1,5,1,0,allow
51558,443,41569,443,254,70,184,5,22,2,3,allow
58822,443,40826,443,3594,1787,1807,31,163,17,14,allow
52250,443,52250,443,162355,8745,153610,178,22,66,112,allow
56588,443,17428,443,15450,6149,9301,106,177,47,59,allow
65359,53,37489,53,210,102,108,2,30,1,1,allow
55232,53,52840,53,177,94,83,2,30,1,1,allow
49835,53,10267,53,199,94,105,2,31,1,1,allow
53890,23310,52916,23310,70,70,0,2,8,2,0,allow
52931,443,65247,443,8519,1687,6832,29,17,16,13,allow
22274,53,9607,53,278,78,200,2,30,1,1,allow
61417,443,25149,443,652760,608740,44020,734,432,496,238,allow
44068,443,30325,443,3947,1744,2203,16,361,8,8,allow
52329,443,64562,443,294025,14919,279106,401,42,192,209,allow
42386,443,56294,443,12516,2906,9610,41,427,17,24,allow
52424,443,16403,443,10070,5084,4986,41,16,24,17,allow
60796,40010,42755,40010,316,136,180,6,7,3,3,allow
60464,11385,6156,11385,1090,712,378,16,26,10,6,allow
52099,28401,4027,28401,70,70,0,2,8,2,0,allow
52100,54130,10499,54130,70,70,0,2,8,2,0,allow
45844,80,40841,80,152,78,74,2,5,1,1,allow
33829,443,29338,443,568,222,346,9,26,4,5,allow
16057,56205,0,0,62,62,0,1,0,1,0,deny
37647,36237,0,0,62,62,0,1,0,1,0,deny
64077,25174,0,0,66,66,0,1,0,1,0,deny
63689,445,0,0,70,70,0,1,0,1,0,drop
55079,25174,0,0,66,66,0,1,0,1,0,deny
52557,44847,0,0,62,62,0,1,0,1,0,deny
63860,445,0,0,66,66,0,1,0,1,0,drop
63855,445,0,0,66,66,0,1,0,1,0,drop
63245,26296,0,0,159,159,0,1,0,1,0,deny
59587,25174,0,0,62,62,0,1,0,1,0,deny
51966,25174,0,0,62,62,0,1,0,1,0,deny
27505,25174,0,0,62,62,0,1,0,1,0,deny
61635,37965,0,0,66,66,0,1,0,1,0,deny
63685,445,0,0,70,70,0,1,0,1,0,drop
7048,25174,0,0,66,66,0,1,0,1,0,deny
52083,445,0,0,70,70,0,1,0,1,0,drop
52080,445,0,0,70,70,0,1,0,1,0,drop
52076,445,0,0,70,70,0,1,0,1,0,drop
52072,445,0,0,70,70,0,1,0,1,0,drop
63684,445,0,0,70,70,0,1,0,1,0,drop
23331,25174,0,0,62,62,0,1,0,1,0,deny
13062,52274,0,0,66,66,0,1,0,1,0,deny
63852,445,0,0,66,66,0,1,0,1,0,drop
50651,25174,0,0,146,146,0,1,0,1,0,deny
22916,25174,0,0,146,146,0,1,0,1,0,deny
63838,445,0,0,66,66,0,1,0,1,0,drop
63847,445,0,0,66,66,0,1,0,1,0,drop
63844,445,0,0,66,66,0,1,0,1,0,drop
63841,445,0,0,66,66,0,1,0,1,0,drop
63843,445,0,0,66,66,0,1,0,1,0,drop
63839,445,0,0,66,66,0,1,0,1,0,drop
63846,445,0,0,66,66,0,1,0,1,0,drop
30574,64147,0,0,62,62,0,1,0,1,0,deny
32970,64147,0,0,145,145,0,1,0,1,0,deny
63679,445,0,0,70,70,0,1,0,1,0,drop
56581,25174,0,0,146,146,0,1,0,1,0,deny
52067,445,0,0,70,70,0,1,0,1,0,drop
49415,22114,0,0,62,62,0,1,0,1,0,deny
60311,30627,0,0,66,66,0,1,0,1,0,deny
52060,445,0,0,70,70,0,1,0,1,0,drop
52063,445,0,0,70,70,0,1,0,1,0,drop
52059,445,0,0,70,70,0,1,0,1,0,drop
54666,36237,0,0,66,66,0,1,0,1,0,deny
65233,23117,0,0,66,66,0,1,0,1,0,deny
24301,6881,0,0,62,62,0,1,0,1,0,deny
57164,50584,0,0,62,62,0,1,0,1,0,deny
63213,35440,0,0,62,62,0,1,0,1,0,deny
2083,25174,0,0,146,146,0,1,0,1,0,deny
5830,22114,0,0,66,66,0,1,0,1,0,deny
31683,35440,0,0,62,62,0,1,0,1,0,deny
52056,445,0,0,70,70,0,1,0,1,0,drop
52053,445,0,0,70,70,0,1,0,1,0,drop
52052,445,0,0,70,70,0,1,0,1,0,drop
64509,9571,0,0,62,62,0,1,0,1,0,deny
63666,445,0,0,70,70,0,1,0,1,0,drop
58627,64097,0,0,66,66,0,1,0,1,0,deny
63830,445,0,0,66,66,0,1,0,1,0,drop
52050,445,0,0,70,70,0,1,0,1,0,drop
50084,26672,0,0,62,62,0,1,0,1,0,deny
63827,445,0,0,66,66,0,1,0,1,0,drop
35657,48637,0,0,62,62,0,1,0,1,0,deny
63663,445,0,0,70,70,0,1,0,1,0,drop
63826,445,0,0,66,66,0,1,0,1,0,drop
63824,445,0,0,66,66,0,1,0,1,0,drop
36679,41864,0,0,148,148,0,1,0,1,0,deny
12527,50584,0,0,62,62,0,1,0,1,0,deny
63823,445,0,0,66,66,0,1,0,1,0,drop
47943,50584,0,0,74,74,0,1,0,1,0,deny
62550,51505,0,0,66,66,0,1,0,1,0,deny
55199,21247,0,0,62,62,0,1,0,1,0,deny
52045,445,0,0,70,70,0,1,0,1,0,drop
63658,445,0,0,70,70,0,1,0,1,0,drop
21606,80,0,0,60,60,0,1,0,1,0,deny
63657,445,0,0,70,70,0,1,0,1,0,drop
52039,445,0,0,70,70,0,1,0,1,0,drop
52036,445,0,0,70,70,0,1,0,1,0,drop
38755,22114,0,0,66,66,0,1,0,1,0,deny
63655,445,0,0,70,70,0,1,0,1,0,drop
55144,30188,0,0,66,66,0,1,0,1,0,deny
63811,445,0,0,66,66,0,1,0,1,0,drop
27995,22114,0,0,62,62,0,1,0,1,0,deny
2427,25174,0,0,62,62,0,1,0,1,0,deny
61382,25174,0,0,66,66,0,1,0,1,0,deny
17097,62413,0,0,62,62,0,1,0,1,0,deny
1074,25174,0,0,146,146,0,1,0,1,0,deny
47910,7454,0,0,60,60,0,1,0,1,0,deny
4706,36237,0,0,146,146,0,1,0,1,0,deny
443,38956,0,0,82,82,0,1,0,1,0,deny
17280,22114,0,0,146,146,0,1,0,1,0,deny
63804,445,0,0,66,66,0,1,0,1,0,drop
52024,445,0,0,70,70,0,1,0,1,0,drop
57860,23,0,0,60,60,0,1,0,1,0,deny
63648,445,0,0,70,70,0,1,0,1,0,drop
45682,37965,0,0,145,145,0,1,0,1,0,deny
52492,37965,0,0,66,66,0,1,0,1,0,deny
63832,25174,0,0,62,62,0,1,0,1,0,deny
0,0,0,0,244,244,0,2,0,2,0,allow
63646,445,0,0,70,70,0,1,0,1,0,drop
55116,7574,0,0,66,66,0,1,0,1,0,deny
5222,27389,0,0,66,66,0,1,0,1,0,deny
63802,445,0,0,66,66,0,1,0,1,0,drop
63645,445,0,0,70,70,0,1,0,1,0,drop
27110,22114,0,0,62,62,0,1,0,1,0,deny
33359,30188,0,0,62,62,0,1,0,1,0,deny
63644,445,0,0,70,70,0,1,0,1,0,drop
63643,445,0,0,70,70,0,1,0,1,0,drop
63640,445,0,0,70,70,0,1,0,1,0,drop
63639,445,0,0,70,70,0,1,0,1,0,drop
7000,23117,0,0,62,62,0,1,0,1,0,deny
63795,445,0,0,66,66,0,1,0,1,0,drop
54618,5900,0,0,60,60,0,1,0,1,0,deny
21542,57470,0,0,74,74,0,1,0,1,0,deny
63787,445,0,0,66,66,0,1,0,1,0,drop
14438,51505,0,0,146,146,0,1,0,1,0,deny
41210,23,0,0,60,60,0,1,0,1,0,deny
11876,22,0,0,60,60,0,1,0,1,0,deny
32132,25174,0,0,66,66,0,1,0,1,0,deny
63625,445,0,0,70,70,0,1,0,1,0,drop
63624,445,0,0,70,70,0,1,0,1,0,drop
63621,445,0,0,70,70,0,1,0,1,0,drop
33886,52255,0,0,162,162,0,1,0,1,0,deny
63614,445,0,0,70,70,0,1,0,1,0,drop
63615,445,0,0,70,70,0,1,0,1,0,drop
42344,48637,0,0,60,60,0,1,0,1,0,deny
27038,51505,0,0,62,62,0,1,0,1,0,deny
26531,25174,0,0,62,62,0,1,0,1,0,deny
26531,37965,0,0,62,62,0,1,0,1,0,deny
51755,5900,0,0,60,60,0,1,0,1,0,deny
52014,445,0,0,70,70,0,1,0,1,0,drop
52012,445,0,0,70,70,0,1,0,1,0,drop
52010,445,0,0,70,70,0,1,0,1,0,drop
57337,64147,0,0,66,66,0,1,0,1,0,deny
2074,32480,0,0,146,146,0,1,0,1,0,deny
63775,445,0,0,66,66,0,1,0,1,0,drop
63771,445,0,0,66,66,0,1,0,1,0,drop
63778,445,0,0,66,66,0,1,0,1,0,drop
63776,445,0,0,66,66,0,1,0,1,0,drop
63779,445,0,0,66,66,0,1,0,1,0,drop
63772,445,0,0,66,66,0,1,0,1,0,drop
63773,445,0,0,66,66,0,1,0,1,0,drop
63777,445,0,0,66,66,0,1,0,1,0,drop
51413,1,0,0,72,72,0,1,0,1,0,deny
54140,17372,0,0,66,66,0,1,0,1,0,deny
47040,25174,0,0,62,62,0,1,0,1,0,deny
63603,445,0,0,70,70,0,1,0,1,0,drop
34932,38608,0,0,62,62,0,1,0,1,0,deny
18086,25174,0,0,62,62,0,1,0,1,0,deny
54280,3396,0,0,60,60,0,1,0,1,0,deny
25871,53,25871,53,266,72,194,2,30,1,1,allow
39186,53,39186,53,371,237,134,3,33,2,1,allow
35201,443,64123,443,291,171,120,4,15,2,2,allow
50729,443,32293,443,10440,3521,6919,42,119,20,22,allow
56354,53,56354,53,214,97,117,2,30,1,1,allow
37906,443,56891,443,11293,3979,7314,29,125,17,12,allow
50727,443,38985,443,26161,3618,22543,80,119,31,49,allow
49665,53,35069,53,168,86,82,2,32,1,1,allow
60480,60519,7495,60519,320,140,180,6,8,3,3,allow
49206,443,56721,443,7875,1817,6058,41,255,19,22,allow
50598,80,50598,80,10463,6606,3857,36,27,20,16,allow
61509,443,47638,443,1506,984,522,14,27,8,6,allow
50574,80,15293,80,61763,2941,58822,75,135,33,42,allow
26852,443,37860,443,6701,2064,4637,19,19,9,10,allow
59652,443,50919,443,562,562,0,4,175,4,0,allow
38019,443,55149,443,884,464,420,13,28,7,6,allow
55014,443,4277,443,4962,1352,3610,19,135,9,10,allow
65003,27046,30438,27046,1749,924,825,6,31,3,3,allow
56303,53,13622,53,170,87,83,2,30,1,1,allow
61964,443,61964,443,4378,1471,2907,19,30,11,8,allow
58997,443,39971,443,3576,2319,1257,21,23,11,10,allow
64455,53,64455,53,257,101,156,2,33,1,1,allow
50602,80,50602,80,7596,5063,2533,28,27,16,12,allow
28557,53,28557,53,213,79,134,2,32,1,1,allow
49104,443,34299,443,7424,2381,5043,24,18,13,11,allow
60479,53928,50197,53928,70,70,0,2,8,2,0,allow
50305,443,11776,443,3325,1851,1474,19,16,9,10,allow
60481,40075,5787,40075,70,70,0,2,8,2,0,allow
64343,53,64343,53,216,98,118,2,30,1,1,allow
53858,6889,25438,6889,372,186,186,6,16,3,3,allow
44319,443,43736,443,13919,3349,10570,46,120,25,21,allow
53893,11344,37839,11344,70,70,0,2,8,2,0,allow
53860,33791,1451,33791,492,306,186,8,16,5,3,allow
40650,443,51106,443,7298,2661,4637,21,17,11,10,allow
65047,53,45819,53,206,91,115,2,30,1,1,allow
58999,443,30350,443,2687,1593,1094,20,20,11,9,allow
57870,7635,57870,7635,138,78,60,2,6,1,1,allow
49357,80,5006,80,3014,1052,1962,14,97,9,5,allow
52866,443,59183,443,3101,801,2300,13,136,6,7,allow
56737,53,36153,53,817,98,719,2,31,1,1,allow
63917,443,22910,443,9043,5948,3095,31,121,15,16,allow
35719,443,27839,443,9736,4347,5389,23,361,11,12,allow
65165,53,27998,53,783,96,687,2,31,1,1,allow
55193,53,60056,53,170,87,83,2,31,1,1,allow
63294,443,54054,443,9929,4574,5355,29,134,14,15,allow
59786,25174,0,0,62,62,0,1,0,1,0,deny
45202,23,0,0,60,60,0,1,0,1,0,deny
18086,25174,0,0,146,146,0,1,0,1,0,deny
52007,445,0,0,70,70,0,1,0,1,0,drop
52006,445,0,0,70,70,0,1,0,1,0,drop
52001,445,0,0,70,70,0,1,0,1,0,drop
51998,445,0,0,70,70,0,1,0,1,0,drop
54473,37807,0,0,66,66,0,1,0,1,0,deny
63599,445,0,0,70,70,0,1,0,1,0,drop
63756,445,0,0,66,66,0,1,0,1,0,drop
63758,445,0,0,66,66,0,1,0,1,0,drop
63755,445,0,0,66,66,0,1,0,1,0,drop
60954,443,45270,443,62583,3743,58840,88,32,40,48,allow
9230,443,20303,443,6020,792,5228,18,25,9,9,allow
64814,53,31747,53,565,215,350,6,37,3,3,allow
21424,53,21424,53,225,90,135,2,29,1,1,allow
59985,443,35984,443,55132,17147,37985,126,150,55,71,allow
57131,35776,0,0,145,145,0,1,0,1,0,deny
48676,53389,0,0,60,60,0,1,0,1,0,deny
38581,22114,0,0,62,62,0,1,0,1,0,deny
38581,22114,0,0,146,146,0,1,0,1,0,deny
35937,25174,0,0,66,66,0,1,0,1,0,deny
63588,445,0,0,70,70,0,1,0,1,0,drop
63589,445,0,0,70,70,0,1,0,1,0,drop
63590,445,0,0,70,70,0,1,0,1,0,drop
57220,26467,0,0,62,62,0,1,0,1,0,deny
62512,25174,0,0,62,62,0,1,0,1,0,deny
63584,445,0,0,70,70,0,1,0,1,0,drop
63582,445,0,0,70,70,0,1,0,1,0,drop
2062,35440,0,0,66,66,0,1,0,1,0,deny
51985,445,0,0,70,70,0,1,0,1,0,drop
51984,445,0,0,70,70,0,1,0,1,0,drop
51981,445,0,0,70,70,0,1,0,1,0,drop
11228,25174,0,0,66,66,0,1,0,1,0,deny
10547,57470,0,0,62,62,0,1,0,1,0,deny
65212,22114,0,0,146,146,0,1,0,1,0,deny
55678,32468,0,0,66,66,0,1,0,1,0,deny
29471,57470,0,0,145,145,0,1,0,1,0,deny
63576,445,0,0,70,70,0,1,0,1,0,drop
28385,50584,0,0,62,62,0,1,0,1,0,deny
25565,51337,0,0,60,60,0,1,0,1,0,deny
34112,44847,0,0,66,66,0,1,0,1,0,deny
9552,57470,0,0,66,66,0,1,0,1,0,deny
51973,445,0,0,70,70,0,1,0,1,0,drop
51972,445,0,0,70,70,0,1,0,1,0,drop
51968,445,0,0,70,70,0,1,0,1,0,drop
51578,44847,0,0,66,66,0,1,0,1,0,deny
63745,445,0,0,66,66,0,1,0,1,0,drop
63569,445,0,0,70,70,0,1,0,1,0,drop
44612,25174,0,0,66,66,0,1,0,1,0,deny
5213,44847,0,0,66,66,0,1,0,1,0,deny
63567,445,0,0,70,70,0,1,0,1,0,drop
45944,44847,0,0,146,146,0,1,0,1,0,deny
12531,22114,0,0,62,62,0,1,0,1,0,deny
23658,18375,0,0,62,62,0,1,0,1,0,deny
44919,26467,0,0,62,62,0,1,0,1,0,deny
55451,56205,0,0,66,66,0,1,0,1,0,deny
44334,26467,0,0,62,62,0,1,0,1,0,deny
11136,15503,0,0,62,62,0,1,0,1,0,deny
11136,15503,0,0,62,62,0,1,0,1,0,deny
65231,50584,0,0,66,66,0,1,0,1,0,deny
12841,37965,0,0,62,62,0,1,0,1,0,deny
54684,37965,0,0,62,62,0,1,0,1,0,deny
36034,35440,0,0,146,146,0,1,0,1,0,deny
63562,445,0,0,70,70,0,1,0,1,0,drop
60957,443,56619,443,68539,4175,64364,98,32,46,52,allow
48852,443,7799,443,38886,2134,36752,55,16,24,31,allow
50724,443,48529,443,12515,5891,6624,42,166,22,20,allow
57231,53,2071,53,168,86,82,2,31,1,1,allow
38140,443,44966,443,82608,3591,79017,101,15,39,62,allow
56761,443,28881,443,8057,2037,6020,20,15,11,9,allow
50605,80,50605,80,2909,1798,1111,14,23,8,6,allow
56274,53,29071,53,177,94,83,2,29,1,1,allow
58094,53,1806,53,249,102,147,2,29,1,1,allow
49278,80,1561,80,254,128,126,5,16,3,2,allow
60477,30889,55230,30889,70,70,0,2,8,2,0,allow
52067,46837,56641,46837,70,70,0,1,5,1,0,allow
2844,3389,2844,3389,4635,2460,2175,21,18,12,9,allow
51523,443,27460,443,4045,765,3280,11,45,5,6,allow
53135,80,21609,80,2959,610,2349,12,15,6,6,allow
51979,443,5164,443,11555,2620,8935,45,822,18,27,allow
38474,443,30004,443,53562,2314,51248,64,31,24,40,allow
53857,22796,40353,22796,492,306,186,8,15,5,3,allow
52096,55854,2133,55854,70,70,0,2,7,2,0,allow
38664,443,9528,443,6887,1076,5811,22,50,12,10,allow
54061,443,17849,443,126027,103934,22093,380,239,237,143,allow
49944,53,58340,53,334,90,244,4,38,2,2,allow
56387,443,8980,443,9569,2225,7344,28,15,15,13,allow
45565,443,30523,443,1784491,72960,1711531,1872,113,687,1185,allow
56760,443,12477,443,8006,1986,6020,20,15,11,9,allow
52094,443,49643,443,3296065,47110,3248955,2746,51,533,2213,allow
61660,443,61660,443,18829,1995,16834,33,17,17,16,allow
18333,53,18333,53,215,98,117,2,30,1,1,allow
53853,39723,8770,39723,1890,1010,880,13,16,8,5,allow
64708,53,37304,53,437,89,348,4,48,2,2,allow
49228,53,52033,53,209,110,99,2,30,1,1,allow
37625,443,14545,443,7766,1810,5956,24,46,14,10,allow
37628,443,37587,443,5783,1761,4022,24,46,14,10,allow
46310,443,24043,443,172,172,0,2,5,2,0,allow
53124,443,13902,443,7459,2962,4497,24,47,14,10,allow
58443,443,26143,443,12060,3749,8311,42,17,23,19,allow
64341,53,61484,53,355,118,237,2,30,1,1,allow
61155,443,61155,443,4575,1668,2907,19,27,11,8,allow
45020,443,16879,443,2293,1592,701,16,21,8,8,allow
55669,53,24694,53,195,94,101,2,30,1,1,allow
42305,443,8617,443,1262512,53286,1209226,1457,280,548,909,allow
51283,443,17367,443,638,292,346,10,28,5,5,allow
50597,80,50597,80,16296,9143,7153,48,27,26,22,allow
55697,14795,5674,14795,564,318,246,9,15,5,4,allow
49566,443,56246,443,2888,1389,1499,18,15,9,9,allow
51559,443,32426,443,254,70,184,5,21,2,3,allow
52097,23279,3582,23279,70,70,0,2,7,2,0,allow
52249,443,52249,443,152755,7304,145451,171,21,65,106,allow
50728,443,61192,443,34661,17810,16851,89,119,40,49,allow
65344,53,8855,53,180,94,86,2,35,1,1,allow
37622,443,52437,443,12542,2527,10015,31,48,18,13,allow
18749,53,18749,53,370,238,132,3,32,2,1,allow
52098,29067,36738,29067,70,70,0,2,7,2,0,allow
56303,53,31666,53,177,94,83,2,30,1,1,allow
18331,53,15455,53,376,94,282,2,30,1,1,allow
64996,27034,9075,27034,1761,924,837,6,30,3,3,allow
49631,53,6299,53,198,102,96,2,33,1,1,allow
49362,443,33824,443,9551,6129,3422,35,47,19,16,allow
55232,53,34536,53,177,94,83,2,29,1,1,allow
44720,53,0,0,86,86,0,1,29,1,0,allow
65224,53,29187,53,232,110,122,2,30,1,1,allow
49665,53,15025,53,168,86,82,2,29,1,1,allow
56303,53,55286,53,177,94,83,2,30,1,1,allow
56557,443,11082,443,36053,3513,32540,54,96,25,29,allow
40662,53,39686,53,223,78,145,2,30,1,1,allow
55223,1053,57960,1053,1210,950,260,2,30,1,1,allow
52422,443,1583,443,1043,556,487,10,15,6,4,allow
60476,55100,21039,55100,70,70,0,2,8,2,0,allow
52066,60118,49058,60118,70,70,0,1,5,1,0,allow
36499,443,51972,443,1159756,1123031,36725,1206,26,753,453,allow
49527,53,63553,53,415,98,317,4,51,2,2,allow
11816,53,11816,53,240,98,142,2,30,1,1,allow
51971,53,51971,53,240,98,142,2,30,1,1,allow
49824,53,50073,53,198,94,104,2,30,1,1,allow
51912,443,41941,443,186,70,116,2,120,1,1,allow
58867,443,37875,443,16230,11127,5103,69,330,34,35,allow
60575,80,18847,80,9034,1860,7174,17,16,8,9,allow
55454,53,64127,53,168,86,82,2,32,1,1,allow
64249,53,6288,53,181,94,87,2,33,1,1,allow
52068,39864,30686,39864,70,70,0,1,5,1,0,allow
59282,443,30587,443,5413,968,4445,20,15,11,9,allow
37621,443,45461,443,27993,2483,25510,51,48,25,26,allow
37600,443,40571,443,19917,8751,11166,51,56,32,19,allow
65071,53,53845,53,411,99,312,4,52,2,2,allow
49819,53,24234,53,94,94,0,1,30,1,0,allow
59189,53,53487,53,222,94,128,2,30,1,1,allow
51944,53,51944,53,832,106,726,2,30,1,1,allow
60986,443,43448,443,7231,2305,4926,32,40,18,14,allow
56759,443,10401,443,8058,2038,6020,20,15,11,9,allow
37626,443,10434,443,7766,1810,5956,24,46,14,10,allow
55133,53,55133,53,228,90,138,2,30,1,1,allow
52854,53,0,0,86,86,0,1,30,1,0,allow
52018,53,53682,53,164,78,86,2,30,1,1,allow
36661,53,19439,53,164,78,86,2,31,1,1,allow
42306,443,42899,443,449862,38989,410873,644,280,286,358,allow
42308,443,54120,443,433261,34730,398531,604,279,258,346,allow
6881,61404,13734,61404,228,118,110,2,1200,1,1,allow
55868,53,18445,53,177,94,83,2,30,1,1,allow
48020,443,61756,443,33481,5635,27846,73,287,32,41,allow
64651,443,22018,443,317618,11688,305930,350,164,118,232,allow
55319,443,12527,443,6210,2720,3490,15,121,7,8,allow
57470,61467,29646,61467,479,150,329,2,1199,1,1,allow
37965,6881,46281,6881,479,150,329,2,1199,1,1,allow
65128,443,26680,443,3055,1759,1296,22,126,12,10,allow
53126,443,58223,443,11811,4242,7569,27,46,15,12,allow
49705,80,19257,80,2733,591,2142,11,45,6,5,allow
25295,53,30242,53,200,94,106,2,30,1,1,allow
53581,53,57842,53,231,94,137,2,30,1,1,allow
33053,53,52435,53,164,78,86,2,31,1,1,allow
56758,443,1030,443,8005,1985,6020,20,16,11,9,allow
53888,39204,30742,39204,70,70,0,2,8,2,0,allow
49767,53,4502,53,177,94,83,2,30,1,1,allow
49562,53,28687,53,198,94,104,2,30,1,1,allow
64030,53,24656,53,338,110,228,2,30,1,1,allow
51965,445,0,0,70,70,0,1,0,1,0,drop
53640,25174,0,0,62,62,0,1,0,1,0,deny
63561,445,0,0,70,70,0,1,0,1,0,drop
31235,22114,0,0,62,62,0,1,0,1,0,deny
51963,445,0,0,70,70,0,1,0,1,0,drop
39110,50584,0,0,62,62,0,1,0,1,0,deny
40481,22114,0,0,66,66,0,1,0,1,0,deny
22439,25174,0,0,66,66,0,1,0,1,0,deny
26235,37965,0,0,66,66,0,1,0,1,0,deny
1865,25174,0,0,62,62,0,1,0,1,0,deny
63557,445,0,0,70,70,0,1,0,1,0,drop
63731,445,0,0,66,66,0,1,0,1,0,drop
63726,445,0,0,66,66,0,1,0,1,0,drop
48706,23393,0,0,60,60,0,1,0,1,0,deny
44674,25174,0,0,62,62,0,1,0,1,0,deny
43207,26467,0,0,62,62,0,1,0,1,0,deny
63556,445,0,0,70,70,0,1,0,1,0,drop
51042,22114,0,0,66,66,0,1,0,1,0,deny
51948,445,0,0,70,70,0,1,0,1,0,drop
51946,445,0,0,70,70,0,1,0,1,0,drop
51944,445,0,0,70,70,0,1,0,1,0,drop
51945,445,0,0,70,70,0,1,0,1,0,drop
1111,25174,0,0,62,62,0,1,0,1,0,deny
6843,42873,0,0,62,62,0,1,0,1,0,deny
63724,445,0,0,66,66,0,1,0,1,0,drop
2083,25174,0,0,62,62,0,1,0,1,0,deny
42030,25,0,0,74,74,0,1,0,1,0,deny
51479,25174,0,0,62,62,0,1,0,1,0,deny
63551,445,0,0,70,70,0,1,0,1,0,drop
42632,44847,0,0,146,146,0,1,0,1,0,deny
54142,20541,0,0,66,66,0,1,0,1,0,deny
63715,445,0,0,66,66,0,1,0,1,0,drop
63713,445,0,0,66,66,0,1,0,1,0,drop
63712,445,0,0,66,66,0,1,0,1,0,drop
63717,445,0,0,66,66,0,1,0,1,0,drop
63719,445,0,0,66,66,0,1,0,1,0,drop
63711,445,0,0,66,66,0,1,0,1,0,drop
63708,445,0,0,66,66,0,1,0,1,0,drop
51706,25174,0,0,66,66,0,1,0,1,0,deny
51938,445,0,0,70,70,0,1,0,1,0,drop
443,38956,0,0,82,82,0,1,0,1,0,deny
51935,445,0,0,70,70,0,1,0,1,0,drop
51932,445,0,0,70,70,0,1,0,1,0,drop
51931,445,0,0,70,70,0,1,0,1,0,drop
50328,22114,0,0,66,66,0,1,0,1,0,deny
62489,23117,0,0,62,62,0,1,0,1,0,deny
55508,64147,0,0,62,62,0,1,0,1,0,deny
64587,43890,0,0,66,66,0,1,0,1,0,deny
25207,48817,0,0,62,62,0,1,0,1,0,deny
54236,36829,0,0,66,66,0,1,0,1,0,deny
55570,44847,0,0,62,62,0,1,0,1,0,deny
1620,53567,0,0,66,66,0,1,0,1,0,deny
55012,25174,0,0,66,66,0,1,0,1,0,deny
56676,37965,0,0,62,62,0,1,0,1,0,deny
63538,445,0,0,70,70,0,1,0,1,0,drop
51930,445,0,0,70,70,0,1,0,1,0,drop
51928,445,0,0,70,70,0,1,0,1,0,drop
51927,445,0,0,70,70,0,1,0,1,0,drop
65025,57866,0,0,66,66,0,1,0,1,0,deny
50052,65008,0,0,60,60,0,1,0,1,0,deny
61643,22114,0,0,62,62,0,1,0,1,0,deny
63702,445,0,0,66,66,0,1,0,1,0,drop
51922,445,0,0,70,70,0,1,0,1,0,drop
63535,445,0,0,70,70,0,1,0,1,0,drop
54121,25174,0,0,62,62,0,1,0,1,0,deny
1114,37965,0,0,62,62,0,1,0,1,0,deny
11878,37807,0,0,62,62,0,1,0,1,0,deny
63699,445,0,0,66,66,0,1,0,1,0,drop
55341,39004,0,0,74,74,0,1,0,1,0,deny
63696,445,0,0,66,66,0,1,0,1,0,drop
63695,445,0,0,66,66,0,1,0,1,0,drop
54373,26467,0,0,62,62,0,1,0,1,0,deny
63694,445,0,0,66,66,0,1,0,1,0,drop
22574,44847,0,0,62,62,0,1,0,1,0,deny
30304,26467,0,0,62,62,0,1,0,1,0,deny
63531,445,0,0,70,70,0,1,0,1,0,drop
63529,445,0,0,70,70,0,1,0,1,0,drop
51918,445,0,0,70,70,0,1,0,1,0,drop
0,0,0,0,200,102,98,2,0,1,1,allow
63527,445,0,0,70,70,0,1,0,1,0,drop
51904,445,0,0,70,70,0,1,0,1,0,drop
47913,25174,0,0,62,62,0,1,0,1,0,deny
28192,50584,0,0,66,66,0,1,0,1,0,deny
60058,25174,0,0,66,66,0,1,0,1,0,deny
63683,445,0,0,66,66,0,1,0,1,0,drop
62097,57470,0,0,146,146,0,1,0,1,0,deny
34914,26467,0,0,62,62,0,1,0,1,0,deny
22948,26467,0,0,62,62,0,1,0,1,0,deny
56872,21247,0,0,74,74,0,1,0,1,0,deny
63520,445,0,0,70,70,0,1,0,1,0,drop
63675,445,0,0,66,66,0,1,0,1,0,drop
63518,445,0,0,70,70,0,1,0,1,0,drop
51894,445,0,0,70,70,0,1,0,1,0,drop
53097,25174,0,0,66,66,0,1,0,1,0,deny
42344,48637,0,0,60,60,0,1,0,1,0,deny
56387,25174,0,0,66,66,0,1,0,1,0,deny
63517,445,0,0,70,70,0,1,0,1,0,drop
63516,445,0,0,70,70,0,1,0,1,0,drop
49514,52255,0,0,162,162,0,1,0,1,0,deny
63515,445,0,0,70,70,0,1,0,1,0,drop
63672,445,0,0,66,66,0,1,0,1,0,drop
54883,60043,0,0,62,62,0,1,0,1,0,deny
63509,445,0,0,70,70,0,1,0,1,0,drop
63510,445,0,0,70,70,0,1,0,1,0,drop
62189,64147,0,0,62,62,0,1,0,1,0,deny
57991,22114,0,0,66,66,0,1,0,1,0,deny
19875,30170,0,0,145,145,0,1,0,1,0,deny
54578,26467,0,0,66,66,0,1,0,1,0,deny
443,38956,0,0,82,82,0,1,0,1,0,deny
49752,50584,0,0,62,62,0,1,0,1,0,deny
51490,30228,0,0,100,100,0,1,0,1,0,deny
6842,42873,0,0,66,66,0,1,0,1,0,deny
17947,36237,0,0,62,62,0,1,0,1,0,deny
64036,23718,0,0,62,62,0,1,0,1,0,deny
63666,445,0,0,66,66,0,1,0,1,0,drop
63595,51050,0,0,62,62,0,1,0,1,0,deny
18683,26467,0,0,62,62,0,1,0,1,0,deny
63497,445,0,0,70,70,0,1,0,1,0,drop
63495,445,0,0,70,70,0,1,0,1,0,drop
63658,445,0,0,66,66,0,1,0,1,0,drop
63494,445,0,0,70,70,0,1,0,1,0,drop
22408,22114,0,0,62,62,0,1,0,1,0,deny
63487,445,0,0,70,70,0,1,0,1,0,drop
63486,445,0,0,70,70,0,1,0,1,0,drop
38018,443,11782,443,1851,1222,629,16,27,10,6,allow
57578,80,57578,80,55886,2728,53158,68,148,25,43,allow
27179,53,27179,53,398,255,143,3,34,2,1,allow
61572,53,61572,53,213,79,134,2,33,1,1,allow
1485,53,1485,53,194,87,107,2,30,1,1,allow
49767,53,37135,53,170,87,83,2,30,1,1,allow
52094,55986,52536,55986,70,70,0,2,8,2,0,allow
38857,443,38857,443,115031,5628,109403,143,104,55,88,allow
51410,443,1294,443,619870,220857,399013,1045,123,531,514,allow
58946,443,24412,443,3990,2586,1404,17,16,9,8,allow
50400,443,40237,443,316,136,180,6,6,3,3,allow
2527,53,2527,53,371,237,134,3,34,2,1,allow
21772,443,21772,443,17221,1314,15907,31,44,16,15,allow
38860,443,38860,443,15584,2721,12863,44,103,21,23,allow
57749,15000,61462,15000,130,70,60,2,6,1,1,allow
35717,443,25554,443,8290,2954,5336,24,361,13,11,allow
38862,443,38862,443,23553,2583,20970,46,103,19,27,allow
52095,48896,12899,48896,70,70,0,2,8,2,0,allow
56324,53,56324,53,257,101,156,2,34,1,1,allow
38140,443,56534,443,11484,3842,7642,30,31,16,14,allow
38858,443,38858,443,226465,10306,216159,292,104,135,157,allow
60415,53,60415,53,257,101,156,2,33,1,1,allow
59812,443,39961,443,6412,1530,4882,24,255,11,13,allow
58943,443,29236,443,6611,4273,2338,22,17,11,11,allow
62044,443,20776,443,10530,2001,8529,29,47,14,15,allow
57577,80,57577,80,172548,4355,168193,172,148,53,119,allow
48150,443,17947,443,502,222,280,8,28,4,4,allow
29226,80,29226,80,490,264,226,8,35,5,3,allow
50868,443,26459,443,7646,1697,5949,31,271,15,16,allow
54776,443,51403,443,9501,1502,7999,24,29,13,11,allow
55698,45710,57579,45710,70,70,0,1,5,1,0,allow
54774,443,8128,443,9501,1502,7999,24,29,13,11,allow
40196,443,61662,443,24750,1845,22905,39,171,17,22,allow
55216,443,23383,443,8058,5498,2560,20,120,11,9,allow
54775,443,48406,443,9501,1502,7999,24,29,13,11,allow
51762,443,40334,443,5048,2345,2703,13,121,7,6,allow
55038,443,38606,443,30239,8906,21333,61,32,34,27,allow
58994,443,55812,443,3284,1878,1406,20,27,11,9,allow
49749,80,64733,80,230959,4381,226578,217,91,60,157,allow
56705,53,36648,53,711,87,624,2,30,1,1,allow
55854,443,29147,443,3387,1672,1715,24,270,11,13,allow
42378,443,63662,443,1970,1231,739,14,30,8,6,allow
58987,443,9430,443,3730,2378,1352,23,28,12,11,allow
41882,443,10450,443,7218,4166,3052,38,133,19,19,allow
64913,53,45280,53,188,96,92,2,30,1,1,allow
56285,53,40728,53,711,87,624,2,30,1,1,allow
49420,53,3179,53,170,87,83,2,31,1,1,allow
30960,45762,15257,45762,330,330,0,6,3609,6,0,allow
57051,53,63796,53,783,96,687,2,30,1,1,allow
55423,53,61643,53,711,87,624,2,31,1,1,allow
38049,53,38049,53,213,87,126,2,31,1,1,allow
65388,53,55189,53,764,99,665,2,31,1,1,allow
40549,443,33434,443,5591,3194,2397,16,122,8,8,allow
4483,53,4483,53,213,87,126,2,31,1,1,allow
44274,53,0,0,82,82,0,1,31,1,0,allow
60432,443,46333,443,4355,2135,2220,15,136,7,8,allow
57978,5228,59102,5228,2725,1610,1115,20,3600,10,10,allow
59360,53,6794,53,429,116,313,2,31,1,1,allow
49676,53,60800,53,322,110,212,4,31,2,2,allow
55897,53,62688,53,711,87,624,2,31,1,1,allow
50280,53,20623,53,916,86,830,2,31,1,1,allow
54691,443,33638,443,4851,1269,3582,21,148,9,12,allow
48817,1024,48817,1024,152,152,0,1,1200,1,0,allow
40204,40001,61401,40001,244,181,63,2,31,1,1,allow
48817,32794,48817,32794,152,152,0,1,1200,1,0,allow
61660,64097,0,0,62,62,0,1,0,1,0,deny
15806,11392,0,0,66,66,0,1,0,1,0,deny
55600,22,0,0,60,60,0,1,0,1,0,deny
55167,48817,0,0,66,66,0,1,0,1,0,deny
31609,26296,0,0,148,148,0,1,0,1,0,deny
4019,50584,0,0,66,66,0,1,0,1,0,deny
9836,22114,0,0,62,62,0,1,0,1,0,deny
51887,445,0,0,70,70,0,1,0,1,0,drop
51885,445,0,0,70,70,0,1,0,1,0,drop
51882,445,0,0,70,70,0,1,0,1,0,drop
59282,51050,0,0,66,66,0,1,0,1,0,deny
63646,445,0,0,66,66,0,1,0,1,0,drop
56755,443,40162,443,8059,2039,6020,20,15,11,9,allow
63644,445,0,0,66,66,0,1,0,1,0,drop
63645,445,0,0,66,66,0,1,0,1,0,drop
63647,445,0,0,66,66,0,1,0,1,0,drop
63643,445,0,0,66,66,0,1,0,1,0,drop
63642,445,0,0,66,66,0,1,0,1,0,drop
63649,445,0,0,66,66,0,1,0,1,0,drop
63641,445,0,0,66,66,0,1,0,1,0,drop
26884,37965,0,0,66,66,0,1,0,1,0,deny
6828,64322,0,0,60,60,0,1,0,1,0,deny
26879,37965,0,0,62,62,0,1,0,1,0,deny
51490,17500,0,0,100,100,0,1,0,1,0,deny
42231,57470,0,0,78,78,0,1,0,1,0,deny
63475,445,0,0,70,70,0,1,0,1,0,drop
55408,64147,0,0,66,66,0,1,0,1,0,deny
60113,22114,0,0,66,66,0,1,0,1,0,deny
63741,50584,0,0,66,66,0,1,0,1,0,deny
59303,21247,0,0,66,66,0,1,0,1,0,deny
61550,5529,0,0,145,145,0,1,0,1,0,deny
54021,25174,0,0,62,62,0,1,0,1,0,deny
16620,25174,0,0,62,62,0,1,0,1,0,deny
45169,14037,0,0,74,74,0,1,0,1,0,deny
443,38956,0,0,82,82,0,1,0,1,0,deny
13294,64147,0,0,145,145,0,1,0,1,0,deny
45535,25174,0,0,66,66,0,1,0,1,0,deny
13525,51505,0,0,62,62,0,1,0,1,0,deny
10949,22114,0,0,62,62,0,1,0,1,0,deny
57369,1433,0,0,60,60,0,1,0,1,0,deny
59209,25174,0,0,62,62,0,1,0,1,0,deny
51490,57587,0,0,100,100,0,1,0,1,0,deny
51880,445,0,0,70,70,0,1,0,1,0,drop
51879,445,0,0,70,70,0,1,0,1,0,drop
51877,445,0,0,70,70,0,1,0,1,0,drop
51866,445,0,0,70,70,0,1,0,1,0,drop
63471,445,0,0,70,70,0,1,0,1,0,drop
51490,50432,0,0,100,100,0,1,0,1,0,deny
49694,5900,0,0,60,60,0,1,0,1,0,deny
51728,44847,0,0,66,66,0,1,0,1,0,deny
50052,65010,0,0,60,60,0,1,0,1,0,deny
63628,445,0,0,66,66,0,1,0,1,0,drop
63627,445,0,0,66,66,0,1,0,1,0,drop
63626,445,0,0,66,66,0,1,0,1,0,drop
35626,22114,0,0,66,66,0,1,0,1,0,deny
60885,443,31610,443,887,542,345,11,15,6,5,allow
50895,80,56986,80,9046,1139,7907,20,255,11,9,allow
60849,80,64699,80,9729,876,8853,21,45,11,10,allow
53859,34334,7486,34334,492,306,186,8,14,5,3,allow
55868,53,41641,53,177,94,83,2,29,1,1,allow
56741,443,24400,443,9868,2027,7841,24,20,12,12,allow
38861,443,38861,443,90303,5838,84465,140,103,68,72,allow
9418,443,37541,443,5691,503,5188,14,15,7,7,allow
34495,80,62171,80,1026,417,609,7,19,5,2,allow
60480,80,35551,80,7406,1038,6368,18,16,10,8,allow
49193,443,7514,443,3283,665,2618,16,160,7,9,allow
55700,26957,33294,26957,70,70,0,2,8,2,0,allow
56670,80,44971,80,234,234,0,4,12,4,0,allow
58894,443,4103,443,152,86,66,2,4,1,1,allow
55695,28182,59050,28182,504,318,186,8,16,5,3,allow
65129,443,48258,443,1765,1126,639,17,125,10,7,allow
57587,80,57587,80,218150,5323,212827,218,145,69,149,allow
56303,53,63690,53,177,94,83,2,29,1,1,allow
49704,80,54649,80,2058,589,1469,10,44,6,4,allow
64913,53,33116,53,194,102,92,2,30,1,1,allow
64022,60918,37297,60918,66,66,0,2,7,2,0,allow
9824,53,59579,53,179,86,93,2,29,1,1,allow
55193,53,27254,53,177,94,83,2,30,1,1,allow
42101,443,25094,443,4904,1934,2970,17,135,8,9,allow
48861,53,40652,53,164,78,86,2,30,1,1,allow
34105,443,37693,443,43883,3446,40437,57,122,22,35,allow
38866,443,54319,443,16577,10269,6308,33,17,20,13,allow
49214,443,63008,443,7177,2666,4511,20,15,11,9,allow
50662,443,50298,443,4190,1882,2308,17,19,10,7,allow
56604,443,32761,443,7314,2061,5253,29,92,15,14,allow
52246,443,52246,443,1615,941,674,15,21,7,8,allow
64787,53,13133,53,299,101,198,4,34,2,2,allow
56756,443,23896,443,8007,1987,6020,20,15,11,9,allow
49222,443,64126,443,476852,12774,464078,491,17,177,314,allow
60882,443,27723,443,4485,794,3691,17,25,9,8,allow
65209,53,43414,53,585,206,379,6,79,3,3,allow
49386,53,12060,53,332,102,230,2,30,1,1,allow
49420,53,37701,53,185,102,83,2,30,1,1,allow
54199,443,3753,443,26903,3579,23324,72,278,33,39,allow
58640,443,44043,443,4440,114,4326,7,122,2,5,allow
55228,443,61820,443,12645,4916,7729,39,94,22,17,allow
58140,53,58140,53,262,106,156,2,34,1,1,allow
55699,21063,52402,21063,70,70,0,1,5,1,0,allow
63201,53,63201,53,262,106,156,2,32,1,1,allow
57204,443,62645,443,340,140,200,6,25,3,3,allow
49925,53,18861,53,953,215,738,6,46,3,3,allow
56360,443,55866,443,188316,24744,163572,302,172,119,183,allow
55193,53,2306,53,177,94,83,2,30,1,1,allow
64636,53,4639,53,325,102,223,2,30,1,1,allow
65336,53,64946,53,275,94,181,2,30,1,1,allow
49367,53,52320,53,718,94,624,2,30,1,1,allow
64528,53,42814,53,353,118,235,2,30,1,1,allow
55347,443,36174,443,3811,2320,1491,33,735,18,15,allow
56510,443,37047,443,8742,2483,6259,41,114,22,19,allow
50670,80,2254,80,1658,1247,411,8,15,5,3,allow
41916,443,13885,443,8634,3251,5383,24,17,14,10,allow
32837,443,39597,443,3167,1498,1669,19,315,10,9,allow
53125,443,2099,443,7738,2230,5508,24,45,14,10,allow
44641,80,65447,80,1354,850,504,13,256,8,5,allow
24988,53,24988,53,214,82,132,2,33,1,1,allow
54197,443,61116,443,190,70,120,4,15,2,2,allow
52093,40828,32567,40828,258,70,188,4,8,2,2,allow
64025,26826,22306,26826,66,66,0,2,7,2,0,allow
53883,24830,47697,24830,258,70,188,4,7,2,2,allow
50360,80,38167,80,5307,2694,2613,17,25,9,8,allow
57604,443,23765,443,2614,1689,925,18,21,10,8,allow
57544,7000,57544,7000,3502,1935,1567,15,15,8,7,allow
38822,80,14880,80,810,413,397,7,19,5,2,allow
57592,80,57592,80,3118,689,2429,13,144,6,7,allow
53884,48754,60851,48754,70,70,0,2,7,2,0,allow
52065,52021,23578,52021,70,70,0,1,4,1,0,allow
43892,443,53731,443,9754,4277,5477,27,330,14,13,allow
45077,443,30343,443,9599,1234,8365,27,29,15,12,allow
57444,53,13400,53,198,94,104,2,29,1,1,allow
49767,53,3628,53,177,94,83,2,29,1,1,allow
32578,443,32578,443,25033,2433,22600,42,25,21,21,allow
50616,53,45129,53,177,94,83,2,30,1,1,allow
64913,53,23262,53,194,102,92,2,29,1,1,allow
55222,53,59150,53,1210,950,260,2,29,1,1,allow
64773,53,48477,53,328,150,178,2,30,1,1,allow
33080,53,44512,53,86,86,0,1,29,1,0,allow
42318,53,4117,53,164,78,86,2,30,1,1,allow
65117,53,25899,53,230,94,136,2,30,1,1,allow
59753,27016,15718,27016,1718,1386,332,8,30,4,4,allow
44757,53,59516,53,179,86,93,2,30,1,1,allow
49491,443,61216,443,33157,17446,15711,66,135,38,28,allow
49666,53,7037,53,325,126,199,2,30,1,1,allow
64750,53,14070,53,276,102,174,2,30,1,1,allow
55542,443,7716,443,11550,3336,8214,52,130,25,27,allow
57307,443,55707,443,35035,5135,29900,81,216,33,48,allow
36411,443,59094,443,10691,3704,6987,25,181,13,12,allow
56757,443,9849,443,8057,2037,6020,20,15,11,9,allow
53163,32834,24170,32834,70,70,0,2,8,2,0,allow
41269,443,9096,443,78,78,0,1,5,1,0,allow
57591,80,57591,80,144228,2522,141706,135,144,36,99,allow
49490,53,51051,53,246,94,152,2,30,1,1,allow
33546,53,33546,53,400,257,143,3,32,2,1,allow
50659,80,44031,80,24433,3378,21055,31,21,12,19,allow
50358,80,6074,80,306,180,126,6,25,4,2,allow
46193,53,56530,53,311,86,225,2,30,1,1,allow
43539,53,26606,53,168,78,90,2,30,1,1,allow
38700,53,38476,53,164,78,86,2,30,1,1,allow
64173,53,16220,53,210,94,116,2,30,1,1,allow
64986,27049,14066,27049,1764,924,840,6,31,3,3,allow
47400,80,8007,80,9083,1822,7261,20,257,5,15,allow
48817,13259,48817,13259,460,150,310,2,1200,1,1,allow
50654,123,28946,123,184,94,90,2,30,1,1,allow
50616,53,27498,53,177,94,83,2,30,1,1,allow
55026,53,14938,53,177,94,83,2,30,1,1,allow
57044,53,54820,53,177,94,83,2,31,1,1,allow
57169,53,45860,53,177,94,83,2,31,1,1,allow
50265,15402,25420,15402,1450,747,703,16,1200,9,7,allow
49160,16767,65061,16767,854,150,704,4,1200,2,2,allow
50265,57799,36521,57799,1450,747,703,16,1200,9,7,allow
55063,5223,9362,5223,4336,1518,2818,23,3002,14,9,allow
37965,63666,47723,63666,10717,6715,4002,121,4588,71,50,allow
49453,53,64414,53,227,110,117,2,31,1,1,allow
34179,80,3058,80,2137,1258,879,11,150,6,5,allow
55877,56299,54578,56299,481,150,331,2,1200,1,1,allow
52089,16543,21777,16543,70,70,0,2,9,2,0,allow
53863,8999,63067,8999,70,70,0,1,5,1,0,allow
64012,40642,7765,40642,70,70,0,1,5,1,0,allow
55185,443,43469,443,6389,1163,5226,19,25,11,8,allow
51414,443,57873,443,8292,2164,6128,31,120,17,14,allow
56754,443,15698,443,8006,1986,6020,20,16,11,9,allow
58949,443,63115,443,5166,700,4466,16,15,7,9,allow
53722,443,28671,443,70,70,0,1,5,1,0,allow
52064,43273,64418,43273,70,70,0,1,5,1,0,allow
51412,443,35247,443,200230,8733,191497,250,122,106,144,allow
50379,80,42640,80,1083,653,430,8,16,5,3,allow
65323,27047,12346,27047,1233,924,309,6,31,3,3,allow
37336,443,19104,443,995086,50081,945005,1281,216,515,766,allow
64123,443,56759,443,1411,852,559,13,25,7,6,allow
65451,53,3084,53,728,234,494,6,67,3,3,allow
55026,53,50435,53,177,94,83,2,30,1,1,allow
8949,53,8949,53,832,106,726,2,30,1,1,allow
57306,53,57306,53,220,90,130,2,30,1,1,allow
57452,53,57452,53,203,82,121,2,30,1,1,allow
63462,445,0,0,70,70,0,1,0,1,0,drop
63459,445,0,0,70,70,0,1,0,1,0,drop
63460,445,0,0,70,70,0,1,0,1,0,drop
29145,8168,0,0,62,62,0,1,0,1,0,deny
63030,25174,0,0,62,62,0,1,0,1,0,deny
63458,445,0,0,70,70,0,1,0,1,0,drop
58120,25174,0,0,62,62,0,1,0,1,0,deny
50609,2323,0,0,60,60,0,1,0,1,0,deny
1500,10387,0,0,157,157,0,1,0,1,0,deny
63455,445,0,0,70,70,0,1,0,1,0,drop
51863,445,0,0,70,70,0,1,0,1,0,drop
50106,30317,0,0,66,66,0,1,0,1,0,deny
27679,37965,0,0,62,62,0,1,0,1,0,deny
51861,445,0,0,70,70,0,1,0,1,0,drop
51858,445,0,0,70,70,0,1,0,1,0,drop
51852,445,0,0,70,70,0,1,0,1,0,drop
49993,37965,0,0,66,66,0,1,0,1,0,deny
57251,37965,0,0,62,62,0,1,0,1,0,deny
1024,63737,0,0,518,518,0,1,0,1,0,deny
29045,41864,0,0,159,159,0,1,0,1,0,deny
443,38956,0,0,82,82,0,1,0,1,0,deny
19747,37965,0,0,62,62,0,1,0,1,0,deny
54917,60043,0,0,66,66,0,1,0,1,0,deny
63385,25174,0,0,66,66,0,1,0,1,0,deny
45682,37965,0,0,62,62,0,1,0,1,0,deny
2837,25174,0,0,62,62,0,1,0,1,0,deny
63449,445,0,0,70,70,0,1,0,1,0,drop
50549,43890,0,0,62,62,0,1,0,1,0,deny
1827,64147,0,0,66,66,0,1,0,1,0,deny
2991,23,0,0,60,60,0,1,0,1,0,deny
50321,48817,0,0,143,143,0,1,0,1,0,deny
38586,3855,0,0,145,145,0,1,0,1,0,deny
10910,57866,0,0,62,62,0,1,0,1,0,deny
10910,57866,0,0,146,146,0,1,0,1,0,deny
51845,445,0,0,70,70,0,1,0,1,0,drop
33328,25174,0,0,62,62,0,1,0,1,0,deny
51843,445,0,0,70,70,0,1,0,1,0,drop
51841,445,0,0,70,70,0,1,0,1,0,drop
63441,445,0,0,70,70,0,1,0,1,0,drop
2332,35440,0,0,66,66,0,1,0,1,0,deny
63438,445,0,0,70,70,0,1,0,1,0,drop
50857,26467,0,0,66,66,0,1,0,1,0,deny
37034,25174,0,0,62,62,0,1,0,1,0,deny
63615,445,0,0,66,66,0,1,0,1,0,drop
52166,26467,0,0,66,66,0,1,0,1,0,deny
65159,37965,0,0,74,74,0,1,0,1,0,deny
22856,22114,0,0,66,66,0,1,0,1,0,deny
22677,25174,0,0,66,66,0,1,0,1,0,deny
50563,37965,0,0,66,66,0,1,0,1,0,deny
63435,445,0,0,70,70,0,1,0,1,0,drop
59535,25174,0,0,62,62,0,1,0,1,0,deny
7423,22114,0,0,146,146,0,1,0,1,0,deny
63433,445,0,0,70,70,0,1,0,1,0,drop
52537,57866,0,0,66,66,0,1,0,1,0,deny
10128,23718,0,0,146,146,0,1,0,1,0,deny
51837,445,0,0,70,70,0,1,0,1,0,drop
443,38956,0,0,82,82,0,1,0,1,0,deny
26263,8168,0,0,66,66,0,1,0,1,0,deny
60869,48817,0,0,66,66,0,1,0,1,0,deny
52494,36237,0,0,62,62,0,1,0,1,0,deny
51836,445,0,0,70,70,0,1,0,1,0,drop
47089,22114,0,0,146,146,0,1,0,1,0,deny
63888,25174,0,0,62,62,0,1,0,1,0,deny
63429,445,0,0,70,70,0,1,0,1,0,drop
51602,22114,0,0,66,66,0,1,0,1,0,deny
59599,62413,0,0,146,146,0,1,0,1,0,deny
4788,53,4788,53,825,99,726,2,0,1,1,allow
51425,37450,0,0,66,66,0,1,0,1,0,deny
63599,445,0,0,66,66,0,1,0,1,0,drop
63598,445,0,0,66,66,0,1,0,1,0,drop
63428,445,0,0,70,70,0,1,0,1,0,drop
56590,25174,0,0,66,66,0,1,0,1,0,deny
49333,25174,0,0,62,62,0,1,0,1,0,deny
60159,22114,0,0,66,66,0,1,0,1,0,deny
1238,51505,0,0,62,62,0,1,0,1,0,deny
64922,26296,0,0,148,148,0,1,0,1,0,deny
51815,445,0,0,70,70,0,1,0,1,0,drop
62579,57866,0,0,66,66,0,1,0,1,0,deny
6929,35440,0,0,66,66,0,1,0,1,0,deny
51825,445,0,0,70,70,0,1,0,1,0,drop
51823,445,0,0,70,70,0,1,0,1,0,drop
51822,445,0,0,70,70,0,1,0,1,0,drop
6247,51221,0,0,78,78,0,1,0,1,0,deny
48605,50584,0,0,146,146,0,1,0,1,0,deny
63423,445,0,0,70,70,0,1,0,1,0,drop
63596,445,0,0,66,66,0,1,0,1,0,drop
42034,28189,0,0,62,62,0,1,0,1,0,deny
25296,51505,0,0,66,66,0,1,0,1,0,deny
64024,22114,0,0,66,66,0,1,0,1,0,deny
61185,54532,0,0,62,62,0,1,0,1,0,deny
27300,6881,0,0,62,62,0,1,0,1,0,deny
63586,445,0,0,66,66,0,1,0,1,0,drop
63590,445,0,0,66,66,0,1,0,1,0,drop
63585,445,0,0,66,66,0,1,0,1,0,drop
63579,445,0,0,66,66,0,1,0,1,0,drop
63588,445,0,0,66,66,0,1,0,1,0,drop
63582,445,0,0,66,66,0,1,0,1,0,drop
63581,445,0,0,66,66,0,1,0,1,0,drop
5222,32859,0,0,66,66,0,1,0,1,0,deny
51811,445,0,0,70,70,0,1,0,1,0,drop
51806,445,0,0,70,70,0,1,0,1,0,drop
51805,445,0,0,70,70,0,1,0,1,0,drop
51803,445,0,0,70,70,0,1,0,1,0,drop
1190,25174,0,0,62,62,0,1,0,1,0,deny
11136,19910,0,0,62,62,0,1,0,1,0,deny
18750,57866,0,0,62,62,0,1,0,1,0,deny
443,2629,0,0,135,135,0,1,0,1,0,deny
63410,445,0,0,70,70,0,1,0,1,0,drop
65289,25174,0,0,66,66,0,1,0,1,0,deny
17982,11392,0,0,62,62,0,1,0,1,0,deny
26301,22114,0,0,146,146,0,1,0,1,0,deny
7288,25174,0,0,66,66,0,1,0,1,0,deny
21064,25174,0,0,146,146,0,1,0,1,0,deny
56800,23,0,0,60,60,0,1,0,1,0,deny
1264,26296,0,0,143,143,0,1,0,1,0,deny
1638,22114,0,0,62,62,0,1,0,1,0,deny
1356,57470,0,0,72,72,0,1,0,1,0,deny
63407,445,0,0,70,70,0,1,0,1,0,drop
35011,37965,0,0,62,62,0,1,0,1,0,deny
51800,445,0,0,70,70,0,1,0,1,0,drop
51799,445,0,0,70,70,0,1,0,1,0,drop
51798,445,0,0,70,70,0,1,0,1,0,drop
63573,445,0,0,66,66,0,1,0,1,0,drop
51794,445,0,0,70,70,0,1,0,1,0,drop
63569,445,0,0,66,66,0,1,0,1,0,drop
53495,37807,0,0,66,66,0,1,0,1,0,deny
46537,25174,0,0,62,62,0,1,0,1,0,deny
63568,445,0,0,66,66,0,1,0,1,0,drop
63566,445,0,0,66,66,0,1,0,1,0,drop
22783,64147,0,0,66,66,0,1,0,1,0,deny
10003,64147,0,0,62,62,0,1,0,1,0,deny
56621,50584,0,0,62,62,0,1,0,1,0,deny
65389,26467,0,0,62,62,0,1,0,1,0,deny
63564,445,0,0,66,66,0,1,0,1,0,drop
56629,25174,0,0,66,66,0,1,0,1,0,deny
64162,22114,0,0,146,146,0,1,0,1,0,deny
63403,445,0,0,70,70,0,1,0,1,0,drop
63401,445,0,0,70,70,0,1,0,1,0,drop
48125,7548,0,0,60,60,0,1,0,1,0,deny
63399,445,0,0,70,70,0,1,0,1,0,drop
12545,43890,0,0,146,146,0,1,0,1,0,deny
51789,445,0,0,70,70,0,1,0,1,0,drop
1114,37965,0,0,62,62,0,1,0,1,0,deny
5228,3434,0,0,345,345,0,1,0,1,0,deny
51783,445,0,0,70,70,0,1,0,1,0,drop
51777,445,0,0,70,70,0,1,0,1,0,drop
42344,48637,0,0,60,60,0,1,0,1,0,deny
9087,37965,0,0,62,62,0,1,0,1,0,deny
63553,445,0,0,66,66,0,1,0,1,0,drop
10091,22114,0,0,62,62,0,1,0,1,0,deny
63587,22114,0,0,62,62,0,1,0,1,0,deny
63392,445,0,0,70,70,0,1,0,1,0,drop
60261,25174,0,0,66,66,0,1,0,1,0,deny
63390,445,0,0,70,70,0,1,0,1,0,drop
48019,22114,0,0,66,66,0,1,0,1,0,deny
10273,21247,0,0,62,62,0,1,0,1,0,deny
27144,25174,0,0,66,66,0,1,0,1,0,deny
53822,25174,0,0,66,66,0,1,0,1,0,deny
63546,445,0,0,66,66,0,1,0,1,0,drop
58228,53733,0,0,62,62,0,1,0,1,0,deny
51767,445,0,0,70,70,0,1,0,1,0,drop
63389,445,0,0,70,70,0,1,0,1,0,drop
34396,443,45872,443,6214,1750,4464,24,316,12,12,allow
64803,80,9867,80,5518,527,4991,13,75,6,7,allow
9413,443,2971,443,3510,430,3080,10,15,6,4,allow
44205,443,40929,443,13019,4593,8426,71,350,34,37,allow
60470,51413,5081,51413,741,435,306,10,16,5,5,allow
51960,443,28367,443,2648,1797,851,19,23,11,8,allow
51618,15000,8356,15000,130,70,60,2,5,1,1,allow
34704,443,48562,443,10207,3126,7081,26,24,14,12,allow
10036,80,8198,80,2058,589,1469,10,46,6,4,allow
49676,53,19443,53,216,110,106,2,30,1,1,allow
58910,443,57868,443,27575,18478,9097,64,22,36,28,allow
48275,15000,58699,15000,130,70,60,2,5,1,1,allow
55563,443,55563,443,4628,1721,2907,19,30,11,8,allow
49655,80,10831,80,6485767,147003,6338764,6221,320,2024,4197,allow
57001,53,10240,53,170,87,83,2,31,1,1,allow
40204,40039,52941,40039,152,90,62,2,31,1,1,allow
54950,443,18760,443,5281,1393,3888,22,16,13,9,allow
53891,1056,54785,1056,260,140,120,5,6,3,2,allow
45122,15000,56634,15000,130,70,60,2,5,1,1,allow
49994,443,47759,443,352,292,60,2,5,1,1,allow
53838,15000,39426,15000,130,70,60,2,5,1,1,allow
9414,443,33463,443,5689,501,5188,14,15,7,7,allow
62693,443,62693,443,4788,1881,2907,19,31,11,8,allow
52245,443,52245,443,1615,941,674,15,21,7,8,allow
57965,443,27190,443,8366,2018,6348,32,104,17,15,allow
59084,443,59084,443,4598,1691,2907,19,30,11,8,allow
50387,443,3636,443,2227,1018,1209,17,16,8,9,allow
64802,80,15134,80,2424,529,1895,11,75,6,5,allow
41278,443,28567,443,7238,2601,4637,20,17,10,10,allow
50354,80,47927,80,306,180,126,6,25,4,2,allow
54516,53,54516,53,235,90,145,2,33,1,1,allow
55454,53,60300,53,168,86,82,2,33,1,1,allow
51408,443,61197,443,1576,789,787,17,122,9,8,allow
49450,443,10791,443,5792,1511,4281,19,77,11,8,allow
42023,443,45040,443,42402,3988,38414,82,89,39,43,allow
47091,15000,23609,15000,138,78,60,2,6,1,1,allow
47168,15000,16770,15000,130,70,60,2,5,1,1,allow
57912,443,57912,443,4559,1652,2907,19,27,11,8,allow
50604,80,50604,80,1707,1007,700,11,21,6,5,allow
51959,443,27606,443,2648,1797,851,19,23,11,8,allow
58939,443,28561,443,6403,4065,2338,22,16,11,11,allow
32866,443,34870,443,23467,16522,6945,51,161,29,22,allow
49721,80,41494,80,340,140,200,6,15,3,3,allow
6960,53,6960,53,186,83,103,2,30,1,1,allow
56225,53,16256,53,188,96,92,2,30,1,1,allow
49696,443,61815,443,42348,4871,37477,71,150,40,31,allow
49330,443,4383,443,7913,2091,5822,23,42,11,12,allow
52138,443,52138,443,80933,20860,60073,121,324,66,55,allow
56800,443,5999,443,8337,2820,5517,19,30,10,9,allow
53861,53065,56189,53065,70,70,0,1,5,1,0,allow
52058,8329,7251,8329,66,66,0,1,5,1,0,allow
58936,443,15489,443,10014,6664,3350,28,17,14,14,allow
58874,443,39745,443,21478,2212,19266,47,86,19,28,allow
56528,443,48835,443,158084,6138,151946,173,95,64,109,allow
56553,53,20095,53,701,88,613,2,30,1,1,allow
57169,53,44732,53,170,87,83,2,30,1,1,allow
56879,53,15909,53,780,93,687,2,31,1,1,allow
6881,51413,48817,51413,200,111,89,2,1200,1,1,allow
65528,53,47715,53,217,75,142,4,30,2,2,allow
55065,53,19490,53,711,87,624,2,30,1,1,allow
56181,53,54189,53,764,99,665,2,31,1,1,allow
49485,53,58732,53,752,93,659,2,31,1,1,allow
56728,53,40582,53,744,95,649,2,31,1,1,allow
54692,443,45906,443,5907,2630,3277,21,147,10,11,allow
55036,53,30063,53,733,93,640,2,31,1,1,allow
50038,53,5932,53,170,87,83,2,31,1,1,allow
52707,443,49592,443,39551,4663,34888,60,357,27,33,allow
64877,53,24917,53,182,93,89,2,31,1,1,allow
55214,53,41945,53,711,87,624,2,31,1,1,allow
57246,53,12706,53,752,93,659,2,31,1,1,allow
39717,5228,64597,5228,7587,2099,5488,26,3602,14,12,allow
64931,53,32751,53,174,89,85,2,31,1,1,allow
57109,53,44560,53,711,87,624,2,31,1,1,allow
50645,53,43858,53,256,93,163,2,31,1,1,allow
55318,53,46114,53,711,87,624,2,31,1,1,allow
50550,5228,24310,5228,2661,1518,1143,18,3600,9,9,allow
63388,445,0,0,70,70,0,1,0,1,0,drop
63387,445,0,0,70,70,0,1,0,1,0,drop
25457,25604,0,0,145,145,0,1,0,1,0,deny
63384,445,0,0,70,70,0,1,0,1,0,drop
63385,445,0,0,70,70,0,1,0,1,0,drop
63545,25174,0,0,66,66,0,1,0,1,0,deny
63543,445,0,0,66,66,0,1,0,1,0,drop
1847,64147,0,0,66,66,0,1,0,1,0,deny
56127,37965,0,0,66,66,0,1,0,1,0,deny
47357,50584,0,0,62,62,0,1,0,1,0,deny
63369,445,0,0,70,70,0,1,0,1,0,drop
63368,445,0,0,70,70,0,1,0,1,0,drop
44993,53,47761,53,168,78,90,2,30,1,1,allow
57136,53,53104,53,177,94,83,2,30,1,1,allow
65513,53,25094,53,178,94,84,2,30,1,1,allow
36191,443,31290,443,9386,1934,7452,32,135,17,15,allow
60475,443,46189,443,5888,1175,4713,19,43,11,8,allow
60721,22114,0,0,62,62,0,1,0,1,0,deny
63362,445,0,0,70,70,0,1,0,1,0,drop
63536,445,0,0,66,66,0,1,0,1,0,drop
58900,37807,0,0,66,66,0,1,0,1,0,deny
63359,445,0,0,70,70,0,1,0,1,0,drop
63358,445,0,0,70,70,0,1,0,1,0,drop
63527,445,0,0,66,66,0,1,0,1,0,drop
59523,37965,0,0,62,62,0,1,0,1,0,deny
55425,37965,0,0,66,66,0,1,0,1,0,deny
53207,50584,0,0,66,66,0,1,0,1,0,deny
50126,23117,0,0,62,62,0,1,0,1,0,deny
62796,37807,0,0,62,62,0,1,0,1,0,deny
12830,25174,0,0,146,146,0,1,0,1,0,deny
56711,25174,0,0,62,62,0,1,0,1,0,deny
48230,57866,0,0,62,62,0,1,0,1,0,deny
51759,445,0,0,70,70,0,1,0,1,0,drop
51754,445,0,0,70,70,0,1,0,1,0,drop
51755,445,0,0,70,70,0,1,0,1,0,drop
63347,445,0,0,70,70,0,1,0,1,0,drop
50446,26467,0,0,66,66,0,1,0,1,0,deny
63517,445,0,0,66,66,0,1,0,1,0,drop
63518,445,0,0,66,66,0,1,0,1,0,drop
63515,445,0,0,66,66,0,1,0,1,0,drop
63520,445,0,0,66,66,0,1,0,1,0,drop
63513,445,0,0,66,66,0,1,0,1,0,drop
63514,445,0,0,66,66,0,1,0,1,0,drop
63519,445,0,0,66,66,0,1,0,1,0,drop
63512,445,0,0,66,66,0,1,0,1,0,drop
59018,22114,0,0,62,62,0,1,0,1,0,deny
68,67,0,0,346,346,0,1,0,1,0,deny
58509,21247,0,0,66,66,0,1,0,1,0,deny
53373,64147,0,0,66,66,0,1,0,1,0,deny
64077,25174,0,0,66,66,0,1,0,1,0,deny
56713,25174,0,0,146,146,0,1,0,1,0,deny
10914,35974,0,0,60,60,0,1,0,1,0,deny
63342,445,0,0,70,70,0,1,0,1,0,drop
7041,37965,0,0,66,66,0,1,0,1,0,deny
51752,445,0,0,70,70,0,1,0,1,0,drop
51753,445,0,0,70,70,0,1,0,1,0,drop
51751,445,0,0,70,70,0,1,0,1,0,drop
51738,445,0,0,70,70,0,1,0,1,0,drop
46734,50265,0,0,74,74,0,1,0,1,0,deny
5223,14446,0,0,220,220,0,1,0,1,0,deny
1377,44847,0,0,62,62,0,1,0,1,0,deny
63333,445,0,0,70,70,0,1,0,1,0,drop
63334,445,0,0,70,70,0,1,0,1,0,drop
63332,445,0,0,70,70,0,1,0,1,0,drop
44293,23,0,0,60,60,0,1,0,1,0,deny
44797,53,29838,53,179,86,93,2,29,1,1,allow
50102,53,50102,53,216,90,126,2,29,1,1,allow
57100,53,13292,53,402,118,284,2,30,1,1,allow
36277,443,45497,443,14212,8194,6018,38,104,21,17,allow
44649,443,58778,443,7013,1092,5921,21,31,12,9,allow
42294,443,1257,443,10384,4353,6031,29,251,16,13,allow
51155,443,7506,443,8351,2366,5985,41,185,20,21,allow
64104,53,1753,53,855,311,544,8,79,4,4,allow
41902,443,1832,443,6511,1866,4645,21,17,12,9,allow
56282,3389,56282,3389,3425,1470,1955,16,16,8,8,allow
50898,443,4601,443,8480,2236,6244,27,81,15,12,allow
52062,60388,22555,60388,70,70,0,1,5,1,0,allow
56733,80,32206,80,214,140,74,4,25,3,1,allow
51411,443,3217,443,1444,723,721,15,121,8,7,allow
64013,48970,31452,48970,70,70,0,1,4,1,0,allow
51990,443,58670,443,2094,1402,692,14,15,8,6,allow
35649,53,35649,53,220,90,130,2,29,1,1,allow
56225,53,65429,53,194,102,92,2,29,1,1,allow
57044,53,13631,53,177,94,83,2,29,1,1,allow
33415,53,42301,53,164,78,86,2,29,1,1,allow
39186,443,31509,443,8126,2183,5943,29,270,14,15,allow
55193,53,10853,53,177,94,83,2,29,1,1,allow
47681,443,29966,443,6790,1336,5454,20,187,11,9,allow
51606,443,52418,443,3013,1661,1352,14,20,8,6,allow
58784,443,58898,443,41305,2456,38849,63,30,29,34,allow
52470,443,33189,443,7915,1213,6702,23,50,12,11,allow
57169,53,49234,53,177,94,83,2,30,1,1,allow
39735,53,51086,53,223,78,145,2,30,1,1,allow
44313,53,51644,53,199,94,105,2,30,1,1,allow
64967,53,44002,53,751,102,649,2,30,1,1,allow
57017,53,22107,53,177,94,83,2,30,1,1,allow
52059,47363,55015,47363,70,70,0,1,5,1,0,allow
64024,57825,29804,57825,312,132,180,6,6,3,3,allow
60356,443,15398,443,8079,2282,5797,26,17,15,11,allow
49665,53,61260,53,361,118,243,4,33,2,2,allow
60501,443,35631,443,12006,3698,8308,23,15,13,10,allow
55694,62954,52341,62954,504,318,186,8,15,5,3,allow
49042,443,19321,443,5792,1764,4028,24,31,14,10,allow
59252,443,29438,443,8442,1134,7308,23,15,13,10,allow
65513,53,49907,53,186,102,84,2,30,1,1,allow
62487,443,47119,443,14840,3978,10862,32,33,15,17,allow
50820,80,16954,80,550,476,74,6,15,5,1,allow
56970,443,55404,443,16378,3002,13376,35,17,17,18,allow
52471,443,64710,443,8398,1552,6846,27,50,14,13,allow
36097,443,29806,443,6131,1384,4747,27,50,15,12,allow
46750,443,52499,443,350,210,140,6,25,4,2,allow
56752,443,37907,443,8007,1987,6020,20,15,11,9,allow
53849,17580,55160,17580,492,306,186,8,15,5,3,allow
49717,53,61877,53,781,94,687,2,30,1,1,allow
51878,443,1905,443,7241,1972,5269,28,68,16,12,allow
50822,80,16918,80,550,476,74,6,15,5,1,allow
43677,443,7474,443,7698,2373,5325,21,159,12,9,allow
52214,443,59996,443,10898,3170,7728,33,331,14,19,allow
55696,64301,60133,64301,316,190,126,5,15,3,2,allow
49715,53,2852,53,734,94,640,2,30,1,1,allow
57169,53,55485,53,177,94,83,2,30,1,1,allow
58207,443,31795,443,10209,2530,7679,33,223,17,16,allow
64583,443,48873,443,9150,2109,7041,27,32,15,12,allow
42951,443,65078,443,6513,1609,4904,26,303,14,12,allow
53016,80,9240,80,4419,271,4148,13,28,3,10,allow
54598,53,30660,53,168,78,90,2,30,1,1,allow
5380,53,15988,53,377,94,283,2,30,1,1,allow
50680,443,36184,443,2993,866,2127,10,120,5,5,allow
53844,16925,27697,16925,940,502,438,14,18,7,7,allow
52092,48658,51084,48658,316,136,180,6,7,3,3,allow
53076,443,8791,443,96850,6037,90813,150,177,55,95,allow
54953,53,34688,53,263,94,169,2,30,1,1,allow
49676,53,26255,53,216,110,106,2,30,1,1,allow
57136,53,3723,53,177,94,83,2,30,1,1,allow
54749,443,23422,443,273283,194709,78574,1567,3312,746,821,allow
42993,443,4203,443,7821,3237,4584,39,149,19,20,allow
43231,443,33460,443,56226,4852,51374,71,106,30,41,allow
57380,443,31912,443,5553,927,4626,16,15,10,6,allow
51409,443,17023,443,1442,721,721,15,122,8,7,allow
39651,443,15343,443,18514,4506,14008,72,105,41,31,allow
38528,443,36554,443,13608,3518,10090,48,217,24,24,allow
58744,443,58147,443,14878,4225,10653,83,330,41,42,allow
51175,443,19417,443,2132473,55149,2077324,2144,63,731,1413,allow
52091,4789,12478,4789,70,70,0,2,7,2,0,allow
58945,443,49273,443,5168,700,4468,16,15,7,9,allow
52088,35605,28933,35605,70,70,0,2,8,2,0,allow
49782,443,53470,443,70,70,0,2,7,2,0,allow
52096,443,13873,443,4747,3601,1146,18,15,10,8,allow
49826,443,11659,443,6105,852,5253,17,77,9,8,allow
52060,29868,29510,29868,70,70,0,1,5,1,0,allow
52061,35717,37968,35717,70,70,0,1,5,1,0,allow
65378,53,29573,53,476,121,355,4,40,2,2,allow
50603,80,50603,80,1706,1006,700,11,21,6,5,allow
62486,443,21615,443,10390,7057,3333,27,33,15,12,allow
48265,443,59042,443,4138,2416,1722,31,80,16,15,allow
36098,443,41283,443,5901,1324,4577,25,50,14,11,allow
56225,53,8973,53,194,102,92,2,29,1,1,allow
43861,123,6210,123,184,94,90,2,29,1,1,allow
58942,443,33385,443,5168,700,4468,16,15,7,9,allow
49800,53,35452,53,485,93,392,4,48,2,2,allow
64040,53,17235,53,226,102,124,2,29,1,1,allow
5588,5588,0,0,3562,1936,1626,48,194,24,24,allow
40495,53,8395,53,168,78,90,2,29,1,1,allow
54998,53,24555,53,168,78,90,2,30,1,1,allow
65110,53,31746,53,406,142,264,2,30,1,1,allow
41153,53,8565,53,168,78,90,2,30,1,1,allow
64950,53,51754,53,728,102,626,2,30,1,1,allow
65314,53,39947,53,195,102,93,2,30,1,1,allow
50130,53,10528,53,183,94,89,2,30,1,1,allow
56703,53,62070,53,183,94,89,2,31,1,1,allow
49858,53,41757,53,177,94,83,2,30,1,1,allow
47135,53,52086,53,199,94,105,2,30,1,1,allow
56367,53,30541,53,194,102,92,2,30,1,1,allow
64974,27054,45428,27054,3142,1386,1756,8,31,4,4,allow
56970,443,7987,443,6815,3817,2998,23,143,11,12,allow
51910,443,52422,443,29367,10171,19196,66,184,32,34,allow
65139,53,58108,53,754,94,660,2,31,1,1,allow
58785,443,2616,443,37165,2164,35001,58,29,28,30,allow
65386,53,49656,53,197,102,95,2,33,1,1,allow
62488,443,33482,443,1326,876,450,11,32,6,5,allow
46862,443,48242,443,6162,925,5237,18,179,10,8,allow
36099,443,35934,443,5901,1324,4577,25,50,14,11,allow
36815,443,48632,443,416,210,206,7,29,4,3,allow
65314,53,31001,53,195,102,93,2,30,1,1,allow
51081,53,49643,53,168,78,90,2,30,1,1,allow
57017,53,16260,53,177,94,83,2,30,1,1,allow
44864,443,47449,443,8779,1861,6918,34,120,17,17,allow
55404,443,57333,443,2352,1394,958,17,275,9,8,allow
57027,53,59688,53,177,94,83,2,31,1,1,allow
49675,7000,49675,7000,3132,815,2317,14,15,7,7,allow
58743,443,24933,443,14819,3993,10826,80,330,36,44,allow
52063,7886,16483,7886,70,70,0,1,5,1,0,allow
51989,80,9142,80,1344,899,445,8,15,6,2,allow
53077,443,54152,443,6173,924,5249,18,177,10,8,allow
52358,443,40970,443,4145,2738,1407,29,27,16,13,allow
64585,443,46353,443,24686,1935,22751,36,18,17,19,allow
50352,80,51125,80,2537,783,1754,13,25,7,6,allow
50477,443,60268,443,130,70,60,2,15,1,1,allow
40806,8000,37524,8000,195,71,124,4,58,2,2,allow
51756,53,33754,53,168,78,90,2,30,1,1,allow
42066,443,21363,443,377544,10569,366975,414,221,152,262,allow
49858,53,34344,53,177,94,83,2,30,1,1,allow
49657,53,23289,53,198,94,104,2,30,1,1,allow
57001,53,43521,53,177,94,83,2,30,1,1,allow
40880,443,42551,443,8142,2090,6052,22,360,10,12,allow
57027,53,37270,53,177,94,83,2,30,1,1,allow
49700,443,6522,443,39240,3804,35436,72,133,38,34,allow
56753,443,16519,443,8058,2038,6020,20,15,11,9,allow
53848,43725,33158,43725,552,306,246,9,15,5,4,allow
58944,443,12374,443,5166,700,4466,16,15,7,9,allow
46500,443,37783,443,494,280,214,8,29,5,3,allow
53437,6057,54615,6057,245,245,0,2,30,2,0,allow
57115,53,44854,53,728,102,626,2,30,1,1,allow
57001,53,25113,53,177,94,83,2,30,1,1,allow
50499,53,23624,53,718,94,624,2,30,1,1,allow
52434,53,49925,53,183,86,97,2,30,1,1,allow
65528,53,44314,53,168,86,82,2,30,1,1,allow
57833,443,7309,443,215996,13055,202941,265,127,96,169,allow
50091,53,1529,53,172,94,78,2,31,1,1,allow
50038,53,46782,53,177,94,83,2,31,1,1,allow
6881,6992,61749,6992,150,150,0,1,1200,1,0,allow
33227,53,32032,53,177,86,91,2,30,1,1,allow
49676,53,4887,53,216,110,106,2,30,1,1,allow
43366,53,27594,53,168,78,90,2,30,1,1,allow
50038,53,24889,53,177,94,83,2,30,1,1,allow
57387,53,49331,53,178,94,84,2,30,1,1,allow
42903,53,55150,53,168,78,90,2,30,1,1,allow
57001,53,51576,53,177,94,83,2,31,1,1,allow
40192,443,40192,443,11928,3226,8702,23,160,11,12,allow
52136,443,52136,443,298081,63335,234746,337,323,145,192,allow
65367,53,17484,53,271,94,177,2,30,1,1,allow
40204,40025,3762,40025,148,86,62,2,30,1,1,allow
64741,53,19831,53,420,110,310,2,30,1,1,allow
59218,53,41217,53,511,126,385,2,31,1,1,allow
65528,53,30567,53,168,86,82,2,31,1,1,allow
34244,443,6672,443,3528,1045,2483,13,120,6,7,allow
50461,443,13300,443,78333,12774,65559,140,128,59,81,allow
57470,50321,60490,50321,5231,5231,0,79,5173,79,0,allow
37658,16385,25619,16385,130,70,60,2,30,1,1,allow
64955,443,38956,443,2279,1129,1150,25,120,12,13,allow
64525,443,3519,443,5981,1902,4079,14,120,7,7,allow
15503,55878,37795,55878,481,150,331,2,1200,1,1,allow
37135,443,52476,443,16921,7469,9452,40,138,19,21,allow
37653,5223,43344,5223,142,142,0,1,5,1,0,allow
45755,443,42960,443,1625,1038,587,14,26,8,6,allow
37565,443,55641,443,4898,1119,3779,17,30,9,8,allow
37564,443,37233,443,1386,924,462,12,30,7,5,allow
51215,443,16837,443,11490,3671,7819,33,93,18,15,allow
37566,443,61835,443,1386,924,462,12,30,7,5,allow
40204,40038,53758,40038,585,86,499,2,30,1,1,allow
37658,16384,24782,16384,130,70,60,2,30,1,1,allow
63500,445,0,0,66,66,0,1,0,1,0,drop
63498,445,0,0,66,66,0,1,0,1,0,drop
63497,445,0,0,66,66,0,1,0,1,0,drop
63328,445,0,0,70,70,0,1,0,1,0,drop
51923,22114,0,0,146,146,0,1,0,1,0,deny
63326,445,0,0,70,70,0,1,0,1,0,drop
13062,52274,0,0,66,66,0,1,0,1,0,deny
31738,51505,0,0,62,62,0,1,0,1,0,deny
1080,8391,0,0,66,66,0,1,0,1,0,deny
53389,23,0,0,60,60,0,1,0,1,0,deny
51734,445,0,0,70,70,0,1,0,1,0,drop
51732,445,0,0,70,70,0,1,0,1,0,drop
51727,445,0,0,70,70,0,1,0,1,0,drop
51724,445,0,0,70,70,0,1,0,1,0,drop
51291,25174,0,0,62,62,0,1,0,1,0,deny
7048,25174,0,0,66,66,0,1,0,1,0,deny
13120,25174,0,0,62,62,0,1,0,1,0,deny
60311,30627,0,0,66,66,0,1,0,1,0,deny
56328,36237,0,0,62,62,0,1,0,1,0,deny
45964,55559,0,0,60,60,0,1,0,1,0,deny
1042,33175,0,0,145,145,0,1,0,1,0,deny
52781,57470,0,0,62,62,0,1,0,1,0,deny
45941,23386,0,0,60,60,0,1,0,1,0,deny
65233,23117,0,0,66,66,0,1,0,1,0,deny
37034,25174,0,0,146,146,0,1,0,1,0,deny
63320,445,0,0,70,70,0,1,0,1,0,drop
51271,37965,0,0,66,66,0,1,0,1,0,deny
63213,35440,0,0,62,62,0,1,0,1,0,deny
60980,5900,0,0,60,60,0,1,0,1,0,deny
63313,445,0,0,70,70,0,1,0,1,0,drop
63310,445,0,0,70,70,0,1,0,1,0,drop
42030,25,0,0,74,74,0,1,0,1,0,deny
51717,445,0,0,70,70,0,1,0,1,0,drop
51716,445,0,0,70,70,0,1,0,1,0,drop
51711,445,0,0,70,70,0,1,0,1,0,drop
65015,22114,0,0,62,62,0,1,0,1,0,deny
58627,64097,0,0,66,66,0,1,0,1,0,deny
31683,35440,0,0,62,62,0,1,0,1,0,deny
63488,445,0,0,66,66,0,1,0,1,0,drop
39061,22114,0,0,146,146,0,1,0,1,0,deny
50063,35776,0,0,148,148,0,1,0,1,0,deny
63307,445,0,0,70,70,0,1,0,1,0,drop
1114,37965,0,0,62,62,0,1,0,1,0,deny
36477,40740,0,0,145,145,0,1,0,1,0,deny
63305,445,0,0,70,70,0,1,0,1,0,drop
49797,25174,0,0,66,66,0,1,0,1,0,deny
27348,22114,0,0,62,62,0,1,0,1,0,deny
27969,25174,0,0,66,66,0,1,0,1,0,deny
62911,36237,0,0,62,62,0,1,0,1,0,deny
30304,64147,0,0,62,62,0,1,0,1,0,deny
12527,50584,0,0,62,62,0,1,0,1,0,deny
51709,445,0,0,70,70,0,1,0,1,0,drop
4793,50584,0,0,66,66,0,1,0,1,0,deny
21482,22114,0,0,62,62,0,1,0,1,0,deny
63301,445,0,0,70,70,0,1,0,1,0,drop
51708,445,0,0,70,70,0,1,0,1,0,drop
34811,56205,0,0,66,66,0,1,0,1,0,deny
25523,35974,0,0,62,62,0,1,0,1,0,deny
16570,25174,0,0,62,62,0,1,0,1,0,deny
24931,25174,0,0,146,146,0,1,0,1,0,deny
55161,37807,0,0,62,62,0,1,0,1,0,deny
63300,445,0,0,70,70,0,1,0,1,0,drop
53389,23,0,0,60,60,0,1,0,1,0,deny
63472,445,0,0,66,66,0,1,0,1,0,drop
63468,445,0,0,66,66,0,1,0,1,0,drop
55130,25174,0,0,62,62,0,1,0,1,0,deny
63032,22114,0,0,66,66,0,1,0,1,0,deny
61961,11392,0,0,66,66,0,1,0,1,0,deny
27995,22114,0,0,62,62,0,1,0,1,0,deny
51695,445,0,0,70,70,0,1,0,1,0,drop
51692,445,0,0,70,70,0,1,0,1,0,drop
51691,445,0,0,70,70,0,1,0,1,0,drop
51686,445,0,0,70,70,0,1,0,1,0,drop
63295,445,0,0,70,70,0,1,0,1,0,drop
54166,25174,0,0,62,62,0,1,0,1,0,deny
25063,64147,0,0,62,62,0,1,0,1,0,deny
63467,445,0,0,66,66,0,1,0,1,0,drop
59755,44512,0,0,66,66,0,1,0,1,0,deny
63457,445,0,0,66,66,0,1,0,1,0,drop
63459,445,0,0,66,66,0,1,0,1,0,drop
63455,445,0,0,66,66,0,1,0,1,0,drop
63453,445,0,0,66,66,0,1,0,1,0,drop
63452,445,0,0,66,66,0,1,0,1,0,drop
63450,445,0,0,66,66,0,1,0,1,0,drop
0,0,0,0,124,64,60,2,0,1,1,allow
13285,29892,0,0,145,145,0,1,0,1,0,deny
55116,7574,0,0,66,66,0,1,0,1,0,deny
51684,445,0,0,70,70,0,1,0,1,0,drop
51678,445,0,0,70,70,0,1,0,1,0,drop
51676,445,0,0,70,70,0,1,0,1,0,drop
51675,445,0,0,70,70,0,1,0,1,0,drop
27505,25174,0,0,62,62,0,1,0,1,0,deny
63282,445,0,0,70,70,0,1,0,1,0,drop
51834,35440,0,0,66,66,0,1,0,1,0,deny
27110,22114,0,0,62,62,0,1,0,1,0,deny
63279,445,0,0,70,70,0,1,0,1,0,drop
51609,37807,0,0,62,62,0,1,0,1,0,deny
55056,44512,0,0,62,62,0,1,0,1,0,deny
51674,445,0,0,70,70,0,1,0,1,0,drop
51672,445,0,0,70,70,0,1,0,1,0,drop
51669,445,0,0,70,70,0,1,0,1,0,drop
42344,48637,0,0,60,60,0,1,0,1,0,deny
63442,445,0,0,66,66,0,1,0,1,0,drop
49824,25174,0,0,146,146,0,1,0,1,0,deny
51666,445,0,0,70,70,0,1,0,1,0,drop
15113,25174,0,0,146,146,0,1,0,1,0,deny
25565,43088,0,0,60,60,0,1,0,1,0,deny
63440,445,0,0,66,66,0,1,0,1,0,drop
9552,57470,0,0,66,66,0,1,0,1,0,deny
59696,57470,0,0,62,62,0,1,0,1,0,deny
6036,51505,0,0,66,66,0,1,0,1,0,deny
63474,48817,0,0,62,62,0,1,0,1,0,deny
63438,445,0,0,66,66,0,1,0,1,0,drop
63437,445,0,0,66,66,0,1,0,1,0,drop
10547,57470,0,0,62,62,0,1,0,1,0,deny
50084,26672,0,0,62,62,0,1,0,1,0,deny
63274,445,0,0,70,70,0,1,0,1,0,drop
35657,48637,0,0,62,62,0,1,0,1,0,deny
63273,445,0,0,70,70,0,1,0,1,0,drop
49651,37965,0,0,74,74,0,1,0,1,0,deny
63436,445,0,0,66,66,0,1,0,1,0,drop
61738,2767,0,0,62,62,0,1,0,1,0,deny
42075,36237,0,0,146,146,0,1,0,1,0,deny
8229,22114,0,0,62,62,0,1,0,1,0,deny
7210,22114,0,0,62,62,0,1,0,1,0,deny
63271,445,0,0,70,70,0,1,0,1,0,drop
47040,25174,0,0,62,62,0,1,0,1,0,deny
23021,25174,0,0,62,62,0,1,0,1,0,deny
51663,445,0,0,70,70,0,1,0,1,0,drop
57761,30317,0,0,66,66,0,1,0,1,0,deny
48817,21939,48817,21939,513,152,361,2,1200,1,1,allow
56367,53,52598,53,188,96,92,2,31,1,1,allow
49601,53,48706,53,762,97,665,2,30,1,1,allow
55892,53,8349,53,182,93,89,2,30,1,1,allow
56370,443,46541,443,3715,1791,1924,23,203,12,11,allow
56361,443,32525,443,3775,1791,1984,24,203,12,12,allow
57809,53,57809,53,213,79,134,2,33,1,1,allow
41850,53,41850,53,257,101,156,2,33,1,1,allow
35485,443,29586,443,1633,1038,595,14,34,8,6,allow
5588,5588,0,0,3562,1936,1626,48,195,24,24,allow
55388,53,60267,53,170,87,83,2,31,1,1,allow
53918,53,0,0,222,82,140,2,30,1,1,allow
50078,443,50829,443,7418,2721,4697,23,17,12,11,allow
62042,80,65130,80,10924,548,10376,17,48,6,11,allow
56353,443,16805,443,3775,1791,1984,24,203,12,12,allow
56365,443,26003,443,3734,1750,1984,24,203,12,12,allow
56356,443,29331,443,3734,1750,1984,24,203,12,12,allow
33734,53,33734,53,257,101,156,2,33,1,1,allow
9405,443,45039,443,5691,503,5188,14,15,7,7,allow
52261,5222,10119,5222,5380,2214,3166,55,503,26,29,allow
57196,53,50893,53,182,93,89,2,30,1,1,allow
51439,443,28008,443,10119,1855,8264,26,28,15,11,allow
47034,443,4001,443,4531,3268,1263,23,27,13,10,allow
53512,443,1529,443,1625,1038,587,14,34,8,6,allow
58463,53,64645,53,380,88,292,2,30,1,1,allow
38677,443,26000,443,5306,1619,3687,20,29,12,8,allow
55693,45341,22935,45341,70,70,0,1,5,1,0,allow
58930,443,60456,443,10413,7123,3290,30,18,17,13,allow
49236,443,49236,443,554853,293345,261508,600,69,317,283,allow
56369,443,26395,443,3674,1750,1924,23,203,12,11,allow
56359,443,2986,443,3734,1750,1984,24,203,12,12,allow
56360,443,15487,443,3734,1750,1984,24,203,12,12,allow
58928,443,59647,443,6548,4210,2338,23,18,12,11,allow
64988,27052,9710,27052,735,462,273,2,31,1,1,allow
48817,46429,48817,46429,763,296,467,4,1200,2,2,allow
56355,443,33571,443,3734,1750,1984,24,203,12,12,allow
38676,443,10906,443,5306,1619,3687,20,29,12,8,allow
50443,80,50443,80,73400,3702,69698,77,19,26,51,allow
56362,443,16235,443,3734,1750,1984,24,203,12,12,allow
53513,443,7067,443,1625,1038,587,14,34,8,6,allow
52632,443,52632,443,4351,1444,2907,19,28,11,8,allow
56363,443,61094,443,3734,1750,1984,24,203,12,12,allow
53516,443,26441,443,560,280,280,9,34,5,4,allow
14605,53,14605,53,209,77,132,2,32,1,1,allow
56354,443,18179,443,3775,1791,1984,24,203,12,12,allow
41252,53,41252,53,398,255,143,3,32,2,1,allow
56368,443,23641,443,3734,1750,1984,24,203,12,12,allow
64877,53,58345,53,182,93,89,2,30,1,1,allow
56358,443,57449,443,3734,1750,1984,24,203,12,12,allow
49611,19000,49520,19000,594,174,420,2,31,1,1,allow
55046,443,52512,443,3804,1099,2705,19,137,8,11,allow
46441,443,33380,443,416,210,206,7,28,4,3,allow
48817,6881,48817,6881,863,363,500,4,1200,2,2,allow
53146,443,41053,443,29874004,955051,28918953,31844,303,10580,21264,allow
38675,443,48538,443,5236,1549,3687,19,29,11,8,allow
35484,443,11377,443,1633,1038,595,14,34,8,6,allow
49237,443,49237,443,33985,8645,25340,53,35,28,25,allow
57442,2258,57442,2258,156,156,0,3,8,3,0,allow
56367,443,45911,443,3674,1750,1924,23,203,12,11,allow
56366,443,31914,443,3715,1791,1924,23,203,12,11,allow
56357,443,45710,443,3674,1750,1924,23,203,12,11,allow
56364,443,6103,443,3775,1791,1984,24,203,12,12,allow
56312,53,62143,53,711,87,624,2,30,1,1,allow
56615,53,58132,53,170,87,83,2,30,1,1,allow
39017,443,58610,443,5176,861,4315,16,26,9,7,allow
57027,53,52973,53,170,87,83,2,30,1,1,allow
50619,53,43137,53,815,95,720,2,30,1,1,allow
63440,53,0,0,206,95,111,2,30,1,1,allow
48817,33028,48817,33028,152,152,0,1,1200,1,0,allow
48817,13073,48817,13073,787,296,491,4,1200,2,2,allow
56088,53,23327,53,256,93,163,2,31,1,1,allow
55179,53,34684,53,182,93,89,2,31,1,1,allow
35708,443,18676,443,8264,1910,6354,21,361,10,11,allow
50176,53,47477,53,768,99,669,2,31,1,1,allow
38287,443,17803,443,424,210,214,7,131,4,3,allow
48817,27003,48817,27003,839,296,543,4,1200,2,2,allow
6881,6881,29502,6881,231,111,120,2,1200,1,1,allow
48817,16156,48817,16156,513,152,361,2,1200,1,1,allow
55349,53,40115,53,701,88,613,2,31,1,1,allow
48817,6884,48817,6884,479,277,202,4,1200,2,2,allow
48817,6881,48817,6881,479,277,202,4,1200,2,2,allow
45184,5228,38008,5228,9107,2358,6749,24,3600,13,11,allow
62988,60038,0,0,66,66,0,1,90,1,0,allow
51656,445,0,0,70,70,0,1,0,1,0,drop
51652,445,0,0,70,70,0,1,0,1,0,drop
54140,17372,0,0,66,66,0,1,0,1,0,deny
2543,25174,0,0,66,66,0,1,0,1,0,deny
55464,22114,0,0,62,62,0,1,0,1,0,deny
63264,445,0,0,70,70,0,1,0,1,0,drop
63423,445,0,0,66,66,0,1,0,1,0,drop
63364,57470,0,0,66,66,0,1,0,1,0,deny
52925,64147,0,0,62,62,0,1,0,1,0,deny
63262,445,0,0,70,70,0,1,0,1,0,drop
43639,26467,0,0,66,66,0,1,0,1,0,deny
26881,25174,0,0,66,66,0,1,0,1,0,deny
40128,80,6000,80,2437,1277,1160,12,16,7,5,allow
19944,22114,0,0,62,62,0,1,0,1,0,deny
63261,445,0,0,70,70,0,1,0,1,0,drop
22636,30188,0,0,66,66,0,1,0,1,0,deny
63260,445,0,0,70,70,0,1,0,1,0,drop
35937,25174,0,0,66,66,0,1,0,1,0,deny
63416,445,0,0,66,66,0,1,0,1,0,drop
63259,445,0,0,70,70,0,1,0,1,0,drop
19662,22114,0,0,62,62,0,1,0,1,0,deny
51638,445,0,0,70,70,0,1,0,1,0,drop
63253,445,0,0,70,70,0,1,0,1,0,drop
63254,445,0,0,70,70,0,1,0,1,0,drop
45169,14037,0,0,74,74,0,1,0,1,0,deny
60793,53733,0,0,66,66,0,1,0,1,0,deny
63414,445,0,0,66,66,0,1,0,1,0,drop
63239,445,0,0,70,70,0,1,0,1,0,drop
63237,445,0,0,70,70,0,1,0,1,0,drop
63234,445,0,0,70,70,0,1,0,1,0,drop
63229,445,0,0,70,70,0,1,0,1,0,drop
37555,16385,34137,16385,130,70,60,2,30,1,1,allow
56367,53,38735,53,194,102,92,2,30,1,1,allow
50980,443,12783,443,3964,1908,2056,23,94,13,10,allow
56751,443,1821,443,8059,2039,6020,20,15,11,9,allow
50038,53,65055,53,286,87,199,4,59,2,2,allow
34200,443,26443,443,7341,2121,5220,18,135,8,10,allow
56477,443,27592,443,5638,2934,2704,15,120,7,8,allow
54762,53,0,0,86,86,0,1,30,1,0,allow
46767,443,3623,443,8376,2231,6145,25,330,12,13,allow
45754,443,17919,443,1625,1038,587,14,25,8,6,allow
49558,443,48351,443,12704,3459,9245,50,1336,18,32,allow
34456,80,16801,80,2913,633,2280,15,16,8,7,allow
44293,443,16772,443,5880,2280,3600,31,76,14,17,allow
49928,443,19902,443,4904,864,4040,17,28,10,7,allow
49929,443,10803,443,7069,2667,4402,22,28,13,9,allow
40634,443,26237,443,4917,1273,3644,17,34,10,7,allow
41821,80,46291,80,1056,362,694,10,49,6,4,allow
64877,53,56552,53,183,94,89,2,29,1,1,allow
41613,80,21847,80,6003,691,5312,13,16,7,6,allow
41612,80,44236,80,2016,552,1464,8,16,5,3,allow
56615,53,39007,53,177,94,83,2,29,1,1,allow
57111,53,59340,53,199,94,105,2,30,1,1,allow
39924,443,50465,443,5229,1002,4227,21,16,11,10,allow
60794,20010,30261,20010,70,70,0,2,8,2,0,allow
56669,80,21282,80,234,234,0,4,12,4,0,allow
55794,443,55794,443,4578,1671,2907,19,28,11,8,allow
64723,53,45766,53,329,118,211,2,30,1,1,allow
38360,53,56266,53,168,78,90,2,30,1,1,allow
57027,53,33808,53,177,94,83,2,30,1,1,allow
56985,443,5059,443,2281,1126,1155,25,120,12,13,allow
55388,53,1153,53,177,94,83,2,30,1,1,allow
56747,53,48027,53,226,110,116,2,30,1,1,allow
56492,53,39207,53,177,94,83,2,30,1,1,allow
56747,53,24796,53,172,94,78,2,30,1,1,allow
55171,53,4183,53,79,79,0,2,34,2,0,allow
51911,80,54033,80,5474,1920,3554,20,65,12,8,allow
54743,80,43064,80,6453,1316,5137,16,315,9,7,allow
60337,443,11026,443,1862,1223,639,18,89,11,7,allow
56437,80,52294,80,17128,1499,15629,24,21,9,15,allow
55535,80,6697,80,18450,1862,16588,29,17,15,14,allow
34952,53,65291,53,177,94,83,2,30,1,1,allow
60553,443,11360,443,7981,1867,6114,32,313,17,15,allow
56221,443,24462,443,129824,16359,113465,185,459,79,106,allow
64009,80,25096,80,314,192,122,6,15,4,2,allow
56703,53,54677,53,183,94,89,2,30,1,1,allow
58938,443,4576,443,6035,770,5265,18,15,8,10,allow
34452,80,18909,80,6260,696,5564,17,16,9,8,allow
55258,53,4040,53,177,94,83,2,30,1,1,allow
56615,53,33953,53,177,94,83,2,30,1,1,allow
64443,53,23166,53,878,184,694,6,71,3,3,allow
57235,53,31902,53,210,102,108,2,30,1,1,allow
64971,27026,15730,27026,1012,462,550,4,30,2,2,allow
55179,53,18189,53,183,94,89,2,30,1,1,allow
56492,53,3429,53,177,94,83,2,30,1,1,allow
63989,53,19416,53,259,110,149,2,30,1,1,allow
65528,53,21468,53,168,86,82,2,30,1,1,allow
56490,443,32124,443,163763,5320,158443,178,120,60,118,allow
40146,443,31443,443,280,140,140,5,130,3,2,allow
40877,443,50860,443,6451,1003,5448,21,360,11,10,allow
48817,47005,48817,47005,158,158,0,1,1200,1,0,allow
55937,53,13424,53,177,94,83,2,30,1,1,allow
34454,80,29541,80,2913,633,2280,15,16,8,7,allow
9394,443,24044,443,3613,433,3180,11,15,6,5,allow
43166,80,43166,80,26540,1137,25403,36,136,15,21,allow
65480,53,23239,53,211,102,109,2,30,1,1,allow
37555,16384,61049,16384,130,70,60,2,30,1,1,allow
65263,53,53101,53,232,110,122,2,30,1,1,allow
56747,53,24392,53,172,94,78,2,30,1,1,allow
44080,443,25950,443,7476,2315,5161,18,135,8,10,allow
50986,443,50781,443,67798,17043,50755,202,146,110,92,allow
10125,443,63386,443,6151,2939,3212,28,332,13,15,allow
8890,443,57332,443,4367,1108,3259,37,426,11,26,allow
51979,443,24826,443,10613,3156,7457,42,15,24,18,allow
56396,443,27935,443,4239,1850,2389,25,179,12,13,allow
35265,80,15083,80,3524,2698,826,14,16,8,6,allow
5588,5588,0,0,3562,1936,1626,48,194,24,24,allow
51221,65427,56298,65427,460,150,310,2,1200,1,1,allow
60338,443,20283,443,3648,2251,1397,28,89,16,12,allow
9404,443,30760,443,5693,499,5194,14,15,7,7,allow
9407,443,42706,443,5697,503,5194,14,15,7,7,allow
49158,80,49158,80,10922,816,10106,19,18,8,11,allow
49935,443,48016,443,366,180,186,7,28,4,3,allow
49631,53,64330,53,198,102,96,2,33,1,1,allow
65422,53,8384,53,448,84,364,4,54,2,2,allow
54955,443,20454,443,10265,1831,8434,34,319,17,17,allow
52070,80,56531,80,3572,2746,826,14,15,8,6,allow
61406,443,61406,443,4529,1622,2907,19,27,11,8,allow
45727,443,38522,443,1625,1038,587,14,29,8,6,allow
41820,80,9493,80,1056,362,694,10,49,6,4,allow
32961,80,43846,80,480,258,222,8,12,5,3,allow
57913,443,45296,443,9578079,276384,9301695,9817,153,2984,6833,allow
38142,53,38142,53,404,259,145,3,32,2,1,allow
55763,8060,49115,8060,70,70,0,2,7,2,0,allow
56749,443,28025,443,8058,2038,6020,20,15,11,9,allow
50657,80,54275,80,23292,2267,21025,28,21,10,18,allow
59779,443,11374,443,142,142,0,1,5,1,0,allow
50441,80,50441,80,79227,5480,73747,89,19,32,57,allow
56279,443,27594,443,15248,5524,9724,54,364,27,27,allow
49566,443,36540,443,10225,5069,5156,30,106,17,13,allow
58420,53,57046,53,351,78,273,2,29,1,1,allow
56615,53,15642,53,177,94,83,2,29,1,1,allow
5588,5588,0,0,3562,1936,1626,48,193,24,24,allow
50130,53,58704,53,183,94,89,2,29,1,1,allow
50130,53,12691,53,183,94,89,2,29,1,1,allow
49008,53,13913,53,168,78,90,2,29,1,1,allow
58940,443,24448,443,5108,700,4408,15,15,7,8,allow
37658,16386,64660,16386,130,70,60,2,29,1,1,allow
34458,80,25271,80,6260,696,5564,17,16,9,8,allow
57387,53,39674,53,178,94,84,2,30,1,1,allow
48933,443,5665,443,4372,2402,1970,27,53,14,13,allow
50091,53,50600,53,164,86,78,2,30,1,1,allow
64927,53,2368,53,315,110,205,2,30,1,1,allow
55545,3389,55545,3389,3527,1638,1889,18,18,11,7,allow
55388,53,28391,53,177,94,83,2,30,1,1,allow
55258,53,48782,53,177,94,83,2,30,1,1,allow
50439,80,50439,80,96018,5956,90062,107,20,41,66,allow
64938,53,18539,53,210,102,108,2,30,1,1,allow
49545,53,14108,53,195,102,93,2,30,1,1,allow
40878,443,41466,443,6517,1003,5514,22,360,11,11,allow
50265,16082,44635,16082,858,858,0,14,1200,14,0,allow
60449,80,21730,80,50477,10880,39597,69,16,33,36,allow
45289,80,45289,80,144717,5580,139137,180,20,81,99,allow
56750,443,39492,443,8006,1986,6020,20,15,11,9,allow
58021,443,29855,443,8075,4109,3966,42,91,19,23,allow
38702,443,49260,443,1117339,17881,1099458,1006,16,256,750,allow
47508,443,1346,443,5778,1095,4683,17,26,10,7,allow
56748,443,11472,443,8007,1987,6020,20,15,11,9,allow
49653,80,47758,80,2815,1605,1210,17,166,9,8,allow
37555,16386,23177,16386,130,70,60,2,30,1,1,allow
57196,53,25390,53,183,94,89,2,30,1,1,allow
59732,27036,24754,27036,1218,924,294,6,30,3,3,allow
54951,443,21945,443,69882,3520,66362,96,320,38,58,allow
64249,53,23999,53,181,94,87,2,33,1,1,allow
48728,80,37214,80,3524,2698,826,14,16,8,6,allow
47643,80,39174,80,3524,2698,826,14,16,8,6,allow
55544,3389,55544,3389,3657,1638,2019,20,18,11,9,allow
56513,53,54850,53,215,102,113,2,30,1,1,allow
64975,27033,50776,27033,734,462,272,2,30,1,1,allow
56703,53,38555,53,183,94,89,2,30,1,1,allow
55840,53,36401,53,199,94,105,2,30,1,1,allow
56559,53,54013,53,177,94,83,2,30,1,1,allow
41554,53,50330,53,199,94,105,2,30,1,1,allow
59773,53,11146,53,218,78,140,2,31,1,1,allow
56134,53,62024,53,183,94,89,2,31,1,1,allow
55283,443,55908,443,2964,1657,1307,18,47,9,9,allow
60474,8999,37889,8999,70,70,0,2,8,2,0,allow
65455,53,29477,53,564,108,456,4,50,2,2,allow
50635,53,9293,53,199,94,105,2,30,1,1,allow
43818,53,4303,53,168,78,90,2,30,1,1,allow
51958,443,6859,443,9994,8270,1724,34,68,19,15,allow
64931,53,5623,53,179,94,85,2,30,1,1,allow
56588,53,8372,53,197,102,95,2,30,1,1,allow
56559,53,63676,53,177,94,83,2,30,1,1,allow
65390,53,64921,53,387,134,253,2,30,1,1,allow
64023,53,29476,53,179,94,85,2,30,1,1,allow
40876,443,14567,443,6450,1003,5447,21,360,11,10,allow
65427,53,2149,53,238,94,144,2,30,1,1,allow
55759,53,49971,53,177,94,83,2,30,1,1,allow
64707,53,25293,53,216,102,114,2,30,1,1,allow
10151,6889,16341,6889,481,150,331,2,1200,1,1,allow
48817,6889,48817,6889,158,158,0,1,1200,1,0,allow
48817,6881,48817,6881,334,158,176,2,1200,1,1,allow
48817,63615,48817,63615,765,296,469,4,1200,2,2,allow
61140,443,36707,443,10803,2906,7897,20,135,10,10,allow
57441,443,53245,443,9774,3034,6740,29,19,14,15,allow
60795,40010,57308,40010,316,136,180,6,6,3,3,allow
50077,80,42513,80,804,380,424,9,15,5,4,allow
55937,53,36384,53,177,94,83,2,30,1,1,allow
55643,53,52917,53,183,94,89,2,31,1,1,allow
38703,443,53775,443,90561,3481,87080,96,16,31,65,allow
52082,14804,9932,14804,70,70,0,2,8,2,0,allow
55179,53,17808,53,183,94,89,2,30,1,1,allow
43681,443,22567,443,40598,5313,35285,83,97,43,40,allow
56747,443,61148,443,8059,2039,6020,20,16,11,9,allow
63228,445,0,0,70,70,0,1,0,1,0,drop
63407,445,0,0,66,66,0,1,0,1,0,drop
63404,445,0,0,66,66,0,1,0,1,0,drop
21064,25174,0,0,62,62,0,1,0,1,0,deny
51578,44847,0,0,66,66,0,1,0,1,0,deny
14397,37965,0,0,62,62,0,1,0,1,0,deny
10914,35974,0,0,60,60,0,1,0,1,0,deny
61767,25174,0,0,62,62,0,1,0,1,0,deny
515,10214,0,0,66,66,0,1,0,1,0,deny
36696,25174,0,0,62,62,0,1,0,1,0,deny
63217,445,0,0,70,70,0,1,0,1,0,drop
59524,25174,0,0,66,66,0,1,0,1,0,deny
1262,23,0,0,60,60,0,1,0,1,0,deny
63062,11392,0,0,66,66,0,1,0,1,0,deny
5228,3434,0,0,1093,1093,0,1,0,1,0,deny
51630,445,0,0,70,70,0,1,0,1,0,drop
51626,445,0,0,70,70,0,1,0,1,0,drop
51627,445,0,0,70,70,0,1,0,1,0,drop
63387,445,0,0,66,66,0,1,0,1,0,drop
63389,445,0,0,66,66,0,1,0,1,0,drop
63391,445,0,0,66,66,0,1,0,1,0,drop
63390,445,0,0,66,66,0,1,0,1,0,drop
63388,445,0,0,66,66,0,1,0,1,0,drop
63385,445,0,0,66,66,0,1,0,1,0,drop
63386,445,0,0,66,66,0,1,0,1,0,drop
63384,445,0,0,66,66,0,1,0,1,0,drop
52483,1433,0,0,60,60,0,1,0,1,0,deny
60403,22114,0,0,66,66,0,1,0,1,0,deny
26531,37965,0,0,62,62,0,1,0,1,0,deny
443,61686,0,0,1484,1484,0,1,0,1,0,deny
31235,22114,0,0,62,62,0,1,0,1,0,deny
63213,445,0,0,70,70,0,1,0,1,0,drop
22439,25174,0,0,66,66,0,1,0,1,0,deny
52340,64147,0,0,66,66,0,1,0,1,0,deny
1865,25174,0,0,62,62,0,1,0,1,0,deny
26235,37965,0,0,66,66,0,1,0,1,0,deny
63203,445,0,0,70,70,0,1,0,1,0,drop
63204,445,0,0,70,70,0,1,0,1,0,drop
51621,445,0,0,70,70,0,1,0,1,0,drop
51622,445,0,0,70,70,0,1,0,1,0,drop
51609,445,0,0,70,70,0,1,0,1,0,drop
51610,445,0,0,70,70,0,1,0,1,0,drop
63200,445,0,0,70,70,0,1,0,1,0,drop
63196,445,0,0,70,70,0,1,0,1,0,drop
16454,25174,0,0,62,62,0,1,0,1,0,deny
63369,445,0,0,66,66,0,1,0,1,0,drop
63370,445,0,0,66,66,0,1,0,1,0,drop
63368,445,0,0,66,66,0,1,0,1,0,drop
9089,55108,0,0,148,148,0,1,0,1,0,deny
32736,22114,0,0,66,66,0,1,0,1,0,deny
34152,11119,0,0,148,148,0,1,0,1,0,deny
28795,37965,0,0,62,62,0,1,0,1,0,deny
22220,25174,0,0,146,146,0,1,0,1,0,deny
59476,23,0,0,60,60,0,1,0,1,0,deny
50046,22114,0,0,62,62,0,1,0,1,0,deny
48706,23393,0,0,60,60,0,1,0,1,0,deny
42030,25,0,0,74,74,0,1,0,1,0,deny
51607,445,0,0,70,70,0,1,0,1,0,drop
57131,35776,0,0,145,145,0,1,0,1,0,deny
51604,445,0,0,70,70,0,1,0,1,0,drop
51600,445,0,0,70,70,0,1,0,1,0,drop
51597,445,0,0,70,70,0,1,0,1,0,drop
63191,445,0,0,70,70,0,1,0,1,0,drop
1860,25174,0,0,66,66,0,1,0,1,0,deny
2849,30188,0,0,62,62,0,1,0,1,0,deny
2083,25174,0,0,62,62,0,1,0,1,0,deny
64587,43890,0,0,66,66,0,1,0,1,0,deny
50328,22114,0,0,66,66,0,1,0,1,0,deny
54236,36829,0,0,66,66,0,1,0,1,0,deny
1620,53567,0,0,66,66,0,1,0,1,0,deny
6247,51221,0,0,78,78,0,1,0,1,0,deny
63183,445,0,0,70,70,0,1,0,1,0,drop
53073,32468,0,0,66,66,0,1,0,1,0,deny
25878,25174,0,0,66,66,0,1,0,1,0,deny
57496,25174,0,0,66,66,0,1,0,1,0,deny
63182,445,0,0,70,70,0,1,0,1,0,drop
51414,22,0,0,60,60,0,1,0,1,0,deny
62512,25174,0,0,62,62,0,1,0,1,0,deny
2383,37965,0,0,66,66,0,1,0,1,0,deny
51588,445,0,0,70,70,0,1,0,1,0,drop
51587,445,0,0,70,70,0,1,0,1,0,drop
51584,445,0,0,70,70,0,1,0,1,0,drop
29972,50584,0,0,62,62,0,1,0,1,0,deny
63176,445,0,0,70,70,0,1,0,1,0,drop
25570,35440,0,0,146,146,0,1,0,1,0,deny
6729,51505,0,0,62,62,0,1,0,1,0,deny
63357,445,0,0,66,66,0,1,0,1,0,drop
11878,37807,0,0,62,62,0,1,0,1,0,deny
63175,445,0,0,70,70,0,1,0,1,0,drop
55341,39004,0,0,74,74,0,1,0,1,0,deny
58627,25174,0,0,62,62,0,1,0,1,0,deny
63171,445,0,0,70,70,0,1,0,1,0,drop
11136,15503,0,0,62,62,0,1,0,1,0,deny
24144,57470,0,0,62,62,0,1,0,1,0,deny
51581,445,0,0,70,70,0,1,0,1,0,drop
52238,26467,0,0,62,62,0,1,0,1,0,deny
51579,445,0,0,70,70,0,1,0,1,0,drop
63170,445,0,0,70,70,0,1,0,1,0,drop
5228,3434,0,0,1093,1093,0,1,0,1,0,deny
5228,3434,0,0,601,601,0,1,0,1,0,deny
5228,3434,0,0,345,345,0,1,0,1,0,deny
40312,55442,0,0,62,62,0,1,0,1,0,deny
47788,30170,0,0,146,146,0,1,0,1,0,deny
30373,23,0,0,60,60,0,1,0,1,0,deny
42285,57470,0,0,62,62,0,1,0,1,0,deny
50734,37965,0,0,62,62,0,1,0,1,0,deny
28192,50584,0,0,66,66,0,1,0,1,0,deny
45726,64147,0,0,62,62,0,1,0,1,0,deny
0,0,0,0,198,128,70,3,0,2,1,allow
47913,25174,0,0,62,62,0,1,0,1,0,deny
52038,50584,0,0,62,62,0,1,0,1,0,deny
63339,445,0,0,66,66,0,1,0,1,0,drop
63341,445,0,0,66,66,0,1,0,1,0,drop
56127,37965,0,0,66,66,0,1,0,1,0,deny
23658,18375,0,0,62,62,0,1,0,1,0,deny
30500,26296,0,0,159,159,0,1,0,1,0,deny
34073,37965,0,0,62,62,0,1,0,1,0,deny
63165,445,0,0,70,70,0,1,0,1,0,drop
54280,3385,0,0,60,60,0,1,0,1,0,deny
51569,445,0,0,70,70,0,1,0,1,0,drop
51567,445,0,0,70,70,0,1,0,1,0,drop
51566,445,0,0,70,70,0,1,0,1,0,drop
51560,445,0,0,70,70,0,1,0,1,0,drop
1943,48817,0,0,62,62,0,1,0,1,0,deny
48301,25174,0,0,66,66,0,1,0,1,0,deny
63336,445,0,0,66,66,0,1,0,1,0,drop
39110,50584,0,0,62,62,0,1,0,1,0,deny
56872,21247,0,0,74,74,0,1,0,1,0,deny
3399,25174,0,0,66,66,0,1,0,1,0,deny
54726,30041,0,0,66,66,0,1,0,1,0,deny
63325,445,0,0,66,66,0,1,0,1,0,drop
63331,445,0,0,66,66,0,1,0,1,0,drop
63330,445,0,0,66,66,0,1,0,1,0,drop
63328,445,0,0,66,66,0,1,0,1,0,drop
63320,445,0,0,66,66,0,1,0,1,0,drop
63329,445,0,0,66,66,0,1,0,1,0,drop
63326,445,0,0,66,66,0,1,0,1,0,drop
52682,22114,0,0,66,66,0,1,0,1,0,deny
60097,22114,0,0,62,62,0,1,0,1,0,deny
32746,50584,0,0,146,146,0,1,0,1,0,deny
42986,25174,0,0,66,66,0,1,0,1,0,deny
13235,44847,0,0,66,66,0,1,0,1,0,deny
51554,445,0,0,70,70,0,1,0,1,0,drop
27038,51505,0,0,146,146,0,1,0,1,0,deny
45118,39004,0,0,74,74,0,1,0,1,0,deny
49824,25174,0,0,62,62,0,1,0,1,0,deny
36663,22114,0,0,146,146,0,1,0,1,0,deny
51551,445,0,0,70,70,0,1,0,1,0,drop
51548,445,0,0,70,70,0,1,0,1,0,drop
51547,445,0,0,70,70,0,1,0,1,0,drop
39313,37965,0,0,62,62,0,1,0,1,0,deny
63152,445,0,0,70,70,0,1,0,1,0,drop
6843,42873,0,0,62,62,0,1,0,1,0,deny
57991,22114,0,0,66,66,0,1,0,1,0,deny
6842,42873,0,0,66,66,0,1,0,1,0,deny
43207,26467,0,0,62,62,0,1,0,1,0,deny
54021,25174,0,0,62,62,0,1,0,1,0,deny
35111,22114,0,0,66,66,0,1,0,1,0,deny
36804,25174,0,0,66,66,0,1,0,1,0,deny
39959,23117,0,0,62,62,0,1,0,1,0,deny
39839,22114,0,0,146,146,0,1,0,1,0,deny
43814,34476,0,0,146,146,0,1,0,1,0,deny
63149,445,0,0,70,70,0,1,0,1,0,drop
56289,25174,0,0,66,66,0,1,0,1,0,deny
51866,22114,0,0,66,66,0,1,0,1,0,deny
30304,26467,0,0,62,62,0,1,0,1,0,deny
52166,26467,0,0,66,66,0,1,0,1,0,deny
51543,445,0,0,70,70,0,1,0,1,0,drop
51544,445,0,0,70,70,0,1,0,1,0,drop
51540,445,0,0,70,70,0,1,0,1,0,drop
63316,445,0,0,66,66,0,1,0,1,0,drop
45964,2225,0,0,60,60,0,1,0,1,0,deny
26940,443,35054,443,7599,2842,4757,27,22,15,12,allow
57702,53,57702,53,398,255,143,3,32,2,1,allow
58929,443,63640,443,6160,4121,2039,22,17,11,11,allow
56149,53,12166,53,174,89,85,2,30,1,1,allow
56902,53,41488,53,768,99,669,2,30,1,1,allow
55609,53,45313,53,172,88,84,2,30,1,1,allow
58986,443,33028,443,2894,1653,1241,24,26,12,12,allow
44661,443,11205,443,9468,2242,7226,23,15,12,11,allow
59923,53,59923,53,365,233,132,3,33,2,1,allow
6159,53,6159,53,404,259,145,3,32,2,1,allow
53875,43611,35716,43611,70,70,0,2,8,2,0,allow
43784,443,17789,443,10458,1688,8770,30,15,17,13,allow
50134,53,55373,53,748,106,642,2,30,1,1,allow
56803,53,43368,53,182,93,89,2,30,1,1,allow
49718,53,39555,53,793,101,692,2,30,1,1,allow
38662,15000,56543,15000,138,78,60,2,6,1,1,allow
137,137,55406,137,114,114,0,2,32,2,0,allow
53878,55950,58060,55950,70,70,0,2,8,2,0,allow
56503,53,37647,53,578,286,292,9,15,5,4,allow
34996,5222,11344,5222,8140,2222,5918,42,201,22,20,allow
53876,53380,35736,53380,70,70,0,2,8,2,0,allow
56556,53,39317,53,762,97,665,2,30,1,1,allow
64023,53,59287,53,174,89,85,2,30,1,1,allow
64628,53,26706,53,753,93,660,2,30,1,1,allow
44967,443,36379,443,7474,1946,5528,33,270,18,15,allow
57163,443,13914,443,1779,1375,404,11,40,5,6,allow
56354,53,25392,53,753,93,660,2,30,1,1,allow
53162,60352,25976,60352,70,70,0,2,8,2,0,allow
55156,53,48355,53,256,87,169,4,37,2,2,allow
25309,53,25309,53,371,237,134,3,33,2,1,allow
29599,443,15239,443,2227,1018,1209,17,16,8,9,allow
56588,53,28936,53,194,99,95,2,30,1,1,allow
52385,53,0,0,138,69,69,2,30,1,1,allow
51606,443,32165,443,9979,4380,5599,26,256,12,14,allow
50108,53,31749,53,174,89,85,2,30,1,1,allow
56668,53,61467,53,701,88,613,2,30,1,1,allow
58922,443,2924,443,14553,9653,4900,38,19,22,16,allow
64950,53,8334,53,186,95,91,2,31,1,1,allow
50176,443,54312,443,6081,844,5237,17,15,9,8,allow
52079,1024,34017,1024,70,70,0,2,8,2,0,allow
37569,443,55677,443,120566,15345,105221,173,125,72,101,allow
55759,53,57416,53,170,87,83,2,30,1,1,allow
50552,53,56537,53,710,89,621,2,30,1,1,allow
56926,53,27418,53,711,87,624,2,30,1,1,allow
55376,53,48930,53,789,110,679,2,31,1,1,allow
56375,53,7555,53,216,110,106,2,31,1,1,allow
55489,53,34902,53,748,106,642,2,31,1,1,allow
56373,53,1027,53,181,98,83,2,31,1,1,allow
49313,53,6801,53,295,101,194,4,31,2,2,allow
64787,53,4166,53,174,89,85,2,31,1,1,allow
59005,443,25143,443,4921,2525,2396,14,135,7,7,allow
48817,32897,48817,32897,152,152,0,1,1200,1,0,allow
56185,53,24061,53,168,86,82,2,31,1,1,allow
55058,53,41146,53,216,110,106,2,31,1,1,allow
56712,443,43897,443,1540037,36876,1503161,1511,62,511,1000,allow
56960,53,22344,53,192,98,94,2,31,1,1,allow
56272,53,26836,53,186,95,91,2,31,1,1,allow
64668,53,32390,53,772,103,669,2,31,1,1,allow
57119,53,0,0,318,95,223,2,31,1,1,allow
50504,53,13475,53,168,86,82,2,31,1,1,allow
56260,53,39887,53,170,87,83,2,31,1,1,allow
64787,53,24820,53,740,93,647,2,31,1,1,allow
55251,53,62666,53,208,106,102,2,31,1,1,allow
54959,53,17105,53,206,105,101,2,31,1,1,allow
24929,53,24929,53,217,87,130,2,31,1,1,allow
55383,443,17690,443,40612,4090,36522,71,150,31,40,allow
57063,53,16093,53,186,95,91,2,31,1,1,allow
55829,53,4732,53,208,106,102,2,31,1,1,allow
64551,53,55757,53,755,94,661,2,31,1,1,allow
56375,53,32161,53,216,110,106,2,31,1,1,allow
55190,53,7214,53,733,86,647,2,31,1,1,allow
57083,53,56856,53,755,94,661,2,31,1,1,allow
63090,53,11762,53,510,164,346,2,31,1,1,allow
65354,53,6099,53,168,86,82,2,31,1,1,allow
56762,53,35908,53,168,86,82,2,31,1,1,allow
56810,53,54787,53,170,87,83,2,31,1,1,allow
51538,445,0,0,70,70,0,1,0,1,0,drop
63145,445,0,0,70,70,0,1,0,1,0,drop
54796,22114,0,0,66,66,0,1,0,1,0,deny
63311,445,0,0,66,66,0,1,0,1,0,drop
3169,22114,0,0,66,66,0,1,0,1,0,deny
63143,445,0,0,70,70,0,1,0,1,0,drop
49577,57470,0,0,62,62,0,1,0,1,0,deny
56403,51505,0,0,66,66,0,1,0,1,0,deny
4019,50584,0,0,66,66,0,1,0,1,0,deny
63308,445,0,0,66,66,0,1,0,1,0,drop
63310,445,0,0,66,66,0,1,0,1,0,drop
63141,445,0,0,70,70,0,1,0,1,0,drop
51567,443,62736,443,400,70,330,7,17,2,5,allow
55156,53,47566,53,256,87,169,4,37,2,2,allow
65506,443,5450,443,92243,4519,87724,105,16,39,66,allow
61643,22114,0,0,62,62,0,1,0,1,0,deny
47812,30627,0,0,62,62,0,1,0,1,0,deny
63307,445,0,0,66,66,0,1,0,1,0,drop
7912,35440,0,0,146,146,0,1,0,1,0,deny
62217,37807,0,0,66,66,0,1,0,1,0,deny
55408,64147,0,0,66,66,0,1,0,1,0,deny
62189,64147,0,0,62,62,0,1,0,1,0,deny
58247,57866,0,0,66,66,0,1,0,1,0,deny
16057,51050,0,0,66,66,0,1,0,1,0,deny
63741,50584,0,0,66,66,0,1,0,1,0,deny
17173,23,0,0,60,60,0,1,0,1,0,deny
60117,50934,0,0,66,66,0,1,0,1,0,deny
51532,445,0,0,70,70,0,1,0,1,0,drop
45169,14037,0,0,74,74,0,1,0,1,0,deny
58193,23,0,0,60,60,0,1,0,1,0,deny
51522,445,0,0,70,70,0,1,0,1,0,drop
51525,445,0,0,70,70,0,1,0,1,0,drop
45682,8055,0,0,159,159,0,1,0,1,0,deny
22948,26467,0,0,62,62,0,1,0,1,0,deny
27081,10197,0,0,62,62,0,1,0,1,0,deny
63134,445,0,0,70,70,0,1,0,1,0,drop
10949,22114,0,0,62,62,0,1,0,1,0,deny
45535,25174,0,0,66,66,0,1,0,1,0,deny
63132,445,0,0,70,70,0,1,0,1,0,drop
51728,44847,0,0,66,66,0,1,0,1,0,deny
63294,445,0,0,66,66,0,1,0,1,0,drop
62348,65348,0,0,145,145,0,1,0,1,0,deny
6872,23,0,0,60,60,0,1,0,1,0,deny
63131,445,0,0,70,70,0,1,0,1,0,drop
64595,64147,0,0,66,66,0,1,0,1,0,deny
29742,50584,0,0,146,146,0,1,0,1,0,deny
6712,5060,0,0,410,410,0,1,0,1,0,deny
63130,445,0,0,70,70,0,1,0,1,0,drop
63717,37965,0,0,62,62,0,1,0,1,0,deny
1030,35776,0,0,139,139,0,1,0,1,0,deny
63129,445,0,0,70,70,0,1,0,1,0,drop
64963,53,58073,53,453,186,267,6,30,3,3,allow
52083,26607,11051,26607,70,70,0,2,7,2,0,allow
49791,53,37520,53,412,90,322,4,34,2,2,allow
60471,19776,4815,19776,70,70,0,1,5,1,0,allow
55388,53,11740,53,292,87,205,4,42,2,2,allow
60334,443,17024,443,7506,4789,2717,28,130,16,12,allow
36816,1812,36816,1812,204,138,66,2,29,1,1,allow
56803,53,52529,53,183,94,89,2,30,1,1,allow
57264,53,53973,53,197,102,95,2,30,1,1,allow
50204,80,48586,80,1221,781,440,11,14,6,5,allow
54519,443,53980,443,8413,2503,5910,23,16,13,10,allow
64735,53,3296,53,730,102,628,2,30,1,1,allow
53042,443,14232,443,5452,1545,3907,22,16,13,9,allow
56446,443,26551,443,8620,2018,6602,34,80,18,16,allow
56703,80,22325,80,41915,4128,37787,59,64,29,30,allow
52084,30863,64593,30863,70,70,0,2,7,2,0,allow
52056,50328,41814,50328,70,70,0,1,4,1,0,allow
55156,53,28197,53,256,87,169,4,36,2,2,allow
46892,443,33257,443,12488,5447,7041,28,16,16,12,allow
55828,443,33777,443,8420,4472,3948,63,450,32,31,allow
123,123,13425,123,184,94,90,2,29,1,1,allow
61066,53,0,0,283,78,205,2,29,1,1,allow
55156,53,47092,53,256,87,169,4,36,2,2,allow
23613,53,55694,53,177,94,83,2,29,1,1,allow
61230,53,16263,53,177,94,83,2,29,1,1,allow
64069,53,35417,53,183,86,97,2,29,1,1,allow
52413,53,24477,53,168,78,90,2,30,1,1,allow
64967,27051,5112,27051,1020,462,558,4,29,2,2,allow
53801,53,14956,53,167,78,89,2,30,1,1,allow
58935,443,64941,443,5167,700,4467,16,15,7,9,allow
63034,443,51705,443,37694,8319,29375,85,153,36,49,allow
58173,993,62958,993,430,60,370,7,24,2,5,allow
49786,443,10389,443,8941,1816,7125,27,15,15,12,allow
36604,443,8659,443,6506,1532,4974,28,16,14,14,allow
34432,80,52921,80,6260,696,5564,17,16,9,8,allow
49376,53,15412,53,391,134,257,2,30,1,1,allow
55641,53,43709,53,70,70,0,1,30,1,0,allow
49686,53,47017,53,183,94,89,2,30,1,1,allow
46674,53,59897,53,168,78,90,2,30,1,1,allow
52080,9554,2824,9554,70,70,0,2,7,2,0,allow
60333,443,9820,443,8945,5766,3179,30,130,18,12,allow
48778,443,13282,443,6770,2047,4723,26,16,14,12,allow
34298,53,58428,53,199,94,105,2,30,1,1,allow
55643,53,36774,53,183,94,89,2,30,1,1,allow
56746,443,25716,443,8006,1986,6020,20,15,11,9,allow
49830,443,24513,443,8471,2343,6128,30,240,15,15,allow
56067,53,5556,53,195,102,93,2,30,1,1,allow
58934,443,63790,443,5167,700,4467,16,15,7,9,allow
64900,53,45787,53,197,102,95,2,30,1,1,allow
49447,53,53080,53,168,78,90,2,30,1,1,allow
50056,27018,46603,27018,468,390,78,5,30,4,1,allow
55669,53,38123,53,177,94,83,2,30,1,1,allow
55759,53,16569,53,177,94,83,2,30,1,1,allow
46707,443,23817,443,9723,1780,7943,35,120,17,18,allow
49777,53,52771,53,216,110,106,2,30,1,1,allow
49747,53,22028,53,278,94,184,2,30,1,1,allow
63884,53,63884,53,400,257,143,3,33,2,1,allow
55609,53,21760,53,178,94,84,2,30,1,1,allow
38564,443,56432,443,1312,651,661,13,185,7,6,allow
33947,443,18903,443,25302,10587,14715,88,123,37,51,allow
45679,53,45679,53,262,106,156,2,33,1,1,allow
60469,60092,63327,60092,70,70,0,1,5,1,0,allow
63848,80,63848,80,555419,4827,550592,451,21,64,387,allow
57206,53,29989,53,292,85,207,4,50,2,2,allow
59782,53,21953,53,168,78,90,2,30,1,1,allow
55179,53,32980,53,183,94,89,2,30,1,1,allow
55609,53,6401,53,178,94,84,2,30,1,1,allow
49251,53,13051,53,94,94,0,1,30,1,0,allow
49908,53,39258,53,789,110,679,2,30,1,1,allow
56149,53,1500,53,179,94,85,2,30,1,1,allow
64787,53,33533,53,179,94,85,2,30,1,1,allow
36621,443,53395,443,2239099,75601,2163498,2512,71,983,1529,allow
56770,443,61506,443,5829,2962,2867,35,89,17,18,allow
56588,53,38290,53,305,99,206,4,49,2,2,allow
51218,5223,10817,5223,11005,5789,5216,34,23,18,16,allow
38405,80,54534,80,1114,534,580,12,16,7,5,allow
53882,13613,12263,13613,320,140,180,6,5,3,3,allow
17428,3389,17428,3389,4695,2520,2175,22,19,13,9,allow
54816,443,23557,443,130,70,60,3,4,2,1,allow
60472,20273,4062,20273,70,70,0,1,5,1,0,allow
55701,31543,58312,31543,320,140,180,6,5,3,3,allow
37116,80,37116,80,2971,1509,1462,10,15,6,4,allow
53964,443,1978,443,152,78,74,2,5,1,1,allow
56700,80,19955,80,51889,4253,47636,68,64,31,37,allow
56745,443,12454,443,8058,2038,6020,20,15,11,9,allow
49545,53,14394,53,195,102,93,2,29,1,1,allow
52164,443,1593,443,161883,8848,153035,177,54,64,113,allow
51709,53,0,0,201,94,107,2,29,1,1,allow
55643,53,52326,53,183,94,89,2,29,1,1,allow
37611,443,31494,443,3936,1618,2318,26,146,14,12,allow
54550,53,0,0,188,86,102,2,29,1,1,allow
9742,80,9742,80,1384,648,736,9,15,5,4,allow
56803,53,37278,53,183,94,89,2,29,1,1,allow
43910,443,49945,443,10506,2984,7522,30,15,17,13,allow
56134,53,59241,53,183,94,89,2,29,1,1,allow
40026,443,36114,443,6058,1749,4309,22,200,13,9,allow
58841,443,21745,443,18238,3980,14258,61,152,27,34,allow
50654,80,39837,80,3728,1504,2224,13,21,7,6,allow
55759,53,35937,53,177,94,83,2,30,1,1,allow
50655,80,2422,80,2108,1167,941,10,20,6,4,allow
61956,80,61956,80,2102,1583,519,11,23,6,5,allow
5588,5588,0,0,3562,1936,1626,48,194,24,24,allow
56588,53,41777,53,197,102,95,2,29,1,1,allow
64023,53,2522,53,179,94,85,2,29,1,1,allow
64987,27042,62086,27042,1012,462,550,4,30,2,2,allow
64900,53,46043,53,197,102,95,2,30,1,1,allow
58764,53,65299,53,268,94,174,2,30,1,1,allow
50108,53,40711,53,179,94,85,2,30,1,1,allow
64023,53,57287,53,179,94,85,2,30,1,1,allow
50376,53,47622,53,167,78,89,2,30,1,1,allow
55609,53,4360,53,178,94,84,2,30,1,1,allow
50077,53,35101,53,787,110,677,2,30,1,1,allow
49777,53,28087,53,216,110,106,2,30,1,1,allow
49620,53,15285,53,211,110,101,2,30,1,1,allow
56267,53,59732,53,453,186,267,6,30,3,3,allow
49686,53,55592,53,183,94,89,2,30,1,1,allow
54974,53,5978,53,212,102,110,2,30,1,1,allow
56260,53,6502,53,177,94,83,2,30,1,1,allow
64892,53,23593,53,772,102,670,2,30,1,1,allow
47512,443,61793,443,8785,2057,6728,31,396,10,21,allow
55058,53,43398,53,216,110,106,2,31,1,1,allow
56960,53,21026,53,196,102,94,2,31,1,1,allow
50584,6881,29773,6881,502,150,352,2,1200,1,1,allow
44847,22467,39791,22467,150,150,0,1,1200,1,0,allow
19473,40959,26703,40959,491,150,341,2,1200,1,1,allow
65381,53,27857,53,317,102,215,2,31,1,1,allow
62345,443,13195,443,6343025,74037,6268988,5018,58,765,4253,allow
53270,443,54512,443,12757,4360,8397,41,17,23,18,allow
43880,80,10125,80,2693,841,1852,13,16,8,5,allow
56809,53,56809,53,404,259,145,3,33,2,1,allow
9227,443,31374,443,5146,960,4186,17,25,9,8,allow
49385,443,34796,443,44437,2600,41837,62,16,28,34,allow
52092,443,18467,443,13078,7055,6023,114,162,59,55,allow
56109,53,22951,53,177,94,83,2,30,1,1,allow
54528,53,37583,53,197,94,103,2,30,1,1,allow
46331,53,26643,53,199,94,105,2,30,1,1,allow
65506,53,15371,53,197,102,95,2,30,1,1,allow
38562,443,22999,443,1310,649,661,13,185,7,6,allow
65505,443,12963,443,458741,13270,445471,469,16,164,305,allow
58614,53,27966,53,168,78,90,2,30,1,1,allow
49866,53,19774,53,225,110,115,2,30,1,1,allow
64546,53,63352,53,889,404,485,10,30,5,5,allow
49359,53,28261,53,718,94,624,2,30,1,1,allow
55669,53,15952,53,177,94,83,2,30,1,1,allow
51622,53,52520,53,260,86,174,2,30,1,1,allow
64549,53,44048,53,273,86,187,2,30,1,1,allow
57338,443,27463,443,8126,1887,6239,32,732,17,15,allow
56067,53,40948,53,195,102,93,2,30,1,1,allow
55961,53,7584,53,214,102,112,2,30,1,1,allow
49224,53,60967,53,177,94,83,2,30,1,1,allow
49598,53,15528,53,214,102,112,2,30,1,1,allow
49255,53,62654,53,212,102,110,2,30,1,1,allow
56160,53,58234,53,195,102,93,2,31,1,1,allow
48817,57013,48817,57013,158,158,0,1,1200,1,0,allow
51221,3054,33559,3054,870,330,540,12,1320,6,6,allow
49977,53,38356,53,209,110,99,2,30,1,1,allow
64950,53,65250,53,193,102,91,2,30,1,1,allow
65335,53,50606,53,216,102,114,2,30,1,1,allow
55417,53,42244,53,179,94,85,2,30,1,1,allow
56367,53,31807,53,194,102,92,2,30,1,1,allow
56160,53,61640,53,195,102,93,2,30,1,1,allow
64357,53,56985,53,183,94,89,2,30,1,1,allow
57210,53,57210,53,628,82,546,2,30,1,1,allow
55660,53,31252,53,177,94,83,2,30,1,1,allow
63095,443,9067,443,571,166,405,2,30,1,1,allow
63094,53,39482,53,384,166,218,2,30,1,1,allow
63092,53,40692,53,304,86,218,2,30,1,1,allow
55945,53,49702,53,177,94,83,2,31,1,1,allow
54959,53,55132,53,211,110,101,2,31,1,1,allow
55417,53,15668,53,179,94,85,2,31,1,1,allow
56272,53,13597,53,193,102,91,2,31,1,1,allow
54540,443,17427,443,6680,3784,2896,18,135,9,9,allow
56560,53,25642,53,900,110,790,2,31,1,1,allow
64357,53,37789,53,183,94,89,2,31,1,1,allow
56373,53,9374,53,177,94,83,2,30,1,1,allow
56260,53,30984,53,177,94,83,2,31,1,1,allow
50999,53,58447,53,214,78,136,2,30,1,1,allow
65506,53,20953,53,197,102,95,2,30,1,1,allow
49828,53,30864,53,340,110,230,2,31,1,1,allow
63631,443,40886,443,8640,5157,3483,17,120,10,7,allow
49656,443,4978,443,182624,7130,175494,212,132,77,135,allow
62287,443,17565,443,3644,610,3034,13,119,6,7,allow
45908,443,37140,443,507235,15454,491781,534,136,188,346,allow
55320,53,54468,53,304,94,210,2,30,1,1,allow
55417,53,40418,53,179,94,85,2,30,1,1,allow
55750,53,13328,53,211,110,101,2,30,1,1,allow
63093,443,45246,443,304,86,218,2,30,1,1,allow
50098,53,35550,53,199,102,97,2,31,1,1,allow
55795,443,23533,443,5283,2688,2595,14,135,7,7,allow
58029,443,3427,443,1312,651,661,13,185,7,6,allow
58031,443,14165,443,1314,653,661,13,185,7,6,allow
30188,49786,29335,49786,502,150,352,2,1200,1,1,allow
60596,53,45720,53,300,86,214,2,31,1,1,allow
55942,53,19231,53,197,102,95,2,31,1,1,allow
52077,51638,13368,51638,70,70,0,2,8,2,0,allow
59875,443,49654,443,6922,2214,4708,32,136,20,12,allow
54960,443,1507,443,17670,2044,15626,53,316,21,32,allow
42158,443,61169,443,6865,3366,3499,39,206,15,24,allow
63319,53,8378,53,315,102,213,2,31,1,1,allow
55454,53,12163,53,168,86,82,2,32,1,1,allow
52075,37919,58563,37919,70,70,0,2,8,2,0,allow
53873,52055,21698,52055,70,70,0,2,8,2,0,allow
56699,80,7390,80,64386,3122,61264,79,64,35,44,allow
49221,36069,51500,36069,1941,1009,932,10,16,6,4,allow
55989,53,49458,53,205,86,119,2,30,1,1,allow
53800,53,27732,53,260,86,174,2,30,1,1,allow
64472,53,59070,53,183,94,89,2,31,1,1,allow
63087,443,39607,443,448,166,282,2,31,1,1,allow
64576,53,14840,53,194,102,92,2,31,1,1,allow
63076,443,26735,443,304,86,218,2,31,1,1,allow
56661,443,39690,443,7900,3324,4576,28,139,13,15,allow
50458,53,29574,53,177,94,83,2,31,1,1,allow
57359,53,20340,53,458,188,270,6,31,3,3,allow
53867,60272,19562,60272,70,70,0,2,8,2,0,allow
49763,53,30741,53,258,110,148,2,30,1,1,allow
49224,53,31598,53,177,94,83,2,30,1,1,allow
63126,445,0,0,70,70,0,1,0,1,0,drop
63124,445,0,0,70,70,0,1,0,1,0,drop
1036,64147,0,0,62,62,0,1,0,1,0,deny
63287,445,0,0,66,66,0,1,0,1,0,drop
50321,18593,0,0,143,143,0,1,0,1,0,deny
35626,22114,0,0,66,66,0,1,0,1,0,deny
51511,445,0,0,70,70,0,1,0,1,0,drop
50106,30317,0,0,66,66,0,1,0,1,0,deny
10914,35974,0,0,60,60,0,1,0,1,0,deny
11382,43890,0,0,66,66,0,1,0,1,0,deny
63111,445,0,0,70,70,0,1,0,1,0,drop
63110,445,0,0,70,70,0,1,0,1,0,drop
54917,60043,0,0,66,66,0,1,0,1,0,deny
54883,60043,0,0,62,62,0,1,0,1,0,deny
63106,445,0,0,70,70,0,1,0,1,0,drop
3717,25174,0,0,62,62,0,1,0,1,0,deny
63285,445,0,0,66,66,0,1,0,1,0,drop
63101,445,0,0,70,70,0,1,0,1,0,drop
63100,445,0,0,70,70,0,1,0,1,0,drop
47783,50432,0,0,62,62,0,1,0,1,0,deny
11136,19910,0,0,62,62,0,1,0,1,0,deny
63278,445,0,0,66,66,0,1,0,1,0,drop
59355,51505,0,0,66,66,0,1,0,1,0,deny
63272,445,0,0,66,66,0,1,0,1,0,drop
51310,64147,0,0,62,62,0,1,0,1,0,deny
27679,37965,0,0,62,62,0,1,0,1,0,deny
65006,26467,0,0,62,62,0,1,0,1,0,deny
51413,57470,0,0,72,72,0,1,0,1,0,deny
18113,22114,0,0,62,62,0,1,0,1,0,deny
33328,25174,0,0,62,62,0,1,0,1,0,deny
33328,25174,0,0,146,146,0,1,0,1,0,deny
46734,50265,0,0,74,74,0,1,0,1,0,deny
63089,445,0,0,70,70,0,1,0,1,0,drop
12318,36866,0,0,139,139,0,1,0,1,0,deny
6666,16010,0,0,60,60,0,1,0,1,0,deny
15701,37965,0,0,146,146,0,1,0,1,0,deny
52503,50584,0,0,66,66,0,1,0,1,0,deny
54769,50584,0,0,146,146,0,1,0,1,0,deny
51726,64147,0,0,66,66,0,1,0,1,0,deny
51045,25174,0,0,62,62,0,1,0,1,0,deny
65159,37965,0,0,74,74,0,1,0,1,0,deny
58103,10197,0,0,66,66,0,1,0,1,0,deny
51503,445,0,0,70,70,0,1,0,1,0,drop
51501,445,0,0,70,70,0,1,0,1,0,drop
51499,445,0,0,70,70,0,1,0,1,0,drop
61840,25174,0,0,62,62,0,1,0,1,0,deny
22856,22114,0,0,66,66,0,1,0,1,0,deny
17947,36237,0,0,62,62,0,1,0,1,0,deny
63262,445,0,0,66,66,0,1,0,1,0,drop
63260,445,0,0,66,66,0,1,0,1,0,drop
63259,445,0,0,66,66,0,1,0,1,0,drop
63255,445,0,0,66,66,0,1,0,1,0,drop
63257,445,0,0,66,66,0,1,0,1,0,drop
63258,445,0,0,66,66,0,1,0,1,0,drop
63261,445,0,0,66,66,0,1,0,1,0,drop
63254,445,0,0,66,66,0,1,0,1,0,drop
7356,25174,0,0,62,62,0,1,0,1,0,deny
14614,25174,0,0,62,62,0,1,0,1,0,deny
52537,57866,0,0,66,66,0,1,0,1,0,deny
56249,55442,0,0,66,66,0,1,0,1,0,deny
26263,8168,0,0,66,66,0,1,0,1,0,deny
29145,8168,0,0,62,62,0,1,0,1,0,deny
63085,445,0,0,70,70,0,1,0,1,0,drop
54418,22114,0,0,62,62,0,1,0,1,0,deny
21604,50201,0,0,62,62,0,1,0,1,0,deny
63076,445,0,0,70,70,0,1,0,1,0,drop
63075,445,0,0,70,70,0,1,0,1,0,drop
63074,445,0,0,70,70,0,1,0,1,0,drop
56621,50584,0,0,62,62,0,1,0,1,0,deny
50620,50584,0,0,66,66,0,1,0,1,0,deny
63071,445,0,0,70,70,0,1,0,1,0,drop
51425,37450,0,0,66,66,0,1,0,1,0,deny
63068,445,0,0,70,70,0,1,0,1,0,drop
63982,25174,0,0,62,62,0,1,0,1,0,deny
54754,50432,0,0,66,66,0,1,0,1,0,deny
51492,445,0,0,70,70,0,1,0,1,0,drop
51487,445,0,0,70,70,0,1,0,1,0,drop
51485,445,0,0,70,70,0,1,0,1,0,drop
51480,445,0,0,70,70,0,1,0,1,0,drop
45964,3111,0,0,60,60,0,1,0,1,0,deny
6712,123,0,0,90,90,0,1,0,1,0,deny
63241,445,0,0,66,66,0,1,0,1,0,drop
63240,445,0,0,66,66,0,1,0,1,0,drop
63239,445,0,0,66,66,0,1,0,1,0,drop
6929,35440,0,0,66,66,0,1,0,1,0,deny
31172,22114,0,0,146,146,0,1,0,1,0,deny
6247,51221,0,0,78,78,0,1,0,1,0,deny
15442,22114,0,0,62,62,0,1,0,1,0,deny
26527,25174,0,0,66,66,0,1,0,1,0,deny
37429,25174,0,0,62,62,0,1,0,1,0,deny
7810,25174,0,0,62,62,0,1,0,1,0,deny
51478,445,0,0,70,70,0,1,0,1,0,drop
63062,445,0,0,70,70,0,1,0,1,0,drop
52430,35440,0,0,146,146,0,1,0,1,0,deny
51471,445,0,0,70,70,0,1,0,1,0,drop
51470,445,0,0,70,70,0,1,0,1,0,drop
51468,445,0,0,70,70,0,1,0,1,0,drop
23021,2222,0,0,60,60,0,1,0,1,0,deny
47424,25174,0,0,66,66,0,1,0,1,0,deny
56897,11446,0,0,66,66,0,1,0,1,0,deny
1190,25174,0,0,62,62,0,1,0,1,0,deny
63055,445,0,0,70,70,0,1,0,1,0,drop
56397,26467,0,0,62,62,0,1,0,1,0,deny
63053,445,0,0,70,70,0,1,0,1,0,drop
36011,25174,0,0,66,66,0,1,0,1,0,deny
6356,26467,0,0,62,62,0,1,0,1,0,deny
54526,44847,0,0,66,66,0,1,0,1,0,deny
52359,23,0,0,60,60,0,1,0,1,0,deny
63049,445,0,0,70,70,0,1,0,1,0,drop
51461,445,0,0,70,70,0,1,0,1,0,drop
51457,445,0,0,70,70,0,1,0,1,0,drop
51458,445,0,0,70,70,0,1,0,1,0,drop
48025,44847,0,0,146,146,0,1,0,1,0,deny
63047,445,0,0,70,70,0,1,0,1,0,drop
0,0,0,0,70,70,0,1,0,1,0,deny
0,0,0,0,480,244,236,4,0,2,2,allow
51414,22,0,0,60,60,0,1,0,1,0,deny
63230,445,0,0,66,66,0,1,0,1,0,drop
53577,35894,0,0,62,62,0,1,0,1,0,deny
3064,44847,0,0,62,62,0,1,0,1,0,deny
63043,445,0,0,70,70,0,1,0,1,0,drop
53199,30188,0,0,66,66,0,1,0,1,0,deny
1356,57470,0,0,72,72,0,1,0,1,0,deny
49893,25174,0,0,66,66,0,1,0,1,0,deny
63041,445,0,0,70,70,0,1,0,1,0,drop
55826,42771,0,0,62,62,0,1,0,1,0,deny
55825,52700,0,0,62,62,0,1,0,1,0,deny
51453,445,0,0,70,70,0,1,0,1,0,drop
48826,25174,0,0,62,62,0,1,0,1,0,deny
53022,25174,0,0,62,62,0,1,0,1,0,deny
51451,445,0,0,70,70,0,1,0,1,0,drop
30598,37965,0,0,62,62,0,1,0,1,0,deny
11488,22114,0,0,62,62,0,1,0,1,0,deny
52744,25174,0,0,66,66,0,1,0,1,0,deny
17415,25174,0,0,62,62,0,1,0,1,0,deny
62056,30317,0,0,146,146,0,1,0,1,0,deny
63211,445,0,0,66,66,0,1,0,1,0,drop
63212,445,0,0,66,66,0,1,0,1,0,drop
63037,445,0,0,70,70,0,1,0,1,0,drop
52808,57470,0,0,146,146,0,1,0,1,0,deny
15176,62413,0,0,66,66,0,1,0,1,0,deny
61017,64147,0,0,62,62,0,1,0,1,0,deny
1733,65448,0,0,62,62,0,1,0,1,0,deny
42238,25174,0,0,62,62,0,1,0,1,0,deny
61185,54532,0,0,62,62,0,1,0,1,0,deny
19875,30170,0,0,145,145,0,1,0,1,0,deny
59668,50584,0,0,66,66,0,1,0,1,0,deny
51441,445,0,0,70,70,0,1,0,1,0,drop
51434,445,0,0,70,70,0,1,0,1,0,drop
51433,445,0,0,70,70,0,1,0,1,0,drop
51431,445,0,0,70,70,0,1,0,1,0,drop
22036,44847,0,0,146,146,0,1,0,1,0,deny
18203,23,0,0,60,60,0,1,0,1,0,deny
60261,25174,0,0,66,66,0,1,0,1,0,deny
63587,22114,0,0,62,62,0,1,0,1,0,deny
63208,445,0,0,66,66,0,1,0,1,0,drop
54216,64147,0,0,66,66,0,1,0,1,0,deny
59373,22,59373,22,295,126,169,4,1,2,2,deny
63202,445,0,0,66,66,0,1,0,1,0,drop
64691,25320,0,0,66,66,0,1,0,1,0,deny
63200,445,0,0,66,66,0,1,0,1,0,drop
63203,445,0,0,66,66,0,1,0,1,0,drop
63083,53,63784,53,303,85,218,2,30,1,1,allow
64357,53,46898,53,182,93,89,2,30,1,1,allow
63091,443,18908,443,382,164,218,2,30,1,1,allow
49197,53,13288,53,777,87,690,2,30,1,1,allow
65506,53,39413,53,194,99,95,2,30,1,1,allow
50641,53,60493,53,760,97,663,2,30,1,1,allow
56714,443,11426,443,579769,15036,564733,578,61,199,379,allow
57148,443,64280,443,12000,9252,2748,34,273,17,17,allow
51437,80,35977,80,1703,538,1165,8,177,5,3,allow
64472,53,7630,53,182,93,89,2,30,1,1,allow
50052,53,19645,53,738,86,652,2,30,1,1,allow
55945,53,26703,53,170,87,83,2,30,1,1,allow
51432,80,62424,80,1675,539,1136,8,178,5,3,allow
60343,80,4297,80,2005,1094,911,11,87,6,5,allow
9296,443,44194,443,3792,488,3304,14,16,7,7,allow
9314,443,56500,443,3792,488,3304,14,16,7,7,allow
42379,443,33462,443,1622,1137,485,11,26,7,4,allow
47647,443,47647,443,4565,1658,2907,19,28,11,8,allow
25436,53,25436,53,235,90,145,2,32,1,1,allow
45416,80,25189,80,2713,753,1960,12,15,7,5,allow
36339,443,4245,443,7295,1830,5465,23,316,13,10,allow
53463,29500,1810,29500,877,577,300,10,143,5,5,allow
65147,53,28135,53,763,101,662,2,30,1,1,allow
55039,443,27278,443,8209,2789,5420,24,42,14,10,allow
45308,443,7277,443,3657,1867,1790,22,391,7,15,allow
9305,443,52742,443,3616,429,3187,11,16,6,5,allow
60341,80,24741,80,2005,1094,911,11,87,6,5,allow
60336,443,57486,443,6613,4394,2219,50,122,29,21,allow
53877,32737,64789,32737,320,140,180,6,7,3,3,allow
52072,25595,25464,25595,70,70,0,2,8,2,0,allow
53870,24535,42849,24535,70,70,0,2,8,2,0,allow
9373,80,65080,80,1643,485,1158,10,15,5,5,allow
9377,80,44297,80,1643,485,1158,10,15,5,5,allow
38280,443,38280,443,3333,2072,1261,21,148,12,9,allow
9319,443,38033,443,5687,499,5188,14,16,7,7,allow
56582,53,23626,53,711,87,624,2,31,1,1,allow
64995,27023,24538,27023,1773,924,849,6,30,3,3,allow
9303,443,49206,443,3616,429,3187,11,16,6,5,allow
55965,53,22177,53,184,94,90,2,30,1,1,allow
60346,80,8391,80,2124,1158,966,13,87,7,6,allow
56020,53,29198,53,711,87,624,2,30,1,1,allow
60344,80,63030,80,2005,1094,911,11,87,6,5,allow
49756,53,23691,53,264,89,175,4,48,2,2,allow
45394,80,27437,80,4886,1260,3626,17,17,10,7,allow
9317,443,63611,443,5687,499,5188,14,16,7,7,allow
45414,80,30413,80,2873,753,2120,12,15,7,5,allow
39233,53,39233,53,235,90,145,2,33,1,1,allow
63150,443,63150,443,6792,1521,5271,18,28,11,7,allow
41036,443,13628,443,153,93,60,2,5,1,1,allow
53880,61393,8542,61393,320,140,180,6,6,3,3,allow
60345,80,36242,80,2124,1158,966,13,87,7,6,allow
45021,53,45021,53,213,79,134,2,32,1,1,allow
52076,28895,42169,28895,70,70,0,2,8,2,0,allow
54977,53,19132,53,275,93,182,4,32,2,2,allow
50663,80,56397,80,1366,865,501,8,15,5,3,allow
49531,80,27250,80,78,78,0,2,8,2,0,allow
42377,443,33699,443,1622,1137,485,11,26,7,4,allow
49304,443,52179,443,932965,16289,916676,768,65,148,620,allow
52054,50513,53866,50513,66,66,0,1,5,1,0,allow
55907,53,13623,53,711,87,624,2,30,1,1,allow
49363,53,12270,53,208,106,102,2,30,1,1,allow
55417,53,13088,53,174,89,85,2,30,1,1,allow
57082,53,0,0,82,82,0,1,30,1,0,allow
13237,53,13237,53,823,98,725,2,30,1,1,allow
36352,443,46352,443,3256,1753,1503,17,315,10,7,allow
41576,443,2351,443,2227,1018,1209,17,15,8,9,allow
31090,53,31090,53,365,233,132,3,34,2,1,allow
64135,53,50232,53,192,98,94,2,31,1,1,allow
60342,80,14869,80,2005,1094,911,11,87,6,5,allow
42380,443,32272,443,1622,1137,485,11,26,7,4,allow
53041,443,37580,443,7263,1834,5429,27,16,15,12,allow
38368,15000,38283,15000,130,70,60,2,5,1,1,allow
28234,36653,45143,36653,64,64,0,1,10,1,0,allow
42631,443,38369,443,153,93,60,2,5,1,1,allow
51855,7700,11959,7700,12087,9521,2566,76,32,38,38,allow
65315,53,25931,53,770,101,669,2,30,1,1,allow
9304,443,28860,443,3922,552,3370,16,16,8,8,allow
55566,53,37015,53,740,93,647,2,30,1,1,allow
49686,53,35211,53,182,93,89,2,30,1,1,allow
63082,443,41312,443,303,85,218,2,30,1,1,allow
55772,53,9529,53,782,105,677,2,30,1,1,allow
60089,53,50988,53,297,83,214,2,30,1,1,allow
55134,53,55134,53,825,99,726,2,31,1,1,allow
56294,53,56294,53,229,89,140,2,31,1,1,allow
64746,53,11815,53,186,95,91,2,31,1,1,allow
48817,6881,48817,6881,773,279,494,4,1200,2,2,allow
48817,6884,48817,6884,328,152,176,2,1200,1,1,allow
48817,7294,48817,7294,479,152,327,2,1200,1,1,allow
55275,53,41187,53,770,101,669,2,30,1,1,allow
65386,53,25163,53,194,99,95,2,30,1,1,allow
56912,53,9519,53,198,101,97,2,31,1,1,allow
59720,443,13294,443,3346,1219,2127,15,136,7,8,allow
48817,45682,48817,45682,513,152,361,2,1200,1,1,allow
48817,42099,48817,42099,479,152,327,2,1200,1,1,allow
56160,53,63340,53,190,97,93,2,30,1,1,allow
56845,53,56845,53,825,99,726,2,30,1,1,allow
60384,53,44713,53,234,96,138,2,31,1,1,allow
56246,53,10681,53,816,97,719,2,31,1,1,allow
64414,53,56894,53,182,93,89,2,31,1,1,allow
63952,53,34336,53,206,105,101,2,31,1,1,allow
57681,53,57681,53,220,100,120,2,31,1,1,allow
55942,53,46906,53,194,99,95,2,31,1,1,allow
57371,53,9888,53,755,93,662,2,31,1,1,allow
56805,53,62222,53,815,95,720,2,31,1,1,allow
64318,53,59823,53,182,93,89,2,31,1,1,allow
48817,49490,48817,49490,513,152,361,2,1200,1,1,allow
55230,53,36374,53,182,93,89,2,30,1,1,allow
54980,53,25043,53,763,101,662,2,30,1,1,allow
57294,53,3249,53,760,97,663,2,31,1,1,allow
35191,53,35191,53,825,99,726,2,31,1,1,allow
58390,53,44510,53,240,76,164,2,31,1,1,allow
56913,53,30099,53,772,103,669,2,31,1,1,allow
56561,53,2642,53,216,110,106,2,31,1,1,allow
49802,53,5262,53,755,93,662,2,31,1,1,allow
49978,53,54478,53,760,97,663,2,31,1,1,allow
57384,53,45393,53,752,93,659,2,31,1,1,allow
64970,27055,4626,27055,735,462,273,2,31,1,1,allow
49286,53,16984,53,184,94,90,2,31,1,1,allow
55024,53,56157,53,168,86,82,2,31,1,1,allow
55194,53,53010,53,190,97,93,2,31,1,1,allow
49631,53,31277,53,196,100,96,2,31,1,1,allow
48817,18529,48817,18529,152,152,0,1,1200,1,0,allow
56497,53,2084,53,170,87,83,2,31,1,1,allow
65336,53,14965,53,732,89,643,2,31,1,1,allow
48817,51413,48817,51413,479,152,327,2,1200,1,1,allow
48817,51413,48817,51413,479,152,327,2,1200,1,1,allow
48817,6882,48817,6882,152,152,0,1,1200,1,0,allow
48817,49157,48817,49157,328,152,176,2,1200,1,1,allow
55786,53,65115,53,186,95,91,2,31,1,1,allow
48817,8621,48817,8621,152,152,0,1,1200,1,0,allow
48817,63838,48817,63838,513,152,361,2,1200,1,1,allow
48817,37028,48817,37028,513,152,361,2,1200,1,1,allow
48817,26484,48817,26484,513,152,361,2,1200,1,1,allow
48817,51413,48817,51413,479,152,327,2,1200,1,1,allow
48817,6881,48817,6881,494,152,342,2,1200,1,1,allow
48817,6881,48817,6881,506,152,354,2,1200,1,1,allow
48817,41706,48817,41706,513,152,361,2,1200,1,1,allow
48817,6881,48817,6881,506,152,354,2,1200,1,1,allow
63195,445,0,0,66,66,0,1,0,1,0,drop
63197,445,0,0,66,66,0,1,0,1,0,drop
63201,445,0,0,66,66,0,1,0,1,0,drop
63192,445,0,0,66,66,0,1,0,1,0,drop
63024,445,0,0,70,70,0,1,0,1,0,drop
51427,445,0,0,70,70,0,1,0,1,0,drop
63545,25174,0,0,66,66,0,1,0,1,0,deny
51423,445,0,0,70,70,0,1,0,1,0,drop
51419,445,0,0,70,70,0,1,0,1,0,drop
51420,445,0,0,70,70,0,1,0,1,0,drop
7222,57470,0,0,62,62,0,1,0,1,0,deny
51979,25174,0,0,66,66,0,1,0,1,0,deny
20576,37965,0,0,62,62,0,1,0,1,0,deny
56127,37965,0,0,66,66,0,1,0,1,0,deny
63021,445,0,0,70,70,0,1,0,1,0,drop
45783,22114,0,0,62,62,0,1,0,1,0,deny
58900,37807,0,0,66,66,0,1,0,1,0,deny
61550,5529,0,0,145,145,0,1,0,1,0,deny
56762,53,10998,53,168,86,82,2,30,1,1,allow
9338,443,8556,443,4462,500,3962,13,15,7,6,allow
50098,53,37375,53,199,102,97,2,30,1,1,allow
63089,53,1694,53,512,166,346,2,30,1,1,allow
64135,53,40678,53,196,102,94,2,30,1,1,allow
50491,443,32943,443,28729,1634,27095,40,120,16,24,allow
56863,80,39475,80,13608,783,12825,21,45,9,12,allow
37613,443,61713,443,10042,3117,6925,28,47,16,12,allow
60129,80,34372,80,2910,1439,1471,12,31,7,5,allow
49270,80,7008,80,254,128,126,5,15,3,2,allow
53881,11513,24027,11513,320,140,180,6,5,3,3,allow
34430,80,5069,80,2913,633,2280,15,15,8,7,allow
34436,80,7684,80,6260,696,5564,17,15,9,8,allow
41611,80,9523,80,1860,712,1148,8,15,5,3,allow
56744,443,27482,443,8008,1988,6020,20,15,11,9,allow
55829,53,51099,53,177,94,83,2,30,1,1,allow
53161,30013,6313,30013,70,70,0,2,7,2,0,allow
41790,443,32230,443,232,172,60,3,4,2,1,allow
9318,443,40235,443,3649,424,3225,12,15,6,6,allow
49765,443,5454,443,11588,4383,7205,39,46,22,17,allow
49773,80,19021,80,70,70,0,2,8,2,0,allow
56698,80,23963,80,176644,9435,167209,266,65,104,162,allow
56940,53,20579,53,316,97,219,4,33,2,2,allow
53869,17089,2091,17089,70,70,0,2,7,2,0,allow
49363,53,19246,53,212,110,102,2,29,1,1,allow
57063,53,6247,53,193,102,91,2,29,1,1,allow
55492,53,7520,53,216,110,106,2,29,1,1,allow
56082,53,1185,53,730,102,628,2,29,1,1,allow
49620,53,9957,53,211,110,101,2,29,1,1,allow
55492,53,34032,53,216,110,106,2,29,1,1,allow
55945,53,7616,53,177,94,83,2,29,1,1,allow
55660,53,60167,53,177,94,83,2,30,1,1,allow
37561,443,20164,443,9766,3093,6673,37,270,21,16,allow
9308,443,57827,443,3837,488,3349,15,15,7,8,allow
9339,443,39172,443,3614,434,3180,11,15,6,5,allow
49702,443,53414,443,42430,4111,38319,79,130,42,37,allow
49756,53,23582,53,264,89,175,4,47,2,2,allow
49875,53,51820,53,399,86,313,4,49,2,2,allow
56375,53,4140,53,322,110,212,4,30,2,2,allow
56810,53,11762,53,177,94,83,2,30,1,1,allow
56960,53,26282,53,196,102,94,2,30,1,1,allow
64746,53,35675,53,193,102,91,2,30,1,1,allow
65248,53,49147,53,212,110,102,2,30,1,1,allow
65225,53,20120,53,822,102,720,2,30,1,1,allow
56561,53,19091,53,216,110,106,2,30,1,1,allow
56741,443,30975,443,8059,2039,6020,20,15,11,9,allow
52071,57491,41650,57491,70,70,0,2,8,2,0,allow
63079,443,63360,443,304,86,218,2,30,1,1,allow
9341,443,61165,443,3835,501,3334,14,15,7,7,allow
59394,443,52019,443,5993,1987,4006,17,26,9,8,allow
55528,80,12209,80,3868,2218,1650,19,39,11,8,allow
53161,443,60488,443,9458,4646,4812,26,25,14,12,allow
53271,443,21027,443,1544,1073,471,13,15,8,5,allow
64699,53,61689,53,338,110,228,2,30,1,1,allow
55058,53,31545,53,216,110,106,2,30,1,1,allow
50504,53,41149,53,168,86,82,2,30,1,1,allow
57431,53,12535,53,994,86,908,2,30,1,1,allow
49620,53,32011,53,198,110,88,2,30,1,1,allow
49172,53,13814,53,305,94,211,2,30,1,1,allow
54959,53,28413,53,211,110,101,2,30,1,1,allow
50458,53,25707,53,177,94,83,2,30,1,1,allow
56375,53,25593,53,216,110,106,2,30,1,1,allow
55251,53,16099,53,212,110,102,2,30,1,1,allow
42025,443,50486,443,70,70,0,1,5,1,0,allow
39055,53,10136,53,289,86,203,2,30,1,1,allow
8896,123,46598,123,94,94,0,1,30,1,0,allow
39114,443,44592,443,1238821,42695,1196126,1389,72,535,854,allow
64384,53,46498,53,350,94,256,2,30,1,1,allow
64486,53,21384,53,290,102,188,2,30,1,1,allow
56272,53,41462,53,193,102,91,2,30,1,1,allow
49313,53,49710,53,199,102,97,2,30,1,1,allow
55251,53,49536,53,212,110,102,2,30,1,1,allow
57778,443,43252,443,6182,3879,2303,53,3828,31,22,allow
56668,80,5597,80,234,234,0,4,12,4,0,allow
9331,443,37171,443,3616,429,3187,11,15,6,5,allow
9340,443,64311,443,3835,501,3334,14,15,7,7,allow
53851,443,36931,443,11779,3603,8176,42,142,21,21,allow
9325,443,25037,443,3616,429,3187,11,15,6,5,allow
9326,443,61009,443,3616,429,3187,11,15,6,5,allow
42457,5222,64493,5222,35380,2898,32482,63,227,22,41,allow
45077,443,32205,443,6533,1777,4756,24,271,13,11,allow
56771,53,50189,53,166,86,80,2,30,1,1,allow
64318,53,51027,53,183,94,89,2,30,1,1,allow
63081,53,24594,53,304,86,218,2,30,1,1,allow
63080,443,52084,443,304,86,218,2,30,1,1,allow
53160,39001,22070,39001,70,70,0,2,8,2,0,allow
55531,80,42208,80,3277,2255,1022,18,39,10,8,allow
9315,443,40509,443,3649,424,3225,12,15,6,6,allow
53163,443,28652,443,12979,4609,8370,27,25,15,12,allow
49293,53,34843,53,382,95,287,4,48,2,2,allow
49686,53,23134,53,183,94,89,2,30,1,1,allow
63088,443,45061,443,512,166,346,2,30,1,1,allow
60203,53,37285,53,328,86,242,2,30,1,1,allow
55230,53,3013,53,183,94,89,2,30,1,1,allow
64472,53,45709,53,183,94,89,2,30,1,1,allow
63078,53,5697,53,304,86,218,2,30,1,1,allow
56769,53,50586,53,195,102,93,2,30,1,1,allow
55942,53,36132,53,197,102,95,2,30,1,1,allow
56629,443,36618,443,22938,14436,8502,43,35,23,20,allow
52073,16316,19866,16316,70,70,0,2,8,2,0,allow
53872,24710,60030,24710,70,70,0,2,7,2,0,allow
49840,443,58601,443,6998,1906,5092,22,24,12,10,allow
60883,443,43627,443,5710,1228,4482,21,16,12,9,allow
49756,53,1585,53,264,89,175,4,48,2,2,allow
55560,443,48574,443,7047,1994,5053,20,24,12,8,allow
53157,34841,3594,34841,698,320,378,10,16,6,4,allow
38358,80,53485,80,409,289,120,5,15,3,2,allow
54447,443,59840,443,9818,2008,7810,23,317,12,11,allow
54977,53,63603,53,275,93,182,4,32,2,2,allow
54977,53,36032,53,275,93,182,4,31,2,2,allow
9332,443,23835,443,3616,429,3187,11,15,6,5,allow
53868,52706,33006,52706,70,70,0,2,7,2,0,allow
9321,443,54415,443,3345,432,2913,11,15,6,5,allow
51968,443,63060,443,5315,3154,2161,56,47,32,24,allow
52053,34411,40436,34411,70,70,0,1,4,1,0,allow
51443,443,42123,443,322,262,60,2,15,1,1,allow
34434,80,45920,80,2913,633,2280,15,15,8,7,allow
50041,443,6754,443,17237,1717,15520,36,152,16,20,allow
59405,443,1405,443,276,70,206,5,26,2,3,allow
52078,15518,47758,15518,70,70,0,2,7,2,0,allow
53871,43266,33475,43266,70,70,0,2,7,2,0,allow
56276,443,23651,443,154,94,60,2,4,1,1,allow
56803,53,3207,53,429,93,336,4,44,2,2,allow
55750,53,45785,53,211,110,101,2,29,1,1,allow
9333,443,63777,443,5200,499,4701,13,15,7,6,allow
64787,53,58679,53,179,94,85,2,29,1,1,allow
9329,443,17986,443,3255,430,2825,11,15,6,5,allow
55829,53,11417,53,212,110,102,2,29,1,1,allow
25608,53,25608,53,823,98,725,2,30,1,1,allow
57023,443,30630,443,10514,2031,8483,28,149,12,16,allow
55530,80,60637,80,3334,2314,1020,19,39,11,8,allow
47149,443,19883,443,5995,1092,4903,22,72,12,10,allow
9327,443,1143,443,3616,429,3187,11,15,6,5,allow
64318,53,45436,53,183,94,89,2,30,1,1,allow
38322,443,57596,443,10632,3838,6794,37,256,18,19,allow
50541,53,14016,53,458,188,270,6,30,3,3,allow
56771,53,26482,53,166,86,80,2,30,1,1,allow
31214,53,31214,53,216,90,126,2,30,1,1,allow
9295,443,22317,443,3837,488,3349,15,15,7,8,allow
63086,53,16338,53,512,166,346,2,30,1,1,allow
64804,53,12585,53,383,97,286,4,58,2,2,allow
57264,53,5808,53,197,102,95,2,29,1,1,allow
56109,53,49882,53,177,94,83,2,29,1,1,allow
55251,53,30492,53,212,110,102,2,30,1,1,allow
63085,53,50123,53,448,166,282,2,30,1,1,allow
64135,53,23762,53,196,102,94,2,30,1,1,allow
55669,53,4616,53,784,94,690,2,30,1,1,allow
65354,53,12903,53,168,86,82,2,30,1,1,allow
56333,53,17825,53,199,102,97,2,30,1,1,allow
55520,443,13062,443,272841,13586,259255,353,176,164,189,allow
64414,53,2206,53,183,94,89,2,30,1,1,allow
56078,53,23353,53,168,86,82,2,30,1,1,allow
55024,53,28341,53,168,86,82,2,30,1,1,allow
43882,443,18318,443,10494,2409,8085,21,137,9,12,allow
37965,6224,9493,6224,38098,12284,25814,207,2433,100,107,allow
56550,53,42634,53,166,86,80,2,30,1,1,allow
55871,53,4127,53,177,94,83,2,30,1,1,allow
9336,443,60185,443,4702,674,4028,15,15,8,7,allow
56743,443,64118,443,8060,2040,6020,20,15,11,9,allow
52074,57947,10118,57947,70,70,0,2,8,2,0,allow
65386,53,26119,53,1160,392,768,10,66,5,5,allow
49313,53,45650,53,199,102,97,2,30,1,1,allow
56185,53,61715,53,168,86,82,2,30,1,1,allow
54959,53,14757,53,211,110,101,2,30,1,1,allow
56260,53,19443,53,177,94,83,2,30,1,1,allow
56769,53,26341,53,195,102,93,2,30,1,1,allow
50074,53,31884,53,168,86,82,2,30,1,1,allow
65506,53,16583,53,197,102,95,2,30,1,1,allow
55020,443,50900,443,670633,656612,14021,657,146,465,192,allow
64576,53,5234,53,194,102,92,2,31,1,1,allow
57219,5223,28908,5223,9687,5105,4582,30,298,16,14,allow
9330,443,63077,443,3255,430,2825,11,15,6,5,allow
48919,443,27329,443,10338,3346,6992,27,19,15,12,allow
56742,443,47140,443,8007,1987,6020,20,15,11,9,allow
55532,80,8734,80,3367,2346,1021,19,39,11,8,allow
9316,443,33323,443,3649,424,3225,12,15,6,6,allow
28033,443,38606,443,6305,2124,4181,20,16,10,10,allow
56762,53,42811,53,168,86,82,2,30,1,1,allow
55058,53,37390,53,216,110,106,2,30,1,1,allow
55965,53,4442,53,184,94,90,2,30,1,1,allow
50074,53,48010,53,168,86,82,2,30,1,1,allow
63084,443,51859,443,571,166,405,2,30,1,1,allow
56272,53,7235,53,193,102,91,2,30,1,1,allow
63077,53,21461,53,304,86,218,2,30,1,1,allow
58463,443,33811,443,19057,9308,9749,111,307,53,58,allow
64746,53,28024,53,193,102,91,2,31,1,1,allow
8283,52443,34417,52443,130,70,60,2,30,1,1,allow
9328,443,4611,443,5198,504,4694,13,15,7,6,allow
58933,443,10888,443,5167,700,4467,16,15,7,9,allow
51513,443,63128,443,10839,705,10134,14,46,4,10,allow
34244,80,38249,80,656,398,258,11,39,7,4,allow
55533,80,6176,80,3386,2365,1021,19,39,11,8,allow
55534,80,1439,80,3335,2314,1021,19,38,11,8,allow
9324,443,33759,443,3255,430,2825,11,15,6,5,allow
54352,443,22800,443,6854,2318,4536,20,16,11,9,allow
9320,443,10901,443,3599,566,3033,15,15,8,7,allow
52498,80,52498,80,15453,911,14542,25,16,11,14,allow
56862,80,27370,80,2058,589,1469,10,45,6,4,allow
49756,53,28013,53,264,89,175,4,47,2,2,allow
65237,53,38520,53,733,86,647,2,30,1,1,allow
56960,53,36561,53,196,102,94,2,30,1,1,allow
57375,53,58111,53,247,102,145,2,30,1,1,allow
56810,53,28804,53,177,94,83,2,30,1,1,allow
49313,53,30091,53,199,102,97,2,30,1,1,allow
64472,53,42723,53,183,94,89,2,30,1,1,allow
64273,53,36287,53,239,94,145,2,30,1,1,allow
50462,53,31547,53,299,94,205,2,30,1,1,allow
55230,53,6138,53,183,94,89,2,30,1,1,allow
65225,53,58694,53,199,102,97,2,30,1,1,allow
56561,53,15305,53,216,110,106,2,30,1,1,allow
55711,53,17367,53,177,94,83,2,30,1,1,allow
49855,53,34570,53,177,94,83,2,30,1,1,allow
56522,53,55041,53,177,94,83,2,30,1,1,allow
49286,53,40231,53,184,94,90,2,31,1,1,allow
56522,53,65076,53,177,94,83,2,31,1,1,allow
48817,1025,48817,1025,334,158,176,2,1199,1,1,allow
48817,60483,48817,60483,519,158,361,2,1199,1,1,allow
48817,39388,48817,39388,1267,631,636,6,1199,3,3,allow
48817,51413,48817,51413,485,158,327,2,1199,1,1,allow
48817,51234,48817,51234,158,158,0,1,1200,1,0,allow
48817,8999,48817,8999,512,158,354,2,1200,1,1,allow
37263,53,37263,53,220,90,130,2,30,1,1,allow
52533,53,8262,53,242,78,164,2,30,1,1,allow
64135,53,37160,53,196,102,94,2,30,1,1,allow
56160,53,39836,53,195,102,93,2,30,1,1,allow
49246,53,41120,53,172,94,78,2,30,1,1,allow
55194,53,9824,53,195,102,93,2,31,1,1,allow
64926,53,21011,53,166,86,80,2,31,1,1,allow
65428,53,31541,53,195,102,93,2,31,1,1,allow
47656,443,30620,443,684,140,544,11,165,3,8,allow
52888,5223,32740,5223,12302,5509,6793,43,1061,16,27,allow
21133,21689,35631,21689,481,150,331,2,1199,1,1,allow
48817,1049,48817,1049,334,158,176,2,1199,1,1,allow
48817,38081,48817,38081,863,363,500,4,1200,2,2,allow
48817,7131,48817,7131,158,158,0,1,1200,1,0,allow
48817,51417,48817,51417,485,158,327,2,1200,1,1,allow
63952,53,14655,53,211,110,101,2,30,1,1,allow
55965,53,49770,53,184,94,90,2,30,1,1,allow
55945,53,48545,53,177,94,83,2,30,1,1,allow
56910,53,3209,53,199,102,97,2,30,1,1,allow
56810,53,31641,53,177,94,83,2,30,1,1,allow
49954,53,59869,53,753,94,659,2,30,1,1,allow
51880,8001,36976,8001,86,86,0,1,30,1,0,allow
56561,53,31365,53,216,110,106,2,31,1,1,allow
49246,53,51289,53,164,86,78,2,31,1,1,allow
65006,53,63104,53,994,86,908,2,30,1,1,allow
55453,443,3812,443,3015948,160028,2855920,3852,218,1499,2353,allow
56963,53,8410,53,199,102,97,2,31,1,1,allow
54644,443,51226,443,6440,3492,2948,19,135,9,10,allow
54539,443,15655,443,4552,2230,2322,14,134,7,7,allow
33525,443,32155,443,8088,2191,5897,28,508,13,15,allow
48817,58518,48817,58518,580,121,459,4,1199,2,2,allow
48817,1722,48817,1722,158,158,0,1,1200,1,0,allow
48817,23456,48817,23456,485,158,327,2,1200,1,1,allow
57648,443,58910,443,35696,3196,32500,48,121,19,29,allow
51088,443,60075,443,14025,7301,6724,38,171,22,16,allow
54977,53,39208,53,275,93,182,4,31,2,2,allow
61141,443,38623,443,383052,17263,365789,396,132,119,277,allow
6881,6889,7381,6889,228,118,110,2,1200,1,1,allow
48817,6889,48817,6889,502,158,344,2,1200,1,1,allow
48817,51413,48817,51413,485,158,327,2,1200,1,1,allow
49717,53,48239,53,444,96,348,4,44,2,2,allow
55881,443,18861,443,25586,4360,21226,57,81,29,28,allow
53879,43702,31911,43702,320,140,180,6,6,3,3,allow
52081,51835,33500,51835,316,136,180,6,6,3,3,allow
52050,31648,38816,31648,70,70,0,1,5,1,0,allow
35961,80,62048,80,11575,902,10673,20,46,11,9,allow
63963,53,7667,53,262,86,176,4,46,2,2,allow
63963,53,46328,53,262,86,176,4,46,2,2,allow
50606,80,30995,80,83795,22317,61478,117,43,52,65,allow
27739,7000,27739,7000,2163,676,1487,14,15,7,7,allow
60167,80,41576,80,6017,5209,808,12,30,7,5,allow
50940,443,27136,443,29500,27698,1802,51,17,29,22,allow
61876,443,60944,443,3776,1446,2330,20,153,9,11,allow
52049,52557,23041,52557,70,70,0,1,5,1,0,allow
52048,44059,7624,44059,160,70,90,2,5,1,1,allow
63952,53,42119,53,358,105,253,4,44,2,2,allow
57655,56205,0,0,62,62,0,1,0,1,0,deny
44815,36829,0,0,62,62,0,1,0,1,0,deny
42231,57470,0,0,78,78,0,1,0,1,0,deny
63016,445,0,0,70,70,0,1,0,1,0,drop
49417,38558,0,0,66,66,0,1,0,1,0,deny
51417,445,0,0,70,70,0,1,0,1,0,drop
51416,445,0,0,70,70,0,1,0,1,0,drop
51414,445,0,0,70,70,0,1,0,1,0,drop
63015,445,0,0,70,70,0,1,0,1,0,drop
14023,37965,0,0,62,62,0,1,0,1,0,deny
63186,445,0,0,66,66,0,1,0,1,0,drop
59192,25174,0,0,66,66,0,1,0,1,0,deny
51410,445,0,0,70,70,0,1,0,1,0,drop
48706,23394,0,0,60,60,0,1,0,1,0,deny
49931,25174,0,0,62,62,0,1,0,1,0,deny
63181,445,0,0,66,66,0,1,0,1,0,drop
63013,445,0,0,70,70,0,1,0,1,0,drop
63180,445,0,0,66,66,0,1,0,1,0,drop
63178,445,0,0,66,66,0,1,0,1,0,drop
45424,23,0,0,60,60,0,1,0,1,0,deny
63176,445,0,0,66,66,0,1,0,1,0,drop
48230,57866,0,0,62,62,0,1,0,1,0,deny
60075,41705,0,0,62,62,0,1,0,1,0,deny
38475,11392,0,0,66,66,0,1,0,1,0,deny
9102,29635,0,0,148,148,0,1,0,1,0,deny
55951,30188,0,0,66,66,0,1,0,1,0,deny
30280,37965,0,0,66,66,0,1,0,1,0,deny
50052,65008,0,0,60,60,0,1,0,1,0,deny
16057,56205,0,0,66,66,0,1,0,1,0,deny
51404,445,0,0,70,70,0,1,0,1,0,drop
47910,7454,0,0,60,60,0,1,0,1,0,deny
63006,445,0,0,70,70,0,1,0,1,0,drop
51401,445,0,0,70,70,0,1,0,1,0,drop
51394,445,0,0,70,70,0,1,0,1,0,drop
10914,35974,0,0,60,60,0,1,0,1,0,deny
63004,445,0,0,70,70,0,1,0,1,0,drop
52557,44847,0,0,66,66,0,1,0,1,0,deny
28156,50584,0,0,62,62,0,1,0,1,0,deny
63166,445,0,0,66,66,0,1,0,1,0,drop
63003,445,0,0,70,70,0,1,0,1,0,drop
63002,445,0,0,70,70,0,1,0,1,0,drop
9087,37965,0,0,62,62,0,1,0,1,0,deny
7041,37965,0,0,66,66,0,1,0,1,0,deny
64755,31573,0,0,62,62,0,1,0,1,0,deny
63001,445,0,0,70,70,0,1,0,1,0,drop
62995,445,0,0,70,70,0,1,0,1,0,drop
62996,445,0,0,70,70,0,1,0,1,0,drop
23331,25174,0,0,66,66,0,1,0,1,0,deny
2422,62507,0,0,62,62,0,1,0,1,0,deny
443,32698,0,0,89,89,0,1,0,1,0,deny
54048,25174,0,0,62,62,0,1,0,1,0,deny
63158,445,0,0,66,66,0,1,0,1,0,drop
51383,445,0,0,70,70,0,1,0,1,0,drop
62983,445,0,0,70,70,0,1,0,1,0,drop
62981,445,0,0,70,70,0,1,0,1,0,drop
37647,36237,0,0,66,66,0,1,0,1,0,deny
62980,445,0,0,70,70,0,1,0,1,0,drop
51291,25174,0,0,62,62,0,1,0,1,0,deny
62973,445,0,0,70,70,0,1,0,1,0,drop
62972,445,0,0,70,70,0,1,0,1,0,drop
61002,37965,0,0,145,145,0,1,0,1,0,deny
63156,445,0,0,66,66,0,1,0,1,0,drop
46734,50265,0,0,74,74,0,1,0,1,0,deny
49415,22114,0,0,66,66,0,1,0,1,0,deny
61591,22114,0,0,62,62,0,1,0,1,0,deny
13120,25174,0,0,62,62,0,1,0,1,0,deny
26435,39004,0,0,62,62,0,1,0,1,0,deny
59234,21247,0,0,62,62,0,1,0,1,0,deny
52973,57470,0,0,74,74,0,1,0,1,0,deny
51271,37965,0,0,66,66,0,1,0,1,0,deny
63149,445,0,0,66,66,0,1,0,1,0,drop
53567,64147,0,0,62,62,0,1,0,1,0,deny
58022,9200,0,0,60,60,0,1,0,1,0,deny
63146,445,0,0,66,66,0,1,0,1,0,drop
42144,30170,0,0,146,146,0,1,0,1,0,deny
50442,25174,0,0,62,62,0,1,0,1,0,deny
7482,57470,0,0,66,66,0,1,0,1,0,deny
62961,445,0,0,70,70,0,1,0,1,0,drop
60269,443,14941,443,499,425,74,4,0,3,1,allow
30574,64147,0,0,62,62,0,1,0,1,0,deny
26752,64147,0,0,62,62,0,1,0,1,0,deny
64509,9571,0,0,62,62,0,1,0,1,0,deny
1024,44847,0,0,146,146,0,1,0,1,0,deny
30654,51221,0,0,72,72,0,1,0,1,0,deny
51374,445,0,0,70,70,0,1,0,1,0,drop
51372,445,0,0,70,70,0,1,0,1,0,drop
51370,445,0,0,70,70,0,1,0,1,0,drop
1238,51505,0,0,146,146,0,1,0,1,0,deny
54817,47993,0,0,66,66,0,1,0,1,0,deny
63133,445,0,0,66,66,0,1,0,1,0,drop
63131,445,0,0,66,66,0,1,0,1,0,drop
63127,445,0,0,66,66,0,1,0,1,0,drop
63128,445,0,0,66,66,0,1,0,1,0,drop
63126,445,0,0,66,66,0,1,0,1,0,drop
63130,445,0,0,66,66,0,1,0,1,0,drop
63125,445,0,0,66,66,0,1,0,1,0,drop
63129,445,0,0,66,66,0,1,0,1,0,drop
27969,25174,0,0,66,66,0,1,0,1,0,deny
30861,46783,0,0,62,62,0,1,0,1,0,deny
62957,445,0,0,70,70,0,1,0,1,0,drop
47943,50584,0,0,74,74,0,1,0,1,0,deny
4793,50584,0,0,66,66,0,1,0,1,0,deny
21482,22114,0,0,62,62,0,1,0,1,0,deny
6247,51221,0,0,78,78,0,1,0,1,0,deny
63708,25174,0,0,62,62,0,1,0,1,0,deny
21496,50265,0,0,62,62,0,1,0,1,0,deny
45837,25174,0,0,146,146,0,1,0,1,0,deny
62948,445,0,0,70,70,0,1,0,1,0,drop
62945,445,0,0,70,70,0,1,0,1,0,drop
62946,445,0,0,70,70,0,1,0,1,0,drop
16570,25174,0,0,62,62,0,1,0,1,0,deny
34811,56205,0,0,66,66,0,1,0,1,0,deny
62944,445,0,0,70,70,0,1,0,1,0,drop
62940,445,0,0,70,70,0,1,0,1,0,drop
51367,445,0,0,70,70,0,1,0,1,0,drop
51365,445,0,0,70,70,0,1,0,1,0,drop
51354,445,0,0,70,70,0,1,0,1,0,drop
51353,445,0,0,70,70,0,1,0,1,0,drop
63032,22114,0,0,66,66,0,1,0,1,0,deny
55144,30188,0,0,66,66,0,1,0,1,0,deny
25031,25174,0,0,62,62,0,1,0,1,0,deny
63113,445,0,0,66,66,0,1,0,1,0,drop
63111,445,0,0,66,66,0,1,0,1,0,drop
63112,445,0,0,66,66,0,1,0,1,0,drop
6141,23,0,0,60,60,0,1,0,1,0,deny
55199,21247,0,0,66,66,0,1,0,1,0,deny
35666,22114,0,0,62,62,0,1,0,1,0,deny
60869,48817,0,0,66,66,0,1,0,1,0,deny
62934,445,0,0,70,70,0,1,0,1,0,drop
20167,1550,0,0,104,104,0,1,0,1,0,deny
44889,23,0,0,60,60,0,1,0,1,0,deny
17097,62413,0,0,62,62,0,1,0,1,0,deny
51351,445,0,0,70,70,0,1,0,1,0,drop
25063,64147,0,0,62,62,0,1,0,1,0,deny
30707,30317,0,0,62,62,0,1,0,1,0,deny
53257,37450,0,0,62,62,0,1,0,1,0,deny
51344,445,0,0,70,70,0,1,0,1,0,drop
51341,445,0,0,70,70,0,1,0,1,0,drop
51339,445,0,0,70,70,0,1,0,1,0,drop
63832,25174,0,0,66,66,0,1,0,1,0,deny
59949,44847,0,0,62,62,0,1,0,1,0,deny
62927,445,0,0,70,70,0,1,0,1,0,drop
62926,445,0,0,70,70,0,1,0,1,0,drop
50936,22114,0,0,62,62,0,1,0,1,0,deny
33359,30188,0,0,66,66,0,1,0,1,0,deny
63347,25174,0,0,62,62,0,1,0,1,0,deny
52024,25174,0,0,62,62,0,1,0,1,0,deny
7877,22114,0,0,62,62,0,1,0,1,0,deny
7000,23117,0,0,66,66,0,1,0,1,0,deny
62920,445,0,0,70,70,0,1,0,1,0,drop
62919,445,0,0,70,70,0,1,0,1,0,drop
59755,44512,0,0,66,66,0,1,0,1,0,deny
55056,44512,0,0,62,62,0,1,0,1,0,deny
51332,445,0,0,70,70,0,1,0,1,0,drop
51329,445,0,0,70,70,0,1,0,1,0,drop
51327,445,0,0,70,70,0,1,0,1,0,drop
63101,445,0,0,66,66,0,1,0,1,0,drop
56306,17500,0,0,146,146,0,1,0,1,0,deny
62915,445,0,0,70,70,0,1,0,1,0,drop
61400,64147,0,0,62,62,0,1,0,1,0,deny
25523,35974,0,0,62,62,0,1,0,1,0,deny
62885,62413,0,0,62,62,0,1,0,1,0,deny
62913,445,0,0,70,70,0,1,0,1,0,drop
59988,64147,0,0,66,66,0,1,0,1,0,deny
50566,22114,0,0,62,62,0,1,0,1,0,deny
57337,64147,0,0,66,66,0,1,0,1,0,deny
51396,56205,0,0,62,62,0,1,0,1,0,deny
49651,37965,0,0,74,74,0,1,0,1,0,deny
33886,65504,0,0,162,162,0,1,0,1,0,deny
51325,445,0,0,70,70,0,1,0,1,0,drop
51320,445,0,0,70,70,0,1,0,1,0,drop
2543,25174,0,0,66,66,0,1,0,1,0,deny
62909,445,0,0,70,70,0,1,0,1,0,drop
50951,53,0,0,82,82,0,1,30,1,0,allow
50972,3544,50946,3544,258,107,151,2,30,1,1,allow
56522,53,28369,53,170,87,83,2,30,1,1,allow
64249,53,29634,53,178,91,87,2,30,1,1,allow
28132,53,28132,53,176,78,98,2,30,1,1,allow
54858,443,53726,443,5252,3392,1860,22,316,12,10,allow
45406,80,51652,80,573,499,74,6,15,5,1,allow
32864,53,32864,53,404,259,145,3,32,2,1,allow
58926,443,61395,443,5329,3428,1901,20,16,10,10,allow
56916,443,36796,443,13829,2472,11357,30,243,13,17,allow
55945,53,36008,53,760,97,663,2,30,1,1,allow
63963,53,56258,53,262,86,176,4,46,2,2,allow
55102,80,41246,80,46215,1615,44600,57,18,24,33,allow
59366,443,63784,443,59122,7352,51770,85,322,41,44,allow
56680,443,28221,443,8942,1817,7125,23,77,13,10,allow
55024,53,61199,53,174,89,85,2,30,1,1,allow
49449,53,12310,53,216,110,106,2,30,1,1,allow
55487,53,4696,53,732,89,643,2,30,1,1,allow
52929,443,62112,443,5582,1388,4194,19,15,9,10,allow
60191,80,55591,80,2589,1231,1358,9,28,5,4,allow
64576,53,33878,53,188,96,92,2,31,1,1,allow
33122,80,28324,80,9055,863,8192,18,45,10,8,allow
56192,53,15421,53,170,87,83,2,30,1,1,allow
36560,3142,36560,3142,138,78,60,2,5,1,1,allow
38406,80,52487,80,52105,1615,50490,61,18,24,37,allow
60500,443,54155,443,103479,7755,95724,165,19,70,95,allow
56832,80,37022,80,54049,2036,52013,69,18,31,38,allow
49298,443,58144,443,3949,2535,1414,24,75,12,12,allow
28035,443,12518,443,5458,1390,4068,17,15,9,8,allow
39776,443,45893,443,6283,1439,4844,25,316,13,12,allow
52529,80,44880,80,1056,682,374,10,15,6,4,allow
51037,443,13769,443,7298,2661,4637,21,17,11,10,allow
45404,80,36835,80,574,500,74,6,15,5,1,allow
56786,443,44559,443,9096,4394,4702,26,256,15,11,allow
60065,80,60065,80,246733,5745,240988,246,144,80,166,allow
58881,443,10013,443,1413,876,537,12,26,6,6,allow
64340,53,64340,53,847,110,737,2,30,1,1,allow
5588,5588,0,0,3562,1936,1626,48,193,24,24,allow
45533,80,45533,80,52365,3013,49352,53,51,13,40,allow
57417,53,14881,53,295,101,194,4,31,2,2,allow
55602,443,15216,443,7360,2298,5062,22,255,12,10,allow
52930,443,20378,443,5584,1390,4194,19,15,9,10,allow
28034,443,40574,443,5456,1388,4068,17,15,9,8,allow
34353,53,34353,53,213,79,134,2,33,1,1,allow
45400,80,25751,80,574,500,74,6,15,5,1,allow
49733,443,61095,443,204,70,134,4,26,2,2,allow
34493,443,37498,443,11771,2624,9147,50,20,25,25,allow
46617,53,46617,53,213,87,126,2,30,1,1,allow
45402,80,27119,80,573,499,74,6,15,5,1,allow
37542,53,41860,53,240,76,164,2,30,1,1,allow
65248,53,20664,53,208,106,102,2,30,1,1,allow
41672,53,20887,53,240,76,164,2,30,1,1,allow
52711,443,58119,443,15118,3979,11139,34,353,17,17,allow
49855,53,31460,53,170,87,83,2,30,1,1,allow
50443,53,37606,53,788,108,680,2,31,1,1,allow
64681,443,43290,443,2924,653,2271,13,135,6,7,allow
64965,27049,54387,27049,747,462,285,2,31,1,1,allow
2267,53,42274,53,204,118,86,2,31,1,1,allow
2267,53,57413,53,204,118,86,2,31,1,1,allow
2267,53,31811,53,204,118,86,2,31,1,1,allow
56963,53,56853,53,198,101,97,2,31,1,1,allow
49111,443,50826,443,43887,3283,40604,60,398,21,39,allow
50265,56845,47720,56845,480,149,331,2,1200,1,1,allow
56091,53,8508,53,771,101,670,2,31,1,1,allow
57322,53,27268,53,192,98,94,2,31,1,1,allow
2267,53,17239,53,204,118,86,2,31,1,1,allow
56340,53,14544,53,196,100,96,2,31,1,1,allow
46770,443,32021,443,90614,3825,86789,108,214,42,66,allow
49484,53,47845,53,742,88,654,2,31,1,1,allow
56603,53,59539,53,168,86,82,2,31,1,1,allow
64106,53,59908,53,190,97,93,2,31,1,1,allow
65279,53,56734,53,182,93,89,2,31,1,1,allow
65428,53,32499,53,190,97,93,2,31,1,1,allow
64960,27021,59267,27021,742,462,280,2,31,1,1,allow
2267,53,29941,53,204,118,86,2,31,1,1,allow
54924,3478,57299,3478,432,200,232,6,31,3,3,allow
54924,3478,25286,3478,312,140,172,4,31,2,2,allow
65099,53,63994,53,198,101,97,2,31,1,1,allow
64146,53,41885,53,194,99,95,2,31,1,1,allow
59061,443,25060,443,5464,3984,1480,35,221,20,15,allow
44063,443,1759,443,7762,2601,5161,18,137,8,10,allow
49891,53,42483,53,164,84,80,2,31,1,1,allow
64963,27037,16564,27037,741,462,279,2,31,1,1,allow
57761,30317,0,0,66,66,0,1,0,1,0,deny
50251,35440,0,0,66,66,0,1,0,1,0,deny
63085,445,0,0,66,66,0,1,0,1,0,drop
63083,445,0,0,66,66,0,1,0,1,0,drop
59786,25174,0,0,66,66,0,1,0,1,0,deny
1024,37450,0,0,62,62,0,1,0,1,0,deny
60786,25174,0,0,66,66,0,1,0,1,0,deny
55464,22114,0,0,62,62,0,1,0,1,0,deny
63364,57470,0,0,66,66,0,1,0,1,0,deny
34932,38608,0,0,62,62,0,1,0,1,0,deny
54438,62413,0,0,66,66,0,1,0,1,0,deny
51315,445,0,0,70,70,0,1,0,1,0,drop
52078,443,12860,443,9757,2051,7706,34,256,15,19,allow
57442,66,38674,66,70,70,0,1,5,1,0,allow
53152,443,33270,443,116790,7062,109728,166,144,85,81,allow
49449,53,15422,53,216,110,106,2,30,1,1,allow
59032,53,50252,53,295,86,209,2,30,1,1,allow
56912,53,3525,53,199,102,97,2,30,1,1,allow
53158,17234,38811,17234,70,70,0,1,4,1,0,allow
63952,53,32922,53,211,110,101,2,29,1,1,allow
56912,53,5094,53,199,102,97,2,29,1,1,allow
55965,53,59955,53,184,94,90,2,29,1,1,allow
37918,443,47034,443,6521,2079,4442,32,3827,19,13,allow
64318,53,41262,53,499,183,316,6,57,3,3,allow
49302,53,61464,53,234,94,140,2,30,1,1,allow
38460,443,14446,443,272822,10124,262698,330,81,126,204,allow
55194,53,43998,53,195,102,93,2,30,1,1,allow
54912,80,63649,80,1992,1350,642,10,15,5,5,allow
62293,443,17682,443,598,598,0,8,40,8,0,allow
42108,80,8576,80,8370,1025,7345,18,80,10,8,allow
55238,443,7974,443,6186,1650,4536,20,16,11,9,allow
64414,53,13029,53,183,94,89,2,29,1,1,allow
55194,53,21353,53,195,102,93,2,29,1,1,allow
52541,53,60922,53,242,78,164,2,29,1,1,allow
49363,53,56997,53,309,94,215,2,29,1,1,allow
55871,53,54584,53,177,94,83,2,29,1,1,allow
49286,53,40508,53,184,94,90,2,29,1,1,allow
64414,53,36942,53,183,94,89,2,29,1,1,allow
65248,53,6844,53,446,106,340,4,47,2,2,allow
55699,53,3858,53,271,103,168,4,59,2,2,allow
51531,443,29173,443,898,460,438,12,39,5,7,allow
54022,443,20800,443,121935,7839,114096,175,255,82,93,allow
49218,443,54857,443,590577,16239,574338,610,23,222,388,allow
45374,80,46773,80,806,463,343,9,15,6,3,allow
53619,443,9096,443,24190,18242,5948,43,330,25,18,allow
49497,443,34229,443,185560,47806,137754,421,295,217,204,allow
64146,53,31528,53,197,102,95,2,30,1,1,allow
65002,27064,63916,27064,735,462,273,2,30,1,1,allow
55024,53,59987,53,179,94,85,2,30,1,1,allow
3580,53,3580,53,832,106,726,2,30,1,1,allow
45886,80,22615,80,6959,2024,4935,14,148,8,6,allow
56336,53,29646,53,178,94,84,2,30,1,1,allow
61856,443,61856,443,4918,1626,3292,17,17,10,7,allow
55024,53,16229,53,179,94,85,2,30,1,1,allow
36998,80,39862,80,130,70,60,2,15,1,1,allow
9247,80,43064,80,860,794,66,6,17,5,1,allow
64140,53,22655,53,306,94,212,4,33,2,2,allow
49286,53,14433,53,184,94,90,2,30,1,1,allow
65116,53,63214,53,200,94,106,2,30,1,1,allow
63137,47117,19060,47117,574,448,126,10,25,8,2,allow
49631,53,56350,53,198,102,96,2,30,1,1,allow
44235,443,40190,443,2863,1501,1362,20,317,10,10,allow
57669,443,51063,443,12569,8228,4341,28,256,16,12,allow
60793,40010,33213,40010,316,136,180,6,6,3,3,allow
64985,27037,29129,27037,734,462,272,2,30,1,1,allow
12364,80,12364,80,7282,653,6629,16,16,8,8,allow
65011,53,59179,53,168,86,82,2,30,1,1,allow
50609,53,13488,53,766,102,664,2,30,1,1,allow
65245,53,31425,53,184,102,82,2,30,1,1,allow
56603,53,39210,53,168,86,82,2,30,1,1,allow
56522,53,51170,53,177,94,83,2,30,1,1,allow
64746,53,23146,53,193,102,91,2,30,1,1,allow
49855,53,65525,53,177,94,83,2,30,1,1,allow
61675,443,61675,443,8512,2483,6029,21,18,12,9,allow
52066,60118,24886,60118,70,70,0,2,8,2,0,allow
52068,39864,59001,39864,70,70,0,2,8,2,0,allow
56739,443,41966,443,7914,1925,5989,20,15,11,9,allow
55699,53,30470,53,271,103,168,4,59,2,2,allow
39785,53,39785,53,229,98,131,2,30,1,1,allow
55942,53,15569,53,197,102,95,2,30,1,1,allow
65000,27019,62331,27019,728,462,266,2,30,1,1,allow
55786,53,31916,53,102,102,0,1,30,1,0,allow
50837,443,12077,443,3292,2022,1270,16,16,9,7,allow
51505,443,22811,443,7211,823,6388,16,15,10,6,allow
58169,443,39268,443,30845,9943,20902,172,133,73,99,allow
49538,80,51947,80,2050,1691,359,9,75,6,3,allow
50644,80,26132,80,314,192,122,6,25,4,2,allow
63963,53,20929,53,262,86,176,4,46,2,2,allow
64935,53,16580,53,765,102,663,2,30,1,1,allow
50520,53,48841,53,183,94,89,2,30,1,1,allow
65011,53,42934,53,168,86,82,2,30,1,1,allow
58681,123,50487,123,184,94,90,2,30,1,1,allow
64249,53,32881,53,181,94,87,2,30,1,1,allow
53831,54676,36346,54676,492,306,186,8,16,5,3,allow
60449,443,18490,443,26571,2432,24139,42,30,21,21,allow
39802,443,46895,443,2863801,103667,2760134,3193,182,1240,1953,allow
53807,443,5620,443,4622,860,3762,16,17,9,7,allow
57221,53,53360,53,184,102,82,2,30,1,1,allow
38145,443,38145,443,4599,1692,2907,19,29,11,8,allow
60422,443,51829,443,7274,1925,5349,24,138,12,12,allow
55526,80,64372,80,6138,1242,4896,15,40,7,8,allow
46318,443,20839,443,6373,1744,4629,22,15,13,9,allow
43827,443,64958,443,130,70,60,2,14,1,1,allow
53874,43922,52145,43922,320,140,180,6,6,3,3,allow
53842,57861,18155,57861,492,306,186,8,14,5,3,allow
33143,80,14116,80,7406,1038,6368,18,15,10,8,allow
52067,46837,12452,46837,70,70,0,2,8,2,0,allow
56740,443,16895,443,7862,1873,5989,20,15,11,9,allow
50938,443,19392,443,37198,29093,8105,64,17,34,30,allow
52069,53446,38596,53446,70,70,0,2,7,2,0,allow
50646,80,29942,80,1328,917,411,10,25,6,4,allow
52051,29868,57987,29868,70,70,0,1,4,1,0,allow
58927,443,34485,443,5168,700,4468,16,15,7,9,allow
56125,80,62901,80,2091,799,1292,10,15,6,4,allow
56333,53,9058,53,822,102,720,2,29,1,1,allow
65248,53,43627,53,212,110,102,2,29,1,1,allow
55829,53,27683,53,177,94,83,2,29,1,1,allow
56762,53,10015,53,168,86,82,2,29,1,1,allow
64357,53,31050,53,183,94,89,2,29,1,1,allow
50661,80,15216,80,1658,1247,411,8,15,5,3,allow
52261,53,10393,53,195,94,101,2,29,1,1,allow
64477,53,60345,53,211,102,109,2,29,1,1,allow
44157,53,44157,53,216,90,126,2,29,1,1,allow
56550,53,19597,53,166,86,80,2,29,1,1,allow
10947,53,10947,53,197,90,107,2,29,1,1,allow
49620,53,16282,53,198,110,88,2,29,1,1,allow
49855,53,48096,53,177,94,83,2,30,1,1,allow
56192,53,47862,53,177,94,83,2,30,1,1,allow
55711,53,26039,53,177,94,83,2,29,1,1,allow
56912,53,8353,53,199,102,97,2,30,1,1,allow
62306,53,46053,53,387,94,293,2,30,1,1,allow
56910,53,22546,53,199,102,97,2,29,1,1,allow
56497,53,16693,53,177,94,83,2,30,1,1,allow
49332,53,35822,53,276,118,158,2,30,1,1,allow
56078,53,11255,53,168,86,82,2,30,1,1,allow
50520,53,8153,53,183,94,89,2,30,1,1,allow
55751,53,8390,53,216,94,122,2,30,1,1,allow
51001,53,26424,53,183,86,97,2,30,1,1,allow
64245,53,16068,53,344,94,250,2,30,1,1,allow
53833,53,46684,53,211,78,133,2,30,1,1,allow
56500,53,38812,53,164,86,78,2,30,1,1,allow
17750,8953,36082,8953,491,150,341,2,1200,1,1,allow
49160,51413,36529,51413,800,150,650,4,1200,2,2,allow
65064,53,46432,53,198,102,96,2,30,1,1,allow
63972,53,46168,53,193,102,91,2,30,1,1,allow
64966,27051,35392,27051,736,462,274,2,30,1,1,allow
65279,53,28048,53,183,94,89,2,31,1,1,allow
2267,53,18224,53,204,118,86,2,31,1,1,allow
47244,443,21922,443,5953,1848,4105,18,17,10,8,allow
53806,443,60221,443,12788,2594,10194,40,17,20,20,allow
9225,443,21069,443,5510,901,4609,15,25,8,7,allow
64287,53,27313,53,497,90,407,4,33,2,2,allow
60970,80,26224,80,912,472,440,8,15,3,5,allow
56281,53,56281,53,851,114,737,2,30,1,1,allow
64894,53,8238,53,195,102,93,2,30,1,1,allow
64926,53,24382,53,166,86,80,2,30,1,1,allow
64894,53,19330,53,195,102,93,2,30,1,1,allow
56192,53,30886,53,177,94,83,2,30,1,1,allow
65245,53,21925,53,184,102,82,2,30,1,1,allow
49304,53,30791,53,214,102,112,2,30,1,1,allow
55786,53,13962,53,193,102,91,2,30,1,1,allow
54673,443,44962,443,10244,2295,7949,38,121,20,18,allow
49776,443,33796,443,214,140,74,4,15,3,1,allow
58883,443,51515,443,1115,591,524,12,25,6,6,allow
51505,443,27614,443,1210,450,760,17,54,5,12,allow
49449,53,11737,53,216,110,106,2,30,1,1,allow
60711,53,53816,53,211,78,133,2,30,1,1,allow
55211,53,36249,53,183,94,89,2,30,1,1,allow
49637,53,0,0,86,86,0,1,30,1,0,allow
56752,53,41172,53,183,94,89,2,30,1,1,allow
46128,443,47204,443,9814,2331,7483,38,255,19,19,allow
52856,443,43323,443,5495,1303,4192,17,15,9,8,allow
37185,443,49991,443,14035,8420,5615,31,256,18,13,allow
56738,443,13897,443,7863,1874,5989,20,15,11,9,allow
42810,443,64537,443,9265,2134,7131,24,123,12,12,allow
56740,80,35362,80,1462,703,759,8,17,5,3,allow
55211,53,32834,53,183,94,89,2,30,1,1,allow
56497,53,37841,53,177,94,83,2,30,1,1,allow
35459,443,23832,443,119911,5690,114221,153,173,63,90,allow
60580,53,20280,53,181,86,95,2,30,1,1,allow
64573,53,37433,53,757,102,655,2,30,1,1,allow
56121,53,26656,53,338,110,228,2,30,1,1,allow
65036,53,4183,53,199,102,97,2,30,1,1,allow
56500,53,54568,53,164,86,78,2,30,1,1,allow
49226,53,3367,53,194,102,92,2,30,1,1,allow
55024,53,31814,53,179,94,85,2,30,1,1,allow
64829,53,40836,53,213,102,111,2,30,1,1,allow
51689,53,34111,53,198,86,112,2,30,1,1,allow
61830,443,61830,443,88574,15708,72866,114,176,52,62,allow
49804,53,30225,53,209,102,107,2,30,1,1,allow
56497,53,27099,53,177,94,83,2,30,1,1,allow
55865,53,64490,53,168,86,82,2,30,1,1,allow
49180,53,27807,53,359,118,241,2,30,1,1,allow
2267,53,1779,53,204,118,86,2,31,1,1,allow
2267,53,42129,53,204,118,86,2,31,1,1,allow
50559,53,4402,53,216,110,106,2,31,1,1,allow
2267,53,1251,53,204,118,86,2,31,1,1,allow
55591,53,39527,53,195,102,93,2,31,1,1,allow
2267,53,46205,53,204,118,86,2,31,1,1,allow
2267,53,54928,53,204,118,86,2,31,1,1,allow
64106,53,27158,53,195,102,93,2,31,1,1,allow
59478,443,44670,443,9310,2994,6316,25,122,11,14,allow
64576,53,63457,53,194,102,92,2,31,1,1,allow
57470,37395,27238,37395,1566,332,1234,11,1199,5,6,allow
56100,53,57045,53,216,110,106,2,31,1,1,allow
2267,53,13385,53,204,118,86,2,31,1,1,allow
2267,53,11454,53,204,118,86,2,31,1,1,allow
56752,53,15313,53,183,94,89,2,31,1,1,allow
56019,53,28168,53,194,102,92,2,31,1,1,allow
65099,53,22746,53,199,102,97,2,31,1,1,allow
57331,53,47400,53,178,94,84,2,31,1,1,allow
55069,53,13593,53,195,102,93,2,31,1,1,allow
49563,443,54610,443,6462,2102,4360,18,180,8,10,allow
57470,1031,51778,1031,402,132,270,6,1209,3,3,allow
64051,53,51013,53,430,172,258,6,61,3,3,allow
40302,443,5180,443,7586,3785,3801,20,30,11,9,allow
55015,443,24425,443,22687,6933,15754,50,50,26,24,allow
54592,80,24898,80,1113,534,579,12,16,7,5,allow
53198,53,24028,53,365,86,279,2,30,1,1,allow
63972,53,35839,53,193,102,91,2,30,1,1,allow
56192,53,42935,53,177,94,83,2,30,1,1,allow
64146,53,63495,53,197,102,95,2,30,1,1,allow
64188,53,45023,53,194,94,100,2,30,1,1,allow
57322,53,63683,53,196,102,94,2,31,1,1,allow
47836,443,38604,443,36324,2308,34016,55,81,22,33,allow
55865,53,56298,53,168,86,82,2,30,1,1,allow
63103,53,6941,53,222,86,136,2,30,1,1,allow
64535,53,33577,53,734,86,648,2,31,1,1,allow
48724,443,22721,443,4371,2036,2335,18,24,10,8,allow
56737,443,49751,443,7915,1926,5989,20,16,11,9,allow
52070,55946,25301,55946,316,136,180,6,7,3,3,allow
51314,445,0,0,70,70,0,1,0,1,0,drop
51308,445,0,0,70,70,0,1,0,1,0,drop
51307,445,0,0,70,70,0,1,0,1,0,drop
45964,2225,0,0,60,60,0,1,0,1,0,deny
45964,2225,0,0,60,60,0,1,0,1,0,deny
63079,445,0,0,66,66,0,1,0,1,0,drop
49754,35440,0,0,146,146,0,1,0,1,0,deny
22636,30188,0,0,66,66,0,1,0,1,0,deny
57220,26467,0,0,66,66,0,1,0,1,0,deny
62896,445,0,0,70,70,0,1,0,1,0,drop
56306,57587,0,0,146,146,0,1,0,1,0,deny
19662,22114,0,0,62,62,0,1,0,1,0,deny
63067,445,0,0,66,66,0,1,0,1,0,drop
63069,445,0,0,66,66,0,1,0,1,0,drop
63068,445,0,0,66,66,0,1,0,1,0,drop
63072,445,0,0,66,66,0,1,0,1,0,drop
63066,445,0,0,66,66,0,1,0,1,0,drop
63065,445,0,0,66,66,0,1,0,1,0,drop
63063,445,0,0,66,66,0,1,0,1,0,drop
2062,35440,0,0,66,66,0,1,0,1,0,deny
51298,445,0,0,70,70,0,1,0,1,0,drop
26881,25174,0,0,66,66,0,1,0,1,0,deny
60793,53733,0,0,66,66,0,1,0,1,0,deny
62893,445,0,0,70,70,0,1,0,1,0,drop
51292,445,0,0,70,70,0,1,0,1,0,drop
51295,445,0,0,70,70,0,1,0,1,0,drop
51291,445,0,0,70,70,0,1,0,1,0,drop
55678,32468,0,0,66,66,0,1,0,1,0,deny
41541,25174,0,0,66,66,0,1,0,1,0,deny
68,67,0,0,346,346,0,1,0,1,0,deny
59213,25174,0,0,66,66,0,1,0,1,0,deny
8889,21251,0,0,60,60,0,1,0,1,0,deny
60104,30188,0,0,62,62,0,1,0,1,0,deny
62888,445,0,0,70,70,0,1,0,1,0,drop
51560,46783,0,0,62,62,0,1,0,1,0,deny
62887,445,0,0,70,70,0,1,0,1,0,drop
515,10214,0,0,66,66,0,1,0,1,0,deny
51289,445,0,0,70,70,0,1,0,1,0,drop
51287,445,0,0,70,70,0,1,0,1,0,drop
51286,445,0,0,70,70,0,1,0,1,0,drop
62885,445,0,0,70,70,0,1,0,1,0,drop
63057,445,0,0,66,66,0,1,0,1,0,drop
51282,445,0,0,70,70,0,1,0,1,0,drop
56306,1,0,0,146,146,0,1,0,1,0,deny
44612,25174,0,0,66,66,0,1,0,1,0,deny
63053,445,0,0,66,66,0,1,0,1,0,drop
59524,25174,0,0,66,66,0,1,0,1,0,deny
63051,445,0,0,66,66,0,1,0,1,0,drop
63050,445,0,0,66,66,0,1,0,1,0,drop
11136,15503,0,0,62,62,0,1,0,1,0,deny
63048,445,0,0,66,66,0,1,0,1,0,drop
62878,445,0,0,70,70,0,1,0,1,0,drop
53640,25174,0,0,66,66,0,1,0,1,0,deny
64214,25174,0,0,62,62,0,1,0,1,0,deny
51281,445,0,0,70,70,0,1,0,1,0,drop
63062,11392,0,0,66,66,0,1,0,1,0,deny
62876,445,0,0,70,70,0,1,0,1,0,drop
40481,22114,0,0,66,66,0,1,0,1,0,deny
6881,46776,0,0,146,146,0,1,0,1,0,deny
53197,25174,0,0,62,62,0,1,0,1,0,deny
51267,445,0,0,70,70,0,1,0,1,0,drop
51265,445,0,0,70,70,0,1,0,1,0,drop
62875,445,0,0,70,70,0,1,0,1,0,drop
62874,445,0,0,70,70,0,1,0,1,0,drop
53470,22114,0,0,66,66,0,1,0,1,0,deny
62873,445,0,0,70,70,0,1,0,1,0,drop
62867,445,0,0,70,70,0,1,0,1,0,drop
62870,445,0,0,70,70,0,1,0,1,0,drop
63037,445,0,0,66,66,0,1,0,1,0,drop
8889,53670,0,0,60,60,0,1,0,1,0,deny
6880,31359,0,0,107,107,0,1,0,1,0,deny
50822,50584,0,0,62,62,0,1,0,1,0,deny
2383,37965,0,0,66,66,0,1,0,1,0,deny
62855,445,0,0,70,70,0,1,0,1,0,drop
62854,445,0,0,70,70,0,1,0,1,0,drop
62852,445,0,0,70,70,0,1,0,1,0,drop
63030,445,0,0,66,66,0,1,0,1,0,drop
25150,25174,0,0,62,62,0,1,0,1,0,deny
51255,445,0,0,70,70,0,1,0,1,0,drop
62844,445,0,0,70,70,0,1,0,1,0,drop
62845,445,0,0,70,70,0,1,0,1,0,drop
46280,5900,0,0,60,60,0,1,0,1,0,deny
55012,25174,0,0,66,66,0,1,0,1,0,deny
54530,46776,0,0,66,66,0,1,0,1,0,deny
55385,53,61909,53,710,89,621,2,0,1,1,allow
55643,53,39402,53,182,93,89,2,0,1,1,allow
18642,42707,0,0,145,145,0,1,0,1,0,deny
28795,37965,0,0,62,62,0,1,0,1,0,deny
51706,25174,0,0,66,66,0,1,0,1,0,deny
45941,23387,0,0,60,60,0,1,0,1,0,deny
63027,445,0,0,66,66,0,1,0,1,0,drop
54684,37965,0,0,62,62,0,1,0,1,0,deny
1860,25174,0,0,66,66,0,1,0,1,0,deny
1027,25174,0,0,62,62,0,1,0,1,0,deny
51479,25174,0,0,66,66,0,1,0,1,0,deny
62489,23117,0,0,66,66,0,1,0,1,0,deny
43185,50584,0,0,146,146,0,1,0,1,0,deny
25207,48817,0,0,62,62,0,1,0,1,0,deny
63019,445,0,0,66,66,0,1,0,1,0,drop
55570,44847,0,0,66,66,0,1,0,1,0,deny
33941,37807,0,0,62,62,0,1,0,1,0,deny
62833,445,0,0,70,70,0,1,0,1,0,drop
53073,32468,0,0,66,66,0,1,0,1,0,deny
63017,445,0,0,66,66,0,1,0,1,0,drop
6247,51221,0,0,78,78,0,1,0,1,0,deny
60260,22114,0,0,62,62,0,1,0,1,0,deny
56306,15503,0,0,146,146,0,1,0,1,0,deny
55711,26467,0,0,62,62,0,1,0,1,0,deny
29972,50584,0,0,62,62,0,1,0,1,0,deny
80,8562,0,0,74,74,0,1,0,1,0,deny
56424,53,24013,53,711,87,624,2,0,1,1,allow
51746,25174,0,0,62,62,0,1,0,1,0,deny
54121,25174,0,0,66,66,0,1,0,1,0,deny
62828,445,0,0,70,70,0,1,0,1,0,drop
51246,445,0,0,70,70,0,1,0,1,0,drop
51242,445,0,0,70,70,0,1,0,1,0,drop
51243,445,0,0,70,70,0,1,0,1,0,drop
57496,25174,0,0,66,66,0,1,0,1,0,deny
63004,445,0,0,66,66,0,1,0,1,0,drop
63005,445,0,0,66,66,0,1,0,1,0,drop
63003,445,0,0,66,66,0,1,0,1,0,drop
63002,445,0,0,66,66,0,1,0,1,0,drop
63001,445,0,0,66,66,0,1,0,1,0,drop
63000,445,0,0,66,66,0,1,0,1,0,drop
62999,445,0,0,66,66,0,1,0,1,0,drop
62997,445,0,0,66,66,0,1,0,1,0,drop
15281,25174,0,0,146,146,0,1,0,1,0,deny
50459,62413,0,0,62,62,0,1,0,1,0,deny
56676,37965,0,0,66,66,0,1,0,1,0,deny
15605,50265,0,0,62,62,0,1,0,1,0,deny
58022,5560,0,0,60,60,0,1,0,1,0,deny
62820,445,0,0,70,70,0,1,0,1,0,drop
62819,445,0,0,70,70,0,1,0,1,0,drop
62818,445,0,0,70,70,0,1,0,1,0,drop
62815,445,0,0,70,70,0,1,0,1,0,drop
32997,22,0,0,60,60,0,1,0,1,0,deny
62812,445,0,0,70,70,0,1,0,1,0,drop
21064,25174,0,0,62,62,0,1,0,1,0,deny
54373,26467,0,0,62,62,0,1,0,1,0,deny
43828,44847,0,0,62,62,0,1,0,1,0,deny
13285,29892,0,0,145,145,0,1,0,1,0,deny
64392,25174,0,0,62,62,0,1,0,1,0,deny
64190,2767,0,0,62,62,0,1,0,1,0,deny
51238,445,0,0,70,70,0,1,0,1,0,drop
51233,445,0,0,70,70,0,1,0,1,0,drop
51236,445,0,0,70,70,0,1,0,1,0,drop
51226,445,0,0,70,70,0,1,0,1,0,drop
43584,24748,0,0,156,156,0,1,0,1,0,deny
23594,48983,0,0,159,159,0,1,0,1,0,deny
60058,25174,0,0,66,66,0,1,0,1,0,deny
62982,445,0,0,66,66,0,1,0,1,0,drop
62984,445,0,0,66,66,0,1,0,1,0,drop
62983,445,0,0,66,66,0,1,0,1,0,drop
57284,22114,0,0,62,62,0,1,0,1,0,deny
62806,445,0,0,70,70,0,1,0,1,0,drop
60823,25174,0,0,62,62,0,1,0,1,0,deny
48301,25174,0,0,66,66,0,1,0,1,0,deny
22714,30188,0,0,146,146,0,1,0,1,0,deny
28306,25604,0,0,62,62,0,1,0,1,0,deny
62064,22114,0,0,66,66,0,1,0,1,0,deny
55508,64147,0,0,62,62,0,1,0,1,0,deny
61523,37807,0,0,66,66,0,1,0,1,0,deny
51222,445,0,0,70,70,0,1,0,1,0,drop
35111,22114,0,0,66,66,0,1,0,1,0,deny
54726,30041,0,0,66,66,0,1,0,1,0,deny
51218,445,0,0,70,70,0,1,0,1,0,drop
51216,445,0,0,70,70,0,1,0,1,0,drop
51213,445,0,0,70,70,0,1,0,1,0,drop
62799,445,0,0,70,70,0,1,0,1,0,drop
62797,445,0,0,70,70,0,1,0,1,0,drop
13235,44847,0,0,66,66,0,1,0,1,0,deny
12841,37965,0,0,62,62,0,1,0,1,0,deny
52682,22114,0,0,66,66,0,1,0,1,0,deny
49752,50584,0,0,62,62,0,1,0,1,0,deny
62793,445,0,0,70,70,0,1,0,1,0,drop
63323,54369,0,0,78,78,0,1,0,1,0,deny
55167,48817,0,0,66,66,0,1,0,1,0,deny
62791,445,0,0,70,70,0,1,0,1,0,drop
49514,65504,0,0,162,162,0,1,0,1,0,deny
64036,23718,0,0,66,66,0,1,0,1,0,deny
51866,22114,0,0,66,66,0,1,0,1,0,deny
49824,25174,0,0,62,62,0,1,0,1,0,deny
63595,51050,0,0,66,66,0,1,0,1,0,deny
22408,22114,0,0,66,66,0,1,0,1,0,deny
51205,445,0,0,70,70,0,1,0,1,0,drop
51204,445,0,0,70,70,0,1,0,1,0,drop
51203,445,0,0,70,70,0,1,0,1,0,drop
62787,445,0,0,70,70,0,1,0,1,0,drop
62972,445,0,0,66,66,0,1,0,1,0,drop
7160,34317,0,0,146,146,0,1,0,1,0,deny
63998,11372,44405,11372,504,382,122,8,16,6,2,allow
49571,443,45165,443,3972,887,3085,13,31,6,7,allow
2267,53,35610,53,204,118,86,2,30,1,1,allow
64739,53,44159,53,172,88,84,2,30,1,1,allow
52045,16853,9076,16853,66,66,0,1,5,1,0,allow
38766,53,38766,53,371,237,134,3,32,2,1,allow
49731,443,10101,443,4484,1063,3421,15,25,7,8,allow
5588,5588,0,0,3562,1936,1626,48,195,24,24,allow
56761,53,40671,53,788,108,680,2,30,1,1,allow
57357,443,47242,443,126,60,66,3,11,2,1,allow
49341,80,65147,80,1969,463,1506,13,55,7,6,allow
55069,53,8912,53,190,97,93,2,31,1,1,allow
56703,53,61350,53,198,101,97,2,31,1,1,allow
56134,53,39668,53,93,93,0,1,30,1,0,allow
55944,53,48983,53,762,98,664,2,30,1,1,allow
51621,443,45721,443,5964,1007,4957,18,16,11,7,allow
55591,53,58697,53,190,97,93,2,31,1,1,allow
54924,3478,2909,3478,312,140,172,4,30,2,2,allow
57318,443,57308,443,10504,1787,8717,27,364,12,15,allow
61827,443,61827,443,56634,10853,45781,76,175,34,42,allow
58077,443,14905,443,9138,4704,4434,24,315,13,11,allow
27322,443,7841,443,5235,1839,3396,22,48,10,12,allow
42382,443,39819,443,4844,1099,3745,18,25,10,8,allow
56633,53,42067,53,164,84,80,2,31,1,1,allow
45837,443,61728,443,39986,3118,36868,72,82,30,42,allow
55879,53,24811,53,749,94,655,2,30,1,1,allow
64051,53,14293,53,430,172,258,6,60,3,3,allow
56752,53,57000,53,182,93,89,2,30,1,1,allow
51071,443,30007,443,13412,5710,7702,50,257,24,26,allow
2267,53,32396,53,204,118,86,2,30,1,1,allow
50116,22,50116,22,146,60,86,2,9,1,1,allow
56308,53,17371,53,814,110,704,2,30,1,1,allow
57168,53,20859,53,760,96,664,2,30,1,1,allow
55896,53,31620,53,168,86,82,2,30,1,1,allow
57331,53,59568,53,172,88,84,2,30,1,1,allow
63972,53,23173,53,186,95,91,2,30,1,1,allow
55441,443,55441,443,4423,1516,2907,19,30,11,8,allow
37151,80,11771,80,130,70,60,2,15,1,1,allow
58921,443,47044,443,10782,7193,3589,30,16,17,13,allow
36017,443,12463,443,4883,3524,1359,20,200,11,9,allow
13553,53,13553,53,235,90,145,2,32,1,1,allow
49732,443,33979,443,4414,993,3421,14,25,6,8,allow
59933,80,6671,80,582,138,444,9,25,3,6,allow
61831,443,61831,443,530764,27638,503126,528,175,179,349,allow
27318,443,31101,443,16040,2126,13914,40,50,21,19,allow
55698,45710,26352,45710,70,70,0,2,8,2,0,allow
58912,443,7357,443,7941,5160,2781,25,17,13,12,allow
58913,443,48481,443,5264,3357,1907,21,17,11,10,allow
51614,443,28714,443,3833,867,2966,14,16,9,5,allow
58909,443,25795,443,7671,4890,2781,25,17,13,12,allow
51619,443,5811,443,3894,863,3031,15,16,9,6,allow
56336,53,24893,53,172,88,84,2,30,1,1,allow
60581,53,60581,53,197,76,121,2,30,1,1,allow
2267,53,10348,53,204,118,86,2,30,1,1,allow
56040,53,54233,53,761,100,661,2,30,1,1,allow
56231,53,34438,53,757,98,659,2,30,1,1,allow
2267,53,10522,53,204,118,86,2,30,1,1,allow
49797,53,55138,53,767,102,665,2,31,1,1,allow
56677,53,31185,53,767,102,665,2,31,1,1,allow
49112,443,21171,443,6319,877,5442,23,396,8,15,allow
57470,26944,61791,26944,480,149,331,2,1200,1,1,allow
55940,53,33630,53,742,88,654,2,30,1,1,allow
52716,443,35091,443,69951,4941,65010,95,351,45,50,allow
57341,53,29078,53,184,94,90,2,31,1,1,allow
35981,53,35981,53,227,89,138,2,31,1,1,allow
57200,53,22685,53,770,102,668,2,31,1,1,allow
52040,53,52040,53,251,98,153,2,31,1,1,allow
65048,53,54954,53,754,94,660,2,31,1,1,allow
49944,53,20178,53,192,98,94,2,31,1,1,allow
55735,53,13880,53,198,101,97,2,31,1,1,allow
49110,443,4488,443,43476,3775,39701,67,397,28,39,allow
57470,17690,10017,17690,1818,1188,630,26,2804,19,7,allow
49885,53,17170,53,760,97,663,2,31,1,1,allow
55323,53,14352,53,172,88,84,2,31,1,1,allow
64964,27035,57797,27035,996,462,534,4,31,2,2,allow
64679,53,50625,53,172,88,84,2,31,1,1,allow
56490,53,61381,53,744,89,655,2,31,1,1,allow
56377,53,45673,53,793,101,692,2,31,1,1,allow
56940,53,36969,53,200,102,98,2,31,1,1,allow
56349,53,17487,53,216,110,106,2,31,1,1,allow
49823,53,45548,53,202,103,99,2,31,1,1,allow
49113,443,18821,443,6318,877,5441,23,396,8,15,allow
39775,443,49168,443,6883,1887,4996,23,361,12,11,allow
46776,443,41505,443,7389,1786,5603,26,211,14,12,allow
55920,53,34293,53,810,108,702,2,31,1,1,allow
55468,53,52823,53,754,94,660,2,31,1,1,allow
64068,53,56393,53,168,86,82,2,31,1,1,allow
55624,53,14345,53,198,101,97,2,31,1,1,allow
55419,53,50922,53,760,97,663,2,31,1,1,allow
55520,53,33643,53,188,96,92,2,31,1,1,allow
56852,53,36624,53,762,101,661,2,31,1,1,allow
60483,443,59259,443,3089,866,2223,11,121,6,5,allow
15503,23852,58898,23852,10840,6789,4051,143,4379,82,61,allow
6881,6883,20913,6883,259,150,109,2,1200,1,1,allow
54578,26467,0,0,66,66,0,1,0,1,0,deny
62786,445,0,0,70,70,0,1,0,1,0,drop
3169,22114,0,0,66,66,0,1,0,1,0,deny
54796,22114,0,0,66,66,0,1,0,1,0,deny
34914,26467,0,0,62,62,0,1,0,1,0,deny
9836,22114,0,0,66,66,0,1,0,1,0,deny
52227,64147,0,0,62,62,0,1,0,1,0,deny
56403,51505,0,0,66,66,0,1,0,1,0,deny
47812,30627,0,0,62,62,0,1,0,1,0,deny
62217,37807,0,0,66,66,0,1,0,1,0,deny
55435,25174,0,0,62,62,0,1,0,1,0,deny
51197,445,0,0,70,70,0,1,0,1,0,drop
50145,53,7031,53,184,94,90,2,30,1,1,allow
54924,3478,47718,3478,312,140,172,4,30,2,2,allow
51612,443,60658,443,5677,918,4759,18,15,10,8,allow
51194,445,0,0,70,70,0,1,0,1,0,drop
62781,445,0,0,70,70,0,1,0,1,0,drop
60117,50934,0,0,66,66,0,1,0,1,0,deny
5227,50584,0,0,62,62,0,1,0,1,0,deny
63577,30188,0,0,66,66,0,1,0,1,0,deny
58247,57866,0,0,66,66,0,1,0,1,0,deny
16057,51050,0,0,66,66,0,1,0,1,0,deny
62956,445,0,0,66,66,0,1,0,1,0,drop
62953,445,0,0,66,66,0,1,0,1,0,drop
41486,1433,0,0,60,60,0,1,0,1,0,deny
52230,50265,0,0,62,62,0,1,0,1,0,deny
42231,57470,0,0,78,78,0,1,0,1,0,deny
55210,53,63664,53,969,86,883,2,30,1,1,allow
65275,53,12888,53,370,126,244,2,30,1,1,allow
56019,53,13898,53,194,102,92,2,30,1,1,allow
16403,16385,49252,16385,548,248,300,10,30,5,5,allow
64739,53,17167,53,178,94,84,2,30,1,1,allow
49514,53,53009,53,749,94,655,2,30,1,1,allow
57379,443,26122,443,7211,823,6388,16,15,10,6,allow
56336,53,15481,53,489,88,401,4,46,2,2,allow
49762,53,30143,53,819,102,717,2,29,1,1,allow
59833,53,30174,53,377,86,291,2,29,1,1,allow
54981,53,59429,53,757,102,655,2,29,1,1,allow
64999,27034,10678,27034,735,462,273,2,29,1,1,allow
56202,53,55288,53,819,102,717,2,29,1,1,allow
65283,53,11652,53,333,102,231,2,29,1,1,allow
57322,53,53567,53,196,102,94,2,29,1,1,allow
64806,53,37126,53,211,102,109,2,29,1,1,allow
50035,53,20021,53,308,102,206,2,29,1,1,allow
53609,53,21780,53,385,94,291,2,30,1,1,allow
57417,53,39419,53,199,102,97,2,30,1,1,allow
61826,443,61826,443,95212,17857,77355,119,175,53,66,allow
53453,443,33620,443,17494,6818,10676,46,46,25,21,allow
54948,443,58033,443,493685,14728,478957,612,316,213,399,allow
49639,443,42419,443,21062,2202,18860,34,80,15,19,allow
49341,53,21121,53,392,86,306,2,29,1,1,allow
64106,53,52132,53,195,102,93,2,29,1,1,allow
64790,53,60024,53,178,94,84,2,29,1,1,allow
49746,53,29622,53,185,102,83,2,30,1,1,allow
49203,53,4131,53,403,99,304,4,32,2,2,allow
2267,53,35940,53,204,118,86,2,30,1,1,allow
55786,53,64576,53,193,102,91,2,29,1,1,allow
2267,53,48892,53,204,118,86,2,30,1,1,allow
64994,27032,29881,27032,737,462,275,2,29,1,1,allow
49762,53,6291,53,196,102,94,2,29,1,1,allow
2267,53,13716,53,204,118,86,2,30,1,1,allow
49449,53,37523,53,216,110,106,2,29,1,1,allow
63972,53,24077,53,193,102,91,2,29,1,1,allow
51328,443,46063,443,6021,1981,4040,21,15,9,12,allow
57221,53,46489,53,184,102,82,2,29,1,1,allow
49226,53,7327,53,194,102,92,2,29,1,1,allow
64065,53,56733,53,264,94,170,2,29,1,1,allow
52046,59791,21148,59791,70,70,0,1,4,1,0,allow
52047,42805,53752,42805,70,70,0,1,4,1,0,allow
2267,53,32602,53,204,118,86,2,30,1,1,allow
49165,5938,24586,5938,143727,72050,71677,1106,10824,655,451,allow
2267,53,54801,53,204,118,86,2,30,1,1,allow
50972,3544,54977,3544,409,107,302,4,29,2,2,allow
56336,53,34970,53,178,94,84,2,29,1,1,allow
57331,53,50054,53,178,94,84,2,30,1,1,allow
50286,53,44602,53,766,102,664,2,30,1,1,allow
49364,80,23008,80,1614,1300,314,10,15,5,5,allow
47453,443,47453,443,4475,1568,2907,19,28,11,8,allow
49673,53,51744,53,421,88,333,4,39,2,2,allow
65261,53,11148,53,313,97,216,4,56,2,2,allow
2267,53,18938,53,204,118,86,2,30,1,1,allow
56560,53,3085,53,199,102,97,2,30,1,1,allow
65279,53,39619,53,183,94,89,2,30,1,1,allow
57339,53,52334,53,196,94,102,2,30,1,1,allow
55896,53,34756,53,168,86,82,2,30,1,1,allow
64068,53,31141,53,168,86,82,2,30,1,1,allow
49746,53,23888,53,177,94,83,2,30,1,1,allow
56100,53,6720,53,216,110,106,2,30,1,1,allow
64068,53,47417,53,168,86,82,2,31,1,1,allow
55855,443,32782,443,11485,3525,7960,32,33,18,14,allow
56667,80,26674,80,234,234,0,4,12,4,0,allow
64962,27048,15901,27048,747,462,285,2,30,1,1,allow
49604,53,29008,53,969,86,883,2,30,1,1,allow
50145,53,3618,53,807,94,713,2,30,1,1,allow
49567,5223,11151,5223,9705,5123,4582,29,74,15,14,allow
54924,3478,45480,3478,452,280,172,5,30,3,2,allow
49782,80,45830,80,130,70,60,2,15,1,1,allow
2267,53,56692,53,204,118,86,2,30,1,1,allow
51327,443,49417,443,8433,3066,5367,21,17,10,11,allow
49900,443,19208,443,52800,13228,39572,134,154,64,70,allow
64980,27047,61209,27047,735,462,273,2,30,1,1,allow
56560,53,4551,53,199,102,97,2,30,1,1,allow
46908,80,46908,80,5464,713,4751,15,16,8,7,allow
65106,53,10929,53,193,102,91,2,30,1,1,allow
50234,53,13512,53,242,78,164,2,30,1,1,allow
64715,53,60767,53,315,98,217,4,58,2,2,allow
49910,53,38613,53,218,94,124,2,30,1,1,allow
65279,53,57423,53,183,94,89,2,30,1,1,allow
57417,53,7685,53,199,102,97,2,30,1,1,allow
49652,53,26066,53,229,110,119,2,30,1,1,allow
15561,53,15561,53,199,90,109,2,30,1,1,allow
35915,80,21762,80,1283,644,639,9,146,5,4,allow
16403,16384,8455,16384,426,186,240,8,30,4,4,allow
58925,443,39506,443,5167,700,4467,16,15,7,9,allow
49220,2710,38165,2710,70,70,0,1,5,1,0,allow
65111,53,19274,53,355,96,259,4,38,2,2,allow
50660,80,51110,80,1658,1247,411,8,15,5,3,allow
55989,53,12782,53,821,102,719,2,30,1,1,allow
50559,53,61943,53,216,110,106,2,30,1,1,allow
65099,53,58455,53,199,102,97,2,30,1,1,allow
65174,53,57194,53,214,110,104,2,30,1,1,allow
43348,443,43348,443,46356,1595,44761,52,17,15,37,allow
34911,443,4016,443,414843,13933,400910,459,136,160,299,allow
27448,5222,60213,5222,8039,1649,6390,41,357,13,28,allow
34901,443,15952,443,70,70,0,1,5,1,0,allow
50151,80,25475,80,1915831,46544,1869287,1569,166,311,1258,allow
56734,443,60875,443,7889,1900,5989,20,15,11,9,allow
58322,53,41674,53,352,78,274,2,30,1,1,allow
50829,53,16960,53,168,78,90,2,30,1,1,allow
49965,53,5956,53,257,110,147,2,30,1,1,allow
55896,53,64776,53,168,86,82,2,30,1,1,allow
55591,53,22310,53,195,102,93,2,30,1,1,allow
56736,443,32910,443,7890,1901,5989,20,15,11,9,allow
7701,80,7701,80,900,519,381,7,141,4,3,allow
64051,53,27383,53,430,172,258,6,59,3,3,allow
56108,53,60144,53,298,92,206,4,41,2,2,allow
55268,53,38039,53,318,91,227,4,33,2,2,allow
55699,21063,32423,21063,70,70,0,2,8,2,0,allow
53841,8999,39565,8999,70,70,0,1,4,1,0,allow
60166,80,1732,80,186,64,122,4,28,2,2,allow
60466,64337,26945,64337,70,70,0,1,5,1,0,allow
49628,53,16334,53,168,86,82,2,31,1,1,allow
47828,443,14141,443,143399,8522,134877,208,153,101,107,allow
33826,443,52979,443,416,210,206,7,57,4,3,allow
40464,80,50769,80,15535,2173,13362,30,21,17,13,allow
55830,443,44368,443,62,62,0,1,5,1,0,allow
52065,52021,26408,52021,70,70,0,2,7,2,0,allow
52147,443,32446,443,27251,9966,17285,70,73,35,35,allow
34166,443,10129,443,1984,1233,751,16,20,8,8,allow
54018,443,16505,443,13330,3836,9494,53,255,29,24,allow
47075,80,40568,80,1614,1300,314,10,15,5,5,allow
65036,53,9458,53,199,102,97,2,29,1,1,allow
49426,53,14946,53,492,91,401,4,56,2,2,allow
49412,53,45661,53,761,102,659,2,29,1,1,allow
64853,53,57521,53,814,110,704,2,29,1,1,allow
57174,53,49887,53,293,86,207,2,29,1,1,allow
56963,53,37570,53,199,102,97,2,29,1,1,allow
49456,53,27659,53,360,110,250,2,29,1,1,allow
56603,53,47573,53,168,86,82,2,29,1,1,allow
65428,53,15132,53,195,102,93,2,29,1,1,allow
64791,53,19745,53,763,102,661,2,29,1,1,allow
65064,53,48752,53,821,102,719,2,29,1,1,allow
64790,53,14045,53,178,94,84,2,29,1,1,allow
65036,53,55693,53,199,102,97,2,29,1,1,allow
57331,53,57928,53,178,94,84,2,29,1,1,allow
65008,53,11411,53,276,118,158,2,29,1,1,allow
56560,53,17987,53,199,102,97,2,30,1,1,allow
65099,53,38778,53,199,102,97,2,29,1,1,allow
2267,53,43002,53,204,118,86,2,30,1,1,allow
56340,53,44693,53,198,102,96,2,30,1,1,allow
64742,53,7062,53,338,110,228,2,30,1,1,allow
2267,53,21811,53,204,118,86,2,30,1,1,allow
56202,53,15464,53,196,102,94,2,29,1,1,allow
50559,53,13725,53,216,110,106,2,29,1,1,allow
65518,53,57051,53,198,94,104,2,30,1,1,allow
63780,28124,24113,28124,4536,2883,1653,27,94,15,12,allow
36088,443,55123,443,7229,2357,4872,26,270,14,12,allow
2267,53,16452,53,204,118,86,2,30,1,1,allow
49697,53,7185,53,195,94,101,2,30,1,1,allow
55069,53,50203,53,195,102,93,2,30,1,1,allow
49504,53,3816,53,198,94,104,2,30,1,1,allow
49823,53,39665,53,209,110,99,2,31,1,1,allow
47582,443,49001,443,6214,1733,4481,13,120,6,7,allow
56340,53,42393,53,198,102,96,2,30,1,1,allow
49238,53,61405,53,274,94,180,2,30,1,1,allow
65028,53,41163,53,265,94,171,2,30,1,1,allow
50045,53,44466,53,168,86,82,2,31,1,1,allow
56349,53,28965,53,216,110,106,2,31,1,1,allow
64627,53,12613,53,184,102,82,2,31,1,1,allow
50515,80,58648,80,7871,1409,6462,17,75,7,10,allow
34902,443,35566,443,70,70,0,1,5,1,0,allow
34900,443,21666,443,70,70,0,1,5,1,0,allow
37672,5223,8222,5223,110,110,0,1,5,1,0,allow
50652,443,65076,443,2477,1505,972,15,20,9,6,allow
64641,53,15849,53,193,94,99,2,30,1,1,allow
65106,53,42197,53,193,102,91,2,30,1,1,allow
2267,53,1505,53,204,118,86,2,30,1,1,allow
57417,53,46711,53,199,102,97,2,30,1,1,allow
55896,53,48962,53,168,86,82,2,30,1,1,allow
54225,53,12389,53,274,78,196,2,30,1,1,allow
65406,53,43109,53,273,102,171,2,30,1,1,allow
49891,53,34490,53,166,86,80,2,30,1,1,allow
56703,53,53438,53,199,102,97,2,30,1,1,allow
56603,53,32862,53,168,86,82,2,30,1,1,allow
55684,53,8013,53,214,110,104,2,30,1,1,allow
55134,53,13756,53,214,110,104,2,30,1,1,allow
56703,53,19999,53,199,102,97,2,30,1,1,allow
55134,53,17370,53,214,110,104,2,30,1,1,allow
56772,53,46490,53,185,102,83,2,31,1,1,allow
56633,53,58541,53,166,86,80,2,30,1,1,allow
65499,53,27799,53,167,86,81,2,30,1,1,allow
9222,443,6216,443,6676,1097,5579,21,26,11,10,allow
51620,443,44132,443,4320,932,3388,16,15,10,6,allow
49918,53,55343,53,396,88,308,4,59,2,2,allow
64934,53,9879,53,216,94,122,2,30,1,1,allow
44014,53,29782,53,199,94,105,2,30,1,1,allow
65248,53,32569,53,779,86,693,2,30,1,1,allow
65174,53,23443,53,214,110,104,2,30,1,1,allow
64969,27044,17492,27044,741,462,279,2,30,1,1,allow
50346,53,1416,53,168,78,90,2,30,1,1,allow
54286,123,33034,123,184,94,90,2,30,1,1,allow
56100,53,20590,53,216,110,106,2,30,1,1,allow
16403,16386,35244,16386,426,186,240,8,30,4,4,allow
56963,53,36385,53,199,102,97,2,30,1,1,allow
64393,53,12221,53,183,94,89,2,31,1,1,allow
50207,53,41164,53,189,102,87,2,30,1,1,allow
10016,443,37717,443,6575,1263,5312,22,315,12,10,allow
51326,443,48019,443,6250,1422,4828,20,17,10,10,allow
58288,443,25819,443,6438,2646,3792,18,37,11,7,allow
9968,53,9968,53,370,238,132,3,32,2,1,allow
57316,53,57316,53,216,82,134,2,32,1,1,allow
56735,443,32808,443,7942,1953,5989,20,15,11,9,allow
55989,53,12123,53,198,102,96,2,30,1,1,allow
54167,53,8254,53,210,94,116,2,30,1,1,allow
64979,27050,52278,27050,735,462,273,2,30,1,1,allow
55684,53,46714,53,214,110,104,2,30,1,1,allow
55551,53,53923,53,180,94,86,2,30,1,1,allow
62067,443,12137,443,4833,2196,2637,13,120,7,6,allow
56231,53,22476,53,779,86,693,2,30,1,1,allow
57322,53,59513,53,196,102,94,2,30,1,1,allow
49348,53,21322,53,749,94,655,2,30,1,1,allow
55624,53,50480,53,199,102,97,2,30,1,1,allow
49156,53,59173,53,195,102,93,2,30,1,1,allow
65428,53,61145,53,195,102,93,2,30,1,1,allow
56340,53,40288,53,198,102,96,2,30,1,1,allow
50218,53,36162,53,165,86,79,2,31,1,1,allow
49156,53,49438,53,195,102,93,2,30,1,1,allow
50267,53,48112,53,734,94,640,2,31,1,1,allow
65038,53,49241,53,173,94,79,2,31,1,1,allow
55591,53,62499,53,195,102,93,2,31,1,1,allow
56117,53,32150,53,178,94,84,2,31,1,1,allow
8907,443,50464,443,7594,1457,6137,26,404,10,16,allow
57341,53,25205,53,184,94,90,2,30,1,1,allow
64679,53,60915,53,178,94,84,2,30,1,1,allow
55323,53,20826,53,178,94,84,2,30,1,1,allow
49606,53,26399,53,231,110,121,2,31,1,1,allow
49944,53,39307,53,196,102,94,2,31,1,1,allow
55134,53,55976,53,214,110,104,2,31,1,1,allow
56272,53,59359,53,167,86,81,2,31,1,1,allow
65471,53,50193,53,498,204,294,6,31,3,3,allow
50207,53,12070,53,189,102,87,2,31,1,1,allow
55887,53,54286,53,166,86,80,2,31,1,1,allow
38262,80,2079,80,3843,1312,2531,19,227,6,13,allow
6881,6889,24381,6889,228,118,110,2,1199,1,1,allow
51083,5223,18916,5223,4070,1456,2614,26,2889,15,11,allow
64979,53,62369,53,754,94,660,2,30,1,1,allow
64130,53,8273,53,215,94,121,2,31,1,1,allow
57341,53,32411,53,184,94,90,2,31,1,1,allow
49203,53,46082,53,168,86,82,2,31,1,1,allow
65187,53,58684,53,199,102,97,2,31,1,1,allow
47661,443,40195,443,3718,420,3298,13,120,6,7,allow
37965,7765,33226,7765,460,150,310,2,1199,1,1,allow
51969,80,21230,80,622,70,552,10,1117,2,8,allow
41332,80,41332,80,230861,5063,225798,227,18,74,153,allow
55069,53,19618,53,195,102,93,2,31,1,1,allow
56703,53,34394,53,199,102,97,2,31,1,1,allow
64012,40642,36772,40642,66,66,0,2,8,2,0,allow
59179,80,14130,80,1399,762,637,10,76,6,4,allow
54270,443,24840,443,6620,672,5948,17,128,8,9,allow
33229,443,52661,443,2161,1231,930,17,180,9,8,allow
49156,443,29780,443,8569,2165,6404,23,34,12,11,allow
45926,443,11767,443,9153,4216,4937,29,331,16,13,allow
58924,443,40571,443,5168,700,4468,16,15,7,9,allow
64013,48970,1892,48970,66,66,0,2,8,2,0,allow
64503,53,62802,53,477,87,390,4,37,2,2,allow
59209,25174,0,0,66,66,0,1,0,1,0,deny
53376,22114,0,0,62,62,0,1,0,1,0,deny
16013,61903,0,0,145,145,0,1,0,1,0,deny
51184,445,0,0,70,70,0,1,0,1,0,drop
51177,445,0,0,70,70,0,1,0,1,0,drop
51176,445,0,0,70,70,0,1,0,1,0,drop
51175,445,0,0,70,70,0,1,0,1,0,drop
64595,64147,0,0,66,66,0,1,0,1,0,deny
45726,64147,0,0,62,62,0,1,0,1,0,deny
62951,445,0,0,66,66,0,1,0,1,0,drop
62768,445,0,0,70,70,0,1,0,1,0,drop
19747,37965,0,0,62,62,0,1,0,1,0,deny
58120,25174,0,0,66,66,0,1,0,1,0,deny
8889,49138,0,0,60,60,0,1,0,1,0,deny
6943,1,0,0,100,100,0,1,0,1,0,deny
62941,445,0,0,66,66,0,1,0,1,0,drop
62939,445,0,0,66,66,0,1,0,1,0,drop
62944,445,0,0,66,66,0,1,0,1,0,drop
62945,445,0,0,66,66,0,1,0,1,0,drop
62940,445,0,0,66,66,0,1,0,1,0,drop
62937,445,0,0,66,66,0,1,0,1,0,drop
62935,445,0,0,66,66,0,1,0,1,0,drop
62765,445,0,0,70,70,0,1,0,1,0,drop
63895,44847,0,0,62,62,0,1,0,1,0,deny
39313,37965,0,0,62,62,0,1,0,1,0,deny
51171,445,0,0,70,70,0,1,0,1,0,drop
42951,22114,0,0,62,62,0,1,0,1,0,deny
22530,23718,0,0,62,62,0,1,0,1,0,deny
51167,445,0,0,70,70,0,1,0,1,0,drop
51164,445,0,0,70,70,0,1,0,1,0,drop
51163,445,0,0,70,70,0,1,0,1,0,drop
63385,25174,0,0,66,66,0,1,0,1,0,deny
41388,1433,0,0,60,60,0,1,0,1,0,deny
2837,25174,0,0,66,66,0,1,0,1,0,deny
59355,51505,0,0,66,66,0,1,0,1,0,deny
62760,445,0,0,70,70,0,1,0,1,0,drop
50549,43890,0,0,66,66,0,1,0,1,0,deny
11382,43890,0,0,66,66,0,1,0,1,0,deny
62759,445,0,0,70,70,0,1,0,1,0,drop
80,5101,0,0,78,78,0,1,0,1,0,deny
1827,64147,0,0,66,66,0,1,0,1,0,deny
63083,25174,0,0,62,62,0,1,0,1,0,deny
18683,26467,0,0,62,62,0,1,0,1,0,deny
62757,445,0,0,70,70,0,1,0,1,0,drop
50316,25604,0,0,62,62,0,1,0,1,0,deny
50563,37965,0,0,66,66,0,1,0,1,0,deny
51160,445,0,0,70,70,0,1,0,1,0,drop
51159,445,0,0,70,70,0,1,0,1,0,drop
51158,445,0,0,70,70,0,1,0,1,0,drop
58022,7474,0,0,60,60,0,1,0,1,0,deny
62929,445,0,0,66,66,0,1,0,1,0,drop
51413,57470,0,0,72,72,0,1,0,1,0,deny
50857,26467,0,0,66,66,0,1,0,1,0,deny
51154,445,0,0,70,70,0,1,0,1,0,drop
52503,50584,0,0,66,66,0,1,0,1,0,deny
51726,64147,0,0,66,66,0,1,0,1,0,deny
1036,64147,0,0,62,62,0,1,0,1,0,deny
62926,445,0,0,66,66,0,1,0,1,0,drop
58103,10197,0,0,66,66,0,1,0,1,0,deny
62923,445,0,0,66,66,0,1,0,1,0,drop
62922,445,0,0,66,66,0,1,0,1,0,drop
27081,10197,0,0,62,62,0,1,0,1,0,deny
39959,23117,0,0,62,62,0,1,0,1,0,deny
62921,445,0,0,66,66,0,1,0,1,0,drop
22677,25174,0,0,66,66,0,1,0,1,0,deny
16092,50265,0,0,62,62,0,1,0,1,0,deny
62750,445,0,0,70,70,0,1,0,1,0,drop
31627,64147,0,0,62,62,0,1,0,1,0,deny
51109,11392,0,0,62,62,0,1,0,1,0,deny
14740,26467,0,0,62,62,0,1,0,1,0,deny
62748,445,0,0,70,70,0,1,0,1,0,drop
63888,25174,0,0,66,66,0,1,0,1,0,deny
51149,445,0,0,70,70,0,1,0,1,0,drop
62747,445,0,0,70,70,0,1,0,1,0,drop
51145,445,0,0,70,70,0,1,0,1,0,drop
51143,445,0,0,70,70,0,1,0,1,0,drop
62746,445,0,0,70,70,0,1,0,1,0,drop
59424,50265,0,0,70,70,0,1,0,1,0,deny
51602,22114,0,0,66,66,0,1,0,1,0,deny
62745,445,0,0,70,70,0,1,0,1,0,drop
62743,445,0,0,70,70,0,1,0,1,0,drop
62739,445,0,0,70,70,0,1,0,1,0,drop
50620,50584,0,0,66,66,0,1,0,1,0,deny
40819,30975,0,0,157,157,0,1,0,1,0,deny
56590,25174,0,0,66,66,0,1,0,1,0,deny
54754,50432,0,0,66,66,0,1,0,1,0,deny
47783,50432,0,0,62,62,0,1,0,1,0,deny
62909,445,0,0,66,66,0,1,0,1,0,drop
63920,64147,0,0,66,66,0,1,0,1,0,deny
3766,25174,0,0,62,62,0,1,0,1,0,deny
55600,22,0,0,60,60,0,1,0,1,0,deny
62727,445,0,0,70,70,0,1,0,1,0,drop
62725,445,0,0,70,70,0,1,0,1,0,drop
62723,445,0,0,70,70,0,1,0,1,0,drop
57131,35776,0,0,145,145,0,1,0,1,0,deny
62717,445,0,0,70,70,0,1,0,1,0,drop
62716,445,0,0,70,70,0,1,0,1,0,drop
48176,50584,0,0,62,62,0,1,0,1,0,deny
3064,44847,0,0,62,62,0,1,0,1,0,deny
62902,445,0,0,66,66,0,1,0,1,0,drop
25296,51505,0,0,66,66,0,1,0,1,0,deny
6247,51221,0,0,78,78,0,1,0,1,0,deny
38475,11392,0,0,66,66,0,1,0,1,0,deny
51126,445,0,0,70,70,0,1,0,1,0,drop
27300,6881,0,0,66,66,0,1,0,1,0,deny
37429,25174,0,0,62,62,0,1,0,1,0,deny
42034,28189,0,0,62,62,0,1,0,1,0,deny
47424,25174,0,0,66,66,0,1,0,1,0,deny
45964,3111,0,0,60,60,0,1,0,1,0,deny
62900,445,0,0,66,66,0,1,0,1,0,drop
56897,11446,0,0,66,66,0,1,0,1,0,deny
26527,25174,0,0,66,66,0,1,0,1,0,deny
63023,51505,0,0,62,62,0,1,0,1,0,deny
53140,51221,0,0,74,74,0,1,0,1,0,deny
6356,26467,0,0,62,62,0,1,0,1,0,deny
52644,57209,0,0,62,62,0,1,0,1,0,deny
62705,445,0,0,70,70,0,1,0,1,0,drop
52143,37807,0,0,62,62,0,1,0,1,0,deny
36011,25174,0,0,66,66,0,1,0,1,0,deny
54526,44847,0,0,66,66,0,1,0,1,0,deny
62893,445,0,0,66,66,0,1,0,1,0,drop
62889,445,0,0,66,66,0,1,0,1,0,drop
43584,24748,0,0,156,156,0,1,0,1,0,deny
43584,24748,0,0,156,156,0,1,0,1,0,deny
43584,24748,0,0,156,156,0,1,0,1,0,deny
59803,22114,0,0,146,146,0,1,0,1,0,deny
62701,445,0,0,70,70,0,1,0,1,0,drop
27063,25174,0,0,62,62,0,1,0,1,0,deny
1646,23,0,0,60,60,0,1,0,1,0,deny
51118,445,0,0,70,70,0,1,0,1,0,drop
51116,445,0,0,70,70,0,1,0,1,0,drop
51114,445,0,0,70,70,0,1,0,1,0,drop
53495,37807,0,0,66,66,0,1,0,1,0,deny
16037,25174,0,0,62,62,0,1,0,1,0,deny
62690,445,0,0,70,70,0,1,0,1,0,drop
62872,445,0,0,66,66,0,1,0,1,0,drop
62691,445,0,0,70,70,0,1,0,1,0,drop
62876,445,0,0,66,66,0,1,0,1,0,drop
62875,445,0,0,66,66,0,1,0,1,0,drop
62692,445,0,0,70,70,0,1,0,1,0,drop
62870,445,0,0,66,66,0,1,0,1,0,drop
62877,445,0,0,66,66,0,1,0,1,0,drop
62871,445,0,0,66,66,0,1,0,1,0,drop
62869,445,0,0,66,66,0,1,0,1,0,drop
62874,445,0,0,66,66,0,1,0,1,0,drop
38518,1900,0,0,139,139,0,1,0,1,0,deny
52210,51505,0,0,62,62,0,1,0,1,0,deny
62687,445,0,0,70,70,0,1,0,1,0,drop
44127,30188,0,0,146,146,0,1,0,1,0,deny
56629,25174,0,0,66,66,0,1,0,1,0,deny
62684,445,0,0,70,70,0,1,0,1,0,drop
60342,36237,0,0,62,62,0,1,0,1,0,deny
17781,50265,0,0,62,62,0,1,0,1,0,deny
21542,57470,0,0,74,74,0,1,0,1,0,deny
18113,22114,0,0,62,62,0,1,0,1,0,deny
1027,64147,0,0,62,62,0,1,0,1,0,deny
50977,56205,0,0,66,66,0,1,0,1,0,deny
52744,25174,0,0,66,66,0,1,0,1,0,deny
48676,53399,0,0,60,60,0,1,0,1,0,deny
17415,25174,0,0,62,62,0,1,0,1,0,deny
51111,445,0,0,70,70,0,1,0,1,0,drop
51108,445,0,0,70,70,0,1,0,1,0,drop
51097,445,0,0,70,70,0,1,0,1,0,drop
51098,445,0,0,70,70,0,1,0,1,0,drop
15176,62413,0,0,66,66,0,1,0,1,0,deny
62679,445,0,0,70,70,0,1,0,1,0,drop
53822,25174,0,0,66,66,0,1,0,1,0,deny
62857,445,0,0,66,66,0,1,0,1,0,drop
62856,445,0,0,66,66,0,1,0,1,0,drop
62854,445,0,0,66,66,0,1,0,1,0,drop
55629,42873,0,0,74,74,0,1,0,1,0,deny
59668,50584,0,0,66,66,0,1,0,1,0,deny
63323,54369,0,0,78,78,0,1,0,1,0,deny
48019,22114,0,0,66,66,0,1,0,1,0,deny
10273,21247,0,0,66,66,0,1,0,1,0,deny
62671,445,0,0,70,70,0,1,0,1,0,drop
27144,25174,0,0,66,66,0,1,0,1,0,deny
51095,445,0,0,70,70,0,1,0,1,0,drop
55443,53,49327,53,188,96,92,2,30,1,1,allow
64721,53,36880,53,212,108,104,2,30,1,1,allow
49156,53,9695,53,190,97,93,2,30,1,1,allow
55551,53,29205,53,176,90,86,2,30,1,1,allow
55070,80,64489,80,246,120,126,5,16,3,2,allow
50983,443,64084,443,11897,6250,5647,27,81,14,13,allow
55812,53,55812,53,235,90,145,2,32,1,1,allow
52058,8329,19334,8329,70,70,0,2,9,2,0,allow
52450,443,52450,443,4750,1843,2907,19,26,11,8,allow
42478,80,42478,80,1913,1464,449,10,19,6,4,allow
59383,80,59383,80,1915,1466,449,10,19,6,4,allow
50985,443,12787,443,8007,3336,4671,19,78,11,8,allow
50982,443,30343,443,8227,3496,4731,20,82,11,9,allow
55782,53,37884,53,728,96,632,2,30,1,1,allow
49605,53,30084,53,756,95,661,2,30,1,1,allow
52240,443,52240,443,1615,941,674,15,21,7,8,allow
42607,443,22766,443,167,107,60,2,5,1,1,allow
56636,443,56636,443,4620,1713,2907,19,28,11,8,allow
46673,80,11851,80,1151,711,440,10,15,5,5,allow
55031,53,63225,53,756,95,661,2,31,1,1,allow
58907,443,50091,443,2976,1572,1404,17,17,9,8,allow
58077,36653,11744,36653,204,64,140,4,11,2,2,allow
51526,4545,51526,4545,156,156,0,3,8,3,0,allow
61099,443,1871,443,82,82,0,1,5,1,0,allow
58915,443,1330,443,6138,3860,2278,20,16,10,10,allow
8889,33873,8889,33873,124,60,64,2,30,1,1,allow
42384,443,16298,443,8561,2300,6261,37,316,18,19,allow
49203,53,20527,53,168,86,82,2,31,1,1,allow
54769,80,54769,80,23168,3380,19788,36,19,18,18,allow
41350,80,41350,80,1914,1465,449,10,19,6,4,allow
55690,53,56846,53,182,93,89,2,30,1,1,allow
47783,80,47783,80,1904,1455,449,10,19,6,4,allow
55946,53,3113,53,762,98,664,2,31,1,1,allow
58889,15000,32384,15000,138,78,60,2,6,1,1,allow
23150,53,23150,53,365,233,132,3,32,2,1,allow
45051,53,45051,53,404,259,145,3,32,2,1,allow
65187,53,4197,53,198,101,97,2,30,1,1,allow
61196,53,61196,53,213,79,134,2,32,1,1,allow
58906,443,27261,443,2896,1492,1404,17,17,9,8,allow
41629,15000,21496,15000,130,70,60,2,5,1,1,allow
58985,443,13213,443,9218,1776,7442,28,23,13,15,allow
36158,443,62102,443,7848,2137,5711,23,25,13,10,allow
52898,80,52898,80,1916,1467,449,10,19,6,4,allow
50678,80,40361,80,300,174,126,5,15,3,2,allow
59951,80,3769,80,1221,339,882,9,16,5,4,allow
50981,443,28253,443,8407,3736,4671,19,101,11,8,allow
49522,443,49522,443,7647,1693,5954,31,77,16,15,allow
49570,443,54043,443,1013,492,521,10,30,4,6,allow
50984,443,27569,443,8023,3352,4671,19,80,11,8,allow
60199,443,24633,443,5858,1511,4347,20,21,11,9,allow
47551,443,47551,443,4743,1836,2907,19,29,11,8,allow
33372,3389,33372,3389,4695,2520,2175,22,19,13,9,allow
50599,80,50599,80,4228,3295,933,17,19,9,8,allow
53861,53065,16335,53065,70,70,0,2,8,2,0,allow
50986,443,39025,443,18156,12850,5306,32,76,19,13,allow
3891,53,3891,53,235,90,145,2,32,1,1,allow
22751,53,22751,53,235,90,145,2,32,1,1,allow
64393,53,49935,53,182,93,89,2,31,1,1,allow
55134,53,14594,53,212,108,104,2,30,1,1,allow
48206,53,48206,53,253,99,154,2,30,1,1,allow
28885,53,28885,53,404,259,145,3,32,2,1,allow
50346,53,56767,53,760,97,663,2,30,1,1,allow
56756,53,42523,53,760,97,663,2,30,1,1,allow
58916,443,3751,443,6376,4098,2278,20,16,10,10,allow
56871,53,58198,53,745,93,652,2,30,1,1,allow
47391,443,14660,443,9921,3169,6752,31,20,17,14,allow
57196,53,22247,53,754,94,660,2,31,1,1,allow
56285,53,7225,53,751,95,656,2,31,1,1,allow
56266,53,14847,53,186,95,91,2,31,1,1,allow
35353,443,50088,443,1864,250,1614,8,120,4,4,allow
53342,443,18889,443,82909,70964,11945,139,283,71,68,allow
55481,53,35011,53,758,96,662,2,30,1,1,allow
56045,53,39272,53,731,91,640,2,30,1,1,allow
55335,53,8773,53,754,94,660,2,30,1,1,allow
49415,53,54397,53,188,96,92,2,31,1,1,allow
56062,53,2393,53,192,98,94,2,31,1,1,allow
56847,53,17178,53,761,100,661,2,31,1,1,allow
64554,53,25900,53,198,101,97,2,31,1,1,allow
49650,53,49396,53,776,102,674,2,31,1,1,allow
55887,53,42850,53,164,84,80,2,31,1,1,allow
61425,443,50113,443,9380,3315,6065,26,93,14,12,allow
61406,443,11878,443,12588,4915,7673,28,94,15,13,allow
55972,53,38960,53,756,95,661,2,31,1,1,allow
65291,53,61483,53,190,97,93,2,31,1,1,allow
38733,443,51557,443,7655,2018,5637,31,93,16,15,allow
56117,53,31292,53,172,88,84,2,31,1,1,allow
55818,53,21143,53,775,103,672,2,31,1,1,allow
64782,53,40065,53,758,93,665,2,31,1,1,allow
64140,53,60265,53,184,94,90,2,31,1,1,allow
48817,49301,48817,49301,490,149,341,2,1200,1,1,allow
59117,53,0,0,82,82,0,1,31,1,0,allow
55889,53,49760,53,198,101,97,2,31,1,1,allow
34351,53,57036,53,202,83,119,2,31,1,1,allow
62619,3389,62619,3389,3504,1790,1714,17,34,9,8,allow
56756,53,46487,53,166,85,81,2,31,1,1,allow
57023,53,64217,53,174,89,85,2,31,1,1,allow
56502,53,50256,53,726,85,641,2,31,1,1,allow
56127,53,8590,53,166,85,81,2,31,1,1,allow
56973,53,12553,53,186,95,91,2,31,1,1,allow
57382,53,8955,53,184,94,90,2,31,1,1,allow
56550,53,58694,53,84,84,0,1,31,1,0,allow
45374,443,48527,443,88469,3492,84977,104,396,35,69,allow
55541,53,53785,53,772,100,672,2,31,1,1,allow
63578,35440,0,0,62,62,0,1,0,1,0,deny
62670,445,0,0,70,70,0,1,0,1,0,drop
58228,53733,0,0,66,66,0,1,0,1,0,deny
51087,445,0,0,70,70,0,1,0,1,0,drop
51084,445,0,0,70,70,0,1,0,1,0,drop
51088,445,0,0,70,70,0,1,0,1,0,drop
64691,25320,0,0,66,66,0,1,0,1,0,deny
1646,23,0,0,60,60,0,1,0,1,0,deny
6712,123,0,0,90,90,0,1,0,1,0,deny
62664,445,0,0,70,70,0,1,0,1,0,drop
62663,445,0,0,70,70,0,1,0,1,0,drop
13684,25174,0,0,62,62,0,1,0,1,0,deny
10088,37807,0,0,66,66,0,1,0,1,0,deny
45783,22114,0,0,62,62,0,1,0,1,0,deny
8889,9794,0,0,60,60,0,1,0,1,0,deny
47357,50584,0,0,66,66,0,1,0,1,0,deny
56268,44847,0,0,66,66,0,1,0,1,0,deny
60721,22114,0,0,66,66,0,1,0,1,0,deny
49156,53,43723,53,195,102,93,2,32,1,1,allow
52061,35717,8703,35717,70,70,0,2,8,2,0,allow
57331,53,27996,53,164,86,78,2,30,1,1,allow
9698,53,9698,53,197,90,107,2,30,1,1,allow
443,62732,0,0,60,60,0,1,0,1,0,deny
62659,445,0,0,70,70,0,1,0,1,0,drop
44546,32468,0,0,62,62,0,1,0,1,0,deny
51077,445,0,0,70,70,0,1,0,1,0,drop
51075,445,0,0,70,70,0,1,0,1,0,drop
51072,445,0,0,70,70,0,1,0,1,0,drop
62658,445,0,0,70,70,0,1,0,1,0,drop
62796,37807,0,0,66,66,0,1,0,1,0,deny
51944,56205,0,0,62,62,0,1,0,1,0,deny
62845,445,0,0,66,66,0,1,0,1,0,drop
19361,23117,0,0,66,66,0,1,0,1,0,deny
51979,25174,0,0,66,66,0,1,0,1,0,deny
10050,31573,0,0,146,146,0,1,0,1,0,deny
33761,25174,0,0,62,62,0,1,0,1,0,deny
58844,51505,0,0,66,66,0,1,0,1,0,deny
42231,57470,0,0,78,78,0,1,0,1,0,deny
62651,445,0,0,70,70,0,1,0,1,0,drop
35011,37965,0,0,62,62,0,1,0,1,0,deny
51068,445,0,0,70,70,0,1,0,1,0,drop
51067,445,0,0,70,70,0,1,0,1,0,drop
55951,30188,0,0,66,66,0,1,0,1,0,deny
16057,56205,0,0,66,66,0,1,0,1,0,deny
58509,21247,0,0,66,66,0,1,0,1,0,deny
3047,50584,0,0,146,146,0,1,0,1,0,deny
15235,36237,0,0,62,62,0,1,0,1,0,deny
62830,445,0,0,66,66,0,1,0,1,0,drop
62829,445,0,0,66,66,0,1,0,1,0,drop
52557,44847,0,0,66,66,0,1,0,1,0,deny
57073,57470,0,0,62,62,0,1,0,1,0,deny
54721,22114,0,0,62,62,0,1,0,1,0,deny
28156,50584,0,0,62,62,0,1,0,1,0,deny
55424,38303,0,0,66,66,0,1,0,1,0,deny
52827,25174,0,0,146,146,0,1,0,1,0,deny
51058,445,0,0,70,70,0,1,0,1,0,drop
51055,445,0,0,70,70,0,1,0,1,0,drop
51054,445,0,0,70,70,0,1,0,1,0,drop
51048,445,0,0,70,70,0,1,0,1,0,drop
62638,445,0,0,70,70,0,1,0,1,0,drop
23331,25174,0,0,66,66,0,1,0,1,0,deny
54817,47993,0,0,66,66,0,1,0,1,0,deny
62821,445,0,0,66,66,0,1,0,1,0,drop
45144,25174,0,0,62,62,0,1,0,1,0,deny
56940,53,28824,53,200,102,98,2,30,1,1,allow
55690,53,37274,53,183,94,89,2,30,1,1,allow
56062,53,34305,53,196,102,94,2,30,1,1,allow
49284,53,21270,53,177,94,83,2,30,1,1,allow
64068,53,59683,53,168,86,82,2,30,1,1,allow
37606,443,47206,443,6277,1868,4409,22,45,13,9,allow
60864,443,60864,443,8578,2549,6029,22,16,13,9,allow
55922,53,5571,53,807,94,713,2,29,1,1,allow
50218,53,12883,53,165,86,79,2,29,1,1,allow
57651,80,10587,80,1151,711,440,10,15,5,5,allow
33410,80,44582,80,1570,754,816,10,15,6,4,allow
55443,53,14959,53,194,102,92,2,30,1,1,allow
58923,443,63838,443,5167,700,4467,16,14,7,9,allow
9248,80,12948,80,844,778,66,6,15,5,1,allow
56062,53,55511,53,196,102,94,2,30,1,1,allow
53722,443,10654,443,70,70,0,2,7,2,0,allow
65127,443,37615,443,146,64,82,3,9,2,1,allow
52095,443,5865,443,3023,2045,978,15,15,9,6,allow
64146,53,50563,53,308,99,209,4,39,2,2,allow
53821,443,16981,443,7980,1434,6546,24,19,13,11,allow
21189,53,21189,53,374,240,134,3,32,2,1,allow
55922,53,13122,53,184,94,90,2,29,1,1,allow
56349,53,42172,53,216,110,106,2,29,1,1,allow
64444,53,35858,53,183,94,89,2,29,1,1,allow
65187,53,35953,53,199,102,97,2,29,1,1,allow
65499,53,26043,53,167,86,81,2,29,1,1,allow
49823,53,8034,53,209,110,99,2,29,1,1,allow
56772,53,30219,53,185,102,83,2,29,1,1,allow
64051,53,30405,53,1114,468,646,12,67,6,6,allow
64679,53,2951,53,178,94,84,2,30,1,1,allow
55551,53,64054,53,180,94,86,2,29,1,1,allow
64858,53,43430,53,211,102,109,2,30,1,1,allow
49415,53,4512,53,194,102,92,2,30,1,1,allow
57374,53,58495,53,216,102,114,2,30,1,1,allow
56423,53,58524,53,168,86,82,2,30,1,1,allow
58917,80,56785,80,4107,3453,654,13,16,7,6,allow
59297,80,59297,80,107500,4003,103497,173,16,57,116,allow
57439,443,32851,443,5502,1543,3959,17,20,9,8,allow
28032,443,27743,443,6756,2587,4169,19,16,10,9,allow
58911,443,55607,443,5168,700,4468,16,16,7,9,allow
56732,443,23589,443,7855,1866,5989,20,15,11,9,allow
50601,80,50601,80,4206,3273,933,17,19,9,8,allow
61060,53,35678,53,311,94,217,2,30,1,1,allow
64721,53,18309,53,214,110,104,2,30,1,1,allow
49284,53,55787,53,185,102,83,2,30,1,1,allow
60870,53,30144,53,220,94,126,2,30,1,1,allow
61740,443,10410,443,9854,2716,7138,36,49,20,16,allow
56272,53,1689,53,167,86,81,2,30,1,1,allow
55735,53,9793,53,199,102,97,2,30,1,1,allow
49300,443,63188,443,6101,848,5253,17,21,9,8,allow
50045,53,13478,53,168,86,82,2,30,1,1,allow
64329,53,38742,53,479,111,368,4,50,2,2,allow
65089,53,28362,53,199,102,97,2,30,1,1,allow
56622,53,10987,53,214,110,104,2,30,1,1,allow
50377,53,41134,53,214,110,104,2,30,1,1,allow
55887,53,55834,53,166,86,80,2,30,1,1,allow
56323,53,21945,53,168,94,74,2,30,1,1,allow
65089,53,20611,53,199,102,97,2,30,1,1,allow
58914,443,39439,443,5168,700,4468,16,16,7,9,allow
56215,53,9049,53,165,86,79,2,30,1,1,allow
49609,53,44822,53,754,94,660,2,30,1,1,allow
56731,443,49373,443,7907,1918,5989,20,15,11,9,allow
55443,53,18885,53,194,102,92,2,30,1,1,allow
64721,53,29674,53,214,110,104,2,30,1,1,allow
56323,53,5698,53,152,78,74,2,30,1,1,allow
56622,53,31873,53,214,110,104,2,30,1,1,allow
49710,53,33849,53,183,102,81,2,30,1,1,allow
65387,53,9016,53,221,94,127,2,30,1,1,allow
49342,53,10156,53,443,182,261,6,30,3,3,allow
64506,53,14791,53,230,94,136,2,30,1,1,allow
49710,53,1886,53,183,102,81,2,30,1,1,allow
51081,443,32211,443,6653,3225,3428,18,135,9,9,allow
55690,53,57021,53,183,94,89,2,30,1,1,allow
59476,443,42006,443,4697,923,3774,13,120,6,7,allow
64792,53,60591,53,166,86,80,2,30,1,1,allow
56127,53,6171,53,167,86,81,2,30,1,1,allow
57319,53,4407,53,189,102,87,2,30,1,1,allow
52064,43273,5722,43273,70,70,0,2,7,2,0,allow
52514,80,52514,80,1916,1467,449,10,19,6,4,allow
59298,80,59298,80,85989,14398,71591,143,15,40,103,allow
63991,80,39490,80,314,192,122,6,15,4,2,allow
65119,53,47223,53,568,188,380,6,60,3,3,allow
64689,53,47457,53,763,102,661,2,30,1,1,allow
36013,53,23635,53,86,86,0,1,30,1,0,allow
49505,53,42199,53,225,110,115,2,30,1,1,allow
47894,443,29583,443,295475,14093,281382,413,469,162,251,allow
52063,7886,55344,7886,70,70,0,2,8,2,0,allow
49518,443,49518,443,103941,6635,97306,158,76,81,77,allow
65187,53,40747,53,345,101,244,4,53,2,2,allow
57331,53,30032,53,172,94,78,2,30,1,1,allow
64493,53,17644,53,280,97,183,4,60,2,2,allow
55132,53,34901,53,889,404,485,10,30,5,5,allow
49741,53,35577,53,766,102,664,2,30,1,1,allow
49795,53,15978,53,209,110,99,2,30,1,1,allow
60710,53,32625,53,211,78,133,2,30,1,1,allow
50026,53,4265,53,395,99,296,4,57,2,2,allow
64297,53,43105,53,364,94,270,4,49,2,2,allow
35814,443,57995,443,9126,3975,5151,21,15,11,10,allow
60602,5222,39358,5222,5564,2206,3358,50,310,20,30,allow
54106,80,38158,80,78,78,0,1,5,1,0,allow
56733,443,4067,443,7941,1952,5989,20,15,11,9,allow
47996,80,47996,80,1920,1471,449,10,19,6,4,allow
57664,80,57664,80,1917,1468,449,10,19,6,4,allow
46248,443,47277,443,979612,946319,33293,1091,25,690,401,allow
64512,53,2401,53,524,91,433,4,34,2,2,allow
56739,80,48782,80,1462,703,759,8,16,5,3,allow
49588,53,53938,53,733,94,639,2,29,1,1,allow
65134,53,52533,53,812,110,702,2,29,1,1,allow
64444,53,57791,53,183,94,89,2,29,1,1,allow
56752,53,3213,53,183,94,89,2,29,1,1,allow
64679,53,32723,53,328,88,240,4,32,2,2,allow
56047,443,45831,443,126,60,66,3,4,2,1,allow
52209,443,18180,443,502469,15202,487267,580,97,193,387,allow
50377,53,58981,53,214,110,104,2,30,1,1,allow
37569,443,45273,443,11226,3029,8197,36,55,18,18,allow
64309,53,55479,53,549,188,361,6,57,3,3,allow
58919,443,29317,443,5166,700,4466,16,15,7,9,allow
60620,80,60620,80,1916,1467,449,10,19,6,4,allow
49347,53,23678,53,342,91,251,4,54,2,2,allow
55636,80,55636,80,1916,1467,449,10,19,6,4,allow
55520,53,61502,53,194,102,92,2,30,1,1,allow
55520,53,61056,53,194,102,92,2,29,1,1,allow
61673,443,61673,443,76863,6096,70767,103,17,49,54,allow
56254,53,3663,53,498,204,294,6,30,3,3,allow
64721,53,12160,53,466,108,358,4,45,2,2,allow
64748,53,3750,53,168,94,74,2,29,1,1,allow
64128,53,22207,53,194,94,100,2,31,1,1,allow
53863,8999,11307,8999,70,70,0,2,7,2,0,allow
64961,27025,27939,27025,1334,462,872,4,30,2,2,allow
52059,47363,50172,47363,70,70,0,2,8,2,0,allow
54519,443,46768,443,70,70,0,1,5,1,0,allow
64748,53,7421,53,152,78,74,2,30,1,1,allow
57319,53,9103,53,189,102,87,2,30,1,1,allow
55624,53,2352,53,199,102,97,2,30,1,1,allow
38701,443,23957,443,1065134,19929,1045205,1009,16,288,721,allow
49527,53,33639,53,173,94,79,2,30,1,1,allow
50600,80,50600,80,4262,3329,933,17,19,9,8,allow
56622,53,54285,53,214,110,104,2,30,1,1,allow
49520,443,49520,443,88797,5446,83351,137,76,70,67,allow
57438,443,63629,443,7720,2815,4905,22,20,10,12,allow
58918,443,16774,443,5166,700,4466,16,16,7,9,allow
56134,53,5515,53,183,94,89,2,29,1,1,allow
64744,53,61506,53,770,102,668,2,29,1,1,allow
49614,53,25029,53,380,110,270,2,29,1,1,allow
56215,53,29779,53,165,86,79,2,30,1,1,allow
64657,53,3237,53,193,102,91,2,30,1,1,allow
55714,53,2036,53,165,86,79,2,30,1,1,allow
64060,53,33741,53,258,110,148,2,30,1,1,allow
56304,53,62384,53,443,182,261,6,31,3,3,allow
55999,443,22014,443,3640,606,3034,13,120,6,7,allow
61681,443,50543,443,10714,3531,7183,26,120,12,14,allow
48305,443,59833,443,572565,17274,555291,546,147,124,422,allow
6881,6881,26676,6881,238,118,120,2,1200,1,1,allow
50228,53,44907,53,173,94,79,2,30,1,1,allow
55463,53,8245,53,193,102,91,2,30,1,1,allow
65142,53,52457,53,167,86,81,2,30,1,1,allow
56266,53,65060,53,193,102,91,2,30,1,1,allow
64140,53,44344,53,184,94,90,2,31,1,1,allow
63885,443,2549,443,254829,10396,244433,255,194,64,191,allow
49415,53,62672,53,194,102,92,2,30,1,1,allow
59965,80,33685,80,1638,1324,314,10,15,5,5,allow
63966,443,14721,443,22930,2512,20418,37,75,17,20,allow
52062,60388,61139,60388,70,70,0,2,8,2,0,allow
52044,5824,26075,5824,70,70,0,1,5,1,0,allow
63139,53,20764,53,234,234,0,4,47,4,0,allow
49476,53,34696,53,764,102,662,2,30,1,1,allow
64052,53,55826,53,232,102,130,2,30,1,1,allow
56136,53,4435,53,733,94,639,2,30,1,1,allow
65056,53,56800,53,270,94,176,2,30,1,1,allow
49944,53,37550,53,196,102,94,2,30,1,1,allow
56388,53,30178,53,165,86,79,2,30,1,1,allow
64178,53,3511,53,276,94,182,2,30,1,1,allow
55735,53,16181,53,199,102,97,2,30,1,1,allow
64959,27038,6979,27038,996,462,534,4,30,2,2,allow
49527,53,30173,53,165,86,79,2,30,1,1,allow
56349,53,21926,53,216,110,106,2,30,1,1,allow
65006,53,44331,53,763,102,661,2,30,1,1,allow
55043,443,31088,443,11681,3607,8074,40,120,20,20,allow
51221,32329,23850,32329,870,330,540,12,1316,6,6,allow
33228,443,46001,443,2567,1173,1394,19,179,8,11,allow
61398,80,61398,80,1917,1468,449,10,19,6,4,allow
52060,29868,16909,29868,70,70,0,2,8,2,0,allow
56738,80,55725,80,1462,703,759,8,16,5,3,allow
65038,53,25509,53,165,86,79,2,30,1,1,allow
9021,53,9021,53,216,90,126,2,30,1,1,allow
49844,53,19437,53,734,102,632,2,30,1,1,allow
64627,53,26278,53,168,86,82,2,30,1,1,allow
56940,53,50066,53,200,102,98,2,30,1,1,allow
55979,53,24460,53,168,86,82,2,30,1,1,allow
56388,53,39602,53,173,94,79,2,30,1,1,allow
55551,53,65057,53,180,94,86,2,30,1,1,allow
53831,53,28587,53,260,86,174,2,30,1,1,allow
49636,53,12225,53,180,94,86,2,30,1,1,allow
39771,80,39771,80,17982,4308,13674,30,20,15,15,allow
54105,80,38446,80,78,78,0,1,5,1,0,allow
50377,53,60945,53,214,110,104,2,30,1,1,allow
55735,53,42351,53,199,102,97,2,30,1,1,allow
36125,443,36185,443,6620,1197,5423,22,129,12,10,allow
45571,443,60221,443,3974,2015,1959,21,345,10,11,allow
65220,53,61957,53,811,94,717,2,30,1,1,allow
65291,53,24701,53,195,102,93,2,30,1,1,allow
49203,53,46894,53,168,86,82,2,30,1,1,allow
64792,53,47254,53,166,86,80,2,30,1,1,allow
64554,53,41182,53,199,102,97,2,30,1,1,allow
56117,53,21155,53,178,94,84,2,30,1,1,allow
46851,53,12035,53,168,78,90,2,30,1,1,allow
39195,443,6951,443,8991,2438,6553,18,120,8,10,allow
55443,53,14783,53,194,102,92,2,30,1,1,allow
50228,53,36486,53,173,94,79,2,30,1,1,allow
64393,53,36156,53,183,94,89,2,30,1,1,allow
49388,53,27609,53,215,102,113,2,30,1,1,allow
41107,53,24186,53,168,78,90,2,30,1,1,allow
64376,53,46569,53,247,94,153,2,30,1,1,allow
64657,53,42843,53,816,102,714,2,30,1,1,allow
56423,53,27855,53,184,102,82,2,30,1,1,allow
50071,53,62204,53,458,188,270,6,30,3,3,allow
49415,53,16500,53,194,102,92,2,30,1,1,allow
55856,53,56508,53,265,94,171,2,30,1,1,allow
60709,53,36089,53,260,86,174,2,30,1,1,allow
49765,53,13036,53,194,102,92,2,31,1,1,allow
55877,42466,20270,42466,481,150,331,2,1200,1,1,allow
56379,53,59317,53,166,86,80,2,30,1,1,allow
49574,53,25202,53,816,102,714,2,30,1,1,allow
57334,53,42427,53,184,94,90,2,30,1,1,allow
55367,53,46146,53,195,102,93,2,31,1,1,allow
57053,53,53183,53,173,94,79,2,31,1,1,allow
57333,53,36710,53,167,86,81,2,31,1,1,allow
65417,53,49087,53,402,118,284,2,30,1,1,allow
55889,53,7647,53,199,102,97,2,30,1,1,allow
56379,53,29859,53,166,86,80,2,31,1,1,allow
57023,53,45929,53,179,94,85,2,31,1,1,allow
49966,53,36472,53,182,102,80,2,30,1,1,allow
56266,53,13342,53,193,102,91,2,31,1,1,allow
64393,53,13343,53,183,94,89,2,31,1,1,allow
57382,53,16095,53,184,94,90,2,31,1,1,allow
57323,53,24768,53,194,102,92,2,31,1,1,allow
56837,443,38721,443,2349,258,2091,10,120,4,6,allow
55141,53,56040,53,184,94,90,2,31,1,1,allow
51221,1950,25491,1950,870,330,540,12,1316,6,6,allow
58934,53,32905,53,205,86,119,2,30,1,1,allow
49966,53,59809,53,166,86,80,2,30,1,1,allow
64140,53,48538,53,184,94,90,2,30,1,1,allow
56195,53,54925,53,811,94,717,2,30,1,1,allow
65139,53,1458,53,216,110,106,2,30,1,1,allow
55714,53,64632,53,173,94,79,2,30,1,1,allow
52165,443,19255,443,289596,9131,280465,283,48,85,198,allow
64853,53,20952,53,199,102,97,2,31,1,1,allow
55887,53,33560,53,166,86,80,2,31,1,1,allow
57430,53,3513,53,200,102,98,2,31,1,1,allow
65139,53,19988,53,216,110,106,2,31,1,1,allow
55816,53,60578,53,214,110,104,2,31,1,1,allow
59477,443,7119,443,14489,12206,2283,25,120,15,10,allow
57334,53,60234,53,184,94,90,2,31,1,1,allow
63996,45759,44503,45759,70,70,0,1,5,1,0,allow
52041,48103,59658,48103,70,70,0,1,5,1,0,allow
64344,53,48570,53,286,102,184,4,46,2,2,allow
49823,53,25346,53,502,103,399,4,51,2,2,allow
55624,53,59892,53,308,101,207,4,53,2,2,allow
56975,53,16815,53,413,170,243,6,31,3,3,allow
49636,53,15924,53,180,94,86,2,31,1,1,allow
56819,53,17305,53,209,110,99,2,31,1,1,allow
55841,53,16397,53,458,188,270,6,31,3,3,allow
58908,443,8392,443,5166,700,4466,16,16,7,9,allow
38700,443,57335,443,90113,3417,86696,95,16,30,65,allow
29988,44847,0,0,66,66,0,1,0,1,0,deny
51564,50584,0,0,62,62,0,1,0,1,0,deny
50079,23,0,0,60,60,0,1,0,1,0,deny
62816,445,0,0,66,66,0,1,0,1,0,drop
62810,445,0,0,66,66,0,1,0,1,0,drop
62812,445,0,0,66,66,0,1,0,1,0,drop
62817,445,0,0,66,66,0,1,0,1,0,drop
62813,445,0,0,66,66,0,1,0,1,0,drop
62818,445,0,0,66,66,0,1,0,1,0,drop
62811,445,0,0,66,66,0,1,0,1,0,drop
37647,36237,0,0,66,66,0,1,0,1,0,deny
44147,64147,0,0,62,62,0,1,0,1,0,deny
51042,445,0,0,70,70,0,1,0,1,0,drop
54377,56205,0,0,62,62,0,1,0,1,0,deny
9528,44847,0,0,62,62,0,1,0,1,0,deny
31738,51505,0,0,62,62,0,1,0,1,0,deny
51039,445,0,0,70,70,0,1,0,1,0,drop
51035,445,0,0,70,70,0,1,0,1,0,drop
51038,445,0,0,70,70,0,1,0,1,0,drop
56328,36237,0,0,66,66,0,1,0,1,0,deny
19267,5555,0,0,60,60,0,1,0,1,0,deny
52781,57470,0,0,66,66,0,1,0,1,0,deny
49415,22114,0,0,66,66,0,1,0,1,0,deny
61591,22114,0,0,62,62,0,1,0,1,0,deny
62630,445,0,0,70,70,0,1,0,1,0,drop
62629,445,0,0,70,70,0,1,0,1,0,drop
7423,22114,0,0,62,62,0,1,0,1,0,deny
62627,445,0,0,70,70,0,1,0,1,0,drop
19455,25174,0,0,146,146,0,1,0,1,0,deny
25565,18855,0,0,60,60,0,1,0,1,0,deny
45682,37965,0,0,62,62,0,1,0,1,0,deny
7001,6881,0,0,62,62,0,1,0,1,0,deny
7067,22114,0,0,62,62,0,1,0,1,0,deny
51034,445,0,0,70,70,0,1,0,1,0,drop
51031,445,0,0,70,70,0,1,0,1,0,drop
51028,445,0,0,70,70,0,1,0,1,0,drop
57669,64147,0,0,62,62,0,1,0,1,0,deny
62802,445,0,0,66,66,0,1,0,1,0,drop
51026,445,0,0,70,70,0,1,0,1,0,drop
65015,22114,0,0,66,66,0,1,0,1,0,deny
62798,445,0,0,66,66,0,1,0,1,0,drop
33215,37965,0,0,62,62,0,1,0,1,0,deny
58880,443,32825,443,1413,876,537,12,11,6,6,allow
34166,22114,0,0,62,62,0,1,0,1,0,deny
58303,22114,0,0,62,62,0,1,0,1,0,deny
62795,445,0,0,66,66,0,1,0,1,0,drop
62794,445,0,0,66,66,0,1,0,1,0,drop
62620,445,0,0,70,70,0,1,0,1,0,drop
49797,25174,0,0,66,66,0,1,0,1,0,deny
62792,445,0,0,66,66,0,1,0,1,0,drop
27348,22114,0,0,66,66,0,1,0,1,0,deny
62911,36237,0,0,66,66,0,1,0,1,0,deny
62618,445,0,0,70,70,0,1,0,1,0,drop
47943,50584,0,0,74,74,0,1,0,1,0,deny
44815,36829,0,0,62,62,0,1,0,1,0,deny
30304,64147,0,0,66,66,0,1,0,1,0,deny
62617,445,0,0,70,70,0,1,0,1,0,drop
62616,445,0,0,70,70,0,1,0,1,0,drop
51021,445,0,0,70,70,0,1,0,1,0,drop
62615,445,0,0,70,70,0,1,0,1,0,drop
22733,26467,0,0,62,62,0,1,0,1,0,deny
55161,37807,0,0,66,66,0,1,0,1,0,deny
5476,23,0,0,60,60,0,1,0,1,0,deny
62609,445,0,0,70,70,0,1,0,1,0,drop
62610,445,0,0,70,70,0,1,0,1,0,drop
6247,51221,0,0,78,78,0,1,0,1,0,deny
51009,445,0,0,70,70,0,1,0,1,0,drop
51012,445,0,0,70,70,0,1,0,1,0,drop
30654,51221,0,0,72,72,0,1,0,1,0,deny
35666,22114,0,0,62,62,0,1,0,1,0,deny
62781,445,0,0,66,66,0,1,0,1,0,drop
57797,64147,0,0,62,62,0,1,0,1,0,deny
55144,30188,0,0,66,66,0,1,0,1,0,deny
61961,11392,0,0,66,66,0,1,0,1,0,deny
62597,445,0,0,70,70,0,1,0,1,0,drop
62595,445,0,0,70,70,0,1,0,1,0,drop
63400,57470,0,0,66,66,0,1,0,1,0,deny
62591,445,0,0,70,70,0,1,0,1,0,drop
59234,21247,0,0,62,62,0,1,0,1,0,deny
62587,445,0,0,70,70,0,1,0,1,0,drop
62586,445,0,0,70,70,0,1,0,1,0,drop
55130,25174,0,0,66,66,0,1,0,1,0,deny
55199,21247,0,0,66,66,0,1,0,1,0,deny
25031,25174,0,0,62,62,0,1,0,1,0,deny
54166,25174,0,0,66,66,0,1,0,1,0,deny
17781,44847,0,0,146,146,0,1,0,1,0,deny
62774,445,0,0,66,66,0,1,0,1,0,drop
51003,445,0,0,70,70,0,1,0,1,0,drop
45941,23386,0,0,60,60,0,1,0,1,0,deny
34713,22114,0,0,146,146,0,1,0,1,0,deny
17097,62413,0,0,62,62,0,1,0,1,0,deny
63832,25174,0,0,66,66,0,1,0,1,0,deny
52321,26467,0,0,62,62,0,1,0,1,0,deny
30707,30317,0,0,62,62,0,1,0,1,0,deny
18017,25773,0,0,143,143,0,1,0,1,0,reset-both
15189,25174,0,0,146,146,0,1,0,1,0,deny
62772,445,0,0,66,66,0,1,0,1,0,drop
62575,445,0,0,70,70,0,1,0,1,0,drop
27321,25174,0,0,146,146,0,1,0,1,0,deny
23306,25174,0,0,146,146,0,1,0,1,0,deny
62765,445,0,0,66,66,0,1,0,1,0,drop
51834,35440,0,0,66,66,0,1,0,1,0,deny
7000,23117,0,0,66,66,0,1,0,1,0,deny
13525,51505,0,0,146,146,0,1,0,1,0,deny
62760,445,0,0,66,66,0,1,0,1,0,drop
34636,23,0,0,60,60,0,1,0,1,0,deny
1536,50584,0,0,146,146,0,1,0,1,0,deny
51609,37807,0,0,66,66,0,1,0,1,0,deny
62571,445,0,0,70,70,0,1,0,1,0,drop
56770,26467,0,0,62,62,0,1,0,1,0,deny
62014,35440,0,0,66,66,0,1,0,1,0,deny
57337,64147,0,0,66,66,0,1,0,1,0,deny
33359,30188,0,0,66,66,0,1,0,1,0,deny
30574,64147,0,0,62,62,0,1,0,1,0,deny
54769,50584,0,0,62,62,0,1,0,1,0,deny
62560,445,0,0,70,70,0,1,0,1,0,drop
62562,445,0,0,70,70,0,1,0,1,0,drop
62559,445,0,0,70,70,0,1,0,1,0,drop
55562,50584,0,0,62,62,0,1,0,1,0,deny
49994,26467,0,0,62,62,0,1,0,1,0,deny
64509,9571,0,0,62,62,0,1,0,1,0,deny
62557,445,0,0,70,70,0,1,0,1,0,drop
50991,445,0,0,70,70,0,1,0,1,0,drop
50987,445,0,0,70,70,0,1,0,1,0,drop
50986,445,0,0,70,70,0,1,0,1,0,drop
63474,48817,0,0,66,66,0,1,0,1,0,deny
19875,30170,0,0,145,145,0,1,0,1,0,deny
6036,51505,0,0,66,66,0,1,0,1,0,deny
62554,445,0,0,70,70,0,1,0,1,0,drop
62743,445,0,0,66,66,0,1,0,1,0,drop
62748,445,0,0,66,66,0,1,0,1,0,drop
62747,445,0,0,66,66,0,1,0,1,0,drop
62746,445,0,0,66,66,0,1,0,1,0,drop
62744,445,0,0,66,66,0,1,0,1,0,drop
62745,445,0,0,66,66,0,1,0,1,0,drop
62742,445,0,0,66,66,0,1,0,1,0,drop
62741,445,0,0,66,66,0,1,0,1,0,drop
46509,36237,0,0,66,66,0,1,0,1,0,deny
61738,2767,0,0,66,66,0,1,0,1,0,deny
58250,35440,0,0,62,62,0,1,0,1,0,deny
8229,22114,0,0,66,66,0,1,0,1,0,deny
63323,54369,0,0,78,78,0,1,0,1,0,deny
7210,22114,0,0,66,66,0,1,0,1,0,deny
23021,25174,0,0,66,66,0,1,0,1,0,deny
56161,62413,0,0,62,62,0,1,0,1,0,deny
55019,443,64416,443,13326,1847,11479,27,31,14,13,allow
64493,53,24989,53,280,97,183,4,59,2,2,allow
48590,443,14073,443,3538,2083,1455,17,256,9,8,allow
5588,5588,0,0,3354,1792,1562,46,193,23,23,allow
5588,5588,0,0,3354,1792,1562,46,194,23,23,allow
55367,53,8311,53,190,97,93,2,31,1,1,allow
56790,53,40538,53,758,93,665,2,30,1,1,allow
31019,53,31019,53,194,87,107,2,30,1,1,allow
52621,443,59205,443,190,70,120,4,15,2,2,allow
57968,53,57968,53,371,237,134,3,32,2,1,allow
49407,53,35774,53,774,101,673,2,30,1,1,allow
56313,53,15835,53,196,100,96,2,30,1,1,allow
55816,53,28988,53,212,108,104,2,30,1,1,allow
24009,53,24009,53,825,99,726,2,30,1,1,allow
65274,53,19286,53,295,101,194,4,32,2,2,allow
57563,443,58695,443,10044,2134,7910,42,34,23,19,allow
58895,443,48917,443,13440,8354,5086,39,20,20,19,allow
60910,443,19521,443,3862,2679,1183,28,46,15,13,allow
64003,38926,55687,38926,66,66,0,1,5,1,0,allow
50309,443,46447,443,5955,1619,4336,23,15,13,10,allow
60909,443,5719,443,5150,3651,1499,34,46,18,16,allow
58902,443,55109,443,8119,5152,2967,29,18,14,15,allow
5588,5588,0,0,3562,1936,1626,48,194,24,24,allow
65180,53,33252,53,751,95,656,2,30,1,1,allow
57314,53,61726,53,190,97,93,2,31,1,1,allow
57334,53,10038,53,184,94,90,2,30,1,1,allow
65139,53,15314,53,216,110,106,2,30,1,1,allow
48833,443,62502,443,1348406,28891,1319515,1247,31,340,907,allow
34879,443,57316,443,167,107,60,2,5,1,1,allow
55147,53,40257,53,776,102,674,2,30,1,1,allow
49408,443,42776,443,4189,2286,1903,35,256,17,18,allow
57430,53,32678,53,200,102,98,2,30,1,1,allow
65420,443,40711,443,3213,2242,971,19,25,9,10,allow
49519,443,49519,443,15064,2611,12453,43,76,23,20,allow
28742,53,28742,53,365,233,132,3,32,2,1,allow
38664,443,19990,443,8195,1780,6415,23,60,12,11,allow
60906,443,59580,443,11543,5375,6168,45,47,24,21,allow
61356,53,61356,53,235,90,145,2,32,1,1,allow
55305,53,52264,53,1448,103,1345,4,54,2,2,allow
52159,80,40700,80,1278,731,547,10,15,6,4,allow
64002,2880,14112,2880,66,66,0,1,5,1,0,allow
65344,53,21017,53,90,90,0,1,30,1,0,allow
58900,443,22833,443,8547,5209,3338,30,19,15,15,allow
42974,53,0,0,82,82,0,1,30,1,0,allow
57323,53,18058,53,188,96,92,2,31,1,1,allow
56431,53,36582,53,778,103,675,2,31,1,1,allow
51038,443,30038,443,7263,1830,5433,27,16,15,12,allow
31680,53,31680,53,404,259,145,3,32,2,1,allow
49765,53,55763,53,188,96,92,2,31,1,1,allow
39858,443,36124,443,167,107,60,2,5,1,1,allow
64344,53,46040,53,286,102,184,4,45,2,2,allow
52712,443,61572,443,348281,20002,328279,401,350,153,248,allow
38334,22,38334,22,9022,3349,5673,57,43,26,31,allow
63987,58476,60558,58476,504,382,122,8,16,6,2,allow
63116,53,14772,53,578,286,292,9,15,5,4,allow
9233,443,25219,443,5955,728,5227,17,15,8,9,allow
58904,443,20613,443,4732,3142,1590,20,18,9,11,allow
55693,45341,14771,45341,70,70,0,2,8,2,0,allow
60911,443,41186,443,3862,2679,1183,28,46,15,13,allow
47281,443,8413,443,190,70,120,4,15,2,2,allow
48834,443,52235,443,655052,13866,641186,599,31,150,449,allow
56439,53,22467,53,751,95,656,2,30,1,1,allow
48847,443,57026,443,2478246,45190,2433056,2175,27,520,1655,allow
41432,53,63040,53,202,83,119,2,30,1,1,allow
65437,53,48894,53,1386,85,1301,4,53,2,2,allow
49253,53,20812,53,198,101,97,2,30,1,1,allow
54973,53,46622,53,178,91,87,2,31,1,1,allow
14205,53,14205,53,233,91,142,2,31,1,1,allow
55127,53,55127,53,220,100,120,2,31,1,1,allow
22394,53,22394,53,233,91,142,2,31,1,1,allow
13160,53,13160,53,198,89,109,2,31,1,1,allow
53404,443,26776,443,8437,4827,3610,50,180,25,25,allow
62009,443,59530,443,5017,1969,3048,14,136,7,7,allow
57470,16288,57203,16288,924,924,0,15,1200,15,0,allow
57340,53,3053,53,747,92,655,2,31,1,1,allow
55141,53,13525,53,184,94,90,2,31,1,1,allow
55268,53,37193,53,186,95,91,2,31,1,1,allow
56964,53,11967,53,774,101,673,2,31,1,1,allow
65204,53,50970,53,182,93,89,2,31,1,1,allow
57351,53,37431,53,184,94,90,2,31,1,1,allow
55056,53,12643,53,202,103,99,2,31,1,1,allow
55220,53,9691,53,186,95,91,2,31,1,1,allow
56711,53,31656,53,202,103,99,2,31,1,1,allow
56126,53,16372,53,774,101,673,2,31,1,1,allow
33133,443,21005,443,8138,2101,6037,17,121,9,8,allow
57416,53,37012,53,771,101,670,2,31,1,1,allow
56819,53,59960,53,202,103,99,2,31,1,1,allow
64020,53,44407,53,192,98,94,2,31,1,1,allow
64896,53,10637,53,716,95,621,2,31,1,1,allow
29076,53,29076,53,231,90,141,2,31,1,1,allow
49636,53,21781,53,176,90,86,2,31,1,1,allow
56857,53,63903,53,190,97,93,2,31,1,1,allow
59899,53,59899,53,194,87,107,2,31,1,1,allow
55415,53,34000,53,182,93,89,2,31,1,1,allow
65132,53,11821,53,166,85,81,2,31,1,1,allow
55123,53,64230,53,196,100,96,2,31,1,1,allow
55577,53,45509,53,198,101,97,2,31,1,1,allow
55688,53,29259,53,184,94,90,2,31,1,1,allow
65505,53,12322,53,164,84,80,2,31,1,1,allow
49628,53,48622,53,168,86,82,2,31,1,1,allow
50353,443,15424,443,1775,169,1606,7,121,3,4,allow
50357,443,38830,443,1786,172,1614,7,121,3,4,allow
11601,53,11601,53,233,91,142,2,31,1,1,allow
20336,53,20336,53,233,91,142,2,31,1,1,allow
55003,53,14075,53,192,98,94,2,31,1,1,allow
64816,53,1997,53,164,84,80,2,31,1,1,allow
23980,53,23980,53,220,100,120,2,31,1,1,allow
64853,53,19289,53,198,101,97,2,31,1,1,allow
27005,27015,65390,27015,891,126,765,2,31,1,1,allow
65495,53,9784,53,202,103,99,2,31,1,1,allow
53144,53,53144,53,231,90,141,2,31,1,1,allow
25434,53,25434,53,231,90,141,2,31,1,1,allow
55224,53,59301,53,180,92,88,2,31,1,1,allow
59919,53,59919,53,231,90,141,2,31,1,1,allow
57386,53,9687,53,186,95,91,2,31,1,1,allow
56532,53,51264,53,186,95,91,2,31,1,1,allow
56543,53,0,0,82,82,0,1,31,1,0,allow
57834,443,16694,443,6214,1733,4481,13,121,6,7,allow
49466,53,56538,53,202,103,99,2,31,1,1,allow
56912,53,37939,53,753,96,657,2,31,1,1,allow
54711,443,40588,443,3663,1136,2527,13,136,6,7,allow
52102,443,38740,443,6903,3076,3827,20,136,10,10,allow
30960,45759,38428,45759,330,330,0,6,3609,6,0,allow
48706,23393,0,0,60,60,0,1,0,1,0,deny
32976,37965,0,0,66,66,0,1,0,1,0,deny
59786,25174,0,0,66,66,0,1,0,1,0,deny
62548,445,0,0,70,70,0,1,0,1,0,drop
58511,50584,0,0,62,62,0,1,0,1,0,deny
50984,445,0,0,70,70,0,1,0,1,0,drop
50979,445,0,0,70,70,0,1,0,1,0,drop
50973,445,0,0,70,70,0,1,0,1,0,drop
50968,445,0,0,70,70,0,1,0,1,0,drop
57479,56205,0,0,66,66,0,1,0,1,0,deny
45205,25174,0,0,146,146,0,1,0,1,0,deny
62729,445,0,0,66,66,0,1,0,1,0,drop
62728,445,0,0,66,66,0,1,0,1,0,drop
62726,445,0,0,66,66,0,1,0,1,0,drop
59696,57470,0,0,62,62,0,1,0,1,0,deny
19944,22114,0,0,66,66,0,1,0,1,0,deny
33502,5529,0,0,143,143,0,1,0,1,0,deny
62541,445,0,0,70,70,0,1,0,1,0,drop
57323,53,27696,53,194,102,92,2,30,1,1,allow
62540,445,0,0,70,70,0,1,0,1,0,drop
57220,26467,0,0,66,66,0,1,0,1,0,deny
50967,445,0,0,70,70,0,1,0,1,0,drop
50965,445,0,0,70,70,0,1,0,1,0,drop
50964,445,0,0,70,70,0,1,0,1,0,drop
1024,37450,0,0,62,62,0,1,0,1,0,deny
50957,445,0,0,70,70,0,1,0,1,0,drop
2062,35440,0,0,66,66,0,1,0,1,0,deny
47727,25174,0,0,62,62,0,1,0,1,0,deny
62535,445,0,0,70,70,0,1,0,1,0,drop
52925,64147,0,0,62,62,0,1,0,1,0,deny
62533,445,0,0,70,70,0,1,0,1,0,drop
22530,25174,0,0,62,62,0,1,0,1,0,deny
40687,64147,0,0,62,62,0,1,0,1,0,deny
45964,2225,0,0,60,60,0,1,0,1,0,deny
26658,25174,0,0,62,62,0,1,0,1,0,deny
61550,5529,0,0,145,145,0,1,0,1,0,deny
55678,32468,0,0,66,66,0,1,0,1,0,deny
6881,6881,0,0,62,62,0,1,0,1,0,deny
55839,56535,0,0,62,62,0,1,0,1,0,deny
62529,445,0,0,70,70,0,1,0,1,0,drop
42231,57470,0,0,78,78,0,1,0,1,0,deny
62527,445,0,0,70,70,0,1,0,1,0,drop
50949,445,0,0,70,70,0,1,0,1,0,drop
50947,445,0,0,70,70,0,1,0,1,0,drop
50944,445,0,0,70,70,0,1,0,1,0,drop
62717,445,0,0,66,66,0,1,0,1,0,drop
36641,25174,0,0,66,66,0,1,0,1,0,deny
44612,25174,0,0,66,66,0,1,0,1,0,deny
64155,60043,0,0,62,62,0,1,0,1,0,deny
14397,37965,0,0,62,62,0,1,0,1,0,deny
62523,445,0,0,70,70,0,1,0,1,0,drop
11136,15503,0,0,62,62,0,1,0,1,0,deny
60403,22114,0,0,66,66,0,1,0,1,0,deny
50940,445,0,0,70,70,0,1,0,1,0,drop
50938,445,0,0,70,70,0,1,0,1,0,drop
39416,443,35535,443,32732,6260,26472,69,217,34,35,allow
52177,443,57914,443,7659,3234,4425,35,288,17,18,allow
64585,53,5921,53,198,102,96,2,30,1,1,allow
49448,53,48392,53,210,102,108,2,30,1,1,allow
64585,53,62482,53,821,102,719,2,30,1,1,allow
51644,53,17659,53,195,78,117,2,30,1,1,allow
49241,53,22091,53,785,110,675,2,30,1,1,allow
55180,53,29558,53,209,110,99,2,30,1,1,allow
44847,20101,53137,20101,150,150,0,1,1200,1,0,allow
65274,53,10401,53,295,101,194,4,32,2,2,allow
55979,53,16779,53,184,102,82,2,29,1,1,allow
57023,53,46258,53,179,94,85,2,29,1,1,allow
57430,53,55125,53,185,102,83,2,29,1,1,allow
56127,53,58620,53,167,86,81,2,29,1,1,allow
55520,53,58665,53,194,102,92,2,29,1,1,allow
49580,53,43364,53,782,110,672,2,30,1,1,allow
49723,53,26637,53,209,110,99,2,30,1,1,allow
49990,53,43468,53,198,102,96,2,30,1,1,allow
50646,443,35425,443,6789,1020,5769,20,101,11,9,allow
64344,53,51510,53,286,102,184,4,45,2,2,allow
53762,53,52593,53,168,78,90,2,30,1,1,allow
19924,53,19924,53,235,90,145,2,32,1,1,allow
46834,53,46834,53,235,90,145,2,32,1,1,allow
50679,80,31597,80,62,62,0,1,4,1,0,allow
63984,53,63454,53,264,110,154,2,30,1,1,allow
60270,443,24845,443,6155,1709,4446,29,1710,15,14,allow
50651,80,37006,80,1555,1103,452,9,21,5,4,allow
63999,10552,38263,10552,70,70,0,1,4,1,0,allow
63995,15396,40455,15396,70,70,0,1,4,1,0,allow
53269,443,51596,443,5766,1925,3841,22,17,14,8,allow
59473,80,31869,80,1052,612,440,10,15,5,5,allow
50623,443,64489,443,1350,773,577,15,107,8,7,allow
64344,53,14813,53,568,192,376,6,71,3,3,allow
53864,24874,8342,24874,320,140,180,6,6,3,3,allow
54969,53,12796,53,199,102,97,2,29,1,1,allow
64000,14441,58412,14441,70,70,0,1,4,1,0,allow
55816,53,14968,53,214,110,104,2,29,1,1,allow
49599,53,2987,53,732,86,646,2,29,1,1,allow
49291,53,35462,53,212,102,110,2,29,1,1,allow
57382,53,23125,53,184,94,90,2,29,1,1,allow
57053,53,14057,53,173,94,79,2,29,1,1,allow
55889,53,50897,53,199,102,97,2,29,1,1,allow
55690,53,21416,53,183,94,89,2,29,1,1,allow
49723,53,9926,53,209,110,99,2,30,1,1,allow
46948,443,43691,443,6374,2446,3928,26,217,13,13,allow
43733,443,15802,443,27525,2389,25136,47,27,22,25,allow
39050,443,47247,443,26692,5527,21165,54,31,28,26,allow
50295,443,29927,443,18401,4536,13865,48,27,24,24,allow
65477,53,50858,53,209,110,99,2,30,1,1,allow
55628,53,3702,53,198,102,96,2,30,1,1,allow
56313,53,27206,53,198,102,96,2,30,1,1,allow
49446,53,1735,53,403,142,261,2,30,1,1,allow
56247,53,6224,53,215,102,113,2,30,1,1,allow
64231,53,19664,53,196,94,102,2,30,1,1,allow
63920,443,64654,443,3192,633,2559,17,135,7,10,allow
43154,53,41451,53,168,78,90,2,30,1,1,allow
55141,53,55990,53,184,94,90,2,30,1,1,allow
64020,53,34722,53,196,102,94,2,30,1,1,allow
56756,53,38135,53,167,86,81,2,30,1,1,allow
39827,443,61705,443,6128,3746,2382,48,46,25,23,allow
52057,34664,13510,34664,70,70,0,2,8,2,0,allow
56632,443,17597,443,13148,2310,10838,29,80,16,13,allow
64307,53,12624,53,463,90,373,4,34,2,2,allow
57139,53,12753,53,816,102,714,2,30,1,1,allow
64853,53,20032,53,199,102,97,2,30,1,1,allow
38643,443,11641,443,1468,893,575,15,62,8,7,allow
65477,53,46159,53,209,110,99,2,30,1,1,allow
44791,443,29863,443,3181,1647,1534,18,31,10,8,allow
56436,80,34544,80,17067,1439,15628,23,25,8,15,allow
55855,53,27713,53,182,102,80,2,30,1,1,allow
57603,443,1218,443,2614,1689,925,18,23,10,8,allow
56756,53,60834,53,167,86,81,2,30,1,1,allow
58088,8765,45865,8765,336,150,186,6,89,3,3,allow
41269,443,34077,443,234,234,0,4,12,4,0,allow
57314,53,53459,53,195,102,93,2,30,1,1,allow
56973,53,50381,53,193,102,91,2,30,1,1,allow
35333,80,8364,80,1432,663,769,10,19,6,4,allow
55180,53,4513,53,209,110,99,2,30,1,1,allow
38432,53,33848,53,336,231,105,3,30,2,1,allow
65501,53,61730,53,774,102,672,2,30,1,1,allow
37645,443,51983,443,23266,18300,4966,56,27,33,23,allow
65228,53,28840,53,200,102,98,2,30,1,1,allow
49713,53,34138,53,198,94,104,2,30,1,1,allow
49693,53,65326,53,209,110,99,2,30,1,1,allow
56117,53,20260,53,178,94,84,2,30,1,1,allow
53739,53,43732,53,168,78,90,2,30,1,1,allow
54372,80,17871,80,3517,1612,1905,17,186,10,7,allow
65204,53,43316,53,183,94,89,2,30,1,1,allow
49213,53,0,0,333,102,231,2,30,1,1,allow
56226,53,33247,53,200,102,98,2,30,1,1,allow
64748,53,54501,53,183,94,89,2,30,1,1,allow
50933,443,10395,443,10546,2453,8093,28,15,16,12,allow
38621,443,27614,443,1593,946,647,15,64,8,7,allow
50293,443,61876,443,12677,3097,9580,37,26,19,18,allow
60948,53,22265,53,168,78,90,2,30,1,1,allow
45932,53,57917,53,199,94,105,2,30,1,1,allow
56313,53,23049,53,198,102,96,2,30,1,1,allow
59124,443,18887,443,9612,1720,7892,32,130,15,17,allow
15503,8624,29745,8624,491,150,341,2,1200,1,1,allow
56062,53,55161,53,537,98,439,4,40,2,2,allow
50292,443,41099,443,183024,16754,166270,247,28,114,133,allow
39053,443,36119,443,6699,4494,2205,27,29,14,13,allow
56756,53,14084,53,167,86,81,2,30,1,1,allow
50010,53,37943,53,205,86,119,2,30,1,1,allow
36936,53,30039,53,78,78,0,1,30,1,0,allow
60211,53,51487,53,205,86,119,2,30,1,1,allow
65316,53,39745,53,225,110,115,2,30,1,1,allow
54973,53,20292,53,181,94,87,2,30,1,1,allow
64748,53,6781,53,183,94,89,2,30,1,1,allow
65228,53,28438,53,200,102,98,2,30,1,1,allow
49765,53,11309,53,194,102,92,2,30,1,1,allow
56266,53,11208,53,193,102,91,2,30,1,1,allow
56468,53,49469,53,209,110,99,2,30,1,1,allow
55686,44049,11130,44049,504,318,186,8,15,5,3,allow
55525,443,64786,443,5200,2825,2375,18,155,9,9,allow
64004,48339,32132,48339,70,70,0,1,4,1,0,allow
63994,47013,15711,47013,70,70,0,1,4,1,0,allow
64493,53,56892,53,280,97,183,4,58,2,2,allow
49521,443,49521,443,25081,3001,22080,55,75,29,26,allow
49754,443,12620,443,17243,5482,11761,82,316,41,41,allow
49909,53,17902,53,1410,95,1315,4,57,2,2,allow
56163,53,14069,53,265,85,180,4,42,2,2,allow
65503,443,44158,443,429890,12640,417250,442,16,155,287,allow
37614,80,61486,80,1399,406,993,15,43,5,10,allow
64001,13051,4222,13051,70,70,0,1,4,1,0,allow
57440,443,35509,443,8200,2465,5735,30,18,14,16,allow
65274,53,29709,53,295,101,194,4,31,2,2,allow
38644,443,44476,443,8165,1664,6501,30,62,14,16,allow
53832,56005,63005,56005,70,70,0,1,4,1,0,allow
53286,80,26328,80,3096,1001,2095,12,150,7,5,allow
62593,7010,62593,7010,4231,2106,2125,15,15,8,7,allow
60022,80,60022,80,2959,1505,1454,10,15,6,4,allow
49452,443,53461,443,13184,2507,10677,27,64,14,13,allow
52347,443,62894,443,7847,2985,4862,30,337,16,14,allow
27076,80,27076,80,6337,947,5390,15,17,8,7,allow
57259,53,43490,53,167,86,81,2,29,1,1,allow
63989,20939,6044,20939,504,382,122,8,15,6,2,allow
5588,5588,0,0,3354,1792,1562,46,193,23,23,allow
53832,53,28034,53,211,78,133,2,29,1,1,allow
49476,53,24497,53,402,118,284,2,29,1,1,allow
65010,53,7971,53,758,102,656,2,29,1,1,allow
49574,53,41987,53,193,102,91,2,29,1,1,allow
54969,53,41747,53,199,102,97,2,29,1,1,allow
57430,53,65274,53,177,94,83,2,30,1,1,allow
43725,443,24670,443,82838,3838,79000,104,31,42,62,allow
57139,53,30822,53,193,102,91,2,30,1,1,allow
65291,53,57485,53,195,102,93,2,29,1,1,allow
57314,53,31776,53,195,102,93,2,30,1,1,allow
55463,53,39462,53,816,102,714,2,29,1,1,allow
32939,443,44702,443,3312,1936,1376,19,29,10,9,allow
57259,53,28924,53,167,86,81,2,29,1,1,allow
65142,53,52775,53,167,86,81,2,29,1,1,allow
57430,53,14392,53,200,102,98,2,29,1,1,allow
64554,53,13352,53,199,102,97,2,29,1,1,allow
55367,53,40346,53,195,102,93,2,30,1,1,allow
64097,53,23639,53,308,91,217,4,56,2,2,allow
55889,53,44791,53,199,102,97,2,30,1,1,allow
56973,53,45728,53,193,102,91,2,30,1,1,allow
64658,53,30936,53,785,110,675,2,30,1,1,allow
64661,53,48759,53,216,102,114,2,30,1,1,allow
64816,53,50725,53,166,86,80,2,30,1,1,allow
57023,53,56230,53,179,94,85,2,30,1,1,allow
55220,53,13554,53,193,102,91,2,30,1,1,allow
57314,53,2474,53,195,102,93,2,31,1,1,allow
54973,53,16224,53,181,94,87,2,31,1,1,allow
53092,443,35345,443,7676,1577,6099,28,395,9,19,allow
57835,443,21443,443,9125,3736,5389,19,120,10,9,allow
65132,53,27212,53,167,86,81,2,30,1,1,allow
64205,53,1901,53,178,94,84,2,30,1,1,allow
49324,53,24551,53,258,94,164,2,30,1,1,allow
56973,53,9162,53,193,102,91,2,30,1,1,allow
65495,53,16317,53,209,110,99,2,30,1,1,allow
53185,443,52524,443,4442408,142153,4300255,4731,235,1574,3157,allow
55056,53,39813,53,209,110,99,2,30,1,1,allow
65204,53,23706,53,183,94,89,2,30,1,1,allow
58753,443,18417,443,10379,2361,8018,27,20,16,11,allow
51963,443,38927,443,14602,6734,7868,46,56,26,20,allow
38660,443,61188,443,7031,1824,5207,23,60,12,11,allow
43361,443,8514,443,13275,10536,2739,50,101,27,23,allow
65504,443,39358,443,92275,4799,87476,107,16,43,64,allow
43732,443,8555,443,19123,2319,16804,39,28,21,18,allow
39058,443,63912,443,8028,5439,2589,32,27,16,16,allow
39051,443,15445,443,7082,4527,2555,31,31,16,15,allow
64493,53,34209,53,280,97,183,4,59,2,2,allow
49253,53,32297,53,593,188,405,6,59,3,3,allow
55628,53,5942,53,821,102,719,2,30,1,1,allow
49693,53,49502,53,209,110,99,2,30,1,1,allow
55268,53,2485,53,193,102,91,2,30,1,1,allow
55003,53,31448,53,196,102,94,2,30,1,1,allow
54371,80,58322,80,3623,1718,1905,17,186,10,7,allow
54731,443,46644,443,9498,2578,6920,28,19,16,12,allow
47531,8080,0,0,184,78,106,3,10,2,1,allow
50294,443,54513,443,9999,2316,7683,30,26,15,15,allow
48436,443,64004,443,9744,1958,7786,25,18,13,12,allow
43731,443,32992,443,10930,1759,9171,27,28,13,14,allow
39062,443,32900,443,11360,8326,3034,36,22,19,17,allow
32934,443,9755,443,7623,3362,4261,26,31,14,12,allow
64724,53,45753,53,336,110,226,2,30,1,1,allow
49253,53,44015,53,199,102,97,2,30,1,1,allow
55855,53,25503,53,182,102,80,2,30,1,1,allow
57351,53,34146,53,184,94,90,2,30,1,1,allow
64816,53,25047,53,166,86,80,2,30,1,1,allow
56127,53,41688,53,167,86,81,2,30,1,1,allow
64554,53,27674,53,199,102,97,2,30,1,1,allow
54973,53,14051,53,181,94,87,2,30,1,1,allow
55046,53,35740,53,198,102,96,2,30,1,1,allow
52189,443,16564,443,36007,4328,31679,65,217,33,32,allow
38642,443,33643,443,1468,893,575,15,62,8,7,allow
63988,43365,3645,43365,624,382,242,10,15,6,4,allow
58905,443,1469,443,6370,706,5664,19,16,7,12,allow
57333,53,60768,53,167,86,81,2,30,1,1,allow
64569,53,4728,53,413,170,243,6,30,3,3,allow
49253,53,58276,53,199,102,97,2,30,1,1,allow
49990,53,60528,53,198,102,96,2,30,1,1,allow
56819,53,1488,53,209,110,99,2,30,1,1,allow
56468,53,56108,53,209,110,99,2,30,1,1,allow
55245,53,36514,53,209,110,99,2,30,1,1,allow
55367,53,11900,53,195,102,93,2,30,1,1,allow
55688,53,25850,53,184,94,90,2,31,1,1,allow
55816,53,3790,53,214,110,104,2,31,1,1,allow
65132,53,40938,53,167,86,81,2,31,1,1,allow
55577,53,15503,53,199,102,97,2,31,1,1,allow
65020,53,14135,53,184,94,90,2,31,1,1,allow
50584,51414,36185,51414,475,150,325,2,1200,1,1,allow
55688,53,51379,53,184,94,90,2,30,1,1,allow
64810,53,57933,53,199,102,97,2,30,1,1,allow
55056,53,20306,53,209,110,99,2,30,1,1,allow
49206,53,3418,53,448,184,264,6,30,3,3,allow
49656,53,55066,53,193,102,91,2,30,1,1,allow
57244,53,57244,53,240,98,142,2,30,1,1,allow
30584,53,30584,53,241,98,143,2,30,1,1,allow
60346,53,60346,53,241,98,143,2,30,1,1,allow
57323,53,38814,53,194,102,92,2,31,1,1,allow
41931,443,53560,443,8579,2273,6306,17,136,8,9,allow
30188,33285,47903,33285,502,150,352,2,1200,1,1,allow
49628,53,6846,53,168,86,82,2,31,1,1,allow
55415,53,31153,53,183,94,89,2,31,1,1,allow
65241,53,22089,53,200,102,98,2,31,1,1,allow
55220,53,48038,53,193,102,91,2,31,1,1,allow
55003,53,40085,53,196,102,94,2,30,1,1,allow
65229,53,50750,53,193,102,91,2,31,1,1,allow
49656,53,53430,53,193,102,91,2,30,1,1,allow
55415,53,7035,53,183,94,89,2,30,1,1,allow
49374,53,42809,53,197,94,103,2,30,1,1,allow
57386,53,13419,53,193,102,91,2,31,1,1,allow
49765,53,24395,53,194,102,92,2,31,1,1,allow
56711,53,61949,53,209,110,99,2,31,1,1,allow
55123,53,57840,53,198,102,96,2,31,1,1,allow
65495,53,62386,53,209,110,99,2,31,1,1,allow
64205,53,47320,53,178,94,84,2,31,1,1,allow
27005,27016,42013,27016,893,126,767,2,31,1,1,allow
57470,20015,34460,20015,150,150,0,1,1199,1,0,allow
50358,443,36799,443,1786,172,1614,7,121,3,4,allow
56637,53,33997,53,199,102,97,2,31,1,1,allow
55159,53,6565,53,200,102,98,2,30,1,1,allow
56821,53,60054,53,199,102,97,2,30,1,1,allow
65505,53,15527,53,166,86,80,2,31,1,1,allow
63932,53,16188,53,179,94,85,2,31,1,1,allow
64520,53,30136,53,198,102,96,2,31,1,1,allow
63949,53,18113,53,195,102,93,2,31,1,1,allow
65291,53,60855,53,335,97,238,4,31,2,2,allow
2371,53,52292,53,164,86,78,2,31,1,1,allow
61419,443,21446,443,1664127,116770,1547357,2028,401,736,1292,allow
49247,53,4260,53,194,102,92,2,31,1,1,allow
65274,53,37017,53,295,101,194,4,31,2,2,allow
37965,1052,51562,1052,132,132,0,3,1199,3,0,allow
44314,443,36123,443,1268867,60489,1208378,1558,141,557,1001,allow
51221,51413,55208,51413,460,150,310,2,1201,1,1,allow
64053,53,8111,53,276,94,182,4,56,2,2,allow
56665,80,42041,80,234,234,0,4,12,4,0,allow
52040,2524,48292,2524,70,70,0,1,5,1,0,allow
37592,443,51917,443,9000,2566,6434,29,47,17,12,allow
52040,80,45485,80,4185,3462,723,14,16,7,7,allow
53152,27367,49089,27367,758,320,438,11,20,6,5,allow
44984,443,57604,443,4499,2807,1692,24,95,13,11,allow
51957,80,56020,80,486,300,186,9,27,6,3,allow
58858,443,41294,443,318,192,126,6,26,4,2,allow
60171,443,39238,443,1059,556,503,12,25,6,6,allow
51951,80,50498,80,366,240,126,7,28,5,2,allow
37582,443,5548,443,15901,7016,8885,37,49,22,15,allow
51933,80,40922,80,3676,2136,1540,15,40,10,5,allow
56561,53,57177,53,183,94,89,2,30,1,1,allow
65040,53,64754,53,749,94,655,2,30,1,1,allow
65241,53,55089,53,200,102,98,2,31,1,1,allow
63949,53,30252,53,195,102,93,2,31,1,1,allow
53722,443,52101,443,327838,13327,314511,355,127,121,234,allow
55836,443,59611,443,7519,2177,5342,16,136,8,8,allow
10151,49001,62928,49001,481,150,331,2,1201,1,1,allow
47096,443,23148,443,6211,1753,4458,43,215,15,28,allow
64998,27037,52668,27037,3573,2238,1335,16,34,8,8,allow
37594,443,15585,443,60339,4689,55650,79,47,35,44,allow
51952,443,19528,443,11367,3820,7547,28,28,16,12,allow
52183,443,15080,443,69339,4124,65215,96,22,45,51,allow
56226,53,49033,53,200,102,98,2,30,1,1,allow
55603,443,55603,443,4684,1777,2907,19,12,11,8,allow
1066,16464,0,0,60,60,0,1,0,1,0,deny
44611,23,0,0,60,60,0,1,0,1,0,deny
53640,25174,0,0,66,66,0,1,0,1,0,deny
40481,22114,0,0,66,66,0,1,0,1,0,deny
22924,25174,0,0,62,62,0,1,0,1,0,deny
62699,445,0,0,66,66,0,1,0,1,0,drop
62698,445,0,0,66,66,0,1,0,1,0,drop
52340,64147,0,0,66,66,0,1,0,1,0,deny
34932,38608,0,0,62,62,0,1,0,1,0,deny
51413,10387,0,0,139,139,0,1,0,1,0,deny
53554,1433,0,0,60,60,0,1,0,1,0,deny
62510,445,0,0,70,70,0,1,0,1,0,drop
16454,25174,0,0,66,66,0,1,0,1,0,deny
53160,25174,0,0,146,146,0,1,0,1,0,deny
50566,22114,0,0,62,62,0,1,0,1,0,deny
50928,445,0,0,70,70,0,1,0,1,0,drop
50927,445,0,0,70,70,0,1,0,1,0,drop
50925,445,0,0,70,70,0,1,0,1,0,drop
50919,445,0,0,70,70,0,1,0,1,0,drop
15345,36829,0,0,62,62,0,1,0,1,0,deny
62348,57470,0,0,109,109,0,1,0,1,0,deny
62507,445,0,0,70,70,0,1,0,1,0,drop
62694,445,0,0,66,66,0,1,0,1,0,drop
54601,26467,0,0,62,62,0,1,0,1,0,deny
32736,22114,0,0,66,66,0,1,0,1,0,deny
25150,25174,0,0,62,62,0,1,0,1,0,deny
50046,22114,0,0,66,66,0,1,0,1,0,deny
3937,36829,0,0,62,62,0,1,0,1,0,deny
54530,46776,0,0,66,66,0,1,0,1,0,deny
62690,445,0,0,66,66,0,1,0,1,0,drop
62684,445,0,0,66,66,0,1,0,1,0,drop
62687,445,0,0,66,66,0,1,0,1,0,drop
62681,445,0,0,66,66,0,1,0,1,0,drop
62683,445,0,0,66,66,0,1,0,1,0,drop
62682,445,0,0,66,66,0,1,0,1,0,drop
62688,445,0,0,66,66,0,1,0,1,0,drop
65404,36237,0,0,62,62,0,1,0,1,0,deny
50916,445,0,0,70,70,0,1,0,1,0,drop
51706,25174,0,0,66,66,0,1,0,1,0,deny
62502,445,0,0,70,70,0,1,0,1,0,drop
50911,445,0,0,70,70,0,1,0,1,0,drop
50910,445,0,0,70,70,0,1,0,1,0,drop
49730,443,47083,443,4484,1063,3421,15,10,7,8,allow
55012,25174,0,0,66,66,0,1,0,1,0,deny
50907,445,0,0,70,70,0,1,0,1,0,drop
1027,25174,0,0,62,62,0,1,0,1,0,deny
1027,25174,0,0,146,146,0,1,0,1,0,deny
62501,445,0,0,70,70,0,1,0,1,0,drop
63554,44847,0,0,62,62,0,1,0,1,0,deny
53323,35253,0,0,62,62,0,1,0,1,0,deny
24378,5169,24378,5169,507,507,0,1,0,1,0,deny
62489,23117,0,0,66,66,0,1,0,1,0,deny
62499,445,0,0,70,70,0,1,0,1,0,drop
51479,25174,0,0,66,66,0,1,0,1,0,deny
2849,30188,0,0,66,66,0,1,0,1,0,deny
55570,44847,0,0,66,66,0,1,0,1,0,deny
25878,25174,0,0,66,66,0,1,0,1,0,deny
27197,22114,0,0,146,146,0,1,0,1,0,deny
15227,26467,0,0,66,66,0,1,0,1,0,deny
33941,37807,0,0,62,62,0,1,0,1,0,deny
33941,37807,0,0,146,146,0,1,0,1,0,deny
50905,445,0,0,70,70,0,1,0,1,0,drop
50903,445,0,0,70,70,0,1,0,1,0,drop
50902,445,0,0,70,70,0,1,0,1,0,drop
62671,445,0,0,66,66,0,1,0,1,0,drop
6882,51505,0,0,66,66,0,1,0,1,0,deny
50898,445,0,0,70,70,0,1,0,1,0,drop
16358,50584,0,0,146,146,0,1,0,1,0,deny
62492,445,0,0,70,70,0,1,0,1,0,drop
62670,445,0,0,66,66,0,1,0,1,0,drop
38093,11392,0,0,62,62,0,1,0,1,0,deny
54121,25174,0,0,66,66,0,1,0,1,0,deny
62668,445,0,0,66,66,0,1,0,1,0,drop
62666,445,0,0,66,66,0,1,0,1,0,drop
62490,445,0,0,70,70,0,1,0,1,0,drop
56676,37965,0,0,66,66,0,1,0,1,0,deny
53140,51221,0,0,74,74,0,1,0,1,0,deny
62665,445,0,0,66,66,0,1,0,1,0,drop
58627,25174,0,0,62,62,0,1,0,1,0,deny
62489,445,0,0,70,70,0,1,0,1,0,drop
30149,23,0,0,60,60,0,1,0,1,0,deny
11136,15503,0,0,62,62,0,1,0,1,0,deny
62488,445,0,0,70,70,0,1,0,1,0,drop
62487,445,0,0,70,70,0,1,0,1,0,drop
60558,51221,0,0,62,62,0,1,0,1,0,deny
62485,445,0,0,70,70,0,1,0,1,0,drop
62483,445,0,0,70,70,0,1,0,1,0,drop
22168,25174,0,0,146,146,0,1,0,1,0,deny
40312,55442,0,0,62,62,0,1,0,1,0,deny
50893,445,0,0,70,70,0,1,0,1,0,drop
44388,63874,0,0,62,62,0,1,0,1,0,deny
41197,30188,0,0,62,62,0,1,0,1,0,deny
53841,37965,0,0,66,66,0,1,0,1,0,deny
50888,445,0,0,70,70,0,1,0,1,0,drop
50880,445,0,0,70,70,0,1,0,1,0,drop
2476,6881,0,0,62,62,0,1,0,1,0,deny
28636,25174,0,0,146,146,0,1,0,1,0,deny
0,0,0,0,98,98,0,1,0,1,0,deny
0,0,0,0,98,98,0,1,0,1,0,deny
0,0,0,0,98,98,0,1,0,1,0,deny
0,0,0,0,98,98,0,1,0,1,0,deny
0,0,0,0,98,98,0,1,0,1,0,deny
0,0,0,0,98,98,0,1,0,1,0,deny
0,0,0,0,98,98,0,1,0,1,0,deny
0,0,0,0,244,244,0,2,0,2,0,allow
0,0,0,0,98,98,0,1,0,1,0,deny
1025,50584,0,0,146,146,0,1,0,1,0,deny
56127,37965,0,0,66,66,0,1,0,1,0,deny
52038,50584,0,0,66,66,0,1,0,1,0,deny
23719,22114,0,0,146,146,0,1,0,1,0,deny
14692,25174,0,0,62,62,0,1,0,1,0,deny
62469,445,0,0,70,70,0,1,0,1,0,drop
62468,445,0,0,70,70,0,1,0,1,0,drop
62465,445,0,0,70,70,0,1,0,1,0,drop
24144,57470,0,0,62,62,0,1,0,1,0,deny
62458,445,0,0,70,70,0,1,0,1,0,drop
62459,445,0,0,70,70,0,1,0,1,0,drop
62653,445,0,0,66,66,0,1,0,1,0,drop
60058,25174,0,0,66,66,0,1,0,1,0,deny
7372,25773,0,0,139,139,0,1,0,1,0,reset-both
23131,25174,0,0,62,62,0,1,0,1,0,deny
1943,48817,0,0,66,66,0,1,0,1,0,deny
62646,445,0,0,66,66,0,1,0,1,0,drop
50870,445,0,0,70,70,0,1,0,1,0,drop
50734,37965,0,0,62,62,0,1,0,1,0,deny
34073,37965,0,0,62,62,0,1,0,1,0,deny
50327,1433,0,0,60,60,0,1,0,1,0,deny
42986,25174,0,0,66,66,0,1,0,1,0,deny
62447,445,0,0,70,70,0,1,0,1,0,drop
52988,53567,0,0,62,62,0,1,0,1,0,deny
60097,22114,0,0,66,66,0,1,0,1,0,deny
62643,445,0,0,66,66,0,1,0,1,0,drop
45118,39004,0,0,74,74,0,1,0,1,0,deny
3399,25174,0,0,66,66,0,1,0,1,0,deny
61190,21247,0,0,62,62,0,1,0,1,0,deny
36663,22114,0,0,62,62,0,1,0,1,0,deny
42285,57470,0,0,62,62,0,1,0,1,0,deny
55232,25174,0,0,146,146,0,1,0,1,0,deny
55629,42873,0,0,74,74,0,1,0,1,0,deny
26192,23,0,0,60,60,0,1,0,1,0,deny
62635,445,0,0,66,66,0,1,0,1,0,drop
36804,25174,0,0,66,66,0,1,0,1,0,deny
54299,28081,0,0,143,143,0,1,0,1,0,deny
15677,64147,0,0,145,145,0,1,0,1,0,deny
52238,26467,0,0,62,62,0,1,0,1,0,deny
64036,23718,0,0,66,66,0,1,0,1,0,deny
56289,25174,0,0,66,66,0,1,0,1,0,deny
55508,64147,0,0,62,62,0,1,0,1,0,deny
62630,445,0,0,66,66,0,1,0,1,0,drop
62443,445,0,0,70,70,0,1,0,1,0,drop
63595,51050,0,0,66,66,0,1,0,1,0,deny
22408,22114,0,0,66,66,0,1,0,1,0,deny
55167,48817,0,0,66,66,0,1,0,1,0,deny
25207,48817,0,0,62,62,0,1,0,1,0,deny
35894,17,0,0,60,60,0,1,0,1,0,deny
3615,53,3615,53,231,90,141,2,30,1,1,allow
54221,443,30270,443,8327,4890,3437,23,316,12,11,allow
55691,16410,1413,16410,70,70,0,1,5,1,0,allow
16012,53,16012,53,235,90,145,2,32,1,1,allow
62591,7000,62591,7000,3530,2027,1503,16,15,9,7,allow
51934,443,29764,443,550,310,240,10,35,6,4,allow
62590,7000,62590,7000,2163,676,1487,14,15,7,7,allow
55687,47613,14281,47613,164,70,94,2,5,1,1,allow
51390,53,51390,53,398,255,143,3,31,2,1,allow
37591,443,4877,443,62657,4444,58213,83,46,37,46,allow
5588,5588,0,0,3562,1936,1626,48,193,24,24,allow
65241,53,18449,53,200,102,98,2,31,1,1,allow
54968,53,43880,53,198,101,97,2,30,1,1,allow
51936,443,23888,443,4940,3363,1577,27,34,16,11,allow
5588,5588,0,0,3354,1792,1562,46,192,23,23,allow
5588,5588,0,0,3354,1792,1562,46,194,23,23,allow
63949,53,59282,53,190,97,93,2,31,1,1,allow
63932,53,54885,53,174,89,85,2,31,1,1,allow
55152,53,27991,53,176,90,86,2,30,1,1,allow
65472,53,63288,53,202,103,99,2,31,1,1,allow
63968,53,37221,53,200,102,98,2,30,1,1,allow
65133,53,56873,53,196,100,96,2,31,1,1,allow
64205,53,12061,53,172,88,84,2,30,1,1,allow
65229,53,55495,53,186,95,91,2,30,1,1,allow
64053,53,64602,53,276,94,182,4,55,2,2,allow
51935,443,8500,443,2780,1797,983,21,35,11,10,allow
48326,53,48326,53,398,255,143,3,33,2,1,allow
49526,53,35749,53,272,97,175,4,58,2,2,allow
35195,443,7133,443,153,93,60,2,5,1,1,allow
64959,53,64959,53,398,255,143,3,33,2,1,allow
52039,38541,32643,38541,66,66,0,1,5,1,0,allow
37851,443,37851,443,4691,1784,2907,19,27,11,8,allow
65363,53,30865,53,178,91,87,2,31,1,1,allow
49532,53,4849,53,190,97,93,2,31,1,1,allow
49521,53,26950,53,182,93,89,2,30,1,1,allow
51591,80,40282,80,12683,8567,4116,53,271,33,20,allow
61440,443,7179,443,7896,1207,6689,20,26,10,10,allow
52054,50513,38403,50513,70,70,0,2,9,2,0,allow
55689,37558,18058,37558,70,70,0,1,5,1,0,allow
56163,53,47516,53,265,85,180,4,41,2,2,allow
57035,53,11215,53,1414,95,1319,4,41,2,2,allow
46744,53,46744,53,404,259,145,3,32,2,1,allow
7198,53,7198,53,398,255,143,3,32,2,1,allow
19789,53,19789,53,371,237,134,3,33,2,1,allow
24692,53,24692,53,235,90,145,2,32,1,1,allow
56740,53,17032,53,716,95,621,2,30,1,1,allow
47357,443,6177,443,153,93,60,2,5,1,1,allow
52038,14487,65073,14487,66,66,0,1,5,1,0,allow
55159,53,29512,53,200,102,98,2,30,1,1,allow
33424,53,33424,53,233,91,142,2,30,1,1,allow
49533,53,65286,53,771,101,670,2,30,1,1,allow
50534,53,50534,53,216,88,128,2,30,1,1,allow
18238,53,18238,53,240,96,144,2,30,1,1,allow
14885,53,14885,53,220,100,120,2,30,1,1,allow
50263,53,61533,53,753,96,657,2,30,1,1,allow
64520,53,59126,53,196,100,96,2,30,1,1,allow
65020,53,8823,53,184,94,90,2,31,1,1,allow
55384,53,37937,53,188,96,92,2,31,1,1,allow
49862,53,25145,53,176,90,86,2,30,1,1,allow
56625,53,59531,53,186,95,91,2,31,1,1,allow
57212,53,19775,53,780,104,676,2,31,1,1,allow
64567,53,31447,53,186,95,91,2,31,1,1,allow
49556,443,19377,443,198375,6279,192096,205,153,69,136,allow
64780,53,55734,53,186,95,91,2,31,1,1,allow
16693,53,16693,53,217,87,130,2,31,1,1,allow
64833,53,14951,53,166,85,81,2,31,1,1,allow
35229,443,14508,443,9488,4114,5374,27,363,14,13,allow
65376,53,45808,53,184,94,90,2,31,1,1,allow
57792,53,57792,53,215,87,128,2,31,1,1,allow
63992,53,33581,53,198,101,97,2,31,1,1,allow
49290,53,14935,53,184,94,90,2,31,1,1,allow
57397,53,42252,53,735,88,647,2,31,1,1,allow
55547,53,9428,53,774,101,673,2,31,1,1,allow
56032,443,63053,443,1775,169,1606,7,120,3,4,allow
50355,443,1395,443,1786,172,1614,7,120,3,4,allow
63991,53,7704,53,186,95,91,2,31,1,1,allow
49752,50584,0,0,62,62,0,1,0,1,0,deny
62432,445,0,0,70,70,0,1,0,1,0,drop
62431,445,0,0,70,70,0,1,0,1,0,drop
62433,445,0,0,70,70,0,1,0,1,0,drop
62429,445,0,0,70,70,0,1,0,1,0,drop
62427,445,0,0,70,70,0,1,0,1,0,drop
13178,37965,0,0,62,62,0,1,0,1,0,deny
80,65095,0,0,66,66,0,1,0,1,0,deny
6881,6881,0,0,146,146,0,1,0,1,0,deny
56381,25174,0,0,62,62,0,1,0,1,0,deny
50862,445,0,0,70,70,0,1,0,1,0,drop
50858,445,0,0,70,70,0,1,0,1,0,drop
50859,445,0,0,70,70,0,1,0,1,0,drop
9836,22114,0,0,66,66,0,1,0,1,0,deny
62614,445,0,0,66,66,0,1,0,1,0,drop
62620,445,0,0,66,66,0,1,0,1,0,drop
62619,445,0,0,66,66,0,1,0,1,0,drop
62616,445,0,0,66,66,0,1,0,1,0,drop
62618,445,0,0,66,66,0,1,0,1,0,drop
62621,445,0,0,66,66,0,1,0,1,0,drop
62617,445,0,0,66,66,0,1,0,1,0,drop
62613,445,0,0,66,66,0,1,0,1,0,drop
47944,50584,0,0,62,62,0,1,0,1,0,deny
55435,25174,0,0,62,62,0,1,0,1,0,deny
49290,53,62128,53,184,94,90,2,30,1,1,allow
56163,53,45369,53,265,85,180,4,41,2,2,allow
64947,53,61833,53,275,96,179,4,41,2,2,allow
45547,53,15973,53,199,94,105,2,30,1,1,allow
55056,53,51122,53,209,110,99,2,30,1,1,allow
65277,53,40732,53,199,102,97,2,30,1,1,allow
57363,53,63578,53,193,102,91,2,30,1,1,allow
55123,53,56989,53,198,102,96,2,30,1,1,allow
40226,53,63320,53,258,78,180,4,30,2,2,allow
56637,53,46210,53,199,102,97,2,30,1,1,allow
65495,53,27520,53,209,110,99,2,30,1,1,allow
64816,53,50363,53,166,86,80,2,30,1,1,allow
64520,53,48129,53,198,102,96,2,30,1,1,allow
65363,53,10698,53,181,94,87,2,30,1,1,allow
49862,53,40662,53,180,94,86,2,30,1,1,allow
38269,80,33887,80,190,70,120,4,14,2,2,allow
37595,443,31654,443,34423,3999,30424,52,46,24,28,allow
57737,53,57737,53,374,240,134,3,32,2,1,allow
10283,53,10283,53,370,238,132,3,31,2,1,allow
56430,443,45343,443,10956,4863,6093,47,82,22,25,allow
57386,53,23091,53,193,102,91,2,29,1,1,allow
64284,53,55514,53,229,110,119,2,30,1,1,allow
56625,53,47756,53,193,102,91,2,30,1,1,allow
56161,53,4993,53,817,102,715,2,30,1,1,allow
49532,53,13697,53,195,102,93,2,30,1,1,allow
49247,53,61621,53,817,102,715,2,30,1,1,allow
51954,80,41489,80,18285,8756,9529,29,27,15,14,allow
51943,80,43908,80,306,120,186,6,27,3,3,allow
53852,14099,17770,14099,320,140,180,6,6,3,3,allow
51938,80,16530,80,4424,3281,1143,12,27,8,4,allow
51940,80,37296,80,366,240,126,7,27,5,2,allow
57061,53,39332,53,1780,674,1106,18,68,9,9,allow
60907,443,25513,443,7477,3022,4455,27,45,15,12,allow
64810,53,23866,53,199,102,97,2,29,1,1,allow
47652,443,53871,443,1058,571,487,10,24,6,4,allow
55046,53,11757,53,198,102,96,2,29,1,1,allow
55451,53,40344,53,816,102,714,2,29,1,1,allow
56550,53,53287,53,166,86,80,2,29,1,1,allow
17206,53,17206,53,240,98,142,2,29,1,1,allow
56271,53,27532,53,195,102,93,2,29,1,1,allow
57351,53,48672,53,184,94,90,2,29,1,1,allow
49276,53,39804,53,199,102,97,2,29,1,1,allow
56561,53,8736,53,183,94,89,2,29,1,1,allow
57430,53,16018,53,200,102,98,2,29,1,1,allow
64308,53,11059,53,258,102,156,2,29,1,1,allow
56819,53,44720,53,209,110,99,2,29,1,1,allow
55688,53,8374,53,184,94,90,2,30,1,1,allow
49532,53,40570,53,195,102,93,2,30,1,1,allow
56161,53,2092,53,194,102,92,2,30,1,1,allow
51036,80,2227,80,1514,480,1034,11,16,6,5,allow
55224,53,48169,53,182,94,88,2,30,1,1,allow
27005,27015,51372,27015,884,126,758,2,30,1,1,allow
65133,53,55111,53,198,102,96,2,30,1,1,allow
65472,53,43093,53,209,110,99,2,30,1,1,allow
45754,80,60037,80,1282,650,632,9,127,5,4,allow
65229,53,46914,53,193,102,91,2,30,1,1,allow
54968,53,59501,53,199,102,97,2,30,1,1,allow
9097,5228,6402,5228,6138,1256,4882,22,58,11,11,allow
64020,53,53035,53,196,102,94,2,30,1,1,allow
49244,80,49244,80,661753,15722,646031,683,17,235,448,allow
49591,80,27431,80,314,128,186,6,27,3,3,allow
60471,19776,35509,19776,70,70,0,2,8,2,0,allow
54805,80,8562,80,448,78,370,6,24,1,5,allow
57386,53,39494,53,193,102,91,2,30,1,1,allow
61438,443,9604,443,4933,771,4162,18,28,8,10,allow
63959,15922,28893,15922,2136,1536,600,18,22,12,6,allow
51606,443,26654,443,2895,2046,849,14,134,8,6,allow
46410,80,31458,80,1163,705,458,10,15,6,4,allow
57398,443,53104,443,1056,569,487,10,24,6,4,allow
55688,33958,16437,33958,70,70,0,1,5,1,0,allow
60377,443,19236,443,10101,2782,7319,22,78,10,12,allow
53468,443,36235,443,3153,2232,921,15,15,8,7,allow
37648,443,15216,443,9618,7387,2231,30,26,18,12,allow
21456,53,21456,53,240,98,142,2,30,1,1,allow
50970,80,61956,80,11340,3061,8279,31,115,12,19,allow
37651,443,4131,443,4162,3001,1161,20,25,12,8,allow
56857,53,15955,53,195,102,93,2,30,1,1,allow
49549,443,14886,443,19491,14463,5028,50,224,26,24,allow
55245,53,25152,53,193,102,91,2,30,1,1,allow
56532,53,25649,53,193,102,91,2,30,1,1,allow
49654,53,46255,53,775,102,673,2,30,1,1,allow
60684,53,9516,53,199,94,105,2,30,1,1,allow
56857,53,39377,53,195,102,93,2,30,1,1,allow
55729,53,3509,53,199,102,97,2,30,1,1,allow
55159,53,29350,53,200,102,98,2,30,1,1,allow
49521,53,40316,53,183,94,89,2,30,1,1,allow
55308,53,65535,53,194,94,100,2,30,1,1,allow
65277,53,48607,53,199,102,97,2,30,1,1,allow
65133,53,34896,53,198,102,96,2,30,1,1,allow
27005,27015,64415,27015,875,126,749,2,30,1,1,allow
49205,53,3818,53,720,94,626,2,30,1,1,allow
59859,443,59054,443,27510,4470,23040,67,122,34,33,allow
1956,53,1956,53,240,98,142,2,30,1,1,allow
60365,443,29839,443,13649,6567,7082,29,127,14,15,allow
51604,443,15214,443,2911,2062,849,14,134,8,6,allow
49792,53,55353,53,755,202,553,6,61,3,3,allow
10049,5222,44592,5222,6103,3081,3022,63,616,34,29,allow
49268,53,9594,53,200,94,106,2,30,1,1,allow
37683,53,37683,53,240,98,142,2,30,1,1,allow
56857,53,28297,53,195,102,93,2,30,1,1,allow
27005,27015,33669,27015,876,126,750,2,30,1,1,allow
57363,53,3624,53,193,102,91,2,30,1,1,allow
55003,53,61767,53,196,102,94,2,30,1,1,allow
55224,53,43043,53,182,94,88,2,30,1,1,allow
49505,443,22158,443,3182,1568,1614,8,120,4,4,allow
48625,443,33941,443,29988,20891,9097,170,598,95,75,allow
61435,443,45257,443,1401,940,461,11,29,7,4,allow
53724,443,35083,443,7759,1476,6283,24,19,14,10,allow
56728,443,11785,443,8652,2148,6504,20,15,11,9,allow
55224,53,2332,53,182,94,88,2,30,1,1,allow
58868,443,25875,443,1826093,48237,1777856,1873,71,599,1274,allow
55317,53,30681,53,216,102,114,2,30,1,1,allow
49466,53,24088,53,209,110,99,2,30,1,1,allow
55141,53,24444,53,184,94,90,2,30,1,1,allow
56625,53,55820,53,193,102,91,2,30,1,1,allow
65020,53,48553,53,184,94,90,2,30,1,1,allow
49776,53,42364,53,182,94,88,2,30,1,1,allow
49526,53,12720,53,272,97,175,4,58,2,2,allow
65136,53,56323,53,458,104,354,4,57,2,2,allow
57396,443,55887,443,1054,567,487,10,24,6,4,allow
61436,443,20457,443,1401,940,461,11,29,7,4,allow
51937,80,32427,80,37552,16143,21409,54,28,26,28,allow
47650,443,28162,443,1056,569,487,10,24,6,4,allow
51919,80,35345,80,16004,8270,7734,32,57,17,15,allow
39456,443,56286,443,6944,1650,5294,24,40,14,10,allow
51850,80,53740,80,2188,1421,767,11,61,7,4,allow
51947,80,31823,80,1582,866,716,11,27,7,4,allow
50402,8080,50402,8080,378,180,198,7,78,4,3,allow
50639,80,20616,80,318,192,126,6,25,4,2,allow
41538,443,31150,443,8090,2462,5628,22,21,12,10,allow
61404,443,64202,443,4526,2655,1871,24,98,14,10,allow
50608,80,12728,80,10029,8683,1346,20,36,11,9,allow
50309,53,29176,53,193,102,91,2,29,1,1,allow
51955,80,57774,80,366,240,126,7,27,5,2,allow
55159,53,20403,53,200,102,98,2,29,1,1,allow
60789,40010,35327,40010,316,136,180,6,6,3,3,allow
64020,53,31935,53,196,102,94,2,29,1,1,allow
57334,53,51470,53,184,94,90,2,29,1,1,allow
55123,53,29393,53,198,102,96,2,29,1,1,allow
55245,53,15511,53,193,102,91,2,30,1,1,allow
51605,443,22416,443,2013,1363,650,12,134,7,5,allow
53268,443,33392,443,13176,4779,8397,47,17,29,18,allow
51602,443,19598,443,2013,1363,650,12,134,7,5,allow
55268,53,12955,53,193,102,91,2,29,1,1,allow
50309,53,52592,53,816,102,714,2,29,1,1,allow
57061,53,28599,53,1780,674,1106,18,68,9,9,allow
65091,53,53299,53,212,102,110,2,29,1,1,allow
49276,53,23238,53,199,102,97,2,29,1,1,allow
55245,53,61157,53,209,110,99,2,29,1,1,allow
65139,53,18725,53,216,110,106,2,29,1,1,allow
55451,53,24181,53,193,102,91,2,29,1,1,allow
57382,53,10173,53,184,94,90,2,29,1,1,allow
27005,23010,48268,23010,881,126,755,2,30,1,1,allow
56821,53,37054,53,199,102,97,2,29,1,1,allow
54960,53,7818,53,448,184,264,6,30,3,3,allow
27005,27015,22346,27015,869,126,743,2,30,1,1,allow
56271,53,40470,53,195,102,93,2,30,1,1,allow
65204,53,50425,53,183,94,89,2,29,1,1,allow
27005,27015,56487,27015,892,126,766,2,30,1,1,allow
56313,53,7170,53,198,102,96,2,29,1,1,allow
55325,53,53505,53,199,102,97,2,30,1,1,allow
64985,53,53017,53,196,102,94,2,30,1,1,allow
65132,53,29079,53,167,86,81,2,30,1,1,allow
65023,53,44980,53,761,102,659,2,30,1,1,allow
64489,53,32733,53,215,102,113,2,30,1,1,allow
34814,53,64232,53,168,78,90,2,30,1,1,allow
65363,53,10206,53,181,94,87,2,30,1,1,allow
49636,53,23682,53,180,94,86,2,30,1,1,allow
55577,53,20988,53,199,102,97,2,30,1,1,allow
65376,53,60931,53,184,94,90,2,30,1,1,allow
55384,53,24803,53,194,102,92,2,30,1,1,allow
49628,53,54412,53,168,86,82,2,30,1,1,allow
64853,53,39005,53,199,102,97,2,30,1,1,allow
64695,53,7882,53,275,118,157,2,30,1,1,allow
49290,53,50836,53,184,94,90,2,30,1,1,allow
52850,443,36065,443,5743,1339,4404,18,180,8,10,allow
60840,53,50587,53,255,86,169,2,31,1,1,allow
55384,53,49003,53,194,102,92,2,31,1,1,allow
51973,12321,46700,12321,1260,636,624,9,30,5,4,allow
53277,80,34172,80,4374,1724,2650,16,150,9,7,allow
37538,443,35991,443,14826,7220,7606,53,94,29,24,allow
56729,443,23413,443,8652,2148,6504,20,15,11,9,allow
46270,7700,51894,7700,1440,956,484,15,35,8,7,allow
33830,443,20220,443,130,70,60,2,15,1,1,allow
51603,443,62273,443,2927,2062,865,14,134,8,6,allow
60875,443,41853,443,7251,2098,5153,27,25,15,12,allow
60369,443,30950,443,12859,2557,10302,25,80,10,15,allow
55729,53,33239,53,199,102,97,2,30,1,1,allow
56532,53,39559,53,193,102,91,2,30,1,1,allow
25209,53,25209,53,240,98,142,2,30,1,1,allow
17855,53,17855,53,240,98,142,2,30,1,1,allow
63968,53,26432,53,200,102,98,2,30,1,1,allow
49466,53,47860,53,209,110,99,2,30,1,1,allow
63932,53,27137,53,179,94,85,2,30,1,1,allow
63968,53,62729,53,200,102,98,2,30,1,1,allow
59133,443,44471,443,2863,1501,1362,20,315,10,10,allow
63984,15847,44273,15847,1344,819,525,14,15,8,6,allow
60469,60092,64603,60092,70,70,0,2,8,2,0,allow
37650,443,41900,443,6898,5202,1696,25,25,15,10,allow
64053,53,64715,53,276,94,182,4,55,2,2,allow
55577,53,26571,53,199,102,97,2,30,1,1,allow
54968,53,43253,53,199,102,97,2,30,1,1,allow
57351,53,35105,53,184,94,90,2,30,1,1,allow
56711,53,25495,53,209,110,99,2,30,1,1,allow
54968,53,59116,53,199,102,97,2,30,1,1,allow
55388,53,5023,53,720,94,626,2,30,1,1,allow
65472,53,51115,53,209,110,99,2,30,1,1,allow
32879,443,46058,443,8137,2110,6027,29,394,10,19,allow
50631,80,34721,80,14784,7048,7736,31,27,18,13,allow
61437,443,53093,443,4872,771,4101,17,28,8,9,allow
40140,53,40140,53,404,259,145,3,32,2,1,allow
60472,20273,1767,20273,70,70,0,2,8,2,0,allow
36368,80,58408,80,78,78,0,1,5,1,0,allow
49526,53,27945,53,272,97,175,4,57,2,2,allow
56711,53,8899,53,209,110,99,2,30,1,1,allow
57707,53,34372,53,70,70,0,1,30,1,0,allow
65505,53,13490,53,166,86,80,2,30,1,1,allow
55415,53,9661,53,183,94,89,2,30,1,1,allow
49521,53,3193,53,183,94,89,2,30,1,1,allow
49452,53,60984,53,244,110,134,2,30,1,1,allow
55220,53,22108,53,193,102,91,2,30,1,1,allow
65229,53,52095,53,193,102,91,2,30,1,1,allow
49521,53,30278,53,183,94,89,2,30,1,1,allow
49838,443,59419,443,6915,3106,3809,21,144,10,11,allow
65472,53,45041,53,209,110,99,2,30,1,1,allow
64833,53,41021,53,167,86,81,2,31,1,1,allow
63999,53,20780,53,193,102,91,2,31,1,1,allow
64985,53,7448,53,196,102,94,2,31,1,1,allow
64449,53,34818,53,255,102,153,2,31,1,1,allow
64780,53,40708,53,193,102,91,2,31,1,1,allow
27005,27015,28442,27015,881,126,755,2,31,1,1,allow
65026,53,29362,53,193,102,91,2,31,1,1,allow
63932,53,25694,53,179,94,85,2,31,1,1,allow
60478,443,17919,443,5045,2009,3036,14,120,7,7,allow
56523,443,55087,443,8130,2093,6037,17,120,9,8,allow
49971,443,5852,443,62,62,0,1,120,1,0,allow
57176,443,31036,443,12844,2619,10225,23,120,10,13,allow
6881,55981,51460,55981,228,118,110,2,1200,1,1,allow
26467,6969,47386,6969,192,192,0,4,1200,4,0,allow
58386,443,63968,443,15705,3421,12284,53,360,23,30,allow
65363,53,1138,53,181,94,87,2,31,1,1,allow
27005,27025,22813,27025,887,126,761,2,31,1,1,allow
63991,53,25716,53,193,102,91,2,31,1,1,allow
50354,443,29554,443,1786,172,1614,7,120,3,4,allow
50228,443,34666,443,1775,169,1606,7,120,3,4,allow
49696,443,49696,443,4871,1623,3248,18,137,8,10,allow
65020,53,24466,53,290,94,196,4,55,2,2,allow
49466,53,63958,53,324,103,221,4,46,2,2,allow
63949,53,2589,53,338,97,241,4,43,2,2,allow
65241,53,13968,53,484,102,382,4,36,2,2,allow
49526,53,6376,53,272,97,175,4,58,2,2,allow
64205,53,39534,53,327,88,239,4,52,2,2,allow
51813,443,18719,443,130,70,60,3,5,2,1,allow
32888,80,22913,80,1542,831,711,7,16,5,2,allow
9231,443,14526,443,4942,429,4513,12,15,6,6,allow
60226,443,32684,443,1907736,31488,1876248,1747,21,470,1277,allow
49265,53,25625,53,211,102,109,2,30,1,1,allow
64567,53,64760,53,193,102,91,2,30,1,1,allow
5227,50584,0,0,62,62,0,1,0,1,0,deny
49577,57470,0,0,66,66,0,1,0,1,0,deny
54578,26467,0,0,66,66,0,1,0,1,0,deny
54373,26467,0,0,62,62,0,1,0,1,0,deny
62421,445,0,0,70,70,0,1,0,1,0,drop
24236,26296,0,0,148,148,0,1,0,1,0,deny
3077,50584,0,0,146,146,0,1,0,1,0,deny
50853,445,0,0,70,70,0,1,0,1,0,drop
50852,445,0,0,70,70,0,1,0,1,0,drop
50850,445,0,0,70,70,0,1,0,1,0,drop
50842,445,0,0,70,70,0,1,0,1,0,drop
53376,22114,0,0,62,62,0,1,0,1,0,deny
62413,445,0,0,70,70,0,1,0,1,0,drop
62600,445,0,0,66,66,0,1,0,1,0,drop
62598,445,0,0,66,66,0,1,0,1,0,drop
62599,445,0,0,66,66,0,1,0,1,0,drop
42231,57470,0,0,78,78,0,1,0,1,0,deny
58120,25174,0,0,66,66,0,1,0,1,0,deny
63717,37965,0,0,66,66,0,1,0,1,0,deny
50839,445,0,0,70,70,0,1,0,1,0,drop
62991,51221,0,0,66,66,0,1,0,1,0,deny
62407,445,0,0,70,70,0,1,0,1,0,drop
57131,31061,0,0,145,145,0,1,0,1,0,deny
50830,445,0,0,70,70,0,1,0,1,0,drop
50828,445,0,0,70,70,0,1,0,1,0,drop
50826,445,0,0,70,70,0,1,0,1,0,drop
62405,445,0,0,70,70,0,1,0,1,0,drop
23519,25174,0,0,146,146,0,1,0,1,0,deny
45941,23386,0,0,60,60,0,1,0,1,0,deny
14000,14914,0,0,157,157,0,1,0,1,0,deny
63852,25174,0,0,62,62,0,1,0,1,0,deny
63385,25174,0,0,66,66,0,1,0,1,0,deny
50563,37965,0,0,66,66,0,1,0,1,0,deny
62401,445,0,0,70,70,0,1,0,1,0,drop
64306,64147,0,0,62,62,0,1,0,1,0,deny
11815,30188,0,0,146,146,0,1,0,1,0,deny
19747,37965,0,0,62,62,0,1,0,1,0,deny
18683,26467,0,0,62,62,0,1,0,1,0,deny
2837,25174,0,0,66,66,0,1,0,1,0,deny
54277,22114,0,0,146,146,0,1,0,1,0,deny
11136,19910,0,0,62,62,0,1,0,1,0,deny
3717,25174,0,0,62,62,0,1,0,1,0,deny
50549,43890,0,0,66,66,0,1,0,1,0,deny
40840,21247,0,0,62,62,0,1,0,1,0,deny
62400,445,0,0,70,70,0,1,0,1,0,drop
56249,55442,0,0,66,66,0,1,0,1,0,deny
36992,25174,0,0,146,146,0,1,0,1,0,deny
51310,64147,0,0,66,66,0,1,0,1,0,deny
50821,445,0,0,70,70,0,1,0,1,0,drop
50817,445,0,0,70,70,0,1,0,1,0,drop
50815,445,0,0,70,70,0,1,0,1,0,drop
65006,26467,0,0,66,66,0,1,0,1,0,deny
62586,445,0,0,66,66,0,1,0,1,0,drop
23349,30188,0,0,62,62,0,1,0,1,0,deny
34914,26467,0,0,62,62,0,1,0,1,0,deny
50857,26467,0,0,66,66,0,1,0,1,0,deny
62395,445,0,0,70,70,0,1,0,1,0,drop
51045,25174,0,0,66,66,0,1,0,1,0,deny
63982,25174,0,0,66,66,0,1,0,1,0,deny
22677,25174,0,0,66,66,0,1,0,1,0,deny
1827,64147,0,0,66,66,0,1,0,1,0,deny
14614,25174,0,0,66,66,0,1,0,1,0,deny
7356,25174,0,0,66,66,0,1,0,1,0,deny
55529,44847,0,0,66,66,0,1,0,1,0,deny
52232,53,0,0,71,71,0,1,0,1,0,deny
50812,445,0,0,70,70,0,1,0,1,0,drop
50810,445,0,0,70,70,0,1,0,1,0,drop
61840,25174,0,0,66,66,0,1,0,1,0,deny
63888,25174,0,0,66,66,0,1,0,1,0,deny
53546,46824,0,0,66,66,0,1,0,1,0,deny
52809,56205,0,0,146,146,0,1,0,1,0,deny
21604,50201,0,0,66,66,0,1,0,1,0,deny
55987,53,22591,53,733,85,648,2,0,1,1,allow
56816,11392,0,0,62,62,0,1,0,1,0,deny
35812,1,0,0,146,146,0,1,0,1,0,deny
56334,1433,0,0,60,60,0,1,0,1,0,deny
54418,22114,0,0,66,66,0,1,0,1,0,deny
62571,445,0,0,66,66,0,1,0,1,0,drop
29509,25174,0,0,62,62,0,1,0,1,0,deny
51602,22114,0,0,66,66,0,1,0,1,0,deny
62382,445,0,0,70,70,0,1,0,1,0,drop
51094,35440,0,0,62,62,0,1,0,1,0,deny
56590,25174,0,0,66,66,0,1,0,1,0,deny
11967,57470,0,0,62,62,0,1,0,1,0,deny
3766,25174,0,0,62,62,0,1,0,1,0,deny
3766,25174,0,0,146,146,0,1,0,1,0,deny
62379,445,0,0,70,70,0,1,0,1,0,drop
50803,445,0,0,70,70,0,1,0,1,0,drop
50799,445,0,0,70,70,0,1,0,1,0,drop
50798,445,0,0,70,70,0,1,0,1,0,drop
50791,445,0,0,70,70,0,1,0,1,0,drop
62566,445,0,0,66,66,0,1,0,1,0,drop
15442,22114,0,0,66,66,0,1,0,1,0,deny
25296,51505,0,0,66,66,0,1,0,1,0,deny
7810,25174,0,0,66,66,0,1,0,1,0,deny
62554,445,0,0,66,66,0,1,0,1,0,drop
62557,445,0,0,66,66,0,1,0,1,0,drop
62558,445,0,0,66,66,0,1,0,1,0,drop
62562,445,0,0,66,66,0,1,0,1,0,drop
62556,445,0,0,66,66,0,1,0,1,0,drop
62553,445,0,0,66,66,0,1,0,1,0,drop
62551,445,0,0,66,66,0,1,0,1,0,drop
27300,6881,0,0,66,66,0,1,0,1,0,deny
62374,445,0,0,70,70,0,1,0,1,0,drop
50786,445,0,0,70,70,0,1,0,1,0,drop
62373,445,0,0,70,70,0,1,0,1,0,drop
50782,445,0,0,70,70,0,1,0,1,0,drop
50783,445,0,0,70,70,0,1,0,1,0,drop
50779,445,0,0,70,70,0,1,0,1,0,drop
28221,37965,0,0,62,62,0,1,0,1,0,deny
62371,445,0,0,70,70,0,1,0,1,0,drop
53140,51221,0,0,74,74,0,1,0,1,0,deny
6666,2222,0,0,60,60,0,1,0,1,0,deny
56397,26467,0,0,66,66,0,1,0,1,0,deny
22547,23,0,0,60,60,0,1,0,1,0,deny
62769,25174,0,0,146,146,0,1,0,1,0,deny
53539,44847,0,0,62,62,0,1,0,1,0,deny
50777,445,0,0,70,70,0,1,0,1,0,drop
50773,445,0,0,70,70,0,1,0,1,0,drop
50772,445,0,0,70,70,0,1,0,1,0,drop
62364,445,0,0,70,70,0,1,0,1,0,drop
64955,53,11149,53,761,100,661,2,0,1,1,allow
0,0,0,0,320,320,0,5,0,5,0,allow
62544,445,0,0,66,66,0,1,0,1,0,drop
50770,445,0,0,70,70,0,1,0,1,0,drop
62362,445,0,0,70,70,0,1,0,1,0,drop
53577,35894,0,0,66,66,0,1,0,1,0,deny
62541,445,0,0,66,66,0,1,0,1,0,drop
6652,25174,0,0,62,62,0,1,0,1,0,deny
62539,445,0,0,66,66,0,1,0,1,0,drop
62538,445,0,0,66,66,0,1,0,1,0,drop
53495,37807,0,0,66,66,0,1,0,1,0,deny
62361,445,0,0,70,70,0,1,0,1,0,drop
62536,445,0,0,66,66,0,1,0,1,0,drop
62360,445,0,0,70,70,0,1,0,1,0,drop
16037,25174,0,0,62,62,0,1,0,1,0,deny
62359,445,0,0,70,70,0,1,0,1,0,drop
16037,25174,0,0,146,146,0,1,0,1,0,deny
62356,445,0,0,70,70,0,1,0,1,0,drop
62353,445,0,0,70,70,0,1,0,1,0,drop
53199,30188,0,0,66,66,0,1,0,1,0,deny
56629,25174,0,0,66,66,0,1,0,1,0,deny
25961,55783,0,0,60,60,0,1,0,1,0,deny
49893,25174,0,0,66,66,0,1,0,1,0,deny
48826,25174,0,0,66,66,0,1,0,1,0,deny
55826,42771,0,0,66,66,0,1,0,1,0,deny
55825,52700,0,0,66,66,0,1,0,1,0,deny
53022,25174,0,0,66,66,0,1,0,1,0,deny
50764,445,0,0,70,70,0,1,0,1,0,drop
1024,25174,0,0,62,62,0,1,0,1,0,deny
11488,22114,0,0,66,66,0,1,0,1,0,deny
50755,445,0,0,70,70,0,1,0,1,0,drop
50751,445,0,0,70,70,0,1,0,1,0,drop
62341,445,0,0,70,70,0,1,0,1,0,drop
62340,445,0,0,70,70,0,1,0,1,0,drop
40400,22114,0,0,62,62,0,1,0,1,0,deny
62337,445,0,0,70,70,0,1,0,1,0,drop
62331,445,0,0,70,70,0,1,0,1,0,drop
62330,445,0,0,70,70,0,1,0,1,0,drop
30598,37965,0,0,62,62,0,1,0,1,0,deny
62525,445,0,0,66,66,0,1,0,1,0,drop
50927,44847,0,0,146,146,0,1,0,1,0,deny
48019,22114,0,0,66,66,0,1,0,1,0,deny
61017,64147,0,0,66,66,0,1,0,1,0,deny
1733,65448,0,0,66,66,0,1,0,1,0,deny
42238,25174,0,0,66,66,0,1,0,1,0,deny
55629,42873,0,0,74,74,0,1,0,1,0,deny
42034,28189,0,0,62,62,0,1,0,1,0,deny
47513,23,0,0,60,60,0,1,0,1,0,deny
62792,53,0,0,88,88,0,1,0,1,0,deny
10273,21247,0,0,66,66,0,1,0,1,0,deny
62518,445,0,0,66,66,0,1,0,1,0,drop
27144,25174,0,0,66,66,0,1,0,1,0,deny
50742,445,0,0,70,70,0,1,0,1,0,drop
62319,445,0,0,70,70,0,1,0,1,0,drop
55045,443,26442,443,5541,2778,2763,24,15,14,10,allow
14597,53,14597,53,404,259,145,3,32,2,1,allow
39704,53,39704,53,398,255,143,3,33,2,1,allow
45844,443,26065,443,44232,11223,33009,97,460,50,47,allow
63999,53,43877,53,186,95,91,2,30,1,1,allow
64985,53,36411,53,192,98,94,2,30,1,1,allow
53917,80,62681,80,1829,755,1074,10,15,6,4,allow
48908,53,48908,53,398,255,143,3,32,2,1,allow
42488,53,42488,53,235,90,145,2,32,1,1,allow
46025,80,38311,80,5037,1911,3126,18,86,10,8,allow
49705,22,49705,22,1108,66,1042,3,15,2,1,allow
26842,443,13375,443,7219,2522,4697,21,20,10,11,allow
51964,443,11131,443,5363,2713,2650,26,53,14,12,allow
58703,443,1950,443,15202,6356,8846,40,119,22,18,allow
55325,53,48577,53,198,101,97,2,30,1,1,allow
49182,53,44027,53,198,101,97,2,30,1,1,allow
49595,53,17154,53,176,90,86,2,30,1,1,allow
57705,443,65472,443,7915,1994,5921,31,270,15,16,allow
55262,443,33483,443,28633618,753499,27880119,30116,102,8846,21270,allow
50381,443,49531,443,316,136,180,6,6,3,3,allow
60463,6890,27604,6890,70,70,0,1,5,1,0,allow
49317,53,41699,53,168,78,90,2,30,1,1,allow
65026,53,32654,53,186,95,91,2,30,1,1,allow
49171,443,58850,443,13649,6228,7421,28,30,15,13,allow
64444,53,59792,53,93,93,0,1,30,1,0,allow
58971,443,47268,443,2702,1593,1109,21,23,11,10,allow
64947,53,18048,53,275,96,179,4,41,2,2,allow
48020,53,48020,53,404,259,145,3,33,2,1,allow
29047,80,29047,80,10148,1458,8690,23,25,11,12,allow
62964,53,62964,53,404,259,145,3,33,2,1,allow
59420,443,36806,443,7913,5787,2126,28,316,14,14,allow
46028,80,31228,80,1176793,65077,1111716,1528,85,788,740,allow
49165,53,64334,53,780,104,676,2,30,1,1,allow
45116,80,45116,80,24787,1571,23216,40,21,20,20,allow
64790,53,58871,53,88,88,0,1,30,1,0,allow
58878,443,22672,443,25575,16682,8893,57,21,31,26,allow
46029,80,61068,80,111564,6775,104789,160,85,86,74,allow
50370,443,23415,443,316,136,180,6,6,3,3,allow
18686,53,18686,53,235,90,145,2,32,1,1,allow
39861,80,23505,80,1056,682,374,10,15,6,4,allow
19116,53,19116,53,398,255,143,3,33,2,1,allow
51638,80,49602,80,19232,1830,17402,35,49,19,16,allow
2402,7000,2402,7000,1236,676,560,13,22,7,6,allow
57089,443,54231,443,5574,999,4575,21,256,11,10,allow
55044,443,54771,443,5549,2777,2772,24,16,14,10,allow
56423,443,49453,443,6294,1494,4800,22,17,11,11,allow
54958,443,14997,443,6578,1571,5007,24,17,13,11,allow
56410,53,65347,53,757,98,659,2,30,1,1,allow
49776,53,56083,53,180,92,88,2,30,1,1,allow
32346,53,32346,53,200,90,110,2,30,1,1,allow
30834,53,30834,53,194,87,107,2,30,1,1,allow
49558,53,30601,53,184,94,90,2,30,1,1,allow
56433,53,16233,53,204,104,100,2,30,1,1,allow
18194,53,18194,53,225,87,138,2,31,1,1,allow
30960,45756,31120,45756,396,396,0,7,3616,7,0,allow
56604,443,22617,443,2904,662,2242,13,135,6,7,allow
40204,40007,54780,40007,140,78,62,2,31,1,1,allow
65487,53,62751,53,204,104,100,2,31,1,1,allow
56327,53,49632,53,172,88,84,2,31,1,1,allow
64034,53,21913,53,188,96,92,2,31,1,1,allow
27005,27015,63024,27015,897,126,771,2,31,1,1,allow
49380,53,50592,53,377,110,267,2,31,1,1,allow
5588,5588,0,0,3354,1792,1562,46,195,23,23,allow
14721,53,14721,53,217,87,130,2,31,1,1,allow
27005,27016,61455,27016,881,126,755,2,31,1,1,allow
27233,53,27233,53,213,87,126,2,31,1,1,allow
56927,53,19352,53,182,93,89,2,31,1,1,allow
49916,53,52400,53,395,111,284,2,31,1,1,allow
55693,53,60577,53,748,95,653,2,31,1,1,allow
27005,27018,40028,27018,891,126,765,2,31,1,1,allow
49969,53,49918,53,198,101,97,2,31,1,1,allow
64290,53,55058,53,192,98,94,2,31,1,1,allow
53822,25174,0,0,66,66,0,1,0,1,0,deny
63888,57470,0,0,62,62,0,1,0,1,0,deny
58228,53733,0,0,66,66,0,1,0,1,0,deny
55732,5900,0,0,60,60,0,1,0,1,0,deny
62516,445,0,0,66,66,0,1,0,1,0,drop
20706,37965,0,0,62,62,0,1,0,1,0,deny
6666,16010,0,0,60,60,0,1,0,1,0,deny
20576,37965,0,0,62,62,0,1,0,1,0,deny
7222,57470,0,0,62,62,0,1,0,1,0,deny
62580,25174,0,0,62,62,0,1,0,1,0,deny
27063,25174,0,0,62,62,0,1,0,1,0,deny
51298,57470,0,0,66,66,0,1,0,1,0,deny
31404,46232,0,0,100,100,0,1,0,1,0,deny
47357,50584,0,0,66,66,0,1,0,1,0,deny
10072,25174,0,0,62,62,0,1,0,1,0,deny
60721,22114,0,0,66,66,0,1,0,1,0,deny
62315,445,0,0,70,70,0,1,0,1,0,drop
62509,445,0,0,66,66,0,1,0,1,0,drop
51600,443,3011,443,12552,2564,9988,29,16,17,12,allow
62716,2323,0,0,60,60,0,1,0,1,0,deny
1882,43890,0,0,62,62,0,1,0,1,0,deny
62506,445,0,0,66,66,0,1,0,1,0,drop
57655,56205,0,0,66,66,0,1,0,1,0,deny
62424,37965,0,0,62,62,0,1,0,1,0,deny
31404,52955,0,0,100,100,0,1,0,1,0,deny
50956,25174,0,0,146,146,0,1,0,1,0,deny
62306,445,0,0,70,70,0,1,0,1,0,drop
62303,445,0,0,70,70,0,1,0,1,0,drop
62305,445,0,0,70,70,0,1,0,1,0,drop
31404,12082,0,0,100,100,0,1,0,1,0,deny
31404,36778,0,0,100,100,0,1,0,1,0,deny
31404,59961,0,0,100,100,0,1,0,1,0,deny
31404,36841,0,0,100,100,0,1,0,1,0,deny
62301,445,0,0,70,70,0,1,0,1,0,drop
49417,38558,0,0,66,66,0,1,0,1,0,deny
62299,445,0,0,70,70,0,1,0,1,0,drop
50126,23117,0,0,66,66,0,1,0,1,0,deny
62796,37807,0,0,66,66,0,1,0,1,0,deny
49931,25174,0,0,66,66,0,1,0,1,0,deny
50211,51050,0,0,62,62,0,1,0,1,0,deny
59192,25174,0,0,66,66,0,1,0,1,0,deny
45908,33330,0,0,60,60,0,1,0,1,0,deny
64035,25174,0,0,62,62,0,1,0,1,0,deny
2090,50265,0,0,145,145,0,1,0,1,0,deny
50735,445,0,0,70,70,0,1,0,1,0,drop
50732,445,0,0,70,70,0,1,0,1,0,drop
50730,445,0,0,70,70,0,1,0,1,0,drop
62488,445,0,0,66,66,0,1,0,1,0,drop
55008,21247,0,0,62,62,0,1,0,1,0,deny
54280,3398,0,0,60,60,0,1,0,1,0,deny
62492,445,0,0,66,66,0,1,0,1,0,drop
62493,445,0,0,66,66,0,1,0,1,0,drop
62491,445,0,0,66,66,0,1,0,1,0,drop
62486,445,0,0,66,66,0,1,0,1,0,drop
62489,445,0,0,66,66,0,1,0,1,0,drop
62487,445,0,0,66,66,0,1,0,1,0,drop
62485,445,0,0,66,66,0,1,0,1,0,drop
10949,22114,0,0,146,146,0,1,0,1,0,deny
60075,41705,0,0,66,66,0,1,0,1,0,deny
33761,25174,0,0,62,62,0,1,0,1,0,deny
62292,445,0,0,70,70,0,1,0,1,0,drop
44903,80,37166,80,918,461,457,9,16,6,3,allow
32975,443,44703,443,4648,1885,2763,20,95,10,10,allow
55384,53,51117,53,194,102,92,2,30,1,1,allow
57252,53,26443,53,229,102,127,2,30,1,1,allow
57558,443,4202,443,42986,7555,35431,69,125,29,40,allow
51295,80,40456,80,6702,5879,823,19,135,10,9,allow
44911,80,9577,80,1492,1050,442,7,15,5,2,allow
49590,80,22848,80,314,128,186,6,26,3,3,allow
43016,53,43016,53,235,90,145,2,32,1,1,allow
64672,53,41499,53,576,195,381,6,51,3,3,allow
65220,53,7032,53,371,97,274,4,53,2,2,allow
49182,53,41433,53,199,102,97,2,29,1,1,allow
49776,53,43757,53,182,94,88,2,29,1,1,allow
49558,53,61450,53,184,94,90,2,29,1,1,allow
64053,53,32861,53,276,94,182,4,54,2,2,allow
49947,53,36871,53,264,102,162,2,30,1,1,allow
49166,443,48248,443,9022,1416,7606,25,31,11,14,allow
47873,443,44942,443,12813,5036,7777,40,383,20,20,allow
47191,443,13970,443,8756,2298,6458,39,314,18,21,allow
52053,34411,20997,34411,70,70,0,2,7,2,0,allow
50362,80,15549,80,3907,880,3027,11,15,5,6,allow
36628,80,36628,80,5529,713,4816,15,15,8,7,allow
53465,443,55749,443,3166,2245,921,15,15,8,7,allow
43683,443,23640,443,6941,1551,5390,25,200,12,13,allow
58068,443,17873,443,543,303,240,8,5,4,4,allow
49320,53,42245,53,331,90,241,4,38,2,2,allow
55325,53,47399,53,199,102,97,2,29,1,1,allow
56625,53,48390,53,193,102,91,2,29,1,1,allow
55152,53,21399,53,180,94,86,2,29,1,1,allow
65505,53,17210,53,166,86,80,2,29,1,1,allow
49233,53,56407,53,196,102,94,2,29,1,1,allow
64520,53,16253,53,198,102,96,2,29,1,1,allow
64790,53,41901,53,178,94,84,2,29,1,1,allow
55236,53,27697,53,196,102,94,2,29,1,1,allow
65026,53,34108,53,193,102,91,2,29,1,1,allow
64011,53,28636,53,288,94,194,2,29,1,1,allow
65376,53,47204,53,184,94,90,2,29,1,1,allow
64567,53,8117,53,193,102,91,2,29,1,1,allow
65167,53,26450,53,212,102,110,2,29,1,1,allow
50535,53,14934,53,210,110,100,2,29,1,1,allow
55236,53,12241,53,819,102,717,2,29,1,1,allow
65376,53,8405,53,184,94,90,2,30,1,1,allow
60874,443,9716,443,4479,788,3691,17,25,9,8,allow
61491,443,56385,443,5628,1716,3912,26,109,16,10,allow
53253,443,36100,443,8662,1469,7193,28,66,15,13,allow
64833,53,62978,53,167,86,81,2,30,1,1,allow
27005,27018,61540,27018,881,126,755,2,30,1,1,allow
49595,53,9542,53,180,94,86,2,30,1,1,allow
63992,53,39861,53,199,102,97,2,30,1,1,allow
49489,53,23234,53,241,118,123,2,30,1,1,allow
57536,443,25705,443,232,172,60,3,5,2,1,allow
55682,32765,50295,32765,3529,1769,1760,11,15,6,5,allow
59999,443,10266,443,1571,660,911,13,18,7,6,allow
53263,443,23949,443,11175,1078,10097,25,41,11,14,allow
55054,80,54288,80,67750,4451,63299,78,60,32,46,allow
49182,53,13161,53,199,102,97,2,30,1,1,allow
55684,80,48603,80,70,70,0,1,5,1,0,allow
27005,27016,10139,27016,887,126,761,2,30,1,1,allow
49534,53,17481,53,315,84,231,4,40,2,2,allow
64312,53,41455,53,225,110,115,2,30,1,1,allow
59996,443,60855,443,1641,730,911,14,18,8,6,allow
52094,443,44037,443,2983,1667,1316,25,153,12,13,allow
49903,53,41942,53,194,94,100,2,30,1,1,allow
44380,443,20721,443,5624,2556,3068,29,80,15,14,allow
65507,53,44287,53,199,102,97,2,30,1,1,allow
36575,443,29496,443,412,140,272,7,25,3,4,allow
53252,443,20191,443,6053,974,5079,20,66,10,10,allow
61490,443,7323,443,4561,1129,3432,22,109,13,9,allow
65216,53,8359,53,775,102,673,2,30,1,1,allow
49248,53,1565,53,301,90,211,4,46,2,2,allow
56433,53,47561,53,210,110,100,2,30,1,1,allow
35350,443,47252,443,13168,2505,10663,21,121,9,12,allow
42792,443,30288,443,7102,1857,5245,28,95,15,13,allow
56453,53,58094,53,243,94,149,2,30,1,1,allow
19473,61397,60276,61397,323,150,173,2,1200,1,1,allow
17860,53,17860,53,216,90,126,2,30,1,1,allow
51221,41939,7547,41939,3917,1584,2333,50,3325,25,25,allow
51388,443,13575,443,6703,3312,3391,31,145,14,17,allow
42568,443,34410,443,8049,2043,6006,23,360,11,12,allow
65121,443,49060,443,11416,4745,6671,45,256,22,23,allow
53035,80,53035,80,373926,8227,365699,379,143,130,249,allow
49835,443,51050,443,8754,2616,6138,34,96,19,15,allow
56288,53,63412,53,210,110,100,2,30,1,1,allow
63992,53,62838,53,199,102,97,2,30,1,1,allow
27005,27015,24846,27015,878,126,752,2,30,1,1,allow
57514,53,51498,53,168,78,90,2,30,1,1,allow
50359,80,14465,80,1770,961,809,10,15,5,5,allow
60000,443,63999,443,1641,730,911,14,18,8,6,allow
50857,3389,50857,3389,3613,1594,2019,19,18,10,9,allow
63988,53,50282,53,559,193,366,6,67,3,3,allow
56288,53,18039,53,210,110,100,2,30,1,1,allow
64833,53,29927,53,167,86,81,2,30,1,1,allow
27005,27016,36126,27016,883,126,757,2,30,1,1,allow
44119,53,25337,53,168,78,90,2,30,1,1,allow
65507,53,53628,53,199,102,97,2,30,1,1,allow
49595,53,47380,53,180,94,86,2,30,1,1,allow
65133,53,1707,53,339,100,239,4,51,2,2,allow
37663,80,36231,80,974,481,493,8,15,5,3,allow
57904,80,60274,80,6453,1210,5243,14,23,8,6,allow
53153,17639,25846,17639,698,320,378,10,18,6,4,allow
48440,443,28168,443,6945,1551,5394,25,200,12,13,allow
44907,80,29624,80,1514,962,552,7,16,5,2,allow
50391,80,25680,80,2837,582,2255,12,17,7,5,allow
51950,80,61236,80,3648,1775,1873,13,26,7,6,allow
49589,80,33481,80,314,128,186,6,26,3,3,allow
46773,443,61841,443,10812,3429,7383,39,315,20,19,allow
53851,23650,26484,23650,320,140,180,6,5,3,3,allow
64947,53,23514,53,275,96,179,4,41,2,2,allow
57695,443,41532,443,9493,2266,7227,24,14,13,11,allow
52036,52608,31210,52608,70,70,0,1,4,1,0,allow
6666,2222,6666,2222,130,66,64,2,5,1,1,allow
56163,53,10376,53,624,188,436,6,60,3,3,allow
43807,80,36292,80,138,78,60,2,4,1,1,allow
64947,53,11296,53,275,96,179,4,41,2,2,allow
59997,443,42772,443,1571,660,911,13,18,7,6,allow
50357,80,43010,80,764,698,66,6,15,5,1,allow
45775,443,19122,443,8706,1430,7276,23,316,9,14,allow
58903,443,20018,443,6033,770,5263,18,15,8,10,allow
50594,80,50594,80,9937,4191,5746,27,17,13,14,allow
10014,443,17937,443,3876,2012,1864,21,315,10,11,allow
49558,53,47394,53,184,94,90,2,30,1,1,allow
63999,53,37511,53,193,102,91,2,29,1,1,allow
49233,53,6991,53,819,102,717,2,29,1,1,allow
41812,443,33083,443,6617,1705,4912,24,331,11,13,allow
64780,53,50803,53,193,102,91,2,29,1,1,allow
27005,27015,62179,27015,889,126,763,2,30,1,1,allow
49277,53,5788,53,199,86,113,2,29,1,1,allow
27005,27017,42100,27017,891,126,765,2,30,1,1,allow
49570,53,16357,53,196,94,102,2,29,1,1,allow
64497,53,35440,53,232,110,122,2,29,1,1,allow
63991,53,55633,53,193,102,91,2,29,1,1,allow
49182,53,3761,53,199,102,97,2,29,1,1,allow
55325,53,5383,53,199,102,97,2,30,1,1,allow
50535,53,65134,53,210,110,100,2,29,1,1,allow
53261,443,44593,443,5025,973,4052,19,53,10,9,allow
51939,53,4042,53,222,94,128,2,30,1,1,allow
65403,53,26978,53,178,94,84,2,30,1,1,allow
53258,443,7093,443,5124,979,4145,19,54,10,9,allow
53249,443,44486,443,11150,2012,9138,29,67,14,15,allow
65026,53,30024,53,193,102,91,2,30,1,1,allow
59868,443,9732,443,6869,3351,3518,22,135,11,11,allow
49942,53,17734,53,741,94,647,2,30,1,1,allow
64271,53,22789,53,198,94,104,2,30,1,1,allow
49290,53,29478,53,184,94,90,2,30,1,1,allow
49160,6889,59737,6889,834,150,684,4,1200,2,2,allow
60462,47821,9617,47821,70,70,0,1,5,1,0,allow
57537,443,24448,443,130,70,60,3,5,2,1,allow
27005,27017,7414,27017,882,126,756,2,30,1,1,allow
63069,443,57757,443,2523249,58976,2464273,2483,33,820,1663,allow
53264,443,4162,443,41321,1491,39830,52,41,15,37,allow
53262,443,44480,443,7608,1340,6268,27,53,13,14,allow
49762,443,52270,443,7479,2226,5253,29,151,15,14,allow
49939,53,35576,53,229,102,127,2,30,1,1,allow
64444,53,10743,53,183,94,89,2,30,1,1,allow
55058,80,17892,80,48751,3044,45707,57,60,23,34,allow
50723,80,33475,80,1546,1109,437,7,15,5,2,allow
53036,80,53036,80,2954,720,2234,13,143,6,7,allow
50912,443,13273,443,5159,1080,4079,20,255,10,10,allow
60420,443,16410,443,7330,1565,5765,20,134,10,10,allow
45885,80,47215,80,23259,2769,20490,36,143,19,17,allow
56937,7150,12270,7150,126,126,0,1,30,1,0,allow
27005,27015,1536,27015,883,126,757,2,30,1,1,allow
53242,443,3574,443,5993,974,5019,19,70,10,9,allow
56433,53,24075,53,210,110,100,2,30,1,1,allow
63991,53,7605,53,193,102,91,2,30,1,1,allow
65403,53,51244,53,178,94,84,2,30,1,1,allow
40428,53,46586,53,168,78,90,2,30,1,1,allow
56462,53,3765,53,168,78,90,2,30,1,1,allow
56327,53,4067,53,178,94,84,2,30,1,1,allow
61387,443,3059,443,12231,6846,5385,38,160,19,19,allow
51738,7000,51738,7000,3550,1983,1567,15,16,8,7,allow
63992,53,19496,53,199,102,97,2,30,1,1,allow
55273,53,2212,53,168,78,90,2,30,1,1,allow
64567,53,13390,53,193,102,91,2,30,1,1,allow
53259,443,63565,443,27501,3878,23623,57,54,24,33,allow
53243,443,50839,443,242426,7999,234427,277,70,100,177,allow
48694,123,37842,123,184,94,90,2,30,1,1,allow
49595,53,24473,53,180,94,86,2,30,1,1,allow
64396,53,16886,53,231,102,129,2,30,1,1,allow
55387,53,41194,53,164,86,78,2,30,1,1,allow
64290,53,18678,53,196,102,94,2,31,1,1,allow
58781,443,55654,443,6133,1655,4478,12,120,5,7,allow
50038,53,4648,53,281,78,203,2,31,1,1,allow
51653,443,13431,443,6660,1542,5118,21,305,11,10,allow
57291,53,29680,53,178,94,84,2,30,1,1,allow
65293,53,30071,53,349,110,239,2,30,1,1,allow
40204,40012,25675,40012,148,86,62,2,30,1,1,allow
40204,40026,38971,40026,148,86,62,2,30,1,1,allow
56938,53,56411,53,199,102,97,2,31,1,1,allow
49776,53,15280,53,289,92,197,4,31,2,2,allow
64034,53,39969,53,194,102,92,2,31,1,1,allow
55569,443,40443,443,8867,3511,5356,20,120,9,11,allow
34478,443,59065,443,9107,2253,6854,22,185,11,11,allow
63789,443,32462,443,4407024,140001,4267023,4628,124,1546,3082,allow
52055,20019,40122,20019,316,136,180,6,7,3,3,allow
53826,10168,43672,10168,70,70,0,1,5,1,0,allow
63985,43081,52828,43081,70,70,0,1,5,1,0,allow
52048,44059,61296,44059,258,70,188,4,8,2,2,allow
52050,31648,17402,31648,70,70,0,2,8,2,0,allow
45720,443,24721,443,1625,1038,587,14,26,8,6,allow
44885,443,54078,443,1849,1130,719,17,38,9,8,allow
34431,443,7506,443,1701,1048,653,15,39,8,7,allow
48008,443,47118,443,10665,3059,7606,28,17,16,12,allow
53250,443,16467,443,70319,5815,64504,146,67,52,94,allow
52049,52557,35035,52557,70,70,0,2,8,2,0,allow
52051,29868,56419,29868,70,70,0,2,8,2,0,allow
36403,443,54491,443,1149,709,440,13,39,8,5,allow
51667,443,62904,443,1203,703,500,14,42,8,6,allow
54188,443,5906,443,2895,1646,1249,17,16,8,9,allow
57291,53,9525,53,178,94,84,2,30,1,1,allow
58509,21247,0,0,66,66,0,1,0,1,0,deny
63565,22114,0,0,146,146,0,1,0,1,0,deny
16387,51369,0,0,60,60,0,1,0,1,0,deny
39132,44847,0,0,62,62,0,1,0,1,0,deny
42231,57470,0,0,78,78,0,1,0,1,0,deny
50265,23,0,0,60,60,0,1,0,1,0,deny
30280,37965,0,0,66,66,0,1,0,1,0,deny
50729,445,0,0,70,70,0,1,0,1,0,drop
50725,445,0,0,70,70,0,1,0,1,0,drop
50712,445,0,0,70,70,0,1,0,1,0,drop
50714,445,0,0,70,70,0,1,0,1,0,drop
62285,445,0,0,70,70,0,1,0,1,0,drop
53257,37450,0,0,66,66,0,1,0,1,0,deny
38134,8497,0,0,143,143,0,1,0,1,0,deny
11599,25174,0,0,146,146,0,1,0,1,0,deny
55136,11392,0,0,62,62,0,1,0,1,0,deny
62282,445,0,0,70,70,0,1,0,1,0,drop
62471,445,0,0,66,66,0,1,0,1,0,drop
62473,445,0,0,66,66,0,1,0,1,0,drop
62470,445,0,0,66,66,0,1,0,1,0,drop
58791,25174,0,0,62,62,0,1,0,1,0,deny
59451,50584,0,0,62,62,0,1,0,1,0,deny
64755,31573,0,0,66,66,0,1,0,1,0,deny
62278,445,0,0,70,70,0,1,0,1,0,drop
63813,26467,0,0,66,66,0,1,0,1,0,deny
62277,445,0,0,70,70,0,1,0,1,0,drop
50711,445,0,0,70,70,0,1,0,1,0,drop
50707,445,0,0,70,70,0,1,0,1,0,drop
50706,445,0,0,70,70,0,1,0,1,0,drop
50700,445,0,0,70,70,0,1,0,1,0,drop
50197,64147,0,0,62,62,0,1,0,1,0,deny
42796,22114,0,0,146,146,0,1,0,1,0,deny
39086,53733,0,0,146,146,0,1,0,1,0,deny
62273,445,0,0,70,70,0,1,0,1,0,drop
9528,44847,0,0,62,62,0,1,0,1,0,deny
43891,8497,0,0,148,148,0,1,0,1,0,deny
56328,36237,0,0,66,66,0,1,0,1,0,deny
2422,62507,0,0,66,66,0,1,0,1,0,deny
52781,57470,0,0,66,66,0,1,0,1,0,deny
50851,25864,0,0,74,74,0,1,0,1,0,deny
31281,57470,0,0,145,145,0,1,0,1,0,deny
80,57411,0,0,1514,1514,0,1,0,1,0,deny
16387,45121,0,0,60,60,0,1,0,1,0,deny
62272,445,0,0,70,70,0,1,0,1,0,drop
54048,25174,0,0,66,66,0,1,0,1,0,deny
16387,41860,0,0,60,60,0,1,0,1,0,deny
65015,22114,0,0,66,66,0,1,0,1,0,deny
31738,51505,0,0,62,62,0,1,0,1,0,deny
41908,1433,0,0,60,60,0,1,0,1,0,deny
53567,64147,0,0,66,66,0,1,0,1,0,deny
7423,22114,0,0,62,62,0,1,0,1,0,deny
80,36466,0,0,1514,1514,0,1,0,1,0,deny
50442,25174,0,0,66,66,0,1,0,1,0,deny
24040,22114,0,0,62,62,0,1,0,1,0,deny
7482,57470,0,0,66,66,0,1,0,1,0,deny
50692,445,0,0,70,70,0,1,0,1,0,drop
50690,445,0,0,70,70,0,1,0,1,0,drop
50687,445,0,0,70,70,0,1,0,1,0,drop
25469,81,0,0,60,60,0,1,0,1,0,deny
46774,51050,0,0,62,62,0,1,0,1,0,deny
62267,445,0,0,70,70,0,1,0,1,0,drop
62459,445,0,0,66,66,0,1,0,1,0,drop
34166,22114,0,0,62,62,0,1,0,1,0,deny
61961,11392,0,0,66,66,0,1,0,1,0,deny
13684,25174,0,0,62,62,0,1,0,1,0,deny
27348,22114,0,0,66,66,0,1,0,1,0,deny
56052,53,55355,53,1392,85,1307,4,12,2,2,allow
49797,25174,0,0,66,66,0,1,0,1,0,deny
26435,39004,0,0,62,62,0,1,0,1,0,deny
14692,25174,0,0,62,62,0,1,0,1,0,deny
22240,22114,0,0,62,62,0,1,0,1,0,deny
62911,36237,0,0,66,66,0,1,0,1,0,deny
30304,64147,0,0,66,66,0,1,0,1,0,deny
35011,37965,0,0,62,62,0,1,0,1,0,deny
50683,445,0,0,70,70,0,1,0,1,0,drop
50682,445,0,0,70,70,0,1,0,1,0,drop
7067,22114,0,0,62,62,0,1,0,1,0,deny
44546,32468,0,0,62,62,0,1,0,1,0,deny
63708,25174,0,0,66,66,0,1,0,1,0,deny
26752,64147,0,0,62,62,0,1,0,1,0,deny
55161,37807,0,0,66,66,0,1,0,1,0,deny
62254,445,0,0,70,70,0,1,0,1,0,drop
5,47993,0,0,62,62,0,1,0,1,0,deny
62446,445,0,0,66,66,0,1,0,1,0,drop
62442,445,0,0,66,66,0,1,0,1,0,drop
63460,55160,0,0,62,62,0,1,0,1,0,deny
62251,445,0,0,70,70,0,1,0,1,0,drop
21108,25174,0,0,62,62,0,1,0,1,0,deny
50673,445,0,0,70,70,0,1,0,1,0,drop
50674,445,0,0,70,70,0,1,0,1,0,drop
50672,445,0,0,70,70,0,1,0,1,0,deny
50663,445,0,0,70,70,0,1,0,1,0,drop
56131,37807,0,0,62,62,0,1,0,1,0,deny
55130,25174,0,0,66,66,0,1,0,1,0,deny
30861,46783,0,0,62,62,0,1,0,1,0,deny
62440,445,0,0,66,66,0,1,0,1,0,drop
49540,50584,0,0,66,66,0,1,0,1,0,deny
54166,25174,0,0,66,66,0,1,0,1,0,deny
59745,25174,0,0,146,146,0,1,0,1,0,deny
62247,445,0,0,70,70,0,1,0,1,0,drop
52471,22114,0,0,62,62,0,1,0,1,0,deny
62245,445,0,0,70,70,0,1,0,1,0,drop
62433,445,0,0,66,66,0,1,0,1,0,drop
62423,445,0,0,66,66,0,1,0,1,0,drop
62434,445,0,0,66,66,0,1,0,1,0,drop
62431,445,0,0,66,66,0,1,0,1,0,drop
62425,445,0,0,66,66,0,1,0,1,0,drop
62424,445,0,0,66,66,0,1,0,1,0,drop
44285,25174,0,0,62,62,0,1,0,1,0,deny
62243,445,0,0,70,70,0,1,0,1,0,drop
50659,445,0,0,70,70,0,1,0,1,0,drop
50655,445,0,0,70,70,0,1,0,1,0,drop
50652,445,0,0,70,70,0,1,0,1,0,drop
50651,445,0,0,70,70,0,1,0,1,0,drop
59949,44847,0,0,66,66,0,1,0,1,0,deny
63840,36829,0,0,62,62,0,1,0,1,0,deny
19330,25174,0,0,62,62,0,1,0,1,0,deny
52024,25174,0,0,66,66,0,1,0,1,0,deny
51155,56205,0,0,62,62,0,1,0,1,0,deny
7877,22114,0,0,66,66,0,1,0,1,0,deny
63347,25174,0,0,66,66,0,1,0,1,0,deny
8903,23,0,0,60,60,0,1,0,1,0,deny
18061,25174,0,0,62,62,0,1,0,1,0,deny
6881,37965,0,0,146,146,0,1,0,1,0,deny
51834,35440,0,0,66,66,0,1,0,1,0,deny
6666,138,0,0,60,60,0,1,0,1,0,deny
45144,25174,0,0,62,62,0,1,0,1,0,deny
17676,23,0,0,60,60,0,1,0,1,0,deny
62236,445,0,0,70,70,0,1,0,1,0,drop
51609,37807,0,0,66,66,0,1,0,1,0,deny
3800,5223,0,0,146,146,0,1,0,1,0,deny
62234,445,0,0,70,70,0,1,0,1,0,drop
50648,445,0,0,70,70,0,1,0,1,0,drop
50647,445,0,0,70,70,0,1,0,1,0,drop
50645,445,0,0,70,70,0,1,0,1,0,drop
21542,57470,0,0,74,74,0,1,0,1,0,deny
62418,445,0,0,66,66,0,1,0,1,0,drop
50642,445,0,0,70,70,0,1,0,1,0,drop
62413,445,0,0,66,66,0,1,0,1,0,drop
62233,445,0,0,70,70,0,1,0,1,0,drop
6666,990,0,0,60,60,0,1,0,1,0,deny
62232,445,0,0,70,70,0,1,0,1,0,drop
62411,445,0,0,66,66,0,1,0,1,0,drop
62410,445,0,0,66,66,0,1,0,1,0,drop
62231,445,0,0,70,70,0,1,0,1,0,drop
61400,64147,0,0,66,66,0,1,0,1,0,deny
6036,51505,0,0,66,66,0,1,0,1,0,deny
62225,445,0,0,70,70,0,1,0,1,0,drop
62229,445,0,0,70,70,0,1,0,1,0,drop
62885,62413,0,0,66,66,0,1,0,1,0,deny
63474,48817,0,0,66,66,0,1,0,1,0,deny
62409,445,0,0,66,66,0,1,0,1,0,drop
59988,64147,0,0,66,66,0,1,0,1,0,deny
32704,25174,0,0,62,62,0,1,0,1,0,deny
45964,3111,0,0,60,60,0,1,0,1,0,deny
62408,50584,0,0,62,62,0,1,0,1,0,deny
62637,42873,0,0,66,66,0,1,0,1,0,deny
51396,56205,0,0,66,66,0,1,0,1,0,deny
61738,2767,0,0,66,66,0,1,0,1,0,deny
7811,44847,0,0,62,62,0,1,0,1,0,deny
8229,22114,0,0,66,66,0,1,0,1,0,deny
23021,25174,0,0,66,66,0,1,0,1,0,deny
62213,445,0,0,70,70,0,1,0,1,0,drop
62212,445,0,0,70,70,0,1,0,1,0,drop
50637,445,0,0,70,70,0,1,0,1,0,drop
62210,445,0,0,70,70,0,1,0,1,0,drop
51999,37965,0,0,62,62,0,1,0,1,0,deny
39195,25174,0,0,62,62,0,1,0,1,0,deny
62202,445,0,0,70,70,0,1,0,1,0,drop
62203,445,0,0,70,70,0,1,0,1,0,drop
54828,53,54828,53,404,259,145,3,33,2,1,allow
37460,443,43570,443,5674,3900,1774,29,80,15,14,allow
55040,443,30969,443,15722,5108,10614,39,16,22,17,allow
49337,443,20876,443,3185,2263,922,18,26,9,9,allow
39966,53,39966,53,235,90,145,2,32,1,1,allow
61817,80,50485,80,3373,591,2782,11,45,6,5,allow
55692,18319,26451,18319,320,140,180,6,7,3,3,allow
57125,53,40271,53,745,93,652,2,30,1,1,allow
27005,27017,4986,27017,881,126,755,2,30,1,1,allow
27005,27015,43445,27015,882,126,756,2,30,1,1,allow
27721,53,27721,53,404,259,145,3,32,2,1,allow
58849,443,61655,443,36920,24591,12329,80,24,47,33,allow
58993,443,47340,443,6414,1614,4800,24,17,13,11,allow
52190,80,11921,80,3223,843,2380,12,30,7,5,allow
49511,443,49511,443,150713,27113,123600,199,82,104,95,allow
53246,443,31450,443,6066,1046,5020,20,69,11,9,allow
53247,443,42679,443,7461,1789,5672,25,69,14,11,allow
54828,443,24747,443,6296,1556,4740,22,16,12,10,allow
46423,443,25968,443,1340,760,580,14,39,8,6,allow
45627,443,27902,443,6410,1610,4800,24,17,13,11,allow
52034,48856,38527,48856,66,66,0,1,5,1,0,allow
61818,80,36349,80,4454,591,3863,12,45,6,6,allow
49377,443,6065,443,6350,1550,4800,23,19,12,11,allow
32782,80,6482,80,1495,779,716,10,30,6,4,allow
54306,443,48186,443,6376,1576,4800,24,19,13,11,allow
53241,443,12408,443,6058,1038,5020,20,69,11,9,allow
56708,443,9469,443,6155,919,5236,18,55,10,8,allow
53240,443,55808,443,14932,1671,13261,31,69,15,16,allow
46424,443,29456,443,1340,760,580,14,39,8,6,allow
58899,443,33038,443,3690,2585,1105,17,16,9,8,allow
27345,53,27345,53,398,255,143,3,33,2,1,allow
41858,443,41858,443,4350,1443,2907,19,26,11,8,allow
53155,28206,56023,28206,70,70,0,1,5,1,0,allow
46780,443,9186,443,9801,3049,6752,29,20,15,14,allow
61816,80,7127,80,2058,589,1469,10,45,6,4,allow
61815,80,10742,80,4268,653,3615,13,45,7,6,allow
49320,443,28886,443,2371,1839,532,14,45,8,6,allow
49846,443,49846,443,4693,1786,2907,19,27,11,8,allow
56938,53,41054,53,198,101,97,2,30,1,1,allow
51539,443,4046,443,6359,1559,4800,24,19,13,11,allow
49636,443,58848,443,9790,1841,7949,24,136,12,12,allow
64798,53,2925,53,172,88,84,2,30,1,1,allow
51594,53,0,0,206,95,111,2,31,1,1,allow
54306,443,20116,443,13053,5216,7837,25,135,11,14,allow
60985,443,19268,443,20423,4091,16332,33,122,15,18,allow
37736,443,59185,443,16925,11562,5363,36,363,19,17,allow
44361,443,44674,443,424,210,214,7,132,4,3,allow
50792,443,51398,443,144115,19017,125098,229,400,112,117,allow
6881,6889,31599,6889,221,111,110,2,1200,1,1,allow
21133,8535,17822,8535,490,149,341,2,1200,1,1,allow
50633,445,0,0,70,70,0,1,0,1,0,drop
50625,445,0,0,70,70,0,1,0,1,0,drop
50251,35440,0,0,66,66,0,1,0,1,0,deny
27677,22114,0,0,62,62,0,1,0,1,0,deny
7210,22114,0,0,66,66,0,1,0,1,0,deny
62397,445,0,0,66,66,0,1,0,1,0,drop
58303,22114,0,0,62,62,0,1,0,1,0,deny
60786,25174,0,0,66,66,0,1,0,1,0,deny
60806,51050,0,0,62,62,0,1,0,1,0,deny
56067,25174,0,0,146,146,0,1,0,1,0,deny
34932,38608,0,0,62,62,0,1,0,1,0,deny
25600,23684,0,0,159,159,0,1,0,1,0,deny
59147,25174,0,0,62,62,0,1,0,1,0,deny
54438,62413,0,0,66,66,0,1,0,1,0,deny
46492,50584,0,0,62,62,0,1,0,1,0,deny
62191,445,0,0,70,70,0,1,0,1,0,drop
62390,445,0,0,66,66,0,1,0,1,0,drop
50615,445,0,0,70,70,0,1,0,1,0,drop
59324,17,0,0,60,60,0,1,0,1,0,deny
1537,22114,0,0,146,146,0,1,0,1,0,deny
62388,445,0,0,66,66,0,1,0,1,0,drop
47727,25174,0,0,62,62,0,1,0,1,0,deny
62187,445,0,0,70,70,0,1,0,1,0,drop
46162,25174,0,0,146,146,0,1,0,1,0,deny
54021,25174,0,0,146,146,0,1,0,1,0,deny
62381,445,0,0,66,66,0,1,0,1,0,drop
41541,25174,0,0,66,66,0,1,0,1,0,deny
22530,25174,0,0,62,62,0,1,0,1,0,deny
19944,22114,0,0,66,66,0,1,0,1,0,deny
62373,445,0,0,66,66,0,1,0,1,0,drop
62175,445,0,0,70,70,0,1,0,1,0,drop
62177,445,0,0,70,70,0,1,0,1,0,drop
62178,445,0,0,70,70,0,1,0,1,0,drop
6461,25174,0,0,66,66,0,1,0,1,0,deny
62173,445,0,0,70,70,0,1,0,1,0,drop
34674,41864,0,0,145,145,0,1,0,1,0,deny
56720,443,60130,443,4989,1014,3975,16,53,9,7,allow
58901,443,21819,443,5168,700,4468,16,15,7,9,allow
63969,57635,11400,57635,504,382,122,8,17,6,2,allow
27005,27015,53679,27015,894,126,768,2,30,1,1,allow
64137,53,46613,53,276,126,150,2,30,1,1,allow
54492,80,36549,80,1384,937,447,9,360,5,4,allow
53245,443,58724,443,4595,1038,3557,19,69,11,8,allow
51535,443,24359,443,322,262,60,2,4,1,1,allow
53825,58968,36842,58968,70,70,0,1,4,1,0,allow
55159,53,49513,53,199,102,97,2,29,1,1,allow
40204,40010,8959,40010,148,86,62,2,29,1,1,allow
56927,53,35589,53,183,94,89,2,30,1,1,allow
56936,53,1448,53,244,94,150,2,30,1,1,allow
53248,443,8243,443,5995,974,5021,19,66,10,9,allow
53256,443,33969,443,6181,1040,5141,22,65,11,11,allow
53239,443,57625,443,84664,6099,78565,140,70,56,84,allow
53254,443,6395,443,310549,9420,301129,339,65,122,217,allow
53251,443,19794,443,5025,973,4052,19,66,10,9,allow
53257,443,20854,443,7422,1563,5859,32,53,15,17,allow
47950,443,47950,443,9159,1627,7532,19,150,11,8,allow
53255,443,13217,443,6244,1104,5140,23,65,12,11,allow
63062,443,18661,443,26697,7168,19529,74,213,39,35,allow
45386,5222,47309,5222,4579,2357,2222,46,114,26,20,allow
36405,443,39201,443,1149,709,440,13,38,8,5,allow
41832,5222,27749,5222,3823,1878,1945,39,309,22,17,allow
34429,443,39079,443,1701,1048,653,15,38,8,7,allow
48936,443,24863,443,494,280,214,8,49,5,3,allow
45721,443,58682,443,1925,1120,805,16,25,9,7,allow
51671,443,38152,443,1143,703,440,13,38,8,5,allow
42804,80,7713,80,1115,534,581,12,15,7,5,allow
40102,443,45271,443,29714,2090,27624,43,97,17,26,allow
56664,80,50394,80,234,234,0,4,11,4,0,allow
33827,443,18177,443,696,152,544,11,48,3,8,allow
53827,5889,39241,5889,70,70,0,1,4,1,0,allow
60627,443,41376,443,5663,1711,3952,22,17,13,9,allow
56433,53,33860,53,210,110,100,2,29,1,1,allow
64034,53,38664,53,194,102,92,2,29,1,1,allow
65487,53,2041,53,210,110,100,2,29,1,1,allow
64238,53,7198,53,211,102,109,2,29,1,1,allow
55159,53,25315,53,199,102,97,2,29,1,1,allow
56327,53,21642,53,178,94,84,2,29,1,1,allow
56240,53,1263,53,226,94,132,2,29,1,1,allow
55387,53,44046,53,172,94,78,2,29,1,1,allow
65487,53,41710,53,210,110,100,2,29,1,1,allow
56534,53,33541,53,276,94,182,2,30,1,1,allow
56938,53,31467,53,452,101,351,4,36,2,2,allow
54772,443,51519,443,3388,894,2494,19,154,8,11,allow
49834,443,52390,443,8332,3418,4914,31,95,17,14,allow
27005,27016,5470,27016,879,126,753,2,30,1,1,allow
50647,443,3164,443,3201,1812,1389,15,19,9,6,allow
12573,53,12573,53,235,90,145,2,32,1,1,allow
37998,49152,32246,49152,156,156,0,3,8,3,0,allow
37567,443,51638,443,13774,4989,8785,35,51,20,15,allow
39133,5223,14877,5223,4113,1213,2900,22,713,12,10,allow
59911,80,3482,80,2025658,45348,1980310,1992,44,640,1352,allow
48844,443,50866,443,36383,29447,6936,103,163,51,52,allow
53812,45694,7999,45694,3156,1011,2145,16,16,8,8,allow
57442,66,49848,66,70,70,0,2,8,2,0,allow
49620,443,22598,443,4565,3479,1086,13,138,8,5,allow
50642,80,53491,80,27013,3578,23435,36,21,15,21,allow
27005,27015,27381,27015,887,126,761,2,30,1,1,allow
50351,80,28696,80,1083,653,430,8,15,5,3,allow
64331,53,13624,53,226,110,116,2,30,1,1,allow
64874,53,59017,53,323,110,213,2,30,1,1,allow
49541,53,16544,53,745,215,530,6,51,3,3,allow
37575,443,11902,443,11095,3227,7868,30,47,17,13,allow
49969,53,31598,53,199,102,97,2,30,1,1,allow
36843,443,62939,443,1988,1348,640,16,30,9,7,allow
59928,80,12349,80,5755,3943,1812,24,31,13,11,allow
64404,53,27516,53,250,102,148,2,30,1,1,allow
55543,53,20770,53,402,118,284,2,30,1,1,allow
56327,53,13541,53,178,94,84,2,30,1,1,allow
27005,27018,44540,27018,882,126,756,2,30,1,1,allow
59595,53,23581,53,164,78,86,2,30,1,1,allow
54461,443,55522,443,7548,2583,4965,26,362,12,14,allow
62336,443,4923,443,8217,2075,6142,31,76,15,16,allow
65344,53,52002,53,190,90,100,3,60,2,1,allow
55875,53,25979,53,296,110,186,2,30,1,1,allow
27005,27015,38295,27015,874,126,748,2,30,1,1,allow
60399,443,57774,443,8061,1926,6135,24,361,11,13,allow
59948,80,1436,80,1756,414,1342,12,15,6,6,allow
56725,443,7873,443,6481,972,5509,17,52,10,7,allow
55374,25,55374,25,130,66,64,2,5,1,1,allow
50653,80,52730,80,1658,1247,411,8,15,5,3,allow
34953,443,6409,443,9415,3482,5933,57,16,29,28,allow
53460,443,30062,443,30688,2660,28028,51,31,23,28,allow
65487,53,56832,53,210,110,100,2,30,1,1,allow
64798,53,7114,53,178,94,84,2,30,1,1,allow
64078,443,31734,443,4458,1569,2889,24,138,10,14,allow
53136,443,65509,443,3028365,2245986,782379,11999,627,7647,4352,allow
53260,443,48140,443,4885,983,3902,21,53,10,11,allow
51670,443,38480,443,1203,703,500,14,38,8,6,allow
33147,443,60062,443,7639,948,6691,25,395,9,16,allow
36406,443,50079,443,1149,709,440,13,38,8,5,allow
54354,443,10906,443,18848,10436,8412,42,33,20,22,allow
60575,443,23365,443,5994,1594,4400,23,42,12,11,allow
36407,443,52772,443,1149,709,440,13,38,8,5,allow
53244,443,63773,443,57649,2489,55160,66,69,23,43,allow
5588,5588,0,0,3354,1792,1562,46,194,23,23,allow
34430,443,8333,443,1701,1048,653,15,38,8,7,allow
10013,443,27326,443,10336,4760,5576,37,315,18,19,allow
43726,443,52371,443,1201,707,494,12,35,7,5,allow
53828,51354,58095,51354,70,70,0,1,4,1,0,allow
54017,443,16478,443,33220,3819,29401,77,255,39,38,allow
53824,41482,6861,41482,70,70,0,1,4,1,0,allow
49624,443,29597,443,2899,1813,1086,12,136,7,5,allow
63140,30685,24929,30685,70,70,0,1,5,1,0,allow
53158,17234,26675,17234,70,70,0,2,8,2,0,allow
63999,53,50492,53,193,102,91,2,29,1,1,allow
50990,53,51984,53,232,94,138,2,29,1,1,allow
56938,53,8399,53,199,102,97,2,29,1,1,allow
62339,443,17791,443,9125,2616,6509,30,76,14,16,allow
50717,80,28545,80,1649,963,686,7,15,5,2,allow
59926,80,37542,80,2615,830,1785,10,32,6,4,allow
53458,443,17930,443,144165,6110,138055,170,31,67,103,allow
50949,80,11302,80,942,527,415,11,342,6,5,allow
49498,443,65049,443,5394,2785,2609,14,134,7,7,allow
39639,80,40156,80,1143,401,742,9,360,5,4,allow
60329,443,10695,443,2859,1499,1360,20,315,10,10,allow
51472,80,52276,80,1410,797,613,10,302,6,4,allow
55532,80,33980,80,12971,971,12000,22,15,12,10,allow
62322,80,60035,80,384,384,0,7,34,7,0,allow
56256,80,30485,80,25043,1750,23293,44,30,23,21,allow
64290,53,4027,53,302,98,204,4,47,2,2,allow
56927,53,57127,53,183,94,89,2,30,1,1,allow
64798,53,14494,53,178,94,84,2,30,1,1,allow
56732,443,47503,443,6205,986,5219,16,48,10,6,allow
64584,443,62186,443,24682,1935,22747,36,19,17,19,allow
64034,53,27312,53,194,102,92,2,30,1,1,allow
49969,53,27742,53,199,102,97,2,30,1,1,allow
33148,443,29475,443,7639,948,6691,25,395,9,16,allow
6881,6881,37501,6881,259,150,109,2,1200,1,1,allow
61542,443,4330,443,6049,1986,4063,23,19,12,11,allow
37997,49152,15013,49152,156,156,0,3,8,3,0,allow
49700,443,48800,443,64,64,0,2,5,2,0,allow
59931,80,27664,80,1272,786,486,8,31,5,3,allow
53811,8999,57709,8999,1322,799,523,13,16,8,5,allow
60868,80,60868,80,5973,779,5194,17,16,9,8,allow
50950,80,33535,80,942,527,415,11,342,6,5,allow
64290,53,4374,53,196,102,94,2,30,1,1,allow
65065,53,58024,53,209,110,99,2,30,1,1,allow
63241,443,59120,443,5248,2550,2698,21,178,10,11,allow
36821,443,62805,443,6164,3172,2992,28,141,12,16,allow
36674,443,40100,443,11882,3450,8432,39,120,19,20,allow
57470,6969,5895,6969,132,132,0,3,1199,3,0,allow
46031,443,52828,443,12395,2182,10213,21,122,10,11,allow
61546,443,4493,443,208,60,148,4,13,2,2,allow
53225,443,9099,443,6597,1798,4799,28,80,12,16,allow
50348,80,25254,80,4929,2773,2156,17,42,9,8,allow
53841,8999,55229,8999,70,70,0,2,8,2,0,allow
52867,443,11328,443,15730,2196,13534,32,436,17,15,allow
62311,443,64602,443,598,598,0,8,41,8,0,allow
52056,50328,8366,50328,70,70,0,1,5,1,0,allow
50344,80,51584,80,3132,730,2402,13,42,7,6,allow
50216,443,23002,443,6796,1796,5000,26,257,14,12,allow
49690,53,46468,53,198,94,104,2,30,1,1,allow
1030,64147,0,0,62,62,0,1,0,1,0,deny
62170,445,0,0,70,70,0,1,0,1,0,drop
60104,30188,0,0,66,66,0,1,0,1,0,deny
51560,46783,0,0,66,66,0,1,0,1,0,deny
26658,25174,0,0,62,62,0,1,0,1,0,deny
42231,57470,0,0,78,78,0,1,0,1,0,deny
59696,57470,0,0,62,62,0,1,0,1,0,deny
50606,445,0,0,70,70,0,1,0,1,0,drop
50605,445,0,0,70,70,0,1,0,1,0,drop
50603,445,0,0,70,70,0,1,0,1,0,drop
47256,37807,0,0,62,62,0,1,0,1,0,deny
62365,445,0,0,66,66,0,1,0,1,0,drop
62363,445,0,0,66,66,0,1,0,1,0,drop
62361,445,0,0,66,66,0,1,0,1,0,drop
62362,445,0,0,66,66,0,1,0,1,0,drop
62360,445,0,0,66,66,0,1,0,1,0,drop
62364,445,0,0,66,66,0,1,0,1,0,drop
62359,445,0,0,66,66,0,1,0,1,0,drop
62358,445,0,0,66,66,0,1,0,1,0,drop
62164,445,0,0,70,70,0,1,0,1,0,drop
41490,25174,0,0,62,62,0,1,0,1,0,deny
51705,22114,0,0,62,62,0,1,0,1,0,deny
60403,22114,0,0,66,66,0,1,0,1,0,deny
36641,25174,0,0,66,66,0,1,0,1,0,deny
64214,25174,0,0,66,66,0,1,0,1,0,deny
23763,23,0,0,60,60,0,1,0,1,0,deny
62157,445,0,0,70,70,0,1,0,1,0,drop
53197,25174,0,0,66,66,0,1,0,1,0,deny
62156,445,0,0,70,70,0,1,0,1,0,drop
54769,50584,0,0,62,62,0,1,0,1,0,deny
52925,64147,0,0,62,62,0,1,0,1,0,deny
52340,64147,0,0,66,66,0,1,0,1,0,deny
50596,445,0,0,70,70,0,1,0,1,0,drop
50597,445,0,0,70,70,0,1,0,1,0,drop
50589,445,0,0,70,70,0,1,0,1,0,drop
50584,445,0,0,70,70,0,1,0,1,0,drop
53470,22114,0,0,66,66,0,1,0,1,0,deny
16454,25174,0,0,66,66,0,1,0,1,0,deny
62345,445,0,0,66,66,0,1,0,1,0,drop
62344,445,0,0,66,66,0,1,0,1,0,drop
62342,445,0,0,66,66,0,1,0,1,0,deny
22924,25174,0,0,62,62,0,1,0,1,0,deny
62150,445,0,0,70,70,0,1,0,1,0,drop
50822,50584,0,0,66,66,0,1,0,1,0,deny
62149,445,0,0,70,70,0,1,0,1,0,drop
62813,25174,0,0,62,62,0,1,0,1,0,deny
50046,22114,0,0,66,66,0,1,0,1,0,deny
58914,37965,0,0,66,66,0,1,0,1,0,deny
50582,445,0,0,70,70,0,1,0,1,0,drop
63878,22114,0,0,62,62,0,1,0,1,0,deny
26717,25174,0,0,62,62,0,1,0,1,0,deny
50574,445,0,0,70,70,0,1,0,1,0,drop
50573,445,0,0,70,70,0,1,0,1,0,drop
50572,445,0,0,70,70,0,1,0,1,0,drop
52459,3399,0,0,60,60,0,1,0,1,0,deny
62145,445,0,0,70,70,0,1,0,1,0,drop
32736,22114,0,0,66,66,0,1,0,1,0,deny
58511,50584,0,0,62,62,0,1,0,1,0,deny
62144,445,0,0,70,70,0,1,0,1,0,drop
2849,30188,0,0,66,66,0,1,0,1,0,deny
32997,50584,0,0,62,62,0,1,0,1,0,deny
27000,23117,0,0,62,62,0,1,0,1,0,deny
25878,25174,0,0,66,66,0,1,0,1,0,deny
20962,22114,0,0,62,62,0,1,0,1,0,deny
54518,25174,0,0,146,146,0,1,0,1,0,deny
62139,445,0,0,70,70,0,1,0,1,0,drop
443,18177,0,0,66,66,0,1,0,1,0,deny
50563,445,0,0,70,70,0,1,0,1,0,drop
50561,445,0,0,70,70,0,1,0,1,0,drop
50559,445,0,0,70,70,0,1,0,1,0,drop
60260,22114,0,0,66,66,0,1,0,1,0,deny
62331,445,0,0,66,66,0,1,0,1,0,drop
6882,51505,0,0,66,66,0,1,0,1,0,deny
55711,26467,0,0,66,66,0,1,0,1,0,deny
51746,25174,0,0,66,66,0,1,0,1,0,deny
58131,29072,0,0,146,146,0,1,0,1,0,deny
43828,44847,0,0,66,66,0,1,0,1,0,deny
50459,62413,0,0,66,66,0,1,0,1,0,deny
50557,445,0,0,70,70,0,1,0,1,0,drop
50556,445,0,0,70,70,0,1,0,1,0,drop
62126,445,0,0,70,70,0,1,0,1,0,drop
28286,22114,0,0,62,62,0,1,0,1,0,deny
14397,37965,0,0,62,62,0,1,0,1,0,deny
13285,29892,0,0,145,145,0,1,0,1,0,deny
41197,30188,0,0,62,62,0,1,0,1,0,deny
443,64347,0,0,131,131,0,1,0,1,0,deny
3399,25174,0,0,66,66,0,1,0,1,0,deny
15605,50265,0,0,62,62,0,1,0,1,0,deny
62316,445,0,0,66,66,0,1,0,1,0,drop
62315,445,0,0,66,66,0,1,0,1,0,drop
62123,445,0,0,70,70,0,1,0,1,0,drop
56127,37965,0,0,66,66,0,1,0,1,0,deny
52038,50584,0,0,66,66,0,1,0,1,0,deny
40312,55442,0,0,62,62,0,1,0,1,0,deny
58627,25174,0,0,62,62,0,1,0,1,0,deny
64190,2767,0,0,66,66,0,1,0,1,0,deny
12700,57470,0,0,145,145,0,1,0,1,0,deny
23131,25174,0,0,62,62,0,1,0,1,0,deny
50547,445,0,0,70,70,0,1,0,1,0,drop
50544,445,0,0,70,70,0,1,0,1,0,drop
50543,445,0,0,70,70,0,1,0,1,0,drop
50535,445,0,0,70,70,0,1,0,1,0,drop
23131,25174,0,0,146,146,0,1,0,1,0,deny
57284,22114,0,0,66,66,0,1,0,1,0,deny
21119,31573,0,0,146,146,0,1,0,1,0,deny
60823,25174,0,0,66,66,0,1,0,1,0,deny
1943,48817,0,0,66,66,0,1,0,1,0,deny
62309,445,0,0,66,66,0,1,0,1,0,drop
62117,445,0,0,70,70,0,1,0,1,0,drop
35450,23,0,0,60,60,0,1,0,1,0,deny
62064,22114,0,0,66,66,0,1,0,1,0,deny
64392,25174,0,0,66,66,0,1,0,1,0,deny
29139,64147,0,0,62,62,0,1,0,1,0,deny
62115,445,0,0,70,70,0,1,0,1,0,drop
61523,37807,0,0,66,66,0,1,0,1,0,deny
62306,445,0,0,66,66,0,1,0,1,0,drop
62304,445,0,0,66,66,0,1,0,1,0,drop
62303,445,0,0,66,66,0,1,0,1,0,drop
62298,445,0,0,66,66,0,1,0,1,0,drop
62295,445,0,0,66,66,0,1,0,1,0,drop
62297,445,0,0,66,66,0,1,0,1,0,drop
62296,445,0,0,66,66,0,1,0,1,0,drop
28306,25604,0,0,62,62,0,1,0,1,0,deny
60097,22114,0,0,66,66,0,1,0,1,0,deny
45313,64147,0,0,62,62,0,1,0,1,0,deny
42986,25174,0,0,66,66,0,1,0,1,0,deny
50530,445,0,0,70,70,0,1,0,1,0,drop
50527,445,0,0,70,70,0,1,0,1,0,drop
50525,445,0,0,70,70,0,1,0,1,0,drop
50523,445,0,0,70,70,0,1,0,1,0,drop
45118,39004,0,0,74,74,0,1,0,1,0,deny
36663,22114,0,0,62,62,0,1,0,1,0,deny
48706,23393,0,0,60,60,0,1,0,1,0,deny
57090,51505,0,0,62,62,0,1,0,1,0,deny
59051,27520,0,0,62,62,0,1,0,1,0,deny
19875,30170,0,0,145,145,0,1,0,1,0,deny
62273,50584,0,0,62,62,0,1,0,1,0,deny
50757,64147,0,0,62,62,0,1,0,1,0,deny
34073,37965,0,0,62,62,0,1,0,1,0,deny
36804,25174,0,0,66,66,0,1,0,1,0,deny
62108,445,0,0,70,70,0,1,0,1,0,drop
56289,25174,0,0,66,66,0,1,0,1,0,deny
62106,445,0,0,70,70,0,1,0,1,0,drop
17573,44847,0,0,146,146,0,1,0,1,0,deny
59938,443,27868,443,1820,1303,517,13,26,7,6,allow
47664,3389,47664,3389,4575,2400,2175,20,19,11,9,allow
45551,443,26442,443,7764,1734,6030,23,20,13,10,allow
55039,443,45987,443,7993,677,7316,16,16,8,8,allow
62919,993,20862,993,134,60,74,3,11,2,1,allow
49306,443,46343,443,83411,4586,78825,94,47,30,64,allow
56425,53,0,0,82,82,0,1,30,1,0,allow
58992,53,0,0,273,86,187,2,30,1,1,allow
58129,80,58129,80,23462,3780,19682,49,47,24,25,allow
49308,443,39770,443,4256,2975,1281,23,47,12,11,allow
49309,443,31644,443,4250,2969,1281,23,47,12,11,allow
54815,3389,54815,3389,3428,1714,1714,16,32,8,8,allow
59945,80,11723,80,1197,419,778,9,16,5,4,allow
49633,443,51430,443,4348,911,3437,14,135,8,6,allow
27005,27019,44528,27019,880,126,754,2,30,1,1,allow
65379,53,64746,53,376,126,250,2,30,1,1,allow
55437,443,56917,443,24415,1491,22924,34,131,14,20,allow
55085,443,57915,443,5803,4960,843,19,124,11,8,allow
44739,443,37697,443,6220,1790,4430,19,120,10,9,allow
57470,41071,64833,41071,1716,1716,0,27,1598,27,0,allow
58643,443,8549,443,4801,2506,2295,12,121,6,6,allow
36889,80,51153,80,1584,1130,454,15,39,10,5,allow
58891,443,55777,443,7641,5165,2476,25,18,13,12,allow
13095,80,13095,80,32613,1160,31453,38,16,13,25,allow
52045,16853,65490,16853,70,70,0,2,8,2,0,allow
44358,443,57886,443,502,288,214,8,131,5,3,allow
53816,42459,30480,42459,552,306,246,9,16,5,4,allow
64728,443,31234,443,25423484,377367,25046117,21027,1082,2865,18162,allow
46862,15000,28105,15000,130,70,60,2,5,1,1,allow
58970,443,57205,443,3715,1958,1757,23,21,12,11,allow
50583,80,50583,80,17375,11554,5821,52,27,32,20,allow
51594,53,0,0,206,95,111,2,30,1,1,allow
50340,80,53882,80,8924,872,8052,19,41,9,10,allow
61281,443,15563,443,3169,979,2190,14,135,7,7,allow
50341,80,19405,80,306,180,126,6,41,4,2,allow
43177,443,43177,443,4493,1586,2907,19,26,11,8,allow
52031,20301,50759,20301,66,66,0,1,5,1,0,allow
49647,53,49647,53,404,259,145,3,32,2,1,allow
57602,443,32129,443,7527,1788,5739,23,20,13,10,allow
35466,443,44428,443,7409,1702,5707,23,20,13,10,allow
58889,443,6054,443,7871,5455,2416,24,18,13,11,allow
27005,27016,63308,27016,887,126,761,2,30,1,1,allow
50116,22,0,0,60,60,0,1,90,1,0,allow
40410,443,37656,443,2975,719,2256,14,136,7,7,allow
30960,45754,34064,45754,396,396,0,7,3615,7,0,allow
50521,445,0,0,70,70,0,1,0,1,0,drop
50517,445,0,0,70,70,0,1,0,1,0,drop
50516,445,0,0,70,70,0,1,0,1,0,drop
6889,65473,0,0,143,143,0,1,0,1,0,deny
62105,445,0,0,70,70,0,1,0,1,0,drop
62288,445,0,0,66,66,0,1,0,1,0,drop
55554,22114,0,0,62,62,0,1,0,1,0,deny
50514,445,0,0,70,70,0,1,0,1,0,drop
62104,445,0,0,70,70,0,1,0,1,0,drop
62103,445,0,0,70,70,0,1,0,1,0,drop
62101,445,0,0,70,70,0,1,0,1,0,drop
62099,445,0,0,70,70,0,1,0,1,0,drop
62286,445,0,0,66,66,0,1,0,1,0,drop
62283,445,0,0,66,66,0,1,0,1,0,drop
62282,445,0,0,66,66,0,1,0,1,0,drop
62281,445,0,0,66,66,0,1,0,1,0,drop
47944,50584,0,0,62,62,0,1,0,1,0,deny
61299,25174,0,0,146,146,0,1,0,1,0,deny
57338,443,31270,443,222159,52803,169356,361,26,173,188,allow
61550,5529,0,0,145,145,0,1,0,1,0,deny
49164,25174,0,0,62,62,0,1,0,1,0,deny
42285,57470,0,0,62,62,0,1,0,1,0,deny
62085,445,0,0,70,70,0,1,0,1,0,drop
62084,445,0,0,70,70,0,1,0,1,0,drop
62082,445,0,0,70,70,0,1,0,1,0,drop
26425,22114,0,0,62,62,0,1,0,1,0,deny
62075,445,0,0,70,70,0,1,0,1,0,drop
62074,445,0,0,70,70,0,1,0,1,0,drop
44383,30188,0,0,66,66,0,1,0,1,0,deny
49577,57470,0,0,66,66,0,1,0,1,0,deny
50511,445,0,0,70,70,0,1,0,1,0,drop
61140,27520,0,0,62,62,0,1,0,1,0,deny
24144,57470,0,0,62,62,0,1,0,1,0,deny
50500,445,0,0,70,70,0,1,0,1,0,drop
50497,445,0,0,70,70,0,1,0,1,0,drop
52230,50265,0,0,66,66,0,1,0,1,0,deny
62269,445,0,0,66,66,0,1,0,1,0,drop
27005,27015,25452,27015,887,126,761,2,30,1,1,allow
34937,443,49817,443,10059,2039,8020,23,186,12,11,allow
50265,43178,20188,43178,481,150,331,2,1200,1,1,allow
63974,80,35530,80,314,192,122,6,15,4,2,allow
50587,80,50587,80,1711,1011,700,11,21,6,5,allow
62158,443,35160,443,4975,2828,2147,14,135,7,7,allow
52052,27427,24815,27427,316,136,180,6,6,3,3,allow
8917,443,55362,443,7308,864,6444,26,394,9,17,allow
60461,10138,64431,10138,70,70,0,1,5,1,0,allow
53365,80,32049,80,405,285,120,5,15,3,2,allow
50346,80,22819,80,502,250,252,9,41,5,4,allow
52047,42805,9664,42805,164,70,94,3,7,2,1,allow
64798,53,32594,53,303,88,215,4,40,2,2,allow
56927,53,28530,53,183,94,89,2,29,1,1,allow
49578,53,60840,53,212,102,110,2,29,1,1,allow
57103,53,61295,53,193,102,91,2,29,1,1,allow
27005,27018,14110,27018,881,126,755,2,30,1,1,allow
49508,53,61449,53,370,102,268,2,30,1,1,allow
58856,80,5930,80,1614,1300,314,10,15,5,5,allow
60026,443,10175,443,8382,2454,5928,44,86,26,18,allow
60967,443,57765,443,11529,8753,2776,41,120,22,19,allow
57089,53,62761,53,226,110,116,2,30,1,1,allow
46831,53,55820,53,391,102,289,2,30,1,1,allow
27005,27017,41161,27017,883,126,757,2,30,1,1,allow
38698,443,50432,443,90261,3545,86716,96,16,32,64,allow
60466,64337,52523,64337,70,70,0,2,8,2,0,allow
36000,443,6421,443,68705,5084,63621,93,172,36,57,allow
57341,443,25399,443,7551,2807,4744,42,26,22,20,allow
36003,443,8954,443,70007,4677,65330,92,172,36,56,allow
48742,443,35072,443,5378,1423,3955,19,49,11,8,allow
53222,53,43522,53,165,78,87,2,30,1,1,allow
53223,53,33950,53,165,78,87,2,30,1,1,allow
27005,27015,43819,27015,868,126,742,2,30,1,1,allow
53455,443,54035,443,240325,8131,232194,262,31,100,162,allow
53457,443,28376,443,26693,2059,24634,42,30,18,24,allow
64698,53,59784,53,430,106,324,4,58,2,2,allow
49444,53,22362,53,212,102,110,2,30,1,1,allow
55739,443,5145,443,47102,3841,43261,59,121,25,34,allow
43112,443,57880,443,7192,1772,5420,25,305,13,12,allow
63139,12311,39911,12311,70,70,0,1,5,1,0,allow
52089,443,56891,443,4408,801,3607,16,34,8,8,allow
57339,443,47908,443,1495,768,727,16,26,9,7,allow
57345,443,32367,443,55537,4477,51060,81,22,38,43,allow
52884,443,37471,443,4466,1914,2552,32,116,18,14,allow
27005,27017,10039,27017,891,126,765,2,30,1,1,allow
54324,27016,3441,27016,924,924,0,3,30,3,0,allow
49429,443,33645,443,8861,3484,5377,19,120,9,10,allow
37572,443,26829,443,30365,21942,8423,58,50,32,26,allow
50343,80,37536,80,1192,658,534,11,41,6,5,allow
50339,80,14820,80,306,180,126,6,41,4,2,allow
53140,80,7687,80,2560,2083,477,13,15,7,6,allow
49220,2710,39360,2710,70,70,0,2,8,2,0,allow
58898,443,10940,443,5108,700,4408,15,15,7,8,allow
52046,59791,37077,59791,70,70,0,2,7,2,0,allow
62061,445,0,0,70,70,0,1,0,1,0,drop
36548,25174,0,0,62,62,0,1,0,1,0,deny
63895,44847,0,0,62,62,0,1,0,1,0,deny
38093,11392,0,0,62,62,0,1,0,1,0,deny
60419,61248,0,0,145,145,0,1,0,1,0,reset-both
55338,11744,0,0,145,145,0,1,0,1,0,deny
51023,443,24793,443,26189,8238,17951,72,18,39,33,allow
50338,80,24125,80,2475,723,1752,12,41,6,6,allow
58718,80,58718,80,106571,3881,102690,128,16,56,72,allow
43169,443,5370,443,8615,2156,6459,37,315,16,21,allow
6259,25,6259,25,130,66,64,2,5,1,1,allow
37710,443,47259,443,13986,9199,4787,59,94,24,35,allow
50759,443,24454,443,19782,3596,16186,38,256,21,17,allow
53456,443,13197,443,25555,2220,23335,44,30,20,24,allow
49219,51237,3510,51237,624,318,306,10,15,5,5,allow
65384,443,21164,443,8613,1465,7148,22,15,13,9,allow
57346,443,34868,443,1547,960,587,14,22,8,6,allow
57599,80,28045,80,808,485,323,8,75,5,3,allow
56512,443,45161,443,155750,151462,4288,169,215,112,57,allow
49470,443,50216,443,2772,1777,995,16,124,9,7,allow
57103,53,56809,53,193,102,91,2,30,1,1,allow
43089,443,26098,443,9737,6695,3042,45,81,24,21,allow
50586,80,50586,80,5320,3428,1892,22,21,12,10,allow
27005,27015,24724,27015,878,126,752,2,30,1,1,allow
50588,80,50588,80,2765,1835,930,14,21,8,6,allow
53537,53,1672,53,391,102,289,2,29,1,1,allow
56903,53,50850,53,232,94,138,2,30,1,1,allow
49515,53,21422,53,226,110,116,2,29,1,1,allow
54325,27016,47516,27016,924,924,0,3,30,3,0,allow
54323,27016,29153,27016,924,924,0,3,30,3,0,allow
54326,27054,42842,27054,924,924,0,3,30,3,0,allow
58614,443,16756,443,12164,4840,7324,29,198,16,13,allow
17750,60780,57502,60780,481,150,331,2,1200,1,1,allow
49626,443,3697,443,35474,2800,32674,56,135,27,29,allow
50589,80,50589,80,1714,1014,700,11,21,6,5,allow
48735,443,54377,443,77050,5353,71697,113,95,46,67,allow
27005,27015,60875,27015,881,126,755,2,30,1,1,allow
55901,53,32764,53,226,110,116,2,30,1,1,allow
63310,443,15095,443,1481,701,780,20,120,10,10,allow
57288,443,16066,443,7427,2084,5343,24,361,12,12,allow
1100,27540,45452,27540,132,70,62,2,31,1,1,allow
53202,443,56977,443,23323,1589,21734,27,85,10,17,allow
40492,1488,40492,1488,156,156,0,3,8,3,0,allow
39771,443,64614,443,6903,1273,5630,25,255,13,12,allow
7634,80,7634,80,1845,523,1322,10,15,6,4,allow
35989,443,62539,443,2840032,64781,2775251,2709,292,769,1940,allow
33894,80,31956,80,1376,788,588,10,35,6,4,allow
37680,443,40317,443,16742,3383,13359,57,309,28,29,allow
57344,53,44764,53,228,110,118,2,30,1,1,allow
27005,27015,45199,27015,892,126,766,2,30,1,1,allow
57398,53,47898,53,232,110,122,2,30,1,1,allow
57344,443,31123,443,30232,22633,7599,77,23,46,31,allow
60457,16881,27690,16881,1948,891,1057,16,18,8,8,allow
53151,34935,46356,34935,698,320,378,10,17,6,4,allow
49598,80,65095,80,400,70,330,6,24,1,5,allow
38699,443,63342,443,759586,14873,744713,719,16,209,510,allow
52094,443,12498,443,2960,1982,978,15,16,9,6,allow
62481,80,55007,80,890,440,450,10,33,6,4,allow
42732,53,10027,53,86,86,0,1,30,1,0,allow
62187,443,25960,443,36473,7710,28763,63,124,27,36,allow
6881,6881,34169,6881,502,150,352,2,1200,1,1,allow
27005,27035,11763,27035,891,126,765,2,31,1,1,allow
52029,52093,64487,52093,70,70,0,1,5,1,0,allow
53819,9472,3134,9472,70,70,0,1,5,1,0,allow
57427,443,63478,443,5337,1085,4252,14,76,8,6,allow
65048,53,24505,53,396,84,312,4,54,2,2,allow
63965,53,50907,53,306,94,212,2,30,1,1,allow
27005,52013,10619,52013,901,126,775,2,31,1,1,allow
65353,53,55498,53,351,105,246,4,57,2,2,allow
63975,24874,47562,24874,70,70,0,1,5,1,0,allow
45764,443,11581,443,57543,2347,55196,68,16,26,42,allow
44864,25,44864,25,130,66,64,2,5,1,1,allow
55012,64147,0,0,62,62,0,1,0,1,0,deny
50734,37965,0,0,62,62,0,1,0,1,0,deny
62769,25174,0,0,62,62,0,1,0,1,0,deny
51414,22,0,0,60,60,0,1,0,1,0,deny
62262,445,0,0,66,66,0,1,0,1,0,drop
50487,445,0,0,70,70,0,1,0,1,0,drop
63717,37965,0,0,66,66,0,1,0,1,0,deny
3717,25174,0,0,62,62,0,1,0,1,0,deny
62260,445,0,0,66,66,0,1,0,1,0,drop
62057,445,0,0,70,70,0,1,0,1,0,drop
42951,22114,0,0,66,66,0,1,0,1,0,deny
22530,23718,0,0,66,66,0,1,0,1,0,deny
62045,445,0,0,70,70,0,1,0,1,0,drop
62048,445,0,0,70,70,0,1,0,1,0,drop
64673,6881,0,0,66,66,0,1,0,1,0,deny
62253,445,0,0,66,66,0,1,0,1,0,drop
62044,445,0,0,70,70,0,1,0,1,0,drop
62654,35440,0,0,62,62,0,1,0,1,0,deny
62041,445,0,0,70,70,0,1,0,1,0,drop
62245,445,0,0,66,66,0,1,0,1,0,drop
51310,64147,0,0,66,66,0,1,0,1,0,deny
52238,26467,0,0,62,62,0,1,0,1,0,deny
65006,26467,0,0,66,66,0,1,0,1,0,deny
50316,25604,0,0,66,66,0,1,0,1,0,deny
23349,30188,0,0,62,62,0,1,0,1,0,deny
63083,25174,0,0,66,66,0,1,0,1,0,deny
7356,25174,0,0,66,66,0,1,0,1,0,deny
51045,25174,0,0,66,66,0,1,0,1,0,deny
50478,445,0,0,70,70,0,1,0,1,0,drop
50474,445,0,0,70,70,0,1,0,1,0,drop
50475,445,0,0,70,70,0,1,0,1,0,drop
23710,41615,0,0,145,145,0,1,0,1,0,deny
62035,445,0,0,70,70,0,1,0,1,0,drop
62237,445,0,0,66,66,0,1,0,1,0,drop
62230,445,0,0,66,66,0,1,0,1,0,drop
62234,445,0,0,66,66,0,1,0,1,0,drop
62233,445,0,0,66,66,0,1,0,1,0,drop
62235,445,0,0,66,66,0,1,0,1,0,drop
62236,445,0,0,66,66,0,1,0,1,0,drop
62229,445,0,0,66,66,0,1,0,1,0,drop
62231,445,0,0,66,66,0,1,0,1,0,drop
14614,25174,0,0,66,66,0,1,0,1,0,deny
51109,11392,0,0,66,66,0,1,0,1,0,deny
52973,57470,0,0,74,74,0,1,0,1,0,deny
35570,22114,0,0,62,62,0,1,0,1,0,deny
61840,25174,0,0,66,66,0,1,0,1,0,deny
16618,52952,0,0,146,146,0,1,0,1,0,deny
24560,25174,0,0,62,62,0,1,0,1,0,deny
21604,50201,0,0,66,66,0,1,0,1,0,deny
62027,445,0,0,70,70,0,1,0,1,0,drop
63878,22114,0,0,146,146,0,1,0,1,0,deny
56249,55442,0,0,66,66,0,1,0,1,0,deny
62558,20170,0,0,145,145,0,1,0,1,0,deny
51769,51505,0,0,62,62,0,1,0,1,0,deny
62025,445,0,0,70,70,0,1,0,1,0,drop
32395,30188,0,0,146,146,0,1,0,1,0,deny
54418,22114,0,0,66,66,0,1,0,1,0,deny
63982,25174,0,0,66,66,0,1,0,1,0,deny
29509,25174,0,0,62,62,0,1,0,1,0,deny
50465,445,0,0,70,70,0,1,0,1,0,drop
50464,445,0,0,70,70,0,1,0,1,0,drop
50458,445,0,0,70,70,0,1,0,1,0,drop
50456,445,0,0,70,70,0,1,0,1,0,drop
37011,25174,0,0,146,146,0,1,0,1,0,deny
62020,445,0,0,70,70,0,1,0,1,0,drop
31683,35440,0,0,146,146,0,1,0,1,0,deny
62019,445,0,0,70,70,0,1,0,1,0,drop
62217,445,0,0,66,66,0,1,0,1,0,drop
62215,445,0,0,66,66,0,1,0,1,0,drop
62214,445,0,0,66,66,0,1,0,1,0,drop
5841,22114,0,0,62,62,0,1,0,1,0,deny
15442,22114,0,0,66,66,0,1,0,1,0,deny
62015,445,0,0,70,70,0,1,0,1,0,drop
64002,15503,0,0,146,146,0,1,0,1,0,deny
50455,445,0,0,70,70,0,1,0,1,0,drop
7810,25174,0,0,66,66,0,1,0,1,0,deny
50446,445,0,0,70,70,0,1,0,1,0,drop
50445,445,0,0,70,70,0,1,0,1,0,drop
50444,445,0,0,70,70,0,1,0,1,0,drop
62512,25174,0,0,146,146,0,1,0,1,0,deny
62014,445,0,0,70,70,0,1,0,1,0,drop
27309,6881,0,0,62,62,0,1,0,1,0,deny
63023,51505,0,0,66,66,0,1,0,1,0,deny
10540,25174,0,0,146,146,0,1,0,1,0,deny
52644,57209,0,0,66,66,0,1,0,1,0,deny
16092,50265,0,0,62,62,0,1,0,1,0,deny
52143,37807,0,0,66,66,0,1,0,1,0,deny
56397,26467,0,0,66,66,0,1,0,1,0,deny
63569,62413,0,0,62,62,0,1,0,1,0,deny
11842,23,0,0,60,60,0,1,0,1,0,deny
62009,445,0,0,70,70,0,1,0,1,0,drop
11136,19910,0,0,62,62,0,1,0,1,0,deny
14740,26467,0,0,62,62,0,1,0,1,0,deny
63116,22114,0,0,62,62,0,1,0,1,0,deny
33556,25174,0,0,146,146,0,1,0,1,0,deny
50432,445,0,0,70,70,0,1,0,1,0,drop
50434,445,0,0,70,70,0,1,0,1,0,drop
50431,445,0,0,70,70,0,1,0,1,0,drop
59424,50265,0,0,74,74,0,1,0,1,0,deny
63467,37807,0,0,62,62,0,1,0,1,0,deny
31627,64147,0,0,62,62,0,1,0,1,0,deny
62203,445,0,0,66,66,0,1,0,1,0,drop
0,0,0,0,74,74,0,1,0,1,0,deny
53577,35894,0,0,66,66,0,1,0,1,0,deny
6652,25174,0,0,62,62,0,1,0,1,0,deny
63852,25174,0,0,62,62,0,1,0,1,0,deny
5223,14446,0,0,220,220,0,1,0,1,0,deny
43578,15503,0,0,74,74,0,1,0,1,0,deny
5223,22981,0,0,60,60,0,1,0,1,0,deny
45908,33330,0,0,60,60,0,1,0,1,0,deny
8889,30434,0,0,60,60,0,1,0,1,0,deny
2731,25174,0,0,146,146,0,1,0,1,0,deny
61996,445,0,0,70,70,0,1,0,1,0,drop
53199,30188,0,0,66,66,0,1,0,1,0,deny
52210,51505,0,0,66,66,0,1,0,1,0,deny
11488,22114,0,0,66,66,0,1,0,1,0,deny
49893,25174,0,0,66,66,0,1,0,1,0,deny
60342,36237,0,0,66,66,0,1,0,1,0,deny
15499,22114,0,0,62,62,0,1,0,1,0,deny
50427,445,0,0,70,70,0,1,0,1,0,drop
50428,445,0,0,70,70,0,1,0,1,0,drop
53022,25174,0,0,66,66,0,1,0,1,0,deny
55826,42771,0,0,66,66,0,1,0,1,0,deny
55825,52700,0,0,66,66,0,1,0,1,0,deny
48826,25174,0,0,66,66,0,1,0,1,0,deny
63242,50584,0,0,62,62,0,1,0,1,0,deny
21542,57470,0,0,74,74,0,1,0,1,0,deny
61993,445,0,0,70,70,0,1,0,1,0,drop
50977,56205,0,0,66,66,0,1,0,1,0,deny
2278,25174,0,0,62,62,0,1,0,1,0,deny
62186,445,0,0,66,66,0,1,0,1,0,drop
12143,56205,0,0,62,62,0,1,0,1,0,deny
42238,25174,0,0,66,66,0,1,0,1,0,deny
61017,64147,0,0,66,66,0,1,0,1,0,deny
1733,65448,0,0,66,66,0,1,0,1,0,deny
50415,445,0,0,70,70,0,1,0,1,0,drop
10462,25174,0,0,62,62,0,1,0,1,0,deny
50413,445,0,0,70,70,0,1,0,1,0,drop
50412,445,0,0,70,70,0,1,0,1,0,drop
50408,445,0,0,70,70,0,1,0,1,0,drop
61989,445,0,0,70,70,0,1,0,1,0,drop
11716,37965,0,0,62,62,0,1,0,1,0,deny
61987,445,0,0,70,70,0,1,0,1,0,drop
62184,445,0,0,66,66,0,1,0,1,0,drop
61985,445,0,0,70,70,0,1,0,1,0,drop
33886,52255,0,0,162,162,0,1,0,1,0,deny
50573,22114,0,0,62,62,0,1,0,1,0,deny
62172,445,0,0,66,66,0,1,0,1,0,drop
62176,445,0,0,66,66,0,1,0,1,0,drop
62177,445,0,0,66,66,0,1,0,1,0,drop
62178,445,0,0,66,66,0,1,0,1,0,drop
62173,445,0,0,66,66,0,1,0,1,0,drop
62171,445,0,0,66,66,0,1,0,1,0,drop
62167,445,0,0,66,66,0,1,0,1,0,drop
63578,35440,0,0,66,66,0,1,0,1,0,deny
52235,443,52235,443,4892,844,4048,19,21,9,10,allow
58968,443,55462,443,4934,1351,3583,21,21,11,10,allow
13171,53,13171,53,404,259,145,3,32,2,1,allow
59944,80,51806,80,1186,390,796,9,16,5,4,allow
55056,80,55056,80,2959,1505,1454,10,16,6,4,allow
47322,80,21803,80,75931,3459,72472,97,43,38,59,allow
52237,443,52237,443,7718,2030,5688,23,20,11,12,allow
18166,53,18166,53,825,99,726,2,30,1,1,allow
40800,443,27923,443,19403,4043,15360,36,48,19,17,allow
49319,443,42333,443,3191,2313,878,17,44,10,7,allow
53589,53,45469,53,578,286,292,9,15,5,4,allow
58876,443,42159,443,19357,12948,6409,47,18,26,21,allow
58610,443,32629,443,6345,1545,4800,23,18,12,11,allow
49217,52769,38751,52769,2189,1143,1046,10,16,6,4,allow
53843,17556,3555,17556,320,140,180,6,7,3,3,allow
53821,7788,40501,7788,70,70,0,1,5,1,0,allow
37665,443,54006,443,8134,2717,5417,24,16,15,9,allow
61432,443,52750,443,2959,1819,1140,19,86,10,9,allow
49656,443,50043,443,11810,2769,9041,29,47,15,14,allow
63118,7000,63118,7000,3310,1535,1775,15,15,8,7,allow
34256,443,33618,443,67835,6280,61555,96,108,45,51,allow
27005,27020,4875,27020,898,126,772,2,30,1,1,allow
34097,443,35195,443,5241,860,4381,17,15,9,8,allow
43324,22,43324,22,8157,3445,4712,59,43,28,31,allow
59517,443,5605,443,6285,1545,4740,22,17,12,10,allow
57428,443,23700,443,6277,1727,4550,16,75,9,7,allow
54902,80,36045,80,1107,630,477,10,16,6,4,allow
52030,43068,29971,43068,66,66,0,1,5,1,0,allow
63976,25725,20832,25725,66,66,0,1,5,1,0,allow
46439,443,34571,443,8246,1739,6507,21,17,11,10,allow
63977,54486,15705,54486,66,66,0,1,5,1,0,allow
40998,80,36819,80,103213,8726,94487,178,38,109,69,allow
60055,53,0,0,82,82,0,1,30,1,0,allow
58969,443,56637,443,2768,1593,1175,22,21,11,11,allow
27005,27018,6738,27018,888,126,762,2,30,1,1,allow
60805,443,29197,443,7983,4398,3585,17,121,8,9,allow
45602,443,17240,443,4417,3084,1333,17,361,9,8,allow
27005,27016,8684,27016,898,126,772,2,31,1,1,allow
61666,443,28189,443,1786,172,1614,7,120,3,4,allow
45141,443,63115,443,4497,2208,2289,15,137,7,8,allow
48389,443,33224,443,6616,3644,2972,18,122,9,9,allow
51426,443,3125,443,15947,5526,10421,38,622,16,22,allow
56381,25174,0,0,62,62,0,1,0,1,0,deny
52811,44847,0,0,66,66,0,1,0,1,0,deny
13414,23,0,0,60,60,0,1,0,1,0,deny
50404,445,0,0,70,70,0,1,0,1,0,drop
50399,445,0,0,70,70,0,1,0,1,0,drop
50398,445,0,0,70,70,0,1,0,1,0,drop
50395,445,0,0,70,70,0,1,0,1,0,drop
62580,25174,0,0,62,62,0,1,0,1,0,deny
55464,22114,0,0,146,146,0,1,0,1,0,deny
10088,37807,0,0,66,66,0,1,0,1,0,deny
61978,445,0,0,70,70,0,1,0,1,0,drop
10072,25174,0,0,62,62,0,1,0,1,0,deny
50358,443,18545,443,5133,2154,2979,26,81,13,13,allow
61923,80,14146,80,4295,719,3576,16,125,8,8,allow
61976,445,0,0,70,70,0,1,0,1,0,drop
56268,44847,0,0,66,66,0,1,0,1,0,deny
57655,56205,0,0,66,66,0,1,0,1,0,deny
61975,445,0,0,70,70,0,1,0,1,0,drop
1027,64147,0,0,62,62,0,1,0,1,0,deny
61974,445,0,0,70,70,0,1,0,1,0,drop
61973,445,0,0,70,70,0,1,0,1,0,drop
50392,445,0,0,70,70,0,1,0,1,0,drop
50391,445,0,0,70,70,0,1,0,1,0,drop
50389,445,0,0,70,70,0,1,0,1,0,drop
61968,445,0,0,70,70,0,1,0,1,0,drop
61967,445,0,0,70,70,0,1,0,1,0,drop
62160,445,0,0,66,66,0,1,0,1,0,drop
49417,38558,0,0,66,66,0,1,0,1,0,deny
49931,25174,0,0,66,66,0,1,0,1,0,deny
50386,445,0,0,70,70,0,1,0,1,0,drop
7099,51505,0,0,62,62,0,1,0,1,0,deny
51944,56205,0,0,66,66,0,1,0,1,0,deny
62157,445,0,0,66,66,0,1,0,1,0,drop
48335,25174,0,0,146,146,0,1,0,1,0,deny
64035,25174,0,0,62,62,0,1,0,1,0,deny
59192,25174,0,0,66,66,0,1,0,1,0,deny
62155,445,0,0,66,66,0,1,0,1,0,drop
62156,445,0,0,66,66,0,1,0,1,0,drop
62153,445,0,0,66,66,0,1,0,1,0,drop
61955,445,0,0,70,70,0,1,0,1,0,drop
61954,445,0,0,70,70,0,1,0,1,0,drop
61950,445,0,0,70,70,0,1,0,1,0,drop
60075,41705,0,0,66,66,0,1,0,1,0,deny
61945,445,0,0,70,70,0,1,0,1,0,drop
61944,445,0,0,70,70,0,1,0,1,0,drop
58844,51505,0,0,66,66,0,1,0,1,0,deny
1024,25174,0,0,146,146,0,1,0,1,0,deny
50381,445,0,0,70,70,0,1,0,1,0,drop
30280,37965,0,0,66,66,0,1,0,1,0,deny
50376,445,0,0,70,70,0,1,0,1,0,drop
50370,445,0,0,70,70,0,1,0,1,0,drop
30598,37965,0,0,62,62,0,1,0,1,0,deny
18203,23,0,0,60,60,0,1,0,1,0,deny
13021,25174,0,0,62,62,0,1,0,1,0,deny
47461,50584,0,0,62,62,0,1,0,1,0,deny
62141,445,0,0,66,66,0,1,0,1,0,drop
61933,445,0,0,70,70,0,1,0,1,0,drop
15235,36237,0,0,62,62,0,1,0,1,0,deny
63346,53,0,0,75,75,0,1,0,1,0,deny
54721,22114,0,0,66,66,0,1,0,1,0,deny
46640,55443,0,0,60,60,0,1,0,1,0,deny
57982,25174,0,0,62,62,0,1,0,1,0,deny
57073,57470,0,0,62,62,0,1,0,1,0,deny
64755,31573,0,0,66,66,0,1,0,1,0,deny
58791,25174,0,0,62,62,0,1,0,1,0,deny
11136,57587,0,0,62,62,0,1,0,1,0,deny
58791,25174,0,0,146,146,0,1,0,1,0,deny
1538,50584,0,0,146,146,0,1,0,1,0,deny
56704,80,26438,80,1146417,29701,1116716,1218,54,422,796,allow
63978,63776,58166,63776,70,70,0,1,4,1,0,allow
63980,4804,25300,4804,70,70,0,1,4,1,0,allow
53800,59950,39242,59950,1973,1021,952,10,15,6,4,allow
53624,53,53624,53,832,106,726,2,29,1,1,allow
54365,443,56544,443,3970,1726,2244,13,134,6,7,allow
43405,443,52895,443,5977,1326,4651,18,30,11,7,allow
49902,443,36938,443,109400,8787,100613,159,81,78,81,allow
52025,42442,45647,42442,70,70,0,1,4,1,0,allow
52027,49743,23707,49743,70,70,0,1,4,1,0,allow
40784,443,40784,443,4378,1471,2907,19,25,11,8,allow
57437,443,10192,443,9539,3344,6195,36,17,17,19,allow
60788,40010,33720,40010,316,136,180,6,5,3,3,allow
50267,80,27570,80,12364,548,11816,17,46,6,11,allow
58897,443,22242,443,5167,700,4467,16,14,7,9,allow
52028,35097,53575,35097,206,136,70,4,13,3,1,allow
50211,1688,3994,1688,70,70,0,1,4,1,0,allow
27005,27016,21347,27016,902,126,776,2,30,1,1,allow
58018,443,65091,443,8828,2193,6635,38,99,17,21,allow
61924,80,25773,80,2170,472,1698,10,125,6,4,allow
27005,27017,42794,27017,880,126,754,2,30,1,1,allow
56445,53,19322,53,374,94,280,2,30,1,1,allow
49282,53,18906,53,197,94,103,2,30,1,1,allow
52003,443,46194,443,18400,6207,12193,60,212,32,28,allow
58893,443,9531,443,5107,700,4407,15,15,7,8,allow
61416,443,34403,443,6437,1994,4443,22,87,12,10,allow
52042,38074,53103,38074,70,70,0,2,8,2,0,allow
46640,443,38435,443,10768,1726,9042,35,199,17,18,allow
58896,443,22104,443,5168,700,4468,16,15,7,9,allow
65501,443,33887,443,416348,12360,403988,429,16,151,278,allow
14199,443,14199,443,416,198,218,7,27,4,3,allow
42430,443,21880,443,3927,1425,2502,18,121,8,10,allow
50584,6881,18955,6881,502,150,352,2,1200,1,1,allow
63971,42759,55186,42759,504,382,122,8,15,6,2,allow
53683,443,41886,443,9880,1687,8193,23,15,12,11,allow
46966,5222,45433,5222,12521,2892,9629,64,356,27,37,allow
49846,80,38683,80,3215,2272,943,15,38,9,6,allow
64088,53,9032,53,434,108,326,4,51,2,2,allow
55722,53,10365,53,229,110,119,2,30,1,1,allow
56809,53,8718,53,232,94,138,2,30,1,1,allow
56663,80,6268,80,234,234,0,4,12,4,0,allow
65502,443,12498,443,92573,4519,88054,105,16,39,66,allow
64157,53,10043,53,323,90,233,4,48,2,2,allow
27005,27015,3156,27015,878,126,752,2,30,1,1,allow
49210,80,26357,80,2965,715,2250,9,75,5,4,allow
63117,7000,63117,7000,4067,1750,2317,16,15,9,7,allow
28000,443,52315,443,5746,1271,4475,25,105,12,13,allow
52041,48103,36252,48103,70,70,0,2,8,2,0,allow
49907,443,10260,443,3787,2434,1353,29,72,16,13,allow
53820,7488,54828,7488,70,70,0,1,4,1,0,allow
60467,51095,40128,51095,320,140,180,6,7,3,3,allow
58171,80,42934,80,1651,550,1101,13,15,7,6,allow
52134,443,44449,443,473832,22822,451010,464,109,139,325,allow
52044,5824,18446,5824,70,70,0,2,8,2,0,allow
52026,12523,4758,12523,70,70,0,1,4,1,0,allow
63981,34250,52912,34250,70,70,0,1,4,1,0,allow
53822,18716,19485,18716,70,70,0,1,4,1,0,allow
63138,51452,7117,51452,70,70,0,1,5,1,0,allow
50700,80,27825,80,142,142,0,1,5,1,0,allow
48111,443,2939,443,214,140,74,4,15,3,1,allow
60265,53,3375,53,215,86,129,2,30,1,1,allow
58890,80,3070,80,1883,1448,435,11,16,6,5,allow
64941,53,51178,53,216,94,122,2,30,1,1,allow
65191,53,55910,53,294,102,192,2,30,1,1,allow
27005,27015,15191,27015,889,126,763,2,30,1,1,allow
27005,27017,27810,27017,890,126,764,2,30,1,1,allow
40940,443,19885,443,9856,1973,7883,32,140,17,15,allow
37965,34591,32228,34591,820,152,668,4,1199,2,2,allow
37912,443,38909,443,2738,1475,1263,19,275,10,9,allow
57470,51413,34007,51413,460,150,310,2,1199,1,1,allow
6882,25021,51756,25021,509,150,359,2,1200,1,1,allow
33227,443,20860,443,8888,1757,7131,26,174,15,11,allow
54184,443,12378,443,2786,1537,1249,17,16,8,9,allow
46592,53,27919,53,168,78,90,2,30,1,1,allow
47876,443,34439,443,996037,37114,958923,1187,271,459,728,allow
59676,53,12870,53,195,94,101,2,30,1,1,allow
50638,80,16658,80,21873,2252,19621,27,21,10,17,allow
50116,22,50116,22,152,66,86,2,9,1,1,allow
61925,80,57280,80,2418,495,1923,11,125,6,5,allow
58894,443,36068,443,5168,700,4468,16,15,7,9,allow
49356,53,31614,53,209,102,107,2,30,1,1,allow
58914,53,2441,53,244,86,158,2,30,1,1,allow
40071,443,38223,443,7855,1850,6005,24,187,14,10,allow
59518,80,10090,80,14862,1091,13771,26,135,14,12,allow
47668,443,3195,443,69732,65832,3900,104,316,55,49,allow
53453,443,41566,443,6824,2097,4727,19,15,11,8,allow
5588,5588,0,0,3354,1792,1562,46,194,23,23,allow
64812,53,57206,53,347,91,256,4,56,2,2,allow
50688,53,22980,53,78,78,0,1,30,1,0,allow
27005,27016,64097,27016,880,126,754,2,30,1,1,allow
53610,443,29299,443,3096,962,2134,13,135,6,7,allow
56713,53,30137,53,226,110,116,2,30,1,1,allow
65265,53,48964,53,207,86,121,2,30,1,1,allow
50345,53,44210,53,193,102,91,2,30,1,1,allow
39098,443,35056,443,5519,1493,4026,20,121,9,11,allow
47127,443,18899,443,7166,2377,4789,16,122,7,9,allow
59661,443,56024,443,9055,2404,6651,24,126,13,11,allow
30188,31063,61312,31063,502,150,352,2,1200,1,1,allow
64463,53,25750,53,183,94,89,2,31,1,1,allow
27005,27018,28436,27018,895,126,769,2,31,1,1,allow
53832,56005,15467,56005,70,70,0,2,8,2,0,allow
59105,443,52375,443,8742,3785,4957,21,16,12,9,allow
54271,80,5783,80,6006,861,5145,18,19,10,8,allow
44097,80,3259,80,36152,2792,33360,55,19,29,26,allow
47894,443,25578,443,52038,3333,48705,74,157,30,44,allow
63994,47013,54250,47013,66,66,0,2,8,2,0,allow
63996,45759,55251,45759,66,66,0,2,8,2,0,allow
59580,443,31817,443,10200,2180,8020,26,19,15,11,allow
37858,443,14705,443,10281,2251,8030,25,17,14,11,allow
56574,443,10843,443,6974,1513,5461,21,81,11,10,allow
63999,10552,13138,10552,66,66,0,2,8,2,0,allow
50679,80,21512,80,132,132,0,2,8,2,0,allow
35821,80,40158,80,34712,2489,32223,52,19,27,25,allow
64617,53,10590,53,301,102,199,2,30,1,1,allow
62134,445,0,0,66,66,0,1,0,1,0,drop
28085,36237,0,0,66,66,0,1,0,1,0,deny
29988,44847,0,0,66,66,0,1,0,1,0,deny
50358,445,0,0,70,70,0,1,0,1,0,drop
5223,7851,0,0,66,66,0,1,0,1,0,deny
51564,50584,0,0,66,66,0,1,0,1,0,deny
1024,25174,0,0,62,62,0,1,0,1,0,deny
61929,445,0,0,70,70,0,1,0,1,0,drop
40400,22114,0,0,62,62,0,1,0,1,0,deny
40086,22114,0,0,62,62,0,1,0,1,0,deny
62132,445,0,0,66,66,0,1,0,1,0,drop
54377,56205,0,0,66,66,0,1,0,1,0,deny
55920,25174,0,0,62,62,0,1,0,1,0,deny
61917,445,0,0,70,70,0,1,0,1,0,drop
61919,445,0,0,70,70,0,1,0,1,0,drop
61920,445,0,0,70,70,0,1,0,1,0,drop
2422,62507,0,0,66,66,0,1,0,1,0,deny
61915,445,0,0,70,70,0,1,0,1,0,drop
61913,445,0,0,70,70,0,1,0,1,0,drop
7482,57470,0,0,66,66,0,1,0,1,0,deny
54048,25174,0,0,66,66,0,1,0,1,0,deny
62125,445,0,0,66,66,0,1,0,1,0,drop
22924,25174,0,0,146,146,0,1,0,1,0,deny
2886,35440,0,0,66,66,0,1,0,1,0,deny
7222,57470,0,0,62,62,0,1,0,1,0,deny
20576,37965,0,0,62,62,0,1,0,1,0,deny
53567,64147,0,0,66,66,0,1,0,1,0,deny
62122,445,0,0,66,66,0,1,0,1,0,drop
30800,25174,0,0,62,62,0,1,0,1,0,deny
10688,25174,0,0,62,62,0,1,0,1,0,deny
37617,443,47875,443,499,425,74,4,0,3,1,allow
31609,25174,0,0,146,146,0,1,0,1,0,deny
24560,25174,0,0,146,146,0,1,0,1,0,deny
24040,22114,0,0,62,62,0,1,0,1,0,deny
46774,51050,0,0,62,62,0,1,0,1,0,deny
49482,22,0,0,60,60,0,1,0,1,0,deny
57669,64147,0,0,66,66,0,1,0,1,0,deny
61906,445,0,0,70,70,0,1,0,1,0,drop
50350,445,0,0,70,70,0,1,0,1,0,drop
50346,445,0,0,70,70,0,1,0,1,0,drop
50347,445,0,0,70,70,0,1,0,1,0,drop
50442,25174,0,0,66,66,0,1,0,1,0,deny
62109,445,0,0,66,66,0,1,0,1,0,drop
62102,445,0,0,66,66,0,1,0,1,0,drop
62105,445,0,0,66,66,0,1,0,1,0,drop
62107,445,0,0,66,66,0,1,0,1,0,drop
62101,445,0,0,66,66,0,1,0,1,0,drop
62103,445,0,0,66,66,0,1,0,1,0,drop
62108,445,0,0,66,66,0,1,0,1,0,drop
62106,445,0,0,66,66,0,1,0,1,0,drop
33215,37965,0,0,62,62,0,1,0,1,0,deny
22240,22114,0,0,62,62,0,1,0,1,0,deny
33183,23,0,0,60,60,0,1,0,1,0,deny
61899,445,0,0,70,70,0,1,0,1,0,drop
26435,39004,0,0,62,62,0,1,0,1,0,deny
61898,445,0,0,70,70,0,1,0,1,0,drop
63708,25174,0,0,66,66,0,1,0,1,0,deny
44147,64147,0,0,62,62,0,1,0,1,0,deny
61892,445,0,0,70,70,0,1,0,1,0,drop
50344,445,0,0,70,70,0,1,0,1,0,drop
50339,445,0,0,70,70,0,1,0,1,0,drop
50330,445,0,0,70,70,0,1,0,1,0,drop
50328,445,0,0,70,70,0,1,0,1,0,drop
61891,445,0,0,70,70,0,1,0,1,0,drop
67,68,0,0,346,346,0,1,0,1,0,deny
57797,64147,0,0,66,66,0,1,0,1,0,deny
62088,445,0,0,66,66,0,1,0,1,0,drop
62089,445,0,0,66,66,0,1,0,1,0,drop
62086,445,0,0,66,66,0,1,0,1,0,drop
63400,57470,0,0,66,66,0,1,0,1,0,deny
45908,33330,0,0,60,60,0,1,0,1,0,deny
61887,445,0,0,70,70,0,1,0,1,0,drop
7877,22114,0,0,66,66,0,1,0,1,0,deny
50327,445,0,0,70,70,0,1,0,1,0,drop
61886,445,0,0,70,70,0,1,0,1,0,drop
50318,445,0,0,70,70,0,1,0,1,0,drop
50322,445,0,0,70,70,0,1,0,1,0,drop
50317,445,0,0,70,70,0,1,0,1,0,drop
13285,29892,0,0,145,145,0,1,0,1,0,deny
0,0,0,0,480,244,236,4,0,2,2,allow
54876,25174,0,0,62,62,0,1,0,1,0,deny
59949,44847,0,0,66,66,0,1,0,1,0,deny
52024,25174,0,0,66,66,0,1,0,1,0,deny
19330,25174,0,0,62,62,0,1,0,1,0,deny
61881,445,0,0,70,70,0,1,0,1,0,drop
63347,25174,0,0,66,66,0,1,0,1,0,deny
18061,25174,0,0,62,62,0,1,0,1,0,deny
63084,64147,0,0,62,62,0,1,0,1,0,deny
50309,445,0,0,70,70,0,1,0,1,0,drop
50308,445,0,0,70,70,0,1,0,1,0,drop
50304,445,0,0,70,70,0,1,0,1,0,drop
56770,26467,0,0,66,66,0,1,0,1,0,deny
52321,26467,0,0,62,62,0,1,0,1,0,deny
62077,445,0,0,66,66,0,1,0,1,0,drop
62014,35440,0,0,66,66,0,1,0,1,0,deny
49001,40108,0,0,161,161,0,1,0,1,0,deny
49686,44847,0,0,62,62,0,1,0,1,0,deny
49001,40108,0,0,161,161,0,1,0,1,0,deny
53756,50584,0,0,62,62,0,1,0,1,0,deny
53257,37450,0,0,66,66,0,1,0,1,0,deny
61400,64147,0,0,66,66,0,1,0,1,0,deny
55562,50584,0,0,66,66,0,1,0,1,0,deny
49994,26467,0,0,66,66,0,1,0,1,0,deny
47771,25174,0,0,62,62,0,1,0,1,0,deny
61868,445,0,0,70,70,0,1,0,1,0,drop
62637,42873,0,0,66,66,0,1,0,1,0,deny
32704,25174,0,0,62,62,0,1,0,1,0,deny
51396,56205,0,0,66,66,0,1,0,1,0,deny
46864,25174,0,0,146,146,0,1,0,1,0,deny
22733,26467,0,0,62,62,0,1,0,1,0,deny
59988,64147,0,0,66,66,0,1,0,1,0,deny
26752,64147,0,0,62,62,0,1,0,1,0,deny
3584,25174,0,0,62,62,0,1,0,1,0,deny
57604,32480,0,0,62,62,0,1,0,1,0,deny
14489,25174,0,0,62,62,0,1,0,1,0,deny
58250,35440,0,0,66,66,0,1,0,1,0,deny
46367,36237,0,0,66,66,0,1,0,1,0,deny
61865,445,0,0,70,70,0,1,0,1,0,drop
50298,445,0,0,70,70,0,1,0,1,0,drop
50293,445,0,0,70,70,0,1,0,1,0,drop
62792,53,0,0,88,88,0,1,0,1,0,deny
56161,62413,0,0,66,66,0,1,0,1,0,deny
49514,52255,0,0,162,162,0,1,0,1,0,deny
12632,25174,0,0,62,62,0,1,0,1,0,deny
29016,25174,0,0,62,62,0,1,0,1,0,deny
32976,37965,0,0,66,66,0,1,0,1,0,deny
49086,443,34505,443,8535,2139,6396,25,394,9,16,allow
38223,443,38223,443,4782,1875,2907,19,29,11,8,allow
55254,443,18308,443,8431,2584,5847,25,46,14,11,allow
54278,53,0,0,82,82,0,1,30,1,0,allow
26867,443,1450,443,11115,3034,8081,35,19,18,17,allow
39192,80,42667,80,62592,60966,1626,63,16,47,16,allow
53817,59216,40309,59216,164,70,94,2,5,1,1,allow
63970,28423,20673,28423,564,382,182,9,15,6,3,allow
61505,443,24914,443,4820,863,3957,18,31,10,8,allow
61506,443,7741,443,15255,2304,12951,30,31,13,17,allow
64002,2880,57977,2880,66,66,0,2,8,2,0,allow
60456,58675,9788,58675,1307,786,521,15,16,8,7,allow
60901,443,60901,443,24367,4634,19733,52,49,26,26,allow
63968,37264,37420,37264,504,382,122,8,15,6,2,allow
49994,443,12654,443,378,82,296,5,17,1,4,allow
56449,443,10507,443,3182,1568,1614,8,120,4,4,allow
63062,53,6744,53,303,85,218,2,30,1,1,allow
55835,443,26347,443,10087,3968,6119,32,271,17,15,allow
63063,443,23701,443,303,85,218,2,30,1,1,allow
57334,443,4953,443,11347,2434,8913,28,62,15,13,allow
40030,443,25382,443,2651,1331,1320,18,17,10,8,allow
40803,443,57775,443,1093,662,431,10,46,6,4,allow
53149,47383,18287,47383,694,320,374,10,18,6,4,allow
52907,443,48453,443,9303,3133,6170,26,22,13,13,allow
60454,18359,20909,18359,1842,1017,825,19,16,9,10,allow
60413,80,20847,80,958,543,415,11,315,6,5,allow
60412,80,59747,80,958,543,415,11,315,6,5,allow
49812,443,22276,443,6128,1356,4772,20,978,10,10,allow
58870,443,34912,443,21207,14062,7145,50,19,28,22,allow
64003,38926,33075,38926,66,66,0,2,8,2,0,allow
41339,443,20728,443,7450,1203,6247,22,16,12,10,allow
53232,80,53232,80,6385,778,5607,17,16,9,8,allow
54054,443,22271,443,12268,7082,5186,26,85,15,11,allow
58967,443,57759,443,9225,1878,7347,28,21,14,14,allow
10808,443,10808,443,4902,861,4041,15,16,7,8,allow
53018,443,37160,443,6352,1552,4800,23,17,12,11,allow
54031,443,8430,443,350,210,140,6,25,4,2,allow
63961,53,35480,53,184,86,98,2,30,1,1,allow
48817,6889,48817,6889,480,149,331,2,1200,1,1,allow
36420,443,54908,443,7018,1381,5637,24,17,14,10,allow
64115,80,27951,80,2575,635,1940,12,36,7,5,allow
5588,5588,0,0,3354,1792,1562,46,196,23,23,allow
5588,5588,0,0,3354,1792,1562,46,194,23,23,allow
27005,27016,57447,27016,885,126,759,2,30,1,1,allow
60903,443,60903,443,13557,3307,10250,43,47,25,18,allow
64827,53,64827,53,288,83,205,2,30,1,1,allow
63071,443,65203,443,569,164,405,2,30,1,1,allow
5588,5588,0,0,3354,1792,1562,46,193,23,23,allow
63070,53,63583,53,446,164,282,2,30,1,1,allow
52062,443,2872,443,61141,52577,8564,102,363,50,52,allow
27005,27017,35476,27017,882,126,756,2,31,1,1,allow
27005,27017,28274,27017,880,126,754,2,31,1,1,allow
55647,443,60557,443,90956,83597,7359,106,127,70,36,allow
62061,445,0,0,66,66,0,1,0,1,0,drop
62057,445,0,0,66,66,0,1,0,1,0,drop
12183,22114,0,0,62,62,0,1,0,1,0,deny
62885,62413,0,0,66,66,0,1,0,1,0,deny
27677,22114,0,0,62,62,0,1,0,1,0,deny
50251,35440,0,0,66,66,0,1,0,1,0,deny
18608,11392,0,0,62,62,0,1,0,1,0,deny
61861,445,0,0,70,70,0,1,0,1,0,drop
54438,62413,0,0,66,66,0,1,0,1,0,deny
36456,25174,0,0,62,62,0,1,0,1,0,deny
57479,56205,0,0,66,66,0,1,0,1,0,deny
61859,445,0,0,70,70,0,1,0,1,0,drop
51210,50584,0,0,146,146,0,1,0,1,0,deny
60786,25174,0,0,66,66,0,1,0,1,0,deny
59147,25174,0,0,62,62,0,1,0,1,0,deny
63910,44847,0,0,62,62,0,1,0,1,0,deny
50285,445,0,0,70,70,0,1,0,1,0,drop
50289,445,0,0,70,70,0,1,0,1,0,drop
50283,445,0,0,70,70,0,1,0,1,0,drop
50282,445,0,0,70,70,0,1,0,1,0,drop
30782,36237,0,0,146,146,0,1,0,1,0,deny
58251,36237,0,0,62,62,0,1,0,1,0,deny
61857,445,0,0,70,70,0,1,0,1,0,drop
62053,445,0,0,66,66,0,1,0,1,0,drop
49591,53,54188,53,408,86,322,4,31,2,2,allow
63056,443,24879,443,304,86,218,2,30,1,1,allow
63068,443,50738,443,571,166,405,2,30,1,1,allow
50632,80,1606,80,1559,1107,452,9,22,5,4,allow
60438,53,27899,53,154,154,0,3,46,3,0,allow
63242,443,5586,443,9042,4612,4430,31,175,17,14,allow
61691,53,19669,53,256,94,162,2,30,1,1,allow
59625,443,5961,443,6703,1307,5396,28,18,14,14,allow
56569,443,12304,443,340595,9013,331582,345,80,119,226,allow
53818,15337,26034,15337,164,70,94,2,4,1,1,allow
50995,53,51013,53,168,78,90,2,30,1,1,allow
38100,53,30457,53,168,78,90,2,30,1,1,allow
53764,443,39809,443,8115,1962,6153,24,18,14,10,allow
52618,80,60049,80,1141,529,612,10,18,6,4,allow
55026,443,39326,443,3591,1906,1685,22,80,11,11,allow
37235,443,30384,443,8877,1380,7497,30,18,15,15,allow
53424,443,24039,443,9953,1605,8348,35,18,19,16,allow
53814,6725,20985,6725,70,70,0,1,4,1,0,allow
64000,14441,35024,14441,66,66,0,2,7,2,0,allow
53815,17290,25400,17290,70,70,0,1,4,1,0,allow
53808,56215,4312,56215,70,70,0,1,4,1,0,allow
50635,80,60349,80,3722,1504,2218,13,20,7,6,allow
51553,443,28429,443,6662,522,6140,15,16,5,10,allow
54136,443,42387,443,1053,566,487,10,16,6,4,allow
50374,53,63648,53,755,102,653,2,29,1,1,allow
63075,53,54531,53,571,166,405,2,29,1,1,allow
63074,443,53301,443,384,166,218,2,29,1,1,allow
58726,53,60102,53,247,102,145,2,30,1,1,allow
50345,53,41743,53,193,102,91,2,30,1,1,allow
63059,53,39205,53,304,86,218,2,30,1,1,allow
54657,6881,47052,6881,1682,716,966,12,15,6,6,allow
56566,443,19189,443,343737,9198,334539,348,80,121,227,allow
64406,53,46788,53,204,204,0,3,46,3,0,allow
64124,53,32205,53,236,86,150,2,30,1,1,allow
63069,53,35959,53,384,166,218,2,30,1,1,allow
63058,443,54083,443,304,86,218,2,30,1,1,allow
60458,61473,34807,61473,1587,935,652,14,16,8,6,allow
60946,443,58938,443,1373,712,661,14,18,8,6,allow
56570,443,57405,443,4722,1330,3392,18,80,9,9,allow
56565,443,50266,443,52157,3066,49091,65,80,26,39,allow
49634,53,43147,53,344,126,218,2,30,1,1,allow
40603,80,57176,80,1104,475,629,10,15,6,4,allow
20954,53,64122,53,223,78,145,2,30,1,1,allow
65064,53,44516,53,338,110,228,2,30,1,1,allow
39607,443,22667,443,559339,545011,14328,595,316,388,207,allow
60949,443,41744,443,1598,794,804,16,18,9,7,allow
27005,27016,52333,27016,892,126,766,2,30,1,1,allow
33936,443,61935,443,9880,2011,7869,38,256,17,21,allow
49732,443,11249,443,592433,191668,400765,1555,1157,608,947,allow
56450,443,16622,443,1786,172,1614,7,120,3,4,allow
56654,53,7518,53,306,306,0,4,47,4,0,allow
59813,53,1465,53,355,118,237,2,30,1,1,allow
65016,443,10524,443,5957,2481,3476,14,120,8,6,allow
1399,53,11703,53,256,94,162,2,30,1,1,allow
54699,53,18510,53,236,86,150,2,30,1,1,allow
60448,443,25494,443,17060,10614,6446,52,132,25,27,allow
44136,53,62801,53,220,78,142,2,30,1,1,allow
50265,12656,39117,12656,402,132,270,6,1209,3,3,allow
58892,443,12440,443,5167,700,4467,16,15,7,9,allow
55008,443,6262,443,7679,2605,5074,26,45,15,11,allow
35879,443,58250,443,6108,3916,2192,51,1143,31,20,allow
61637,53,50085,53,246,246,0,4,47,4,0,allow
27005,27016,17194,27016,878,126,752,2,30,1,1,allow
50265,40448,36258,40448,2118,858,1260,28,1274,14,14,allow
48144,443,29490,443,16198,9822,6376,54,35,28,26,allow
60956,443,57163,443,13342,9687,3655,53,17,28,25,allow
60944,443,6650,443,59999,8737,51262,95,18,43,52,allow
42319,443,8708,443,6664,1570,5094,23,18,13,10,allow
59779,443,38576,443,142,142,0,1,5,1,0,allow
45511,443,41466,443,130,70,60,2,15,1,1,allow
55445,53,39762,53,192,192,0,3,46,3,0,allow
53434,53,32877,53,261,261,0,4,47,4,0,allow
60473,8765,34134,8765,199,75,124,4,59,2,2,allow
27005,27018,49128,27018,879,126,753,2,30,1,1,allow
63067,53,20594,53,384,166,218,2,30,1,1,allow
8893,123,39834,123,94,94,0,1,30,1,0,allow
63060,53,7236,53,304,86,218,2,30,1,1,allow
35506,80,16634,80,120,60,60,3,3600,2,1,allow
55305,53,27046,53,176,176,0,3,46,3,0,allow
60945,443,60187,443,1373,712,661,14,18,8,6,allow
54056,443,63986,443,8340,3417,4923,20,75,11,9,allow
40656,443,51290,443,10293,1331,8962,22,255,12,10,allow
56576,443,12093,443,6971,1510,5461,21,80,11,10,allow
64001,13051,20049,13051,66,66,0,2,7,2,0,allow
46683,443,6885,443,234,234,0,4,12,4,0,allow
64004,48339,7779,48339,66,66,0,2,7,2,0,allow
60953,443,32015,443,103580,4856,98724,133,17,56,77,allow
42574,443,64198,443,130,70,60,3,5,2,1,allow
64828,53,47016,53,881,243,638,6,39,3,3,allow
59942,80,31955,80,2241,1549,692,9,15,5,4,allow
53753,443,14141,443,6973,2166,4807,20,15,11,9,allow
42137,443,46635,443,9173,2080,7093,22,18,13,9,allow
60950,443,63675,443,7431,2753,4678,40,18,21,19,allow
62995,53,20908,53,202,202,0,3,46,3,0,allow
37663,443,39550,443,8493,2314,6179,33,15,18,15,allow
2089,7000,2089,7000,2227,676,1551,15,14,7,8,allow
63995,15396,7460,15396,66,66,0,2,7,2,0,allow
55348,53,14185,53,332,94,238,2,29,1,1,allow
51923,443,5090,443,8964,6357,2607,44,163,23,21,allow
63073,53,51318,53,304,86,218,2,30,1,1,allow
54553,53,62342,53,202,202,0,3,46,3,0,allow
27005,27018,51393,27018,881,126,755,2,30,1,1,allow
65501,53,1213,53,226,94,132,2,29,1,1,allow
63072,443,30970,443,304,86,218,2,30,1,1,allow
63066,443,9445,443,448,166,282,2,30,1,1,allow
46676,443,54715,443,16425,3923,12502,37,156,19,18,allow
60580,53,24695,53,229,94,135,2,30,1,1,allow
63064,443,8160,443,448,166,282,2,30,1,1,allow
49897,53,22937,53,384,94,290,2,30,1,1,allow
63057,53,17577,53,304,86,218,2,30,1,1,allow
45387,443,38103,443,3999,2255,1744,37,1122,19,18,allow
60955,443,4042,443,40105,2847,37258,61,17,28,33,allow
27005,27016,52967,27016,879,126,753,2,30,1,1,allow
46404,53,18296,53,240,86,154,2,30,1,1,allow
63061,443,64217,443,304,86,218,2,30,1,1,allow
60958,443,2953,443,1547,960,587,14,17,8,6,allow
60947,443,46012,443,1373,712,661,14,18,8,6,allow
60460,54233,13899,54233,70,70,0,1,5,1,0,allow
45510,443,22832,443,130,70,60,2,15,1,1,allow
41000,443,2288,443,6237,1811,4426,22,22,12,10,allow
61071,1053,14234,1053,1139,878,261,2,30,1,1,allow
27005,27015,13591,27015,880,126,754,2,30,1,1,allow
27005,27025,23287,27025,895,126,769,2,30,1,1,allow
52989,53,36046,53,406,94,312,2,30,1,1,allow
40204,40016,4435,40016,148,86,62,2,30,1,1,allow
60952,443,35261,443,391561,17125,374436,478,17,213,265,allow
60948,443,3715,443,1373,712,661,14,18,8,6,allow
54181,443,63427,443,9283,2154,7129,22,15,12,10,allow
50116,22,50116,22,66,66,0,1,5,1,0,allow
62074,443,56208,443,350,210,140,6,15,4,2,allow
53791,53,58724,53,204,204,0,3,46,3,0,allow
61072,53,60652,53,1139,878,261,2,30,1,1,allow
63065,53,14429,53,448,166,282,2,30,1,1,allow
54672,443,56107,443,2285,1130,1155,25,120,12,13,allow
59984,443,65136,443,2419,330,2089,12,135,5,7,allow
56485,443,48158,443,5711,1208,4503,21,121,11,10,allow
57470,50321,52574,50321,1584,1584,0,25,1537,25,0,allow
37526,443,48276,443,10637,4761,5876,30,145,17,13,allow
55877,56148,26245,56148,481,150,331,2,1200,1,1,allow
42207,443,33313,443,7870,2945,4925,19,136,9,10,allow
60455,65054,62710,65054,624,318,306,10,16,5,5,allow
58731,443,5711,443,2383,1460,923,18,201,10,8,allow
64463,53,17671,53,183,94,89,2,30,1,1,allow
55427,53,42725,53,442,110,332,4,44,2,2,allow
55078,80,14305,80,265275,25834,239441,366,101,182,184,allow
65071,53,49896,53,93,93,0,2,60,2,0,allow
52178,443,8092,443,414,140,274,7,26,3,4,allow
59489,53,5531,53,168,78,90,2,30,1,1,allow
62709,57470,0,0,62,62,0,1,0,1,0,deny
62048,445,0,0,66,66,0,1,0,1,0,drop
62047,445,0,0,66,66,0,1,0,1,0,drop
62042,445,0,0,66,66,0,1,0,1,0,drop
62050,445,0,0,66,66,0,1,0,1,0,drop
62049,445,0,0,66,66,0,1,0,1,0,drop
62044,445,0,0,66,66,0,1,0,1,0,drop
62038,445,0,0,66,66,0,1,0,1,0,drop
55435,25174,0,0,146,146,0,1,0,1,0,deny
7977,25174,0,0,146,146,0,1,0,1,0,deny
7977,25174,0,0,62,62,0,1,0,1,0,deny
50274,445,0,0,70,70,0,1,0,1,0,drop
10632,25174,0,0,146,146,0,1,0,1,0,deny
50271,445,0,0,70,70,0,1,0,1,0,drop
50270,445,0,0,70,70,0,1,0,1,0,drop
50267,445,0,0,70,70,0,1,0,1,0,drop
55839,56535,0,0,62,62,0,1,0,1,0,deny
61850,445,0,0,70,70,0,1,0,1,0,drop
21108,25174,0,0,62,62,0,1,0,1,0,deny
61848,445,0,0,70,70,0,1,0,1,0,drop
44285,25174,0,0,62,62,0,1,0,1,0,deny
15400,47807,0,0,159,159,0,1,0,1,0,deny
37633,44847,0,0,62,62,0,1,0,1,0,deny
2717,31573,0,0,62,62,0,1,0,1,0,deny
47727,25174,0,0,146,146,0,1,0,1,0,deny
41541,25174,0,0,66,66,0,1,0,1,0,deny
61847,445,0,0,70,70,0,1,0,1,0,drop
61846,445,0,0,70,70,0,1,0,1,0,drop
15249,22114,0,0,62,62,0,1,0,1,0,deny
61845,445,0,0,70,70,0,1,0,1,0,drop
61843,445,0,0,70,70,0,1,0,1,0,drop
61841,445,0,0,70,70,0,1,0,1,0,drop
59213,25174,0,0,66,66,0,1,0,1,0,deny
60104,30188,0,0,66,66,0,1,0,1,0,deny
50264,445,0,0,70,70,0,1,0,1,0,drop
50263,445,0,0,70,70,0,1,0,1,0,drop
50261,445,0,0,70,70,0,1,0,1,0,drop
30861,46783,0,0,62,62,0,1,0,1,0,deny
51560,46783,0,0,66,66,0,1,0,1,0,deny
62033,445,0,0,66,66,0,1,0,1,0,drop
39873,23,0,0,60,60,0,1,0,1,0,deny
50258,445,0,0,70,70,0,1,0,1,0,drop
35828,8970,0,0,146,146,0,1,0,1,0,reset-both
54876,25174,0,0,146,146,0,1,0,1,0,deny
62029,445,0,0,66,66,0,1,0,1,0,drop
60558,51221,0,0,62,62,0,1,0,1,0,deny
64155,60043,0,0,66,66,0,1,0,1,0,deny
5926,25174,0,0,62,62,0,1,0,1,0,deny
61827,445,0,0,70,70,0,1,0,1,0,drop
6881,35894,0,0,62,62,0,1,0,1,0,deny
61826,445,0,0,70,70,0,1,0,1,0,drop
61820,445,0,0,70,70,0,1,0,1,0,drop
62027,445,0,0,66,66,0,1,0,1,0,drop
62026,445,0,0,66,66,0,1,0,1,0,drop
18091,32480,0,0,62,62,0,1,0,1,0,deny
61816,445,0,0,70,70,0,1,0,1,0,drop
61817,445,0,0,70,70,0,1,0,1,0,drop
62025,445,0,0,66,66,0,1,0,1,0,drop
47256,37807,0,0,62,62,0,1,0,1,0,deny
11136,15503,0,0,62,62,0,1,0,1,0,deny
41490,25174,0,0,62,62,0,1,0,1,0,deny
57994,30188,0,0,62,62,0,1,0,1,0,deny
60941,25174,0,0,62,62,0,1,0,1,0,deny
33074,5900,0,0,60,60,0,1,0,1,0,deny
50255,445,0,0,70,70,0,1,0,1,0,drop
64214,25174,0,0,66,66,0,1,0,1,0,deny
50240,445,0,0,70,70,0,1,0,1,0,drop
50242,445,0,0,70,70,0,1,0,1,0,drop
40687,64147,0,0,62,62,0,1,0,1,0,deny
53197,25174,0,0,66,66,0,1,0,1,0,deny
56309,22114,0,0,62,62,0,1,0,1,0,deny
50822,50584,0,0,66,66,0,1,0,1,0,deny
61805,445,0,0,70,70,0,1,0,1,0,drop
57131,31061,0,0,145,145,0,1,0,1,0,deny
62013,445,0,0,66,66,0,1,0,1,0,drop
3937,36829,0,0,62,62,0,1,0,1,0,deny
53470,22114,0,0,66,66,0,1,0,1,0,deny
2946,25174,0,0,62,62,0,1,0,1,0,deny
46808,25174,0,0,146,146,0,1,0,1,0,deny
6881,8305,0,0,143,143,0,1,0,1,0,deny
51948,17372,0,0,62,62,0,1,0,1,0,deny
15345,36829,0,0,66,66,0,1,0,1,0,deny
56922,29434,0,0,107,107,0,1,0,1,0,deny
53906,17372,0,0,145,145,0,1,0,1,0,deny
54601,26467,0,0,66,66,0,1,0,1,0,deny
62006,445,0,0,66,66,0,1,0,1,0,drop
61801,445,0,0,70,70,0,1,0,1,0,drop
39195,25174,0,0,62,62,0,1,0,1,0,deny
50233,445,0,0,70,70,0,1,0,1,0,deny
62813,25174,0,0,62,62,0,1,0,1,0,deny
19455,25174,0,0,62,62,0,1,0,1,0,deny
63878,22114,0,0,62,62,0,1,0,1,0,deny
1266,57470,0,0,146,146,0,1,0,1,0,deny
49163,22114,0,0,62,62,0,1,0,1,0,deny
65400,36237,0,0,66,66,0,1,0,1,0,deny
61792,445,0,0,70,70,0,1,0,1,0,drop
33804,443,22331,443,5815,1128,4687,19,0,9,10,allow
61791,445,0,0,70,70,0,1,0,1,0,drop
61790,445,0,0,70,70,0,1,0,1,0,drop
62003,445,0,0,66,66,0,1,0,1,0,drop
61788,445,0,0,70,70,0,1,0,1,0,drop
61784,445,0,0,70,70,0,1,0,1,0,drop
54280,3398,0,0,60,60,0,1,0,1,0,deny
27000,23117,0,0,62,62,0,1,0,1,0,deny
63554,44847,0,0,66,66,0,1,0,1,0,deny
61997,445,0,0,66,66,0,1,0,1,0,drop
26469,26348,0,0,62,62,0,1,0,1,0,deny
32997,50584,0,0,62,62,0,1,0,1,0,deny
61993,445,0,0,66,66,0,1,0,1,0,drop
25756,22114,0,0,146,146,0,1,0,1,0,deny
20962,22114,0,0,62,62,0,1,0,1,0,deny
60438,17372,0,0,66,66,0,1,0,1,0,deny
53323,35253,0,0,66,66,0,1,0,1,0,deny
61779,445,0,0,70,70,0,1,0,1,0,drop
17270,44847,0,0,146,146,0,1,0,1,0,deny
24504,37965,0,0,62,62,0,1,0,1,0,deny
43332,81,0,0,60,60,0,1,0,1,0,deny
50254,2323,0,0,60,60,0,1,0,1,0,deny
55711,26467,0,0,66,66,0,1,0,1,0,deny
51746,25174,0,0,66,66,0,1,0,1,0,deny
23274,50584,0,0,146,146,0,1,0,1,0,deny
52459,5555,0,0,60,60,0,1,0,1,0,deny
48335,25174,0,0,62,62,0,1,0,1,0,deny
4500,4500,0,0,862,862,0,1,0,1,0,deny
43828,44847,0,0,66,66,0,1,0,1,0,deny
50222,445,0,0,70,70,0,1,0,1,0,drop
50218,445,0,0,70,70,0,1,0,1,0,drop
50219,445,0,0,70,70,0,1,0,1,0,drop
15513,25174,0,0,62,62,0,1,0,1,0,deny
61979,445,0,0,66,66,0,1,0,1,0,drop
61981,445,0,0,66,66,0,1,0,1,0,drop
61977,445,0,0,66,66,0,1,0,1,0,drop
61976,445,0,0,66,66,0,1,0,1,0,drop
61978,445,0,0,66,66,0,1,0,1,0,drop
61975,445,0,0,66,66,0,1,0,1,0,drop
61974,445,0,0,66,66,0,1,0,1,0,drop
61973,445,0,0,66,66,0,1,0,1,0,drop
5222,46866,0,0,66,66,0,1,0,1,0,deny
61771,445,0,0,70,70,0,1,0,1,0,drop
53841,37965,0,0,66,66,0,1,0,1,0,deny
61770,445,0,0,70,70,0,1,0,1,0,drop
50459,62413,0,0,66,66,0,1,0,1,0,deny
60260,22114,0,0,66,66,0,1,0,1,0,deny
52630,1433,0,0,60,60,0,1,0,1,0,deny
6355,25174,0,0,62,62,0,1,0,1,0,deny
39661,53733,0,0,146,146,0,1,0,1,0,deny
12965,37965,0,0,66,66,0,1,0,1,0,deny
9588,37965,0,0,62,62,0,1,0,1,0,deny
44388,63874,0,0,66,66,0,1,0,1,0,deny
61764,445,0,0,70,70,0,1,0,1,0,drop
61763,445,0,0,70,70,0,1,0,1,0,drop
53513,56205,0,0,146,146,0,1,0,1,0,deny
50211,445,0,0,70,70,0,1,0,1,0,drop
50209,445,0,0,70,70,0,1,0,1,0,drop
50201,445,0,0,70,70,0,1,0,1,0,drop
50199,445,0,0,70,70,0,1,0,1,0,drop
37455,50584,0,0,62,62,0,1,0,1,0,deny
64190,2767,0,0,66,66,0,1,0,1,0,deny
2394,55108,0,0,159,159,0,1,0,1,0,deny
61959,445,0,0,66,66,0,1,0,1,0,drop
61960,445,0,0,66,66,0,1,0,1,0,drop
61961,445,0,0,66,66,0,1,0,1,0,drop
61759,445,0,0,70,70,0,1,0,1,0,drop
2475,6881,0,0,66,66,0,1,0,1,0,deny
57284,22114,0,0,66,66,0,1,0,1,0,deny
25961,55783,0,0,62,62,0,1,0,1,0,deny
61758,445,0,0,70,70,0,1,0,1,0,drop
60823,25174,0,0,66,66,0,1,0,1,0,deny
38549,22114,0,0,146,146,0,1,0,1,0,deny
6712,44818,0,0,66,66,0,1,0,1,0,deny
50197,445,0,0,70,70,0,1,0,1,0,drop
64392,25174,0,0,66,66,0,1,0,1,0,deny
62064,22114,0,0,66,66,0,1,0,1,0,deny
61523,37807,0,0,66,66,0,1,0,1,0,deny
50192,445,0,0,70,70,0,1,0,1,0,drop
50191,445,0,0,70,70,0,1,0,1,0,drop
50187,445,0,0,70,70,0,1,0,1,0,drop
48513,44847,0,0,146,146,0,1,0,1,0,deny
52988,53567,0,0,66,66,0,1,0,1,0,deny
61753,445,0,0,70,70,0,1,0,1,0,drop
61190,21247,0,0,66,66,0,1,0,1,0,deny
37834,45129,0,0,145,145,0,1,0,1,0,deny
13840,37965,0,0,146,146,0,1,0,1,0,deny
50180,445,0,0,70,70,0,1,0,1,0,drop
50178,445,0,0,70,70,0,1,0,1,0,drop
50176,445,0,0,70,70,0,1,0,1,0,drop
26717,25174,0,0,62,62,0,1,0,1,0,deny
1262,23,0,0,60,60,0,1,0,1,0,deny
27195,21247,0,0,146,146,0,1,0,1,0,deny
55554,22114,0,0,62,62,0,1,0,1,0,deny
61948,445,0,0,66,66,0,1,0,1,0,drop
61740,445,0,0,70,70,0,1,0,1,0,drop
57333,443,55597,443,12837,1681,11156,30,62,16,14,allow
36754,443,36754,443,4699,1792,2907,19,30,11,8,allow
52043,43578,45799,43578,316,136,180,6,6,3,3,allow
27005,27015,49738,27015,893,126,767,2,30,1,1,allow
27005,27018,4129,27018,881,126,755,2,30,1,1,allow
35555,53,35555,53,194,87,107,2,30,1,1,allow
52022,53657,53149,53657,66,66,0,1,5,1,0,allow
52037,45647,32087,45647,316,136,180,6,7,3,3,allow
63965,11785,30846,11785,66,66,0,1,5,1,0,allow
35955,5228,64424,5228,6776,1542,5234,21,3600,12,9,allow
51149,443,26017,443,5092,2574,2518,14,135,7,7,allow
42749,53,42749,53,847,110,737,2,30,1,1,allow
26229,80,26229,80,7372,954,6418,17,18,9,8,allow
55691,16410,58376,16410,70,70,0,2,8,2,0,allow
53803,17637,39254,17637,70,70,0,1,5,1,0,allow
58874,443,12303,443,10630,6981,3649,31,17,17,14,allow
64612,53,64612,53,213,87,126,2,30,1,1,allow
27005,27015,45876,27015,886,126,760,2,30,1,1,allow
15503,51413,47539,51413,459,149,310,2,1200,1,1,allow
51463,53,0,0,82,82,0,1,30,1,0,allow
48013,53,0,0,82,82,0,1,30,1,0,allow
47892,443,19816,443,6454,1447,5007,22,17,11,11,allow
52038,14487,18653,14487,70,70,0,2,7,2,0,allow
57228,8525,57228,8525,138,78,60,2,5,1,1,allow
52039,38541,31838,38541,70,70,0,2,7,2,0,allow
52035,36498,46508,36498,70,70,0,2,9,2,0,allow
55687,47613,13232,47613,258,70,188,4,8,2,2,allow
52021,32202,28754,32202,66,66,0,1,5,1,0,allow
41395,443,34255,443,6292,1492,4800,22,17,11,11,allow
54666,443,61385,443,3648,1080,2568,18,135,8,10,allow
56222,5228,31508,5228,2531,1513,1018,17,3601,8,9,allow
58886,443,39424,443,3989,2585,1404,17,15,9,8,allow
52649,443,45569,443,6292,1492,4800,22,17,11,11,allow
50649,80,63151,80,1366,865,501,8,15,5,3,allow
59940,80,29186,80,1169137,23501,1145636,1104,22,344,760,allow
53614,443,48622,443,6352,1552,4800,23,17,12,11,allow
61099,443,33626,443,492,492,0,7,15,7,0,allow
55689,37558,21710,37558,70,70,0,2,8,2,0,allow
63961,51641,64148,51641,504,382,122,8,16,6,2,allow
49199,8106,41963,8106,370,190,180,6,15,3,3,allow
49566,80,12827,80,1268,703,565,11,23,6,5,allow
27005,27014,42282,27014,882,126,756,2,30,1,1,allow
33063,443,10345,443,6411,1611,4800,24,17,13,11,allow
27005,27016,41906,27016,882,126,756,2,30,1,1,allow
22263,53,22263,53,288,83,205,2,30,1,1,allow
53502,443,33693,443,10893,6516,4377,36,131,16,20,allow
57470,58695,5572,58695,726,726,0,12,1200,12,0,allow
26651,25174,0,0,146,146,0,1,0,1,0,deny
13159,37965,0,0,66,66,0,1,0,1,0,deny
52227,64147,0,0,66,66,0,1,0,1,0,deny
29139,64147,0,0,62,62,0,1,0,1,0,deny
40797,25174,0,0,62,62,0,1,0,1,0,deny
27860,23,0,0,60,60,0,1,0,1,0,deny
49521,80,17385,80,1653,831,822,13,93,7,6,allow
45630,443,4110,443,2996,1629,1367,17,21,9,8,allow
53799,6881,10719,6881,70,70,0,1,4,1,0,allow
52024,47600,3124,47600,70,70,0,1,4,1,0,allow
64891,53,61433,53,320,97,223,4,34,2,2,allow
57470,64738,24802,64738,1577,594,983,20,1582,10,10,allow
34297,443,14287,443,65853,31390,34463,203,694,105,98,allow
38675,443,37452,443,13929,2854,11075,43,128,22,21,allow
57587,443,15184,443,7150,1958,5192,28,144,14,14,allow
52179,443,47721,443,414,140,274,7,25,3,4,allow
42164,80,6790,80,1658,1344,314,10,15,5,5,allow
49440,443,59866,443,5141,896,4245,17,69,8,9,allow
51053,80,62409,80,1638,1324,314,10,14,5,5,allow
8291,23,8291,23,66,66,0,1,4,1,0,allow
53798,62166,25360,62166,164,70,94,2,4,1,1,allow
53807,28630,23692,28630,70,70,0,1,4,1,0,allow
53804,24067,28773,24067,70,70,0,1,4,1,0,allow
53805,34155,22730,34155,70,70,0,1,4,1,0,allow
63966,42532,2551,42532,70,70,0,1,4,1,0,allow
45768,80,41776,80,2784,1804,980,17,20,9,8,allow
49214,58485,20411,58485,70,70,0,1,5,1,0,allow
65245,53,10432,53,479,98,381,4,57,2,2,allow
39197,443,22296,443,65158,3519,61639,89,200,41,48,allow
50619,443,52531,443,10483,1021,9462,30,100,11,19,allow
64063,53,31532,53,339,110,229,2,29,1,1,allow
19328,53,26253,53,236,86,150,2,29,1,1,allow
49997,53,41448,53,284,94,190,2,29,1,1,allow
49581,80,58944,80,2339,1107,1232,11,21,6,5,allow
38957,443,58777,443,7457,1333,6124,18,200,10,8,allow
57082,80,34844,80,2944,1074,1870,12,75,7,5,allow
55012,443,47170,443,3388,2236,1152,28,904,16,12,allow
60787,40010,15005,40010,316,136,180,6,6,3,3,allow
65469,53,60792,53,327,110,217,2,30,1,1,allow
49216,63752,26927,63752,70,70,0,1,5,1,0,allow
52023,41791,57379,41791,70,70,0,1,5,1,0,allow
49443,80,19440,80,3642,1460,2182,23,143,12,11,allow
50710,443,41434,443,6141,1268,4873,22,18,12,10,allow
49558,80,45042,80,39679,7315,32364,45,24,17,28,allow
49212,38306,22542,38306,70,70,0,1,5,1,0,allow
36803,53,44440,53,243,86,157,2,30,1,1,allow
58046,443,58046,443,4682,1775,2907,19,29,11,8,allow
54677,443,15752,443,3704,1428,2276,14,135,7,7,allow
54819,443,51937,443,9035,1873,7162,28,124,14,14,allow
52609,443,37495,443,24091,7349,16742,75,162,36,39,allow
52036,52608,61881,52608,70,70,0,2,8,2,0,allow
50648,80,9788,80,1717,1247,470,9,15,5,4,allow
54548,7000,54548,7000,4487,2090,2397,15,15,8,7,allow
37573,443,7707,443,13637,6347,7290,34,46,20,14,allow
49319,53,53546,53,260,102,158,2,30,1,1,allow
48717,443,44246,443,232,172,60,3,5,2,1,allow
50169,53,35420,53,223,78,145,2,30,1,1,allow
49160,6889,25152,6889,834,150,684,4,1200,2,2,allow
53270,443,30676,443,6894,1556,5338,23,3601,13,10,allow
60993,443,45715,443,7201,2107,5094,23,61,13,10,allow
58887,443,25823,443,5167,700,4467,16,15,7,9,allow
45767,80,42626,80,2768,1722,1046,17,20,8,9,allow
55360,443,39812,443,6379,1762,4617,27,27,14,13,allow
49196,443,53527,443,789207,20847,768360,812,23,294,518,allow
58813,80,56191,80,2393,551,1842,10,21,6,4,allow
50181,443,54274,443,8113,2063,6050,23,255,11,12,allow
59758,443,17824,443,4114,2557,1557,22,418,9,13,allow
58888,443,9606,443,5166,700,4466,16,14,7,9,allow
52040,2524,8539,2524,70,70,0,2,7,2,0,allow
37672,5223,41244,5223,220,220,0,3,6,3,0,allow
53806,37267,20623,37267,70,70,0,1,4,1,0,allow
64214,53,1437,53,337,106,231,4,43,2,2,allow
46405,80,41634,80,1213,755,458,10,15,6,4,allow
37833,80,26930,80,2087,729,1358,10,15,5,5,allow
33642,443,1036,443,8533,4446,4087,65,160,32,33,allow
55310,53,40255,53,168,78,90,2,29,1,1,allow
65134,53,41256,53,273,102,171,2,30,1,1,allow
39442,123,6602,123,184,94,90,2,30,1,1,allow
20254,53,7951,53,223,78,145,2,29,1,1,allow
64463,53,2430,53,183,94,89,2,29,1,1,allow
27005,27015,6059,27015,881,126,755,2,30,1,1,allow
27988,40021,42591,40021,245,182,63,2,30,1,1,allow
49380,53,7490,53,110,110,0,1,30,1,0,allow
38886,53,39118,53,223,78,145,2,30,1,1,allow
64494,53,62617,53,402,118,284,2,30,1,1,allow
51487,443,12254,443,828,390,438,11,60,4,7,allow
49215,52611,6615,52611,70,70,0,1,5,1,0,allow
58885,443,57111,443,5167,700,4467,16,15,7,9,allow
41231,443,41940,443,65667,5371,60296,89,85,36,53,allow
48063,80,21248,80,1638,1324,314,10,15,5,5,allow
61100,80,15206,80,1516,481,1035,11,15,6,5,allow
60222,443,18964,443,4308,1658,2650,14,16,7,7,allow
27005,27015,5411,27015,887,126,761,2,30,1,1,allow
27005,27017,58319,27017,883,126,757,2,30,1,1,allow
55688,33958,47150,33958,70,70,0,2,8,2,0,allow
56662,80,65360,80,234,234,0,4,12,4,0,allow
49986,53,37815,53,312,93,219,4,37,2,2,allow
47282,443,1990,443,130,70,60,2,15,1,1,allow
61737,445,0,0,70,70,0,1,0,1,0,drop
49164,25174,0,0,62,62,0,1,0,1,0,deny
50172,445,0,0,70,70,0,1,0,1,0,drop
50170,445,0,0,70,70,0,1,0,1,0,drop
26425,22114,0,0,62,62,0,1,0,1,0,deny
16270,56205,0,0,62,62,0,1,0,1,0,deny
49916,53,53241,53,118,118,0,1,30,1,0,allow
46694,443,30947,443,3680,1777,1903,18,34,8,10,allow
64711,53,30437,53,179,86,93,2,30,1,1,allow
64906,53,18657,53,209,110,99,2,30,1,1,allow
64921,53,46383,53,238,102,136,2,31,1,1,allow
49211,15576,30482,15576,70,70,0,1,5,1,0,allow
40561,443,22594,443,3167,2456,711,15,16,10,5,allow
65149,443,54688,443,2963,1304,1659,28,120,14,14,allow
53796,48019,63153,48019,70,70,0,1,5,1,0,allow
58933,80,48784,80,2055,1651,404,8,76,5,3,allow
35595,80,11916,80,1566,684,882,10,15,5,5,allow
37802,80,16566,80,1702,1388,314,10,16,5,5,allow
39297,443,18589,443,21690,2882,18808,59,197,30,29,allow
51245,443,54725,443,9847,4746,5101,43,16,24,19,allow
55056,443,52975,443,8309,1561,6748,26,204,14,12,allow
38076,80,55546,80,15538,1307,14231,27,45,15,12,allow
38956,443,38557,443,9096,4245,4851,29,121,14,15,allow
27005,30000,27515,30000,913,126,787,2,31,1,1,allow
44182,443,55726,443,8241,1810,6431,25,20,14,11,allow
58879,443,4460,443,5168,700,4468,16,15,7,9,allow
49546,443,43053,443,1346,918,428,10,23,6,4,allow
49547,443,35951,443,1346,918,428,10,23,6,4,allow
54374,443,53616,443,7402,1350,6052,24,16,13,11,allow
41228,443,9093,443,9161,2210,6951,23,187,11,12,allow
10552,25174,0,0,62,62,0,1,0,1,0,deny
60163,26467,0,0,66,66,0,1,0,1,0,deny
40742,2967,0,0,62,62,0,1,0,1,0,deny
63577,30188,0,0,66,66,0,1,0,1,0,deny
55653,23,0,0,60,60,0,1,0,1,0,deny
61933,445,0,0,66,66,0,1,0,1,0,drop
61931,445,0,0,66,66,0,1,0,1,0,drop
49324,64147,0,0,66,66,0,1,0,1,0,deny
61733,445,0,0,70,70,0,1,0,1,0,drop
61731,445,0,0,70,70,0,1,0,1,0,drop
63895,44847,0,0,62,62,0,1,0,1,0,deny
15605,50265,0,0,62,62,0,1,0,1,0,deny
52230,50265,0,0,66,66,0,1,0,1,0,deny
61729,445,0,0,70,70,0,1,0,1,0,drop
50159,445,0,0,70,70,0,1,0,1,0,drop
50160,445,0,0,70,70,0,1,0,1,0,drop
50154,445,0,0,70,70,0,1,0,1,0,drop
50152,445,0,0,70,70,0,1,0,1,0,drop
13508,15503,0,0,66,66,0,1,0,1,0,deny
61927,445,0,0,66,66,0,1,0,1,0,drop
61918,445,0,0,66,66,0,1,0,1,0,drop
61911,445,0,0,66,66,0,1,0,1,0,drop
61917,445,0,0,66,66,0,1,0,1,0,drop
61916,445,0,0,66,66,0,1,0,1,0,drop
61912,445,0,0,66,66,0,1,0,1,0,drop
61910,445,0,0,66,66,0,1,0,1,0,drop
62991,51221,0,0,66,66,0,1,0,1,0,deny
22461,34021,0,0,62,62,0,1,0,1,0,reset-both
61722,445,0,0,70,70,0,1,0,1,0,drop
50145,445,0,0,70,70,0,1,0,1,0,drop
40840,21247,0,0,62,62,0,1,0,1,0,deny
22530,23718,0,0,66,66,0,1,0,1,0,deny
42951,22114,0,0,66,66,0,1,0,1,0,deny
33380,48817,0,0,146,146,0,1,0,1,0,deny
50142,445,0,0,70,70,0,1,0,1,0,drop
50140,445,0,0,70,70,0,1,0,1,0,drop
53883,443,37691,443,495,421,74,4,0,3,1,allow
53879,443,22578,443,499,425,74,4,1,3,1,allow
53874,443,50535,443,499,425,74,4,1,3,1,allow
53877,443,42282,443,499,425,74,4,1,3,1,allow
53875,443,27415,443,499,425,74,4,1,3,1,allow
53872,443,24185,443,499,425,74,4,1,3,1,allow
50138,445,0,0,70,70,0,1,0,1,0,drop
61720,445,0,0,70,70,0,1,0,1,0,drop
49001,40108,0,0,161,161,0,1,0,1,0,deny
61719,445,0,0,70,70,0,1,0,1,0,drop
64306,64147,0,0,66,66,0,1,0,1,0,deny
13518,25174,0,0,62,62,0,1,0,1,0,deny
61718,445,0,0,70,70,0,1,0,1,0,drop
21817,22114,0,0,62,62,0,1,0,1,0,deny
54206,25174,0,0,62,62,0,1,0,1,0,deny
61717,445,0,0,70,70,0,1,0,1,0,drop
64673,6881,0,0,66,66,0,1,0,1,0,deny
61714,445,0,0,70,70,0,1,0,1,0,drop
61711,445,0,0,70,70,0,1,0,1,0,drop
49001,40108,0,0,161,161,0,1,0,1,0,deny
12164,22114,0,0,62,62,0,1,0,1,0,deny
17262,25174,0,0,146,146,0,1,0,1,0,deny
25961,55783,0,0,60,60,0,1,0,1,0,deny
62654,35440,0,0,62,62,0,1,0,1,0,deny
28306,25604,0,0,62,62,0,1,0,1,0,deny
50137,445,0,0,70,70,0,1,0,1,0,drop
50133,445,0,0,70,70,0,1,0,1,0,drop
50132,445,0,0,70,70,0,1,0,1,0,drop
50316,25604,0,0,66,66,0,1,0,1,0,deny
61903,445,0,0,66,66,0,1,0,1,0,drop
61699,445,0,0,70,70,0,1,0,1,0,drop
61698,445,0,0,70,70,0,1,0,1,0,drop
21322,25174,0,0,146,146,0,1,0,1,0,deny
50129,445,0,0,70,70,0,1,0,1,0,drop
61692,445,0,0,70,70,0,1,0,1,0,drop
8239,37965,0,0,146,146,0,1,0,1,0,deny
61902,445,0,0,66,66,0,1,0,1,0,drop
61689,445,0,0,70,70,0,1,0,1,0,drop
61688,445,0,0,70,70,0,1,0,1,0,drop
49001,40108,0,0,161,161,0,1,0,1,0,deny
61899,445,0,0,66,66,0,1,0,1,0,drop
61898,445,0,0,66,66,0,1,0,1,0,drop
2946,25174,0,0,146,146,0,1,0,1,0,deny
63083,25174,0,0,66,66,0,1,0,1,0,deny
61897,445,0,0,66,66,0,1,0,1,0,drop
59366,35440,0,0,62,62,0,1,0,1,0,deny
37431,25174,0,0,146,146,0,1,0,1,0,deny
51109,11392,0,0,66,66,0,1,0,1,0,deny
53873,443,46663,443,499,425,74,4,1,3,1,allow
53878,443,30400,443,499,425,74,4,1,3,1,allow
53876,443,64698,443,499,425,74,4,1,3,1,allow
53868,443,61364,443,499,425,74,4,1,3,1,allow
53871,443,16922,443,499,425,74,4,1,3,1,allow
53863,443,62778,443,499,425,74,4,1,3,1,allow
53869,443,21669,443,499,425,74,4,1,3,1,allow
53865,443,28083,443,499,425,74,4,1,3,1,allow
53862,443,35996,443,499,425,74,4,1,3,1,allow
53870,443,3316,443,499,425,74,4,1,3,1,allow
53864,443,39351,443,499,425,74,4,1,3,1,allow
53861,443,51732,443,499,425,74,4,1,3,1,allow
53867,443,58511,443,499,425,74,4,1,3,1,allow
53860,443,61776,443,499,425,74,4,1,3,1,allow
53858,443,59816,443,499,425,74,4,1,3,1,allow
53866,443,56444,443,499,425,74,4,1,3,1,allow
53857,443,11803,443,499,425,74,4,1,3,1,allow
53859,443,52772,443,499,425,74,4,1,3,1,allow
53906,17372,0,0,62,62,0,1,0,1,0,deny
50123,445,0,0,70,70,0,1,0,1,0,drop
24560,25174,0,0,62,62,0,1,0,1,0,deny
56816,11392,0,0,66,66,0,1,0,1,0,deny
61677,445,0,0,70,70,0,1,0,1,0,drop
51490,1,0,0,100,100,0,1,0,1,0,deny
59424,50265,0,0,74,74,0,1,0,1,0,deny
50118,445,0,0,70,70,0,1,0,1,0,drop
55529,44847,0,0,66,66,0,1,0,1,0,deny
50112,445,0,0,70,70,0,1,0,1,0,drop
2238,22114,0,0,146,146,0,1,0,1,0,deny
16092,50265,0,0,62,62,0,1,0,1,0,deny
58357,62413,0,0,62,62,0,1,0,1,0,deny
51094,35440,0,0,66,66,0,1,0,1,0,deny
61885,445,0,0,66,66,0,1,0,1,0,drop
54280,3385,0,0,60,60,0,1,0,1,0,deny
16376,35440,0,0,62,62,0,1,0,1,0,deny
6881,6881,0,0,62,62,0,1,0,1,0,deny
8108,55108,0,0,157,157,0,1,0,1,0,deny
1025,25174,0,0,62,62,0,1,0,1,0,deny
61673,445,0,0,70,70,0,1,0,1,0,drop
58488,37965,0,0,62,62,0,1,0,1,0,deny
61878,445,0,0,66,66,0,1,0,1,0,drop
50106,445,0,0,70,70,0,1,0,1,0,drop
5841,22114,0,0,62,62,0,1,0,1,0,deny
26698,57470,0,0,62,62,0,1,0,1,0,deny
61661,445,0,0,70,70,0,1,0,1,0,drop
61664,445,0,0,70,70,0,1,0,1,0,drop
61662,445,0,0,70,70,0,1,0,1,0,drop
61659,445,0,0,70,70,0,1,0,1,0,drop
54752,31573,0,0,62,62,0,1,0,1,0,deny
61657,445,0,0,70,70,0,1,0,1,0,drop
52644,57209,0,0,66,66,0,1,0,1,0,deny
61875,445,0,0,66,66,0,1,0,1,0,drop
63116,22114,0,0,62,62,0,1,0,1,0,deny
63023,51505,0,0,66,66,0,1,0,1,0,deny
52143,37807,0,0,66,66,0,1,0,1,0,deny
61869,445,0,0,66,66,0,1,0,1,0,drop
36548,25174,0,0,62,62,0,1,0,1,0,deny
57762,25174,0,0,62,62,0,1,0,1,0,deny
47910,7461,0,0,60,60,0,1,0,1,0,deny
61865,445,0,0,66,66,0,1,0,1,0,drop
62769,25174,0,0,62,62,0,1,0,1,0,deny
61650,445,0,0,70,70,0,1,0,1,0,drop
42252,33303,0,0,60,60,0,1,0,1,0,deny
53539,44847,0,0,66,66,0,1,0,1,0,deny
59745,25174,0,0,62,62,0,1,0,1,0,deny
13285,29892,0,0,145,145,0,1,0,1,0,deny
0,0,0,0,320,320,0,5,0,5,0,allow
0,0,0,0,70,70,0,1,0,1,0,deny
22150,6881,0,0,146,146,0,1,0,1,0,deny
12184,56205,0,0,146,146,0,1,0,1,0,deny
61643,445,0,0,70,70,0,1,0,1,0,drop
50093,445,0,0,70,70,0,1,0,1,0,drop
50090,445,0,0,70,70,0,1,0,1,0,drop
50089,445,0,0,70,70,0,1,0,1,0,drop
61642,445,0,0,70,70,0,1,0,1,0,drop
61848,445,0,0,66,66,0,1,0,1,0,drop
61852,445,0,0,66,66,0,1,0,1,0,drop
61851,445,0,0,66,66,0,1,0,1,0,drop
61850,445,0,0,66,66,0,1,0,1,0,drop
61853,445,0,0,66,66,0,1,0,1,0,drop
61849,445,0,0,66,66,0,1,0,1,0,drop
61846,445,0,0,66,66,0,1,0,1,0,drop
65018,7302,0,0,146,146,0,1,0,1,0,deny
40977,21247,0,0,62,62,0,1,0,1,0,deny
17251,10387,0,0,159,159,0,1,0,1,0,deny
52210,51505,0,0,66,66,0,1,0,1,0,deny
57459,51505,0,0,62,62,0,1,0,1,0,deny
60342,36237,0,0,66,66,0,1,0,1,0,deny
15499,22114,0,0,62,62,0,1,0,1,0,deny
49160,59033,0,0,146,146,0,1,0,1,0,deny
25187,31573,0,0,62,62,0,1,0,1,0,deny
61635,445,0,0,70,70,0,1,0,1,0,drop
46856,25174,0,0,62,62,0,1,0,1,0,deny
23475,25174,0,0,146,146,0,1,0,1,0,deny
50977,56205,0,0,66,66,0,1,0,1,0,deny
80,37649,0,0,60,60,0,1,0,1,0,deny
15451,25174,0,0,146,146,0,1,0,1,0,deny
50651,25174,0,0,62,62,0,1,0,1,0,deny
14023,37965,0,0,62,62,0,1,0,1,0,deny
50082,445,0,0,70,70,0,1,0,1,0,drop
50080,445,0,0,70,70,0,1,0,1,0,drop
50073,445,0,0,70,70,0,1,0,1,0,drop
50071,445,0,0,70,70,0,1,0,1,0,drop
35291,44847,0,0,62,62,0,1,0,1,0,deny
61631,445,0,0,70,70,0,1,0,1,0,drop
48706,23393,0,0,60,60,0,1,0,1,0,deny
19875,30170,0,0,145,145,0,1,0,1,0,deny
10462,25174,0,0,62,62,0,1,0,1,0,deny
61833,445,0,0,66,66,0,1,0,1,0,drop
61832,445,0,0,66,66,0,1,0,1,0,drop
61831,445,0,0,66,66,0,1,0,1,0,drop
2278,25174,0,0,62,62,0,1,0,1,0,deny
14740,26467,0,0,62,62,0,1,0,1,0,deny
52318,22114,0,0,62,62,0,1,0,1,0,deny
61630,445,0,0,70,70,0,1,0,1,0,drop
31017,50584,0,0,62,62,0,1,0,1,0,deny
31627,64147,0,0,62,62,0,1,0,1,0,deny
35570,22114,0,0,62,62,0,1,0,1,0,deny
62792,53,0,0,88,88,0,1,0,1,0,deny
50069,445,0,0,70,70,0,1,0,1,0,drop
50573,22114,0,0,62,62,0,1,0,1,0,deny
50068,445,0,0,70,70,0,1,0,1,0,drop
50064,445,0,0,70,70,0,1,0,1,0,drop
50059,445,0,0,70,70,0,1,0,1,0,drop
63578,35440,0,0,66,66,0,1,0,1,0,deny
59813,53,59813,53,228,97,131,2,30,1,1,allow
21184,53,21184,53,194,87,107,2,30,1,1,allow
37382,80,11429,80,1221,781,440,11,16,6,5,allow
52016,80,9292,80,124703,6134,118569,147,125,64,83,allow
56539,443,14998,443,52465,2787,49678,66,80,26,40,allow
60463,6890,23297,6890,164,70,94,3,8,2,1,allow
41173,443,28924,443,11771,2624,9147,50,19,25,25,allow
50593,443,49390,443,6292,1492,4800,22,16,11,11,allow
27005,27016,3846,27016,889,126,763,2,30,1,1,allow
34616,443,64459,443,9265,4429,4836,23,18,14,9,allow
40147,443,40147,443,1092,575,517,10,145,5,5,allow
11350,3389,11350,3389,3850,1745,2105,19,18,11,8,allow
64771,53,46292,53,793,101,692,2,30,1,1,allow
57367,443,57367,443,4381,1474,2907,19,29,11,8,allow
53795,22719,46314,22719,164,70,94,2,6,1,1,allow
49680,80,4197,80,1548,847,701,10,16,5,5,allow
32959,443,7767,443,9262,2792,6470,53,616,28,25,allow
55511,443,12800,443,10499,2421,8078,28,15,14,14,allow
56415,53,16835,53,740,93,647,2,30,1,1,allow
49532,443,49532,443,20488,16649,3839,30,24,18,12,allow
56525,443,51595,443,14108,2487,11621,32,81,18,14,allow
52017,26175,30441,26175,66,66,0,1,5,1,0,allow
49201,17852,10581,17852,66,66,0,1,5,1,0,allow
52034,48856,21980,48856,70,70,0,2,9,2,0,allow
49209,52030,14863,52030,66,66,0,1,5,1,0,allow
37244,53,37244,53,172,76,96,2,30,1,1,allow
4738,53,4738,53,213,87,126,2,30,1,1,allow
11786,53,11786,53,194,87,107,2,30,1,1,allow
60341,443,14614,443,54103,3190,50913,68,362,27,41,allow
61289,53,61289,53,197,76,121,2,30,1,1,allow
49681,80,35209,80,4584,3642,942,15,15,8,7,allow
57119,80,41470,80,5774,783,4991,17,75,10,7,allow
40620,443,2727,443,7049,1412,5637,24,16,14,10,allow
58818,443,11066,443,1413,876,537,12,25,6,6,allow
56538,443,45521,443,7760,1599,6161,23,80,13,10,allow
65484,443,65484,443,4640,1733,2907,19,27,11,8,allow
58817,443,7616,443,1413,876,537,12,25,6,6,allow
2954,443,2954,443,6915,882,6033,16,149,9,7,allow
58483,443,25541,443,3024,709,2315,13,120,6,7,allow
58877,443,18145,443,2577,1550,1027,15,15,7,8,allow
47368,443,14689,443,7057,2186,4871,25,316,13,12,allow
46716,443,30978,443,7298,2661,4637,21,17,11,10,allow
49208,6881,5366,6881,66,66,0,1,5,1,0,allow
49533,443,49533,443,20402,16563,3839,29,24,17,12,allow
49901,53,49901,53,194,87,107,2,30,1,1,allow
54989,443,11421,443,34038,16039,17999,79,63,43,36,allow
16814,53,16814,53,217,87,130,2,30,1,1,allow
60166,443,38227,443,8198,2252,5946,29,318,14,15,allow
31011,53,31011,53,197,76,121,2,30,1,1,allow
27005,27015,44783,27015,939,126,813,2,30,1,1,allow
6881,38554,27434,38554,221,111,110,2,1200,1,1,allow
59319,53,47365,53,285,106,179,2,31,1,1,allow
59247,53,59247,53,825,99,726,2,31,1,1,allow
60505,53,0,0,340,90,250,2,31,1,1,allow
50820,443,59076,443,6133,1655,4478,12,121,5,7,allow
52332,443,60314,443,15746,4302,11444,17,122,5,12,allow
60505,53,0,0,340,90,250,2,31,1,1,allow
55269,53,20584,53,186,95,91,2,31,1,1,allow
58279,53,58279,53,847,110,737,2,31,1,1,allow
11859,64147,0,0,62,62,0,1,0,1,0,deny
41499,23,0,0,60,60,0,1,0,1,0,deny
61625,445,0,0,70,70,0,1,0,1,0,drop
2598,23718,0,0,62,62,0,1,0,1,0,deny
63888,57470,0,0,62,62,0,1,0,1,0,deny
55484,25174,0,0,62,62,0,1,0,1,0,deny
1882,43890,0,0,62,62,0,1,0,1,0,deny
55689,37965,0,0,66,66,0,1,0,1,0,deny
10701,11392,0,0,146,146,0,1,0,1,0,deny
20706,37965,0,0,62,62,0,1,0,1,0,deny
10088,37807,0,0,66,66,0,1,0,1,0,deny
51298,57470,0,0,66,66,0,1,0,1,0,deny
51800,80,7944,80,2169,472,1697,10,77,6,4,allow
54355,443,13555,443,15334,4707,10627,28,24,14,14,allow
54538,80,35235,80,4162,3455,707,14,15,8,6,allow
38077,80,35599,80,1484,601,883,9,44,6,3,allow
60132,443,39833,443,350,210,140,6,25,4,2,allow
33459,80,37833,80,1658,1344,314,10,14,5,5,allow
53132,443,53588,443,7271,2540,4731,32,20,18,14,allow
64327,53,59589,53,214,102,112,2,29,1,1,allow
64782,53,60235,53,212,102,110,2,29,1,1,allow
27005,27016,28994,27016,880,126,754,2,30,1,1,allow
27005,31000,15120,31000,898,126,772,2,30,1,1,allow
64160,53,55275,53,258,110,148,2,30,1,1,allow
56941,443,33358,443,4581,2831,1750,29,96,15,14,allow
42661,80,47037,80,78310,9243,69067,109,93,57,52,allow
63997,59512,17767,59512,312,132,180,6,5,3,3,allow
58926,80,29286,80,1291,887,404,8,89,5,3,allow
42663,80,49274,80,5562,1204,4358,11,91,7,4,allow
42665,80,22230,80,7651,2046,5605,16,91,10,6,allow
52019,40689,33926,40689,70,70,0,1,5,1,0,allow
64451,53,26294,53,363,92,271,4,31,2,2,allow
5385,22,5385,22,66,66,0,1,4,1,0,allow
9204,443,60040,443,5399,368,5031,18,31,5,13,allow
27005,27020,19187,27020,890,126,764,2,30,1,1,allow
27005,27016,54195,27016,876,126,750,2,30,1,1,allow
37635,443,24027,443,9406,2044,7362,27,21,16,11,allow
5588,5588,0,0,3354,1792,1562,46,192,23,23,allow
54808,443,25043,443,9657,1944,7713,31,82,15,16,allow
41593,53,64892,53,243,86,157,2,29,1,1,allow
35047,53,53594,53,70657,70002,655,845,88,839,6,allow
64581,443,64560,443,9221,2109,7112,28,32,15,13,allow
52020,28704,61808,28704,70,70,0,1,5,1,0,allow
52033,37905,61391,37905,70,70,0,2,8,2,0,allow
64394,53,6864,53,226,102,124,2,30,1,1,allow
52002,53,64717,53,289,86,203,2,30,1,1,allow
49206,12242,47287,12242,70,70,0,1,5,1,0,allow
53268,443,58840,443,4241,706,3535,14,25,8,6,allow
49202,31719,26471,31719,70,70,0,1,5,1,0,allow
49200,38001,12165,38001,70,70,0,1,5,1,0,allow
56059,80,49532,80,1151,711,440,10,15,5,5,allow
58875,443,10382,443,5168,700,4468,16,15,7,9,allow
60394,11136,28099,11136,7512,2276,5236,39,94,21,18,allow
60462,47821,34484,47821,70,70,0,2,8,2,0,allow
64515,53,64413,53,231,86,145,2,30,1,1,allow
33060,443,63569,443,25617,6531,19086,87,220,46,41,allow
49198,64509,55959,64509,70,70,0,1,5,1,0,allow
55269,53,18249,53,102,102,0,1,30,1,0,allow
54348,443,11963,443,8863,3511,5352,20,120,9,11,allow
57354,443,9548,443,28807,2716,26091,54,466,21,33,allow
56695,53,7335,53,183,94,89,2,30,1,1,allow
42454,443,47292,443,3513,795,2718,11,120,5,6,allow
60136,443,22877,443,3647,1221,2426,13,135,6,7,allow
65379,443,37475,443,76625,63648,12977,139,83,79,60,allow
60431,443,1098,443,3260,1646,1614,9,120,5,4,allow
65224,443,29038,443,18887,8273,10614,42,62,22,20,allow
48542,80,42394,80,811,671,140,6,32,4,2,allow
57903,80,16780,80,6457,1210,5247,14,17,8,6,allow
48550,80,64861,80,811,671,140,6,22,4,2,allow
37097,80,49884,80,1114,534,580,12,15,7,5,allow
39840,443,35916,443,6097,1540,4557,25,191,13,12,allow
51393,443,1567,443,4721,2724,1997,35,130,19,16,allow
42664,80,62788,80,63654,7979,55675,90,91,49,41,allow
50353,443,5439,443,130,70,60,3,4,2,1,allow
49548,443,37968,443,1346,918,428,10,22,6,4,allow
65127,443,61568,443,648,648,0,7,15,7,0,allow
49725,53,18742,53,211,102,109,2,29,1,1,allow
64359,53,13819,53,230,102,128,2,30,1,1,allow
51244,443,19950,443,8024,2572,5452,39,15,23,16,allow
50590,53,53774,53,889,404,485,10,30,5,5,allow
52065,443,43327,443,7851,2487,5364,35,383,16,19,allow
65281,53,27234,53,216,94,122,2,30,1,1,allow
49642,53,3732,53,302,110,192,2,30,1,1,allow
27005,27015,27369,27015,889,126,763,2,30,1,1,allow
57157,53,58237,53,458,188,270,6,30,3,3,allow
56695,53,47655,53,183,94,89,2,30,1,1,allow
64683,53,6623,53,168,78,90,2,30,1,1,allow
65129,53,16453,53,324,110,214,2,30,1,1,allow
55684,80,6722,80,70,70,0,2,8,2,0,allow
52018,2425,48269,2425,70,70,0,1,5,1,0,allow
45454,80,45454,80,42171,1901,40270,57,16,26,31,allow
62885,443,65198,443,8097,2684,5413,22,248,12,10,allow
38805,443,57310,443,6686,1197,5489,23,16,12,11,allow
37643,443,56932,443,10517,2926,7591,29,20,16,13,allow
49207,58751,38431,58751,70,70,0,1,5,1,0,allow
64152,53,18184,53,232,110,122,2,30,1,1,allow
56607,443,26886,443,133596,5859,127737,148,120,51,97,allow
55269,53,51344,53,193,102,91,2,30,1,1,allow
65080,53,46581,53,741,94,647,2,30,1,1,allow
33994,443,56656,443,19547,2951,16596,42,82,21,21,allow
52032,55505,56842,55505,70,70,0,2,8,2,0,allow
49210,33757,6282,33757,70,70,0,1,5,1,0,allow
8108,80,8108,80,7972,840,7132,16,50,6,10,allow
49416,80,5310,80,318,192,126,6,28,4,2,allow
35047,53,40543,53,214830,214584,246,2594,88,2591,3,allow
54033,443,12852,443,5260,2704,2556,13,121,7,6,allow
50821,443,29846,443,7619,3064,4555,14,121,6,8,allow
53545,443,54715,443,7330,2295,5035,19,135,9,10,allow
36983,80,48738,80,1143,401,742,9,360,5,4,allow
49366,443,29757,443,5777400,184445,5592955,6224,332,2268,3956,allow
40238,443,22315,443,7283,2384,4899,25,361,12,13,allow
10151,6881,1638,6881,460,150,310,2,1200,1,1,allow
27005,27015,1344,27015,880,126,754,3,31,2,1,allow
27005,27017,49884,27017,877,126,751,2,31,1,1,allow
27005,27015,55780,27015,873,126,747,3,31,2,1,allow
55245,443,43023,443,7725129,126824,7598305,6259,607,740,5519,allow
33555,443,31836,443,10856,3151,7705,34,361,16,18,allow
6881,6882,46322,6882,324,150,174,2,1200,1,1,allow
51221,51413,15223,51413,460,150,310,2,1200,1,1,allow
40326,443,22959,443,7937,3883,4054,65,4602,25,40,allow
5588,5588,0,0,3354,1792,1562,46,195,23,23,allow
60743,443,59766,443,7028,2639,4389,23,16,12,11,allow
27005,49000,16886,49000,887,126,761,2,31,1,1,allow
53824,41482,38792,41482,70,70,0,2,8,2,0,allow
53790,21011,8352,21011,70,70,0,1,5,1,0,allow
8243,443,8243,443,1024,539,485,10,58,5,5,allow
50619,80,32397,80,499,192,307,6,26,4,2,allow
49073,443,9351,443,7032,2643,4389,23,16,12,11,allow
57117,53,8258,53,209,102,107,2,31,1,1,allow
43788,80,23555,80,2597,699,1898,11,181,6,5,allow
53828,51354,7216,51354,70,70,0,2,8,2,0,allow
10012,40009,21244,40009,253,190,63,2,30,1,1,allow
56268,44847,0,0,66,66,0,1,0,1,0,deny
31991,23,0,0,60,60,0,1,0,1,0,deny
50051,445,0,0,70,70,0,1,0,1,0,drop
50050,445,0,0,70,70,0,1,0,1,0,drop
50049,445,0,0,70,70,0,1,0,1,0,drop
62424,37965,0,0,66,66,0,1,0,1,0,deny
49036,44847,0,0,146,146,0,1,0,1,0,deny
61612,445,0,0,70,70,0,1,0,1,0,drop
61550,5529,0,0,145,145,0,1,0,1,0,deny
61819,445,0,0,66,66,0,1,0,1,0,drop
50280,38558,0,0,62,62,0,1,0,1,0,deny
42898,25174,0,0,62,62,0,1,0,1,0,deny
50211,51050,0,0,66,66,0,1,0,1,0,deny
61609,445,0,0,70,70,0,1,0,1,0,drop
55008,21247,0,0,66,66,0,1,0,1,0,deny
51944,56205,0,0,66,66,0,1,0,1,0,deny
59592,37965,0,0,62,62,0,1,0,1,0,deny
58844,51505,0,0,66,66,0,1,0,1,0,deny
50044,445,0,0,70,70,0,1,0,1,0,drop
50036,445,0,0,70,70,0,1,0,1,0,drop
22530,25174,0,0,146,146,0,1,0,1,0,deny
3212,22114,0,0,62,62,0,1,0,1,0,deny
59451,50584,0,0,66,66,0,1,0,1,0,deny
26553,57470,0,0,62,62,0,1,0,1,0,deny
3341,23117,0,0,62,62,0,1,0,1,0,deny
61605,445,0,0,70,70,0,1,0,1,0,drop
61589,21247,0,0,62,62,0,1,0,1,0,deny
61603,445,0,0,70,70,0,1,0,1,0,drop
13021,25174,0,0,62,62,0,1,0,1,0,deny
26658,25174,0,0,146,146,0,1,0,1,0,deny
61806,445,0,0,66,66,0,1,0,1,0,drop
61803,445,0,0,66,66,0,1,0,1,0,drop
25565,13556,0,0,60,60,0,1,0,1,0,deny
39132,44847,0,0,66,66,0,1,0,1,0,deny
61601,445,0,0,70,70,0,1,0,1,0,drop
47461,50584,0,0,62,62,0,1,0,1,0,deny
55136,11392,0,0,66,66,0,1,0,1,0,deny
54721,22114,0,0,66,66,0,1,0,1,0,deny
50026,445,0,0,70,70,0,1,0,1,0,drop
50024,445,0,0,70,70,0,1,0,1,0,drop
50021,445,0,0,70,70,0,1,0,1,0,drop
50020,445,0,0,70,70,0,1,0,1,0,drop
56711,25174,0,0,146,146,0,1,0,1,0,deny
3875,25174,0,0,146,146,0,1,0,1,0,deny
10333,22114,0,0,62,62,0,1,0,1,0,deny
54614,37807,0,0,62,62,0,1,0,1,0,deny
11136,17500,0,0,62,62,0,1,0,1,0,deny
45941,23386,0,0,60,60,0,1,0,1,0,deny
61800,445,0,0,66,66,0,1,0,1,0,drop
15113,25174,0,0,62,62,0,1,0,1,0,deny
55713,25174,0,0,62,62,0,1,0,1,0,deny
8108,47807,0,0,157,157,0,1,0,1,0,deny
29988,44847,0,0,66,66,0,1,0,1,0,deny
61594,445,0,0,70,70,0,1,0,1,0,drop
61790,445,0,0,66,66,0,1,0,1,0,drop
61784,445,0,0,66,66,0,1,0,1,0,drop
61793,445,0,0,66,66,0,1,0,1,0,drop
61788,445,0,0,66,66,0,1,0,1,0,drop
61791,445,0,0,66,66,0,1,0,1,0,drop
61786,445,0,0,66,66,0,1,0,1,0,drop
61782,445,0,0,66,66,0,1,0,1,0,drop
63984,25174,0,0,62,62,0,1,0,1,0,deny
57131,8055,0,0,145,145,0,1,0,1,0,deny
14618,6881,0,0,62,62,0,1,0,1,0,deny
61592,445,0,0,70,70,0,1,0,1,0,drop
30179,23,0,0,60,60,0,1,0,1,0,deny
50017,445,0,0,70,70,0,1,0,1,0,drop
50197,64147,0,0,66,66,0,1,0,1,0,deny
54377,56205,0,0,66,66,0,1,0,1,0,deny
50013,445,0,0,70,70,0,1,0,1,0,drop
50010,445,0,0,70,70,0,1,0,1,0,drop
50009,445,0,0,70,70,0,1,0,1,0,drop
51564,50584,0,0,66,66,0,1,0,1,0,deny
40086,22114,0,0,62,62,0,1,0,1,0,deny
61591,445,0,0,70,70,0,1,0,1,0,drop
61590,445,0,0,70,70,0,1,0,1,0,drop
61589,445,0,0,70,70,0,1,0,1,0,drop
61583,445,0,0,70,70,0,1,0,1,0,drop
61586,445,0,0,70,70,0,1,0,1,0,drop
50478,51505,0,0,62,62,0,1,0,1,0,deny
65249,25864,0,0,72,72,0,1,0,1,0,deny
30800,25174,0,0,62,62,0,1,0,1,0,deny
18029,50584,0,0,66,66,0,1,0,1,0,deny
10688,25174,0,0,62,62,0,1,0,1,0,deny
52973,57470,0,0,74,74,0,1,0,1,0,deny
61571,445,0,0,70,70,0,1,0,1,0,drop
61570,445,0,0,70,70,0,1,0,1,0,drop
61566,445,0,0,70,70,0,1,0,1,0,drop
56874,67,0,0,60,60,0,1,0,1,0,deny
50007,445,0,0,70,70,0,1,0,1,0,drop
50006,445,0,0,70,70,0,1,0,1,0,drop
50004,445,0,0,70,70,0,1,0,1,0,drop
61561,445,0,0,70,70,0,1,0,1,0,drop
61560,445,0,0,70,70,0,1,0,1,0,drop
42252,33306,0,0,60,60,0,1,0,1,0,deny
51903,26467,0,0,62,62,0,1,0,1,0,deny
61777,445,0,0,66,66,0,1,0,1,0,drop
50000,445,0,0,70,70,0,1,0,1,0,drop
1027,64147,0,0,62,62,0,1,0,1,0,deny
57669,64147,0,0,66,66,0,1,0,1,0,deny
61773,445,0,0,66,66,0,1,0,1,0,drop
61772,445,0,0,66,66,0,1,0,1,0,drop
61770,445,0,0,66,66,0,1,0,1,0,drop
30575,11119,0,0,148,148,0,1,0,1,0,deny
54365,64147,0,0,62,62,0,1,0,1,0,deny
61768,445,0,0,66,66,0,1,0,1,0,drop
12465,11392,0,0,146,146,0,1,0,1,0,deny
38971,25174,0,0,146,146,0,1,0,1,0,deny
51414,22,0,0,60,60,0,1,0,1,0,deny
29697,51221,0,0,62,62,0,1,0,1,0,deny
61549,445,0,0,70,70,0,1,0,1,0,drop
59422,51221,0,0,62,62,0,1,0,1,0,deny
49993,445,0,0,70,70,0,1,0,1,0,drop
27343,55839,0,0,137,137,0,1,0,1,0,deny
60155,23718,0,0,66,66,0,1,0,1,0,deny
49988,445,0,0,70,70,0,1,0,1,0,drop
49987,445,0,0,70,70,0,1,0,1,0,drop
40095,23,0,0,60,60,0,1,0,1,0,deny
63460,55160,0,0,66,66,0,1,0,1,0,deny
7099,51505,0,0,62,62,0,1,0,1,0,deny
29016,25174,0,0,62,62,0,1,0,1,0,deny
56943,44847,0,0,62,62,0,1,0,1,0,deny
80,53945,0,0,60,60,0,1,0,1,0,deny
61757,445,0,0,66,66,0,1,0,1,0,drop
443,9986,0,0,669,669,0,1,0,1,0,deny
61545,445,0,0,70,70,0,1,0,1,0,drop
44147,64147,0,0,62,62,0,1,0,1,0,deny
67,68,0,0,346,346,0,1,0,1,0,deny
57797,64147,0,0,66,66,0,1,0,1,0,deny
57917,44847,0,0,62,62,0,1,0,1,0,deny
57073,57470,0,0,62,62,0,1,0,1,0,deny
63400,57470,0,0,66,66,0,1,0,1,0,deny
56131,37807,0,0,66,66,0,1,0,1,0,deny
443,62732,0,0,332,332,0,1,0,1,0,deny
61534,445,0,0,70,70,0,1,0,1,0,drop
61533,445,0,0,70,70,0,1,0,1,0,drop
61536,445,0,0,70,70,0,1,0,1,0,drop
49540,50584,0,0,66,66,0,1,0,1,0,deny
61750,445,0,0,66,66,0,1,0,1,0,drop
61530,445,0,0,70,70,0,1,0,1,0,drop
49974,445,0,0,70,70,0,1,0,1,0,drop
61528,445,0,0,70,70,0,1,0,1,0,drop
52471,22114,0,0,66,66,0,1,0,1,0,deny
60818,37965,0,0,62,62,0,1,0,1,0,deny
0,0,0,0,156,156,0,2,0,2,0,deny
0,0,0,0,156,156,0,2,0,2,0,deny
0,0,0,0,156,156,0,2,0,2,0,deny
0,0,0,0,156,156,0,2,0,2,0,deny
61747,445,0,0,66,66,0,1,0,1,0,drop
6703,21247,0,0,62,62,0,1,0,1,0,deny
19882,22114,0,0,62,62,0,1,0,1,0,deny
39996,23,0,0,60,60,0,1,0,1,0,deny
11688,23718,0,0,62,62,0,1,0,1,0,deny
62799,25174,0,0,146,146,0,1,0,1,0,deny
57982,25174,0,0,62,62,0,1,0,1,0,deny
63840,36829,0,0,66,66,0,1,0,1,0,deny
51155,56205,0,0,66,66,0,1,0,1,0,deny
50052,65008,0,0,60,60,0,1,0,1,0,deny
61739,445,0,0,66,66,0,1,0,1,0,drop
61522,445,0,0,70,70,0,1,0,1,0,drop
61735,445,0,0,66,66,0,1,0,1,0,drop
63084,64147,0,0,62,62,0,1,0,1,0,deny
62341,26467,0,0,62,62,0,1,0,1,0,deny
56770,26467,0,0,66,66,0,1,0,1,0,deny
61515,445,0,0,70,70,0,1,0,1,0,drop
55920,25174,0,0,62,62,0,1,0,1,0,deny
61512,445,0,0,70,70,0,1,0,1,0,drop
41848,23,0,0,60,60,0,1,0,1,0,deny
62014,35440,0,0,66,66,0,1,0,1,0,deny
55920,25174,0,0,146,146,0,1,0,1,0,deny
49964,445,0,0,70,70,0,1,0,1,0,drop
49961,445,0,0,70,70,0,1,0,1,0,drop
49960,445,0,0,70,70,0,1,0,1,0,drop
64124,25174,0,0,62,62,0,1,0,1,0,deny
17205,41864,0,0,143,143,0,1,0,1,0,deny
55562,50584,0,0,66,66,0,1,0,1,0,deny
61725,445,0,0,66,66,0,1,0,1,0,drop
61723,445,0,0,66,66,0,1,0,1,0,drop
61721,445,0,0,66,66,0,1,0,1,0,drop
61719,445,0,0,66,66,0,1,0,1,0,drop
61720,445,0,0,66,66,0,1,0,1,0,drop
61718,445,0,0,66,66,0,1,0,1,0,drop
61717,445,0,0,66,66,0,1,0,1,0,drop
49994,26467,0,0,66,66,0,1,0,1,0,deny
52321,26467,0,0,62,62,0,1,0,1,0,deny
61508,445,0,0,70,70,0,1,0,1,0,drop
62408,50584,0,0,66,66,0,1,0,1,0,deny
58250,35440,0,0,66,66,0,1,0,1,0,deny
61507,445,0,0,70,70,0,1,0,1,0,drop
443,60040,0,0,60,60,0,1,0,1,0,deny
7720,44847,0,0,66,66,0,1,0,1,0,deny
46367,36237,0,0,66,66,0,1,0,1,0,deny
26531,25174,0,0,146,146,0,1,0,1,0,deny
62792,53,0,0,88,88,0,1,0,1,0,deny
56161,62413,0,0,66,66,0,1,0,1,0,deny
2681,48817,0,0,146,146,0,1,0,1,0,deny
47040,25174,0,0,146,146,0,1,0,1,0,deny
62792,53,0,0,88,88,0,1,0,1,0,deny
64790,443,36803,443,53280,3270,50010,78,142,31,47,allow
55406,53,15179,53,768,99,669,2,30,1,1,allow
51959,443,18601,443,20648,4726,15922,40,48,19,21,allow
53789,47191,38332,47191,70,70,0,1,5,1,0,allow
56931,443,32343,443,34750,2997,31753,61,95,29,32,allow
64636,3389,64636,3389,3424,1710,1714,16,32,8,8,allow
52030,443,52030,443,4400,1493,2907,19,30,11,8,allow
40219,443,6179,443,2387,979,1408,15,36,6,9,allow
63962,10115,25745,10115,66,66,0,1,5,1,0,allow
58865,443,15727,443,10775,7126,3649,31,17,17,14,allow
1831,53,1831,53,194,87,107,2,30,1,1,allow
46216,443,47226,443,13769,11153,2616,30,361,16,14,allow
40472,443,17256,443,317215,285998,31217,436,982,244,192,allow
52016,58318,42027,58318,66,66,0,1,5,1,0,allow
52031,20301,11089,20301,70,70,0,2,8,2,0,allow
58281,53,0,0,82,82,0,2,40,2,0,allow
35437,443,7147,443,53756,46525,7231,82,275,51,31,allow
58869,443,7982,443,4052,2588,1464,18,16,9,9,allow
50607,443,39884,443,25263,2606,22657,41,90,19,22,allow
52830,443,59305,443,12577,3687,8890,63,415,30,33,allow
50981,443,20620,443,5553,1179,4374,24,80,13,11,allow
53155,28206,42266,28206,70,70,0,2,8,2,0,allow
53794,39607,26801,39607,70,70,0,1,5,1,0,allow
2547,53,2547,53,194,87,107,2,30,1,1,allow
27005,27013,23327,27013,869,126,743,2,30,1,1,allow
51961,443,54912,443,2600,1396,1204,18,48,10,8,allow
26978,443,38800,443,7547,2728,4819,26,20,13,13,allow
50982,443,1681,443,5552,1179,4373,24,80,13,11,allow
62854,443,62854,443,4579,1672,2907,19,29,11,8,allow
54063,80,60737,80,2545,515,2030,12,17,6,6,allow
53793,20468,19761,20468,70,70,0,1,5,1,0,allow
53156,57780,14557,57780,320,140,180,6,7,3,3,allow
56968,53,34326,53,762,97,665,2,30,1,1,allow
50116,22,50116,22,60,60,0,1,5,1,0,allow
50560,53,62139,53,755,94,661,2,30,1,1,allow
50859,53,0,0,286,79,207,2,30,1,1,allow
52189,53,52189,53,825,99,726,2,30,1,1,allow
50235,53,32276,53,768,99,669,2,30,1,1,allow
54630,53,54630,53,825,99,726,2,30,1,1,allow
19473,41049,5316,41049,149,149,0,1,1200,1,0,allow
50269,443,37644,443,8272,2455,5817,29,391,10,19,allow
53788,1,42504,1,70,70,0,1,5,1,0,allow
58845,443,51619,443,22402,14820,7582,52,20,29,23,allow
33809,80,12746,80,1052,612,440,10,15,5,5,allow
64547,53,37211,53,762,97,665,2,30,1,1,allow
10307,53,10307,53,213,87,126,2,30,1,1,allow
53791,16881,2744,16881,70,70,0,1,5,1,0,allow
24270,53,24270,53,825,99,726,2,30,1,1,allow
52013,35185,29346,35185,66,66,0,1,5,1,0,allow
58344,53,58344,53,847,110,737,2,30,1,1,allow
27005,27015,60571,27015,902,126,776,2,30,1,1,allow
56571,53,30480,53,749,94,655,2,31,1,1,allow
62121,443,9258,443,1864,250,1614,8,120,4,4,allow
27005,27017,40940,27017,600,126,474,2,31,1,1,allow
56941,443,11257,443,8304,2968,5336,24,362,13,11,allow
61503,445,0,0,70,70,0,1,0,1,0,drop
33215,37965,0,0,62,62,0,1,0,1,0,deny
32976,37965,0,0,66,66,0,1,0,1,0,deny
51655,26467,0,0,62,62,0,1,0,1,0,deny
49958,445,0,0,70,70,0,1,0,1,0,drop
49946,445,0,0,70,70,0,1,0,1,0,drop
49942,445,0,0,70,70,0,1,0,1,0,drop
36456,25174,0,0,62,62,0,1,0,1,0,deny
12632,25174,0,0,62,62,0,1,0,1,0,deny
51999,37965,0,0,62,62,0,1,0,1,0,deny
61501,445,0,0,70,70,0,1,0,1,0,drop
51756,64147,0,0,62,62,0,1,0,1,0,deny
45964,3111,0,0,60,60,0,1,0,1,0,deny
57479,56205,0,0,66,66,0,1,0,1,0,deny
2990,64147,0,0,62,62,0,1,0,1,0,deny
61702,445,0,0,66,66,0,1,0,1,0,drop
61704,445,0,0,66,66,0,1,0,1,0,drop
61703,445,0,0,66,66,0,1,0,1,0,drop
60806,51050,0,0,66,66,0,1,0,1,0,deny
6666,16010,0,0,60,60,0,1,0,1,0,deny
59663,37965,0,0,62,62,0,1,0,1,0,deny
59147,25174,0,0,146,146,0,1,0,1,0,deny
34932,38608,0,0,62,62,0,1,0,1,0,deny
33193,50584,0,0,146,146,0,1,0,1,0,deny
49676,53,32954,53,197,102,95,2,30,1,1,allow
49656,53,53745,53,309,118,191,2,30,1,1,allow
27005,27016,18981,27016,884,126,758,2,30,1,1,allow
48840,443,52863,443,3297,2327,970,22,51,11,11,allow
55839,56535,0,0,62,62,0,1,0,1,0,deny
49941,445,0,0,70,70,0,1,0,1,0,drop
61497,445,0,0,70,70,0,1,0,1,0,drop
49938,445,0,0,70,70,0,1,0,1,0,drop
49934,445,0,0,70,70,0,1,0,1,0,drop
49933,445,0,0,70,70,0,1,0,1,0,drop
7977,25174,0,0,62,62,0,1,0,1,0,deny
25510,48817,0,0,140,140,0,1,0,1,0,deny
46491,50584,0,0,66,66,0,1,0,1,0,deny
38592,57209,0,0,62,62,0,1,0,1,0,deny
12550,37807,0,0,62,62,0,1,0,1,0,deny
49923,445,0,0,70,70,0,1,0,1,0,drop
64463,53,5557,53,182,93,89,2,0,1,1,allow
60951,443,8364,443,11464,5499,5965,54,15,29,25,allow
55685,48407,34505,48407,320,140,180,6,6,3,3,allow
50939,443,29204,443,134,60,74,3,5,2,1,allow
49531,443,49531,443,95223,30803,64420,107,23,50,57,allow
49676,53,40519,53,197,102,95,2,30,1,1,allow
50585,80,50585,80,9588,4478,5110,28,21,16,12,allow
53785,33324,8660,33324,70,70,0,1,4,1,0,allow
62724,53,2730,53,195,78,117,2,29,1,1,allow
57033,443,35994,443,1092898,42451,1050447,1213,155,423,790,allow
63985,43081,42263,43081,66,66,0,2,7,2,0,allow
53826,10168,29575,10168,70,70,0,2,7,2,0,allow
53784,16671,31656,16671,70,70,0,1,4,1,0,allow
51607,53,46424,53,322,102,220,2,29,1,1,allow
64005,53,33305,53,226,102,124,2,30,1,1,allow
46072,443,46479,443,16656,3094,13562,29,271,14,15,allow
64907,53,3413,53,168,86,82,2,30,1,1,allow
65244,53,58540,53,378,99,279,4,45,2,2,allow
60451,17432,27417,17432,504,318,186,8,17,5,3,allow
51226,7275,28428,7275,416,210,206,7,16,4,3,allow
62884,5223,41292,5223,11427,6608,4819,37,248,21,16,allow
50544,53,44871,53,969,86,883,2,30,1,1,allow
55680,23711,32600,23711,70,70,0,1,5,1,0,allow
52014,20524,7082,20524,70,70,0,1,5,1,0,allow
51844,443,37014,443,6752,1387,5365,21,115,10,11,allow
55269,53,35707,53,193,102,91,2,31,1,1,allow
55956,443,61641,443,6058,1749,4309,22,200,13,9,allow
16689,53,15770,53,199,94,105,2,30,1,1,allow
64572,53,23687,53,561,104,457,4,57,2,2,allow
53782,42855,3816,42855,70,70,0,1,5,1,0,allow
44173,53,9700,53,168,78,90,2,30,1,1,allow
55681,31948,14765,31948,70,70,0,1,5,1,0,allow
49351,53,18900,53,212,102,110,2,30,1,1,allow
56864,15646,57596,15646,70,70,0,1,5,1,0,allow
55853,53,55965,53,197,102,95,2,30,1,1,allow
58873,443,46096,443,5166,700,4466,16,15,7,9,allow
51174,443,12417,443,786014,23908,762106,803,47,276,527,allow
55509,53,37936,53,215,102,113,2,30,1,1,allow
27005,27015,9880,27015,937,126,811,2,30,1,1,allow
49194,443,50497,443,159850,5338,154512,179,200,64,115,allow
50632,443,61474,443,10084,2145,7939,36,120,18,18,allow
56432,53,38041,53,195,102,93,2,30,1,1,allow
60199,443,60774,443,8958,1697,7261,18,15,9,9,allow
65121,53,39585,53,440,94,346,4,37,2,2,allow
38696,443,18796,443,1069542,21337,1048205,1028,16,310,718,allow
51212,443,57861,443,18745,11713,7032,67,77,37,30,allow
53605,443,11722,443,8738,2628,6110,23,154,11,12,allow
48098,80,19717,80,1638,1324,314,10,15,5,5,allow
37176,80,24453,80,941,526,415,11,315,6,5,allow
59377,53,59377,53,216,98,118,2,30,1,1,allow
55570,53,55501,53,341,134,207,2,30,1,1,allow
27005,27016,17329,27016,883,126,757,2,30,1,1,allow
37058,80,51116,80,1056,682,374,10,15,6,4,allow
9223,443,33719,443,4081,443,3638,12,15,6,6,allow
34768,443,44621,443,21905,3249,18656,38,271,18,20,allow
52093,443,48994,443,3687037,41923,3645114,3002,34,534,2468,allow
55690,54233,5574,54233,320,140,180,6,6,3,3,allow
63140,30685,55473,30685,70,70,0,2,8,2,0,allow
51099,443,34189,443,11482,3696,7786,28,62,15,13,allow
53827,5889,21032,5889,70,70,0,2,7,2,0,allow
53792,1,64543,1,70,70,0,1,4,1,0,allow
34341,28678,47024,28678,1806,1806,0,22,224,22,0,allow
42522,80,42522,80,29727,1571,28156,44,16,21,23,allow
49369,443,63066,443,6277395,184853,6092542,6543,317,2262,4281,allow
48068,443,12098,443,10418,1427,8991,27,16,12,15,allow
63996,443,19057,443,122293139,3727246,118565893,125460,331,39649,85811,allow
63957,80,57502,80,314,192,122,6,15,4,2,allow
49424,443,6642,443,77408,4295,73113,106,271,52,54,allow
57405,443,36790,443,5734,1543,4191,24,26,13,11,allow
49203,53,34232,53,195,102,93,2,30,1,1,allow
33990,443,59264,443,11404,1948,9456,30,81,15,15,allow
37075,80,46978,80,1678,1364,314,10,15,5,5,allow
43356,443,48473,443,79561,11513,68048,183,94,95,88,allow
53825,58968,28988,58968,70,70,0,2,7,2,0,allow
49421,53,13940,53,215,94,121,2,29,1,1,allow
16768,53,24708,53,199,94,105,2,30,1,1,allow
65379,53,2143,53,126,126,0,1,29,1,0,allow
64905,53,22894,53,458,188,270,6,29,3,3,allow
55323,443,19578,443,229587,8510,221077,245,121,82,163,allow
49393,443,42342,443,62,62,0,1,5,1,0,allow
52015,25487,39642,25487,70,70,0,1,5,1,0,allow
49203,53,1575,53,195,102,93,2,30,1,1,allow
64711,53,31035,53,273,118,155,2,30,1,1,allow
56661,80,6258,80,234,234,0,4,12,4,0,allow
65524,53,9019,53,386,122,264,4,52,2,2,allow
64683,53,44457,53,370,126,244,2,30,1,1,allow
10011,40005,27073,40005,148,86,62,2,30,1,1,allow
27005,27015,13852,27015,881,126,755,2,30,1,1,allow
56199,53,59192,53,227,110,117,2,30,1,1,allow
55679,1024,62004,1024,70,70,0,1,5,1,0,allow
49247,53,64384,53,776,283,493,8,82,4,4,allow
33062,53,30187,53,86,86,0,1,30,1,0,allow
44815,443,9189,443,7570,1955,5615,24,1179,12,12,allow
38420,80,16840,80,4535,1637,2898,23,2899,14,9,allow
50542,443,2915,443,6787,1846,4941,24,361,11,13,allow
6881,6881,44839,6881,238,118,120,2,1200,1,1,allow
27005,27017,47675,27017,878,126,752,2,31,1,1,allow
49380,443,11402,443,2382775,72482,2310293,2485,252,843,1642,allow
49340,443,62697,443,7492336,235716,7256620,8119,428,3022,5097,allow
51195,443,30169,443,291595,261981,29614,587,206,339,248,allow
34788,443,32056,443,8230,2275,5955,18,135,8,10,allow
44704,443,31142,443,7228,3478,3750,37,164,17,20,allow
33149,5228,22043,5228,15651,3559,12092,63,6557,28,35,allow
51547,443,55970,443,642,582,60,2,5,1,1,allow
60194,443,58489,443,8894,1633,7261,18,16,9,9,allow
58872,443,35466,443,5166,700,4466,16,15,7,9,allow
50641,80,49164,80,1658,1247,411,8,15,5,3,allow
51098,443,32791,443,7250,2813,4437,21,62,12,9,allow
56432,53,16819,53,195,102,93,2,30,1,1,allow
10003,40811,32278,40811,292,158,134,2,30,1,1,allow
21133,24035,37028,24035,481,150,331,2,1200,1,1,allow
38662,443,42991,443,6525,1695,4830,19,51,8,11,allow
57038,53,18190,53,240,86,154,2,30,1,1,allow
34150,443,7922,443,12564,9272,3292,66,107,31,35,allow
46434,443,35412,443,14879,4981,9898,43,121,21,22,allow
49922,445,0,0,70,70,0,1,0,1,0,drop
49919,445,0,0,70,70,0,1,0,1,0,drop
61482,445,0,0,70,70,0,1,0,1,0,drop
19455,25174,0,0,62,62,0,1,0,1,0,deny
61690,445,0,0,66,66,0,1,0,1,0,drop
37249,25174,0,0,146,146,0,1,0,1,0,deny
61479,445,0,0,70,70,0,1,0,1,0,drop
54876,25174,0,0,62,62,0,1,0,1,0,deny
12545,25174,0,0,146,146,0,1,0,1,0,deny
64155,60043,0,0,66,66,0,1,0,1,0,deny
42615,25174,0,0,146,146,0,1,0,1,0,deny
49913,445,0,0,70,70,0,1,0,1,0,drop
49907,445,0,0,70,70,0,1,0,1,0,drop
61474,445,0,0,70,70,0,1,0,1,0,drop
51705,22114,0,0,66,66,0,1,0,1,0,deny
60941,25174,0,0,62,62,0,1,0,1,0,deny
61473,445,0,0,70,70,0,1,0,1,0,drop
45981,51505,0,0,62,62,0,1,0,1,0,deny
33710,22114,0,0,146,146,0,1,0,1,0,deny
53469,36237,0,0,62,62,0,1,0,1,0,deny
6881,35894,0,0,62,62,0,1,0,1,0,deny
61471,445,0,0,70,70,0,1,0,1,0,drop
36903,56205,0,0,62,62,0,1,0,1,0,deny
61677,445,0,0,66,66,0,1,0,1,0,drop
61676,445,0,0,66,66,0,1,0,1,0,drop
57894,44847,0,0,62,62,0,1,0,1,0,deny
27507,25174,0,0,146,146,0,1,0,1,0,deny
2946,25174,0,0,62,62,0,1,0,1,0,deny
15249,22114,0,0,62,62,0,1,0,1,0,deny
47771,25174,0,0,62,62,0,1,0,1,0,deny
3928,64147,0,0,62,62,0,1,0,1,0,deny
49905,445,0,0,70,70,0,1,0,1,0,drop
49904,445,0,0,70,70,0,1,0,1,0,drop
49903,445,0,0,70,70,0,1,0,1,0,drop
49895,445,0,0,70,70,0,1,0,1,0,drop
3937,36829,0,0,62,62,0,1,0,1,0,deny
14489,25174,0,0,62,62,0,1,0,1,0,deny
15345,36829,0,0,66,66,0,1,0,1,0,deny
3584,25174,0,0,62,62,0,1,0,1,0,deny
61671,445,0,0,66,66,0,1,0,1,0,drop
3584,25174,0,0,146,146,0,1,0,1,0,deny
61464,445,0,0,70,70,0,1,0,1,0,drop
49629,26467,0,0,62,62,0,1,0,1,0,deny
47910,7454,0,0,60,60,0,1,0,1,0,deny
47910,7454,0,0,60,60,0,1,0,1,0,deny
1030,64147,0,0,62,62,0,1,0,1,0,deny
61462,445,0,0,70,70,0,1,0,1,0,drop
54601,26467,0,0,66,66,0,1,0,1,0,deny
50383,443,21192,443,452,386,66,4,1,3,1,allow
58914,37965,0,0,66,66,0,1,0,1,0,deny
64649,81,0,0,60,60,0,1,0,1,0,deny
61666,445,0,0,66,66,0,1,0,1,0,drop
61665,445,0,0,66,66,0,1,0,1,0,drop
61664,445,0,0,66,66,0,1,0,1,0,drop
61661,445,0,0,66,66,0,1,0,1,0,drop
61658,445,0,0,66,66,0,1,0,1,0,drop
61655,445,0,0,66,66,0,1,0,1,0,drop
61656,445,0,0,66,66,0,1,0,1,0,drop
53012,51050,0,0,62,62,0,1,0,1,0,deny
43461,35440,0,0,62,62,0,1,0,1,0,deny
61461,445,0,0,70,70,0,1,0,1,0,drop
49888,445,0,0,70,70,0,1,0,1,0,drop
12183,22114,0,0,62,62,0,1,0,1,0,deny
61460,445,0,0,70,70,0,1,0,1,0,drop
65400,36237,0,0,66,66,0,1,0,1,0,deny
61459,445,0,0,70,70,0,1,0,1,0,drop
49885,445,0,0,70,70,0,1,0,1,0,drop
49884,445,0,0,70,70,0,1,0,1,0,drop
49881,445,0,0,70,70,0,1,0,1,0,drop
61457,445,0,0,70,70,0,1,0,1,0,drop
61455,445,0,0,70,70,0,1,0,1,0,drop
15105,25174,0,0,146,146,0,1,0,1,0,deny
63554,44847,0,0,66,66,0,1,0,1,0,deny
32551,51221,0,0,62,62,0,1,0,1,0,deny
40687,64147,0,0,62,62,0,1,0,1,0,deny
62415,57470,0,0,66,66,0,1,0,1,0,deny
61441,445,0,0,70,70,0,1,0,1,0,drop
61440,445,0,0,70,70,0,1,0,1,0,drop
13166,57470,0,0,62,62,0,1,0,1,0,deny
59599,62413,0,0,62,62,0,1,0,1,0,deny
61437,445,0,0,70,70,0,1,0,1,0,drop
2622,25174,0,0,146,146,0,1,0,1,0,deny
61431,445,0,0,70,70,0,1,0,1,0,drop
61430,445,0,0,70,70,0,1,0,1,0,drop
50570,57470,0,0,66,66,0,1,0,1,0,deny
3585,64147,0,0,62,62,0,1,0,1,0,deny
49879,445,0,0,70,70,0,1,0,1,0,drop
53323,35253,0,0,66,66,0,1,0,1,0,deny
49875,445,0,0,70,70,0,1,0,1,0,drop
49874,445,0,0,70,70,0,1,0,1,0,drop
61647,445,0,0,66,66,0,1,0,1,0,drop
1024,26296,0,0,159,159,0,1,0,1,0,deny
49872,445,0,0,70,70,0,1,0,1,0,drop
61645,445,0,0,66,66,0,1,0,1,0,drop
61644,445,0,0,66,66,0,1,0,1,0,drop
61642,445,0,0,66,66,0,1,0,1,0,drop
19286,25174,0,0,146,146,0,1,0,1,0,deny
61640,445,0,0,66,66,0,1,0,1,0,drop
15513,25174,0,0,62,62,0,1,0,1,0,deny
61419,445,0,0,70,70,0,1,0,1,0,drop
24066,25174,0,0,146,146,0,1,0,1,0,deny
11136,15503,0,0,62,62,0,1,0,1,0,deny
61230,22114,0,0,62,62,0,1,0,1,0,deny
49867,445,0,0,70,70,0,1,0,1,0,drop
49861,445,0,0,70,70,0,1,0,1,0,drop
49860,445,0,0,70,70,0,1,0,1,0,drop
44388,63874,0,0,66,66,0,1,0,1,0,deny
53841,37965,0,0,66,66,0,1,0,1,0,deny
52146,1433,0,0,60,60,0,1,0,1,0,deny
0,0,0,0,82,82,0,1,0,1,0,deny
0,0,0,0,124,64,60,2,0,1,1,allow
61415,445,0,0,70,70,0,1,0,1,0,drop
56278,52752,0,0,62,62,0,1,0,1,0,deny
61630,445,0,0,66,66,0,1,0,1,0,drop
47788,12250,0,0,146,146,0,1,0,1,0,deny
42429,22114,0,0,62,62,0,1,0,1,0,deny
61405,445,0,0,70,70,0,1,0,1,0,drop
61406,445,0,0,70,70,0,1,0,1,0,drop
61404,445,0,0,70,70,0,1,0,1,0,drop
33582,44847,0,0,62,62,0,1,0,1,0,deny
61402,445,0,0,70,70,0,1,0,1,0,drop
2475,6881,0,0,66,66,0,1,0,1,0,deny
57994,30188,0,0,62,62,0,1,0,1,0,deny
12240,48817,0,0,146,146,0,1,0,1,0,deny
61399,445,0,0,70,70,0,1,0,1,0,drop
56309,22114,0,0,62,62,0,1,0,1,0,deny
61622,445,0,0,66,66,0,1,0,1,0,drop
49847,445,0,0,70,70,0,1,0,1,0,drop
25497,44847,0,0,62,62,0,1,0,1,0,deny
45941,23386,0,0,60,60,0,1,0,1,0,deny
40116,23,0,0,60,60,0,1,0,1,0,deny
5926,25174,0,0,62,62,0,1,0,1,0,deny
45313,64147,0,0,62,62,0,1,0,1,0,deny
61619,445,0,0,66,66,0,1,0,1,0,drop
55496,64097,0,0,62,62,0,1,0,1,0,deny
27773,56205,0,0,62,62,0,1,0,1,0,deny
52988,53567,0,0,66,66,0,1,0,1,0,deny
61190,21247,0,0,66,66,0,1,0,1,0,deny
61392,445,0,0,70,70,0,1,0,1,0,drop
57090,51505,0,0,66,66,0,1,0,1,0,deny
56718,50584,0,0,62,62,0,1,0,1,0,deny
62273,50584,0,0,66,66,0,1,0,1,0,deny
61613,445,0,0,66,66,0,1,0,1,0,drop
50757,64147,0,0,66,66,0,1,0,1,0,deny
56015,56205,0,0,62,62,0,1,0,1,0,deny
61608,445,0,0,66,66,0,1,0,1,0,drop
39460,23117,0,0,62,62,0,1,0,1,0,deny
60112,23,0,0,60,60,0,1,0,1,0,deny
50052,65008,0,0,60,60,0,1,0,1,0,deny
61385,445,0,0,70,70,0,1,0,1,0,drop
21993,25174,0,0,146,146,0,1,0,1,0,deny
61383,445,0,0,70,70,0,1,0,1,0,drop
50516,53,53120,53,168,86,82,2,30,1,1,allow
57622,7000,57622,7000,2343,856,1487,17,16,10,7,allow
50579,80,50579,80,32612,18106,14506,83,24,47,36,allow
40671,443,5840,443,190,70,120,4,15,2,2,allow
49317,443,8477,443,1486172,26246,1459926,1245,40,266,979,allow
43131,53,0,0,82,82,0,1,30,1,0,allow
41101,443,39031,443,7067,2430,4637,18,17,8,10,allow
55765,53,10201,53,770,101,669,2,30,1,1,allow
58842,443,44558,443,16260,10863,5397,39,19,21,18,allow
55842,80,22065,80,1151,711,440,10,15,5,5,allow
56817,53,9899,53,772,103,669,2,30,1,1,allow
54730,443,29479,443,20465,3839,16626,43,229,22,21,allow
44695,443,65027,443,4419,3179,1240,17,17,10,7,allow
55510,53,10819,53,578,286,292,9,15,5,4,allow
28743,53,28743,53,197,76,121,2,30,1,1,allow
64907,53,25739,53,168,86,82,2,30,1,1,allow
42386,443,40078,443,10424,3393,7031,31,274,16,15,allow
57106,33000,6001,33000,223,223,0,1,30,1,0,allow
55704,53,41065,53,752,93,659,2,30,1,1,allow
57044,53,19964,53,194,99,95,2,31,1,1,allow
55176,53,63516,53,190,97,93,2,31,1,1,allow
50046,443,28953,443,12134,6888,5246,27,37,15,12,allow
37568,443,13649,443,1702,861,841,19,110,10,9,allow
13088,80,11600,80,4079,3203,876,12,97,8,4,allow
56078,80,65466,80,2458,531,1927,11,75,6,5,allow
64843,53,27388,53,772,103,669,2,30,1,1,allow
65419,443,11559,443,2494,1643,851,17,24,9,8,allow
63548,443,63548,443,4742,1835,2907,19,29,11,8,allow
58863,443,23250,443,3873,2469,1404,17,16,9,8,allow
49839,443,44506,443,7021,1767,5254,26,224,13,13,allow
49573,53,33204,53,738,86,652,2,30,1,1,allow
38961,443,19720,443,67063,17409,49654,94,274,48,46,allow
38300,443,24962,443,200383,4673,195710,196,30,58,138,allow
50193,53,18428,53,770,101,669,2,30,1,1,allow
65342,53,53223,53,760,97,663,2,30,1,1,allow
49934,53,41301,53,752,93,659,2,30,1,1,allow
27005,27015,61503,27015,868,126,742,3,31,2,1,allow
55382,53,44759,53,738,86,652,2,31,1,1,allow
58868,443,40093,443,3867,2403,1464,17,15,8,9,allow
37874,19000,47411,19000,602,174,428,2,31,1,1,allow
49771,80,10429,80,254,128,126,5,16,3,2,allow
50582,80,50582,80,6647,4891,1756,23,21,13,10,allow
49312,443,38998,443,3171,2293,878,17,40,10,7,allow
58850,443,33361,443,9035,5883,3152,26,17,14,12,allow
55992,80,41926,80,57401,3150,54251,84,109,43,41,allow
56077,80,49245,80,2481,529,1952,11,75,6,5,allow
62074,443,62074,443,151233,12592,138641,190,19,88,102,allow
61295,443,61295,443,5014,1722,3292,17,18,10,7,allow
50912,53,50912,53,213,81,132,2,30,1,1,allow
52968,53,0,0,82,82,0,1,30,1,0,allow
27005,27015,5725,27015,876,126,750,2,30,1,1,allow
49964,53,9082,53,760,97,663,2,30,1,1,allow
65071,53,11229,53,93,93,0,2,60,2,0,allow
46215,443,63410,443,4182,2874,1308,17,361,9,8,allow
49522,443,58242,443,2731084,2639957,91127,2979,151,1945,1034,allow
55123,53,62052,53,762,97,665,2,31,1,1,allow
37965,11102,8568,11102,132,132,0,3,1200,3,0,allow
46211,443,8239,443,9805,1642,8163,24,362,12,12,allow
27005,27015,40148,27015,886,126,760,2,31,1,1,allow
46212,443,60547,443,9753,1572,8181,22,362,11,11,allow
40967,1433,0,0,60,60,0,1,0,1,0,deny
8999,57470,0,0,146,146,0,1,0,1,0,deny
63944,30188,0,0,62,62,0,1,0,1,0,deny
13159,37965,0,0,66,66,0,1,0,1,0,deny
55123,64097,0,0,66,66,0,1,0,1,0,deny
49835,445,0,0,70,70,0,1,0,1,0,drop
49834,445,0,0,70,70,0,1,0,1,0,drop
49832,445,0,0,70,70,0,1,0,1,0,drop
61379,445,0,0,70,70,0,1,0,1,0,drop
61597,445,0,0,66,66,0,1,0,1,0,drop
61596,445,0,0,66,66,0,1,0,1,0,drop
61595,445,0,0,66,66,0,1,0,1,0,drop
61593,445,0,0,66,66,0,1,0,1,0,drop
61594,445,0,0,66,66,0,1,0,1,0,drop
61592,445,0,0,66,66,0,1,0,1,0,drop
61591,445,0,0,66,66,0,1,0,1,0,drop
61589,445,0,0,66,66,0,1,0,1,0,drop
33912,25174,0,0,146,146,0,1,0,1,0,deny
59051,27520,0,0,62,62,0,1,0,1,0,deny
61377,445,0,0,70,70,0,1,0,1,0,drop
43725,57470,0,0,109,109,0,1,0,1,0,deny
16270,56205,0,0,62,62,0,1,0,1,0,deny
1046,25174,0,0,146,146,0,1,0,1,0,deny
61373,445,0,0,70,70,0,1,0,1,0,drop
36688,443,58971,443,178,118,60,2,15,1,1,allow
50298,53,22376,53,172,94,78,2,30,1,1,allow
34209,80,4661,80,1280,586,694,10,14,5,5,allow
10006,40025,40345,40025,284,190,94,2,29,1,1,allow
10552,25174,0,0,62,62,0,1,0,1,0,deny
10627,36829,0,0,146,146,0,1,0,1,0,deny
61372,445,0,0,70,70,0,1,0,1,0,drop
12986,64147,0,0,62,62,0,1,0,1,0,deny
49825,445,0,0,70,70,0,1,0,1,0,drop
49822,445,0,0,70,70,0,1,0,1,0,drop
49817,445,0,0,70,70,0,1,0,1,0,drop
49814,445,0,0,70,70,0,1,0,1,0,drop
40356,9192,0,0,145,145,0,1,0,1,0,deny
61140,27520,0,0,66,66,0,1,0,1,0,deny
48335,25174,0,0,62,62,0,1,0,1,0,deny
61576,445,0,0,66,66,0,1,0,1,0,drop
61575,445,0,0,66,66,0,1,0,1,0,drop
61574,445,0,0,66,66,0,1,0,1,0,drop
2636,7302,0,0,66,66,0,1,0,1,0,deny
13062,52752,0,0,66,66,0,1,0,1,0,deny
61367,445,0,0,70,70,0,1,0,1,0,drop
55012,64147,0,0,66,66,0,1,0,1,0,deny
40204,40031,4239,40031,140,78,62,2,29,1,1,allow
15241,53,62094,53,215,86,129,2,30,1,1,allow
53464,3389,53464,3389,4245,2461,1784,18,31,9,9,allow
49922,443,6981,443,11466,1320,10146,22,135,10,12,allow
50616,443,60964,443,8643,1918,6725,21,26,11,10,allow
10128,443,36900,443,22677,11756,10921,45,315,26,19,allow
65405,53,50341,53,560,104,456,4,43,2,2,allow
38697,443,5230,443,90001,3161,86840,91,15,26,65,allow
39803,443,33160,443,1701571,69958,1631613,1930,170,782,1148,allow
54993,53,49299,53,410,109,301,4,32,2,2,allow
63961,53,2242,53,373,171,202,5,40,3,2,allow
38873,443,28510,443,10209,2574,7635,39,917,18,21,allow
57044,53,35114,53,197,102,95,2,30,1,1,allow
55176,53,23619,53,195,102,93,2,30,1,1,allow
52489,53,54304,53,302,78,224,2,29,1,1,allow
64907,53,65054,53,168,86,82,2,29,1,1,allow
55853,53,20879,53,197,102,95,2,29,1,1,allow
65404,53,11597,53,182,94,88,2,30,1,1,allow
10978,8443,10978,8443,66,66,0,1,5,1,0,allow
50432,5222,28391,5222,28281,9813,18468,196,608,100,96,allow
64926,53,45252,53,257,102,155,2,30,1,1,allow
40290,22,40290,22,66,66,0,1,5,1,0,allow
35869,80,16584,80,2604,1690,914,20,610,11,9,allow
50673,443,61982,443,14723,2606,12117,54,19,22,32,allow
55836,443,63316,443,320,140,180,6,15,3,3,allow
56522,443,50354,443,5212,1037,4175,20,115,10,10,allow
55239,53,38143,53,272,94,178,2,30,1,1,allow
54287,443,13671,443,122,62,60,2,15,1,1,allow
60453,24369,18318,24369,70,70,0,1,5,1,0,allow
65024,53,6765,53,199,102,97,2,30,1,1,allow
42443,443,56747,443,5378,1512,3866,20,16,11,9,allow
58867,443,59291,443,5167,700,4467,16,15,7,9,allow
27005,27111,30399,27111,893,126,767,2,30,1,1,allow
27005,27015,38392,27015,878,126,752,2,30,1,1,allow
63139,12311,7837,12311,70,70,0,2,8,2,0,allow
55834,443,1790,443,190,70,120,4,15,2,2,allow
49742,53,64876,53,223,102,121,2,30,1,1,allow
57326,53,9216,53,180,94,86,2,35,1,1,allow
27005,27015,2437,27015,878,126,752,2,30,1,1,allow
64684,53,7467,53,757,102,655,2,30,1,1,allow
56523,443,42102,443,5212,1037,4175,20,115,10,10,allow
51641,443,16546,443,7419,2682,4737,26,66,13,13,allow
65499,443,30170,443,410116,12150,397966,421,16,148,273,allow
46082,443,8016,443,137024,6442,130582,171,109,61,110,allow
46085,443,28925,443,13018,2021,10997,34,95,14,20,allow
64555,53,23004,53,297,102,195,4,48,2,2,allow
64649,53,32892,53,807,94,713,2,30,1,1,allow
27005,27222,26856,27222,890,126,764,2,30,1,1,allow
52824,443,36459,443,7118,2239,4879,22,15,12,10,allow
46279,443,60019,443,172,172,0,2,5,2,0,allow
50578,80,50578,80,35580,13335,22245,69,23,38,31,allow
50584,80,50584,80,6706,4950,1756,23,20,13,10,allow
61461,443,61461,443,19070,4830,14240,33,18,18,15,allow
56524,443,12291,443,5212,1037,4175,20,115,10,10,allow
54449,443,31656,443,128477,6347,122130,155,276,56,99,allow
27005,27333,40989,27333,890,126,764,2,30,1,1,allow
55865,53,34168,53,807,94,713,2,30,1,1,allow
50516,53,58230,53,168,86,82,2,30,1,1,allow
49614,53,6383,53,183,94,89,2,30,1,1,allow
55821,443,39900,443,128791,11254,117537,141,132,48,93,allow
49894,80,26822,80,1409,735,674,12,17,5,7,allow
48574,443,45361,443,9336,1153,8183,27,34,14,13,allow
58871,443,24134,443,5106,700,4406,15,15,7,8,allow
51967,443,38807,443,10684,3167,7517,43,34,24,19,allow
46315,443,19188,443,5571,2240,3331,28,87,14,14,allow
53425,51689,2819,51689,546,306,240,9,142,5,4,allow
56388,443,41257,443,15485,8351,7134,71,130,40,31,allow
39180,443,51621,443,3221,2218,1003,16,15,8,8,allow
60195,443,54821,443,8894,1633,7261,18,15,9,9,allow
60782,20010,25511,20010,70,70,0,1,5,1,0,allow
49296,443,32357,443,50454,5259,45195,52,105,17,35,allow
10010,40029,17242,40029,148,86,62,2,29,1,1,allow
65460,53,50952,53,215,102,113,2,29,1,1,allow
49921,443,56889,443,11831,1466,10365,24,135,11,13,allow
55012,53,50167,53,275,110,165,2,30,1,1,allow
65440,53,38806,53,240,86,154,2,29,1,1,allow
27005,27019,53599,27019,881,126,755,2,30,1,1,allow
55865,53,22117,53,184,94,90,2,30,1,1,allow
50298,53,38554,53,164,86,78,2,30,1,1,allow
63560,443,29520,443,2773,1570,1203,22,275,11,11,allow
65024,53,19328,53,199,102,97,2,30,1,1,allow
26815,80,16585,80,2894,1095,1799,15,131,8,7,allow
63076,443,41788,443,7975,423,7552,15,119,6,9,allow
65286,53,17051,53,756,94,662,2,30,1,1,allow
49420,53,26234,53,364,102,262,2,30,1,1,allow
20222,53,8890,53,223,78,145,2,30,1,1,allow
59792,443,33674,443,12836,2016,10820,48,361,20,28,allow
35785,80,12900,80,1594,1280,314,10,15,5,5,allow
65500,443,21161,443,91813,4379,87434,101,16,37,64,allow
59044,53,47816,53,78,78,0,1,30,1,0,allow
65404,53,9178,53,198,110,88,2,30,1,1,allow
32927,443,31722,443,867883,29498,838385,922,58,328,594,allow
60036,161,64579,161,2800,2800,0,28,111,28,0,allow
49157,443,64620,443,2529,1230,1299,17,16,9,8,allow
34574,443,39427,443,130,70,60,2,15,1,1,allow
55057,443,7517,443,1364,940,424,12,16,7,5,allow
65101,53,44970,53,749,94,655,2,30,1,1,allow
64649,53,56977,53,184,94,90,2,30,1,1,allow
49867,53,28958,53,232,110,122,2,30,1,1,allow
55176,53,57165,53,195,102,93,2,30,1,1,allow
56724,53,27864,53,182,94,88,2,30,1,1,allow
49534,53,11716,53,193,102,91,2,31,1,1,allow
52092,443,50536,443,4642,3496,1146,18,16,10,8,allow
60461,10138,55813,10138,70,70,0,2,8,2,0,allow
60452,62582,62916,62582,70,70,0,1,5,1,0,allow
56435,80,7640,80,17248,1619,15629,26,25,11,15,allow
65432,53,2736,53,254,94,160,2,30,1,1,allow
57044,53,24810,53,197,102,95,2,30,1,1,allow
44847,43154,42931,43154,150,150,0,1,1200,1,0,allow
15503,52798,43633,52798,28448,16525,11923,253,3696,148,105,allow
30188,27772,64348,27772,502,150,352,2,1200,1,1,allow
37965,1,53190,1,330,330,0,6,1199,6,0,allow
51148,443,35605,443,4332,1907,2425,18,136,8,10,allow
6882,50239,19851,50239,296,150,146,2,1200,1,1,allow
55683,19215,63970,19215,320,140,180,6,7,3,3,allow
63978,63776,45573,63776,66,66,0,2,8,2,0,allow
63981,34250,53768,34250,66,66,0,2,8,2,0,allow
53822,18716,3913,18716,70,70,0,2,8,2,0,allow
64102,53,54377,53,619,102,517,4,43,2,2,allow
50077,53,56181,53,261,97,164,4,44,2,2,allow
47040,443,54181,443,10326,4295,6031,29,62,16,13,allow
50669,443,37355,443,12463,2350,10113,46,20,19,27,allow
49920,443,51438,443,10526,811,9715,20,135,8,12,allow
50077,53,51701,53,261,97,164,4,44,2,2,allow
9059,443,42849,443,19816,13030,6786,80,159,40,40,allow
63980,4804,28040,4804,66,66,0,2,8,2,0,allow
58866,443,35097,443,5166,700,4466,16,15,7,9,allow
55993,53,52586,53,199,102,97,2,30,1,1,allow
50596,53,57766,53,168,86,82,2,30,1,1,allow
57136,53,36933,53,209,110,99,2,31,1,1,allow
56055,53,2822,53,168,86,82,2,31,1,1,allow
54488,443,26044,443,4967,2482,2485,26,271,13,13,allow
60786,40010,58556,40010,316,136,180,6,7,3,3,allow
51462,3027,51462,3027,156,156,0,3,8,3,0,allow
53820,7488,11201,7488,70,70,0,2,8,2,0,allow
52008,49383,19063,49383,70,70,0,1,5,1,0,allow
58856,443,29128,443,2881,1766,1115,17,16,9,8,allow
64769,53,55242,53,418,150,268,2,30,1,1,allow
49812,445,0,0,70,70,0,1,0,1,0,drop
49806,445,0,0,70,70,0,1,0,1,0,drop
49807,445,0,0,70,70,0,1,0,1,0,deny
49805,445,0,0,70,70,0,1,0,1,0,drop
60558,51221,0,0,62,62,0,1,0,1,0,deny
62991,51221,0,0,66,66,0,1,0,1,0,deny
52578,34021,0,0,62,62,0,1,0,1,0,reset-both
12794,25174,0,0,146,146,0,1,0,1,0,deny
6889,8497,0,0,143,143,0,1,0,1,0,deny
57825,13014,0,0,74,74,0,1,0,1,0,deny
40840,21247,0,0,62,62,0,1,0,1,0,deny
62079,30188,0,0,62,62,0,1,0,1,0,deny
50160,57470,0,0,146,146,0,1,0,1,0,deny
13518,25174,0,0,62,62,0,1,0,1,0,deny
64306,64147,0,0,66,66,0,1,0,1,0,deny
58276,43890,0,0,62,62,0,1,0,1,0,deny
61354,445,0,0,70,70,0,1,0,1,0,drop
37014,23,0,0,60,60,0,1,0,1,0,deny
2890,443,2890,443,6915,882,6033,16,134,9,7,allow
12164,22114,0,0,62,62,0,1,0,1,0,deny
49795,445,0,0,70,70,0,1,0,1,0,drop
49792,445,0,0,70,70,0,1,0,1,0,drop
49789,445,0,0,70,70,0,1,0,1,0,drop
3478,61463,0,0,233,233,0,1,0,1,0,deny
3478,61463,0,0,1262,1262,0,1,0,1,0,deny
61351,445,0,0,70,70,0,1,0,1,0,drop
48706,23393,0,0,60,60,0,1,0,1,0,deny
61563,445,0,0,66,66,0,1,0,1,0,drop
60311,56205,0,0,62,62,0,1,0,1,0,deny
55766,36237,0,0,62,62,0,1,0,1,0,deny
3478,61463,0,0,301,301,0,1,0,1,0,deny
3478,61463,0,0,1248,1248,0,1,0,1,0,deny
61346,445,0,0,70,70,0,1,0,1,0,drop
27539,25174,0,0,146,146,0,1,0,1,0,deny
61345,445,0,0,70,70,0,1,0,1,0,drop
6355,25174,0,0,62,62,0,1,0,1,0,deny
49787,445,0,0,70,70,0,1,0,1,0,drop
49779,445,0,0,70,70,0,1,0,1,0,drop
13120,25174,0,0,146,146,0,1,0,1,0,deny
61343,445,0,0,70,70,0,1,0,1,0,drop
14103,35440,0,0,62,62,0,1,0,1,0,deny
14175,10387,0,0,159,159,0,1,0,1,0,deny
52973,57470,0,0,74,74,0,1,0,1,0,deny
50371,443,40015,443,456,390,66,4,0,3,1,allow
50372,443,12434,443,456,390,66,4,0,3,1,allow
29895,23,0,0,60,60,0,1,0,1,0,deny
51769,51505,0,0,66,66,0,1,0,1,0,deny
53546,46824,0,0,66,66,0,1,0,1,0,deny
56816,11392,0,0,66,66,0,1,0,1,0,deny
3478,61463,0,0,921,921,0,1,0,1,0,deny
61549,445,0,0,66,66,0,1,0,1,0,drop
61546,445,0,0,66,66,0,1,0,1,0,drop
48125,7548,0,0,60,60,0,1,0,1,0,deny
443,61686,0,0,1484,1484,0,1,0,1,0,deny
58195,38303,0,0,66,66,0,1,0,1,0,deny
5223,14446,0,0,220,220,0,1,0,1,0,deny
52459,5555,0,0,60,60,0,1,0,1,0,deny
58357,62413,0,0,62,62,0,1,0,1,0,deny
51094,35440,0,0,66,66,0,1,0,1,0,deny
59934,35440,0,0,62,62,0,1,0,1,0,deny
14350,56205,0,0,62,62,0,1,0,1,0,deny
49773,445,0,0,70,70,0,1,0,1,0,drop
49769,445,0,0,70,70,0,1,0,1,0,drop
49767,445,0,0,70,70,0,1,0,1,0,drop
49766,445,0,0,70,70,0,1,0,1,0,drop
61336,445,0,0,70,70,0,1,0,1,0,drop
3478,61463,0,0,164,164,0,1,0,1,0,deny
3478,61463,0,0,1262,1262,0,1,0,1,0,deny
45964,2225,0,0,60,60,0,1,0,1,0,deny
48327,57470,0,0,145,145,0,1,0,1,0,deny
61334,445,0,0,70,70,0,1,0,1,0,drop
61544,445,0,0,66,66,0,1,0,1,0,drop
1025,25174,0,0,62,62,0,1,0,1,0,deny
55524,46232,0,0,62,62,0,1,0,1,0,deny
24127,56205,0,0,66,66,0,1,0,1,0,deny
61333,445,0,0,70,70,0,1,0,1,0,drop
61536,445,0,0,66,66,0,1,0,1,0,drop
61532,445,0,0,66,66,0,1,0,1,0,drop
61537,445,0,0,66,66,0,1,0,1,0,drop
61530,445,0,0,66,66,0,1,0,1,0,drop
61538,445,0,0,66,66,0,1,0,1,0,drop
61535,445,0,0,66,66,0,1,0,1,0,drop
61528,445,0,0,66,66,0,1,0,1,0,drop
40797,25174,0,0,62,62,0,1,0,1,0,deny
61332,445,0,0,70,70,0,1,0,1,0,drop
45941,23386,0,0,60,60,0,1,0,1,0,deny
3478,61463,0,0,1188,1188,0,1,0,1,0,deny
61331,445,0,0,70,70,0,1,0,1,0,drop
14693,64147,0,0,62,62,0,1,0,1,0,deny
61329,445,0,0,70,70,0,1,0,1,0,drop
61326,445,0,0,70,70,0,1,0,1,0,deny
3478,61463,0,0,455,455,0,1,0,1,0,deny
3478,61463,0,0,1275,1275,0,1,0,1,0,deny
49761,445,0,0,70,70,0,1,0,1,0,drop
50063,35776,0,0,148,148,0,1,0,1,0,deny
49757,445,0,0,70,70,0,1,0,1,0,drop
49756,445,0,0,70,70,0,1,0,1,0,drop
49753,445,0,0,70,70,0,1,0,1,0,drop
54868,1433,0,0,60,60,0,1,0,1,0,deny
61313,445,0,0,70,70,0,1,0,1,0,drop
61312,445,0,0,70,70,0,1,0,1,0,drop
61306,445,0,0,70,70,0,1,0,1,0,drop
51453,64147,0,0,62,62,0,1,0,1,0,deny
61302,445,0,0,70,70,0,1,0,1,0,drop
61303,445,0,0,70,70,0,1,0,1,0,drop
3478,61463,0,0,928,928,0,1,0,1,0,deny
57762,25174,0,0,62,62,0,1,0,1,0,deny
63569,62413,0,0,66,66,0,1,0,1,0,deny
50160,57470,0,0,146,146,0,1,0,1,0,deny
23936,41615,0,0,146,146,0,1,0,1,0,deny
23936,41615,0,0,146,146,0,1,0,1,0,deny
58022,1471,0,0,60,60,0,1,0,1,0,deny
50160,57470,0,0,146,146,0,1,0,1,0,deny
53539,44847,0,0,66,66,0,1,0,1,0,deny
59745,25174,0,0,62,62,0,1,0,1,0,deny
49750,445,0,0,70,70,0,1,0,1,0,drop
49749,445,0,0,70,70,0,1,0,1,0,drop
49747,445,0,0,70,70,0,1,0,1,0,drop
3478,61463,0,0,665,665,0,1,0,1,0,deny
61522,445,0,0,66,66,0,1,0,1,0,drop
63467,37807,0,0,62,62,0,1,0,1,0,deny
49744,445,0,0,70,70,0,1,0,1,0,drop
62043,25174,0,0,146,146,0,1,0,1,0,deny
0,0,0,0,156,156,0,2,0,2,0,allow
0,0,0,0,2000,1020,980,20,0,10,10,allow
0,0,0,0,244,244,0,2,0,2,0,allow
61518,445,0,0,66,66,0,1,0,1,0,drop
1024,41055,0,0,157,157,0,1,0,1,0,deny
3478,61463,0,0,1097,1097,0,1,0,1,0,deny
61516,445,0,0,66,66,0,1,0,1,0,drop
61515,445,0,0,66,66,0,1,0,1,0,drop
61291,445,0,0,70,70,0,1,0,1,0,drop
61513,445,0,0,66,66,0,1,0,1,0,drop
31950,22114,0,0,62,62,0,1,0,1,0,deny
54206,25174,0,0,62,62,0,1,0,1,0,deny
46856,25174,0,0,62,62,0,1,0,1,0,deny
46330,56205,0,0,146,146,0,1,0,1,0,deny
45767,50584,0,0,146,146,0,1,0,1,0,deny
49736,445,0,0,70,70,0,1,0,1,0,drop
25187,31573,0,0,62,62,0,1,0,1,0,deny
25233,23,0,0,60,60,0,1,0,1,0,deny
49730,445,0,0,70,70,0,1,0,1,0,drop
49726,445,0,0,70,70,0,1,0,1,0,drop
63242,50584,0,0,66,66,0,1,0,1,0,deny
61287,445,0,0,70,70,0,1,0,1,0,drop
3478,61463,0,0,1049,1049,0,1,0,1,0,deny
61461,50584,0,0,62,62,0,1,0,1,0,deny
61502,445,0,0,66,66,0,1,0,1,0,drop
19790,35440,0,0,146,146,0,1,0,1,0,deny
61278,445,0,0,70,70,0,1,0,1,0,drop
61275,445,0,0,70,70,0,1,0,1,0,drop
61277,445,0,0,70,70,0,1,0,1,0,drop
63855,25174,0,0,146,146,0,1,0,1,0,deny
12143,56205,0,0,66,66,0,1,0,1,0,deny
61273,445,0,0,70,70,0,1,0,1,0,drop
52318,22114,0,0,62,62,0,1,0,1,0,deny
3375,35253,0,0,62,62,0,1,0,1,0,deny
61270,445,0,0,70,70,0,1,0,1,0,drop
31017,50584,0,0,62,62,0,1,0,1,0,deny
61494,445,0,0,66,66,0,1,0,1,0,drop
3478,61463,0,0,822,822,0,1,0,1,0,deny
49719,445,0,0,70,70,0,1,0,1,0,drop
26717,25174,0,0,146,146,0,1,0,1,0,deny
33886,65504,0,0,162,162,0,1,0,1,0,deny
29363,36237,0,0,146,146,0,1,0,1,0,deny
1882,43890,0,0,62,62,0,1,0,1,0,deny
25901,50265,0,0,62,62,0,1,0,1,0,deny
62067,80,14393,80,1862,616,1246,11,15,6,5,allow
58854,443,18047,443,5202,3361,1841,19,16,10,9,allow
38380,80,38380,80,5397,713,4684,14,16,8,6,allow
56715,443,19932,443,1207531,28695,1178836,1184,46,400,784,allow
54870,443,54870,443,313399,38167,275232,411,23,205,206,allow
57331,53,13149,53,1420,95,1325,4,32,2,2,allow
65184,53,54868,53,164,84,80,2,31,1,1,allow
54587,53,0,0,82,82,0,1,30,1,0,allow
56500,53,18802,53,775,103,672,2,31,1,1,allow
57136,53,51914,53,202,103,99,2,31,1,1,allow
56055,53,24959,53,168,86,82,2,30,1,1,allow
55830,53,60660,53,182,93,89,2,31,1,1,allow
58020,80,7358,80,2482,516,1966,11,75,6,5,allow
50042,80,50042,80,2986,1514,1472,10,15,6,4,allow
53821,7788,19069,7788,70,70,0,2,8,2,0,allow
48983,15000,51295,15000,130,70,60,2,6,1,1,allow
52030,43068,39879,43068,70,70,0,2,8,2,0,allow
53060,1433,53060,1433,60,60,0,1,5,1,0,allow
56505,443,54192,443,78426,3219,75207,98,96,37,61,allow
58846,443,58496,443,7680,4905,2775,24,17,12,12,allow
60587,443,60587,443,4572,1665,2907,19,27,11,8,allow
56590,53,27360,53,760,97,663,2,30,1,1,allow
56360,53,50871,53,814,110,704,2,30,1,1,allow
50542,53,19780,53,762,98,664,2,30,1,1,allow
61018,443,61018,443,4400,1493,2907,19,29,11,8,allow
51230,80,14122,80,579418,15579,563839,599,76,219,380,allow
63977,54486,31444,54486,66,66,0,2,8,2,0,allow
54833,443,54833,443,306802,26705,280097,395,21,190,205,allow
36858,443,39662,443,3789,2373,1416,24,26,14,10,allow
63976,25725,46114,25725,66,66,0,2,8,2,0,allow
62068,80,36797,80,2806,626,2180,12,15,6,6,allow
33661,53,33661,53,643,88,555,2,30,1,1,allow
53781,36366,2063,36366,70,70,0,1,5,1,0,allow
55076,53,44619,53,760,97,663,2,30,1,1,allow
27005,27017,29678,27017,917,126,791,2,30,1,1,allow
58113,3389,58113,3389,4245,2461,1784,18,33,9,9,allow
27005,27015,49152,27015,919,126,793,2,30,1,1,allow
54291,443,41478,443,8056,3762,4294,55,517,28,27,allow
44482,443,20797,443,7464,1869,5595,29,409,11,18,allow
50467,53,38713,53,758,93,665,2,31,1,1,allow
49898,53,38099,53,184,94,90,2,31,1,1,allow
53687,19010,53687,19010,64,64,0,1,31,1,0,allow
59003,443,53579,443,10196,6897,3299,39,121,20,19,allow
50584,53,23534,53,744,89,655,2,31,1,1,allow
55261,53,40486,53,716,95,621,2,31,1,1,allow
49534,53,33345,53,186,95,91,2,31,1,1,allow
55200,53,19804,53,202,103,99,2,31,1,1,allow
56697,53,31729,53,196,100,96,2,31,1,1,allow
55362,53,13886,53,190,97,93,2,31,1,1,allow
27005,27017,53289,27017,900,126,774,2,31,1,1,allow
50265,42805,33244,42805,480,149,331,2,1200,1,1,allow
55831,53,12169,53,182,93,89,2,31,1,1,allow
50219,53,44100,53,751,95,656,2,31,1,1,allow
57470,17984,29715,17984,870,330,540,12,1496,6,6,allow
64614,443,5122,443,5505,3166,2339,22,136,11,11,allow
52811,44847,0,0,66,66,0,1,0,1,0,deny
61491,445,0,0,66,66,0,1,0,1,0,drop
61265,445,0,0,70,70,0,1,0,1,0,drop
3478,61463,0,0,1063,1063,0,1,0,1,0,deny
3478,61463,0,0,1012,1012,0,1,0,1,0,deny
16376,35440,0,0,62,62,0,1,0,1,0,deny
61485,445,0,0,66,66,0,1,0,1,0,drop
61475,445,0,0,66,66,0,1,0,1,0,drop
3478,61463,0,0,164,164,0,1,0,1,0,deny
61257,445,0,0,70,70,0,1,0,1,0,drop
3478,61463,0,0,942,942,0,1,0,1,0,deny
51298,57470,0,0,66,66,0,1,0,1,0,deny
49296,80,39063,80,1515,481,1034,11,15,6,5,allow
54826,443,54826,443,158092,23051,135041,216,21,110,106,allow
52025,42442,23036,42442,70,70,0,2,7,2,0,allow
52011,10722,14551,10722,70,70,0,1,4,1,0,allow
56724,53,33113,53,182,94,88,2,29,1,1,allow
49677,53,61420,53,373,126,247,2,29,1,1,allow
8998,53,50504,53,225,78,147,2,29,1,1,allow
50378,53,9266,53,199,102,97,2,29,1,1,allow
55993,53,8187,53,199,102,97,2,29,1,1,allow
58862,443,26650,443,5167,700,4467,16,15,7,9,allow
63975,24874,26677,24874,66,66,0,2,7,2,0,allow
52026,12523,2339,12523,70,70,0,2,7,2,0,allow
63139,53,8265,53,78,78,0,2,31,2,0,allow
52007,37732,20807,37732,70,70,0,1,4,1,0,allow
49197,2710,30685,2710,70,70,0,1,4,1,0,allow
49537,80,13843,80,5514,3156,2358,21,66,15,6,allow
50596,53,52895,53,168,86,82,2,29,1,1,allow
58860,443,58775,443,5594,3484,2110,16,15,8,8,allow
45852,53,16051,53,774,76,698,4,29,2,2,allow
37093,53,37093,53,645,90,555,2,29,1,1,allow
25463,53,62402,53,827,91,736,4,29,2,2,allow
26079,53,52153,53,226,78,148,2,29,1,1,allow
50378,53,11083,53,199,102,97,2,29,1,1,allow
50378,53,26291,53,199,102,97,2,29,1,1,allow
65504,53,13937,53,216,94,122,2,30,1,1,allow
55176,53,60647,53,195,102,93,2,30,1,1,allow
56961,53,64914,53,757,102,655,2,30,1,1,allow
51453,80,39611,80,214,140,74,4,15,3,1,allow
49749,443,9817,443,438048,86860,351188,491,420,213,278,allow
49895,443,62049,443,493316,12157,481159,470,94,122,348,allow
50100,53,44319,53,216,110,106,2,30,1,1,allow
50386,53,42277,53,782,110,672,2,30,1,1,allow
64548,53,58347,53,209,110,99,2,30,1,1,allow
49317,53,61782,53,194,102,92,2,30,1,1,allow
54998,53,51168,53,195,102,93,2,30,1,1,allow
64827,53,50756,53,291,86,205,2,30,1,1,allow
49842,443,3993,443,6212,1823,4389,16,75,9,7,allow
38799,53,0,0,86,86,0,1,30,1,0,allow
38101,443,38674,443,190,70,120,4,15,2,2,allow
55107,53,60503,53,816,102,714,2,30,1,1,allow
53638,443,51723,443,24895,2856,22039,46,270,22,24,allow
55223,443,2473,443,1118883,33814,1085069,1206,48,451,755,allow
62480,443,56428,443,1326,876,450,11,26,6,5,allow
64126,53,37940,53,216,102,114,2,30,1,1,allow
53770,58120,33681,58120,684,432,252,10,19,6,4,allow
56456,53,45669,53,199,102,97,2,30,1,1,allow
55380,53,60904,53,289,97,192,4,45,2,2,allow
56456,53,39368,53,199,102,97,2,30,1,1,allow
39839,443,5588,443,5829,1408,4421,21,188,11,10,allow
63138,51452,48571,51452,70,70,0,2,8,2,0,allow
55830,53,64690,53,183,94,89,2,30,1,1,allow
55715,53,57381,53,168,86,82,2,30,1,1,allow
7318,443,16542,443,6458,2658,3800,34,255,16,18,allow
50028,53,64249,53,256,102,154,2,30,1,1,allow
57435,53,43686,53,184,102,82,2,30,1,1,allow
56799,80,63768,80,1514,481,1033,11,15,6,5,allow
49199,53,25125,53,193,102,91,2,30,1,1,allow
49199,53,34176,53,816,102,714,2,30,1,1,allow
54476,443,29193,443,48303,3997,44306,69,271,30,39,allow
49678,80,44529,80,1977,921,1056,9,15,5,4,allow
41714,443,33432,443,4590,3026,1564,28,80,15,13,allow
64387,53,16161,53,359,99,260,4,54,2,2,allow
49503,443,38675,443,1363701,35511,1328190,1382,271,476,906,allow
57340,53,29949,53,216,110,106,2,30,1,1,allow
27005,27015,8670,27015,877,126,751,2,30,1,1,allow
65300,53,36602,53,758,102,656,2,30,1,1,allow
51263,443,3091,443,8247,2116,6131,23,360,11,12,allow
55392,443,3923,443,7347,2127,5220,18,135,8,10,allow
55042,443,48187,443,5409,1471,3938,21,17,12,9,allow
57340,53,7589,53,216,110,106,2,30,1,1,allow
58864,443,14029,443,5167,700,4467,16,15,7,9,allow
33971,443,52032,443,244193,7090,237103,260,136,87,173,allow
52027,49743,54736,49743,70,70,0,2,7,2,0,allow
50126,443,34426,443,15032,5689,9343,51,35,27,24,allow
50211,1688,29763,1688,70,70,0,2,7,2,0,allow
57893,80,44001,80,318,192,126,6,26,4,2,allow
49772,80,38817,80,70,70,0,1,5,1,0,allow
59734,443,48585,443,1312,651,661,13,184,7,6,allow
33845,443,64577,443,6495,1547,4948,19,318,10,9,allow
55285,53,16025,53,268,95,173,4,47,2,2,allow
58872,443,3820,443,1178,820,358,9,15,6,3,allow
57034,443,8240,443,30645,2719,27926,60,153,25,35,allow
56660,80,51147,80,234,234,0,4,12,4,0,allow
64794,80,22092,80,22646,1660,20986,29,135,10,19,allow
55285,53,18984,53,268,95,173,4,46,2,2,allow
53819,9472,27834,9472,70,70,0,2,7,2,0,allow
52029,52093,47612,52093,70,70,0,2,7,2,0,allow
64589,53,62557,53,814,110,704,2,29,1,1,allow
27724,53,46943,53,322,84,238,4,29,2,2,allow
64882,53,62094,53,343,134,209,2,30,1,1,allow
56357,53,8894,53,168,86,82,2,30,1,1,allow
39422,80,48610,80,1057,683,374,10,15,6,4,allow
64774,53,37147,53,214,102,112,2,29,1,1,allow
49614,53,48973,53,183,94,89,2,29,1,1,allow
56372,53,7936,53,172,94,78,2,30,1,1,allow
56456,53,58146,53,199,102,97,2,30,1,1,allow
65234,53,55204,53,248,110,138,2,29,1,1,allow
62749,53,25858,53,184,86,98,2,30,1,1,allow
56372,53,63368,53,172,94,78,2,29,1,1,allow
49283,53,8368,53,251,102,149,2,30,1,1,allow
39869,53,19258,53,394,80,314,4,29,2,2,allow
50100,53,47683,53,216,110,106,2,30,1,1,allow
56357,53,62096,53,168,86,82,2,30,1,1,allow
27005,27015,51947,27015,879,126,753,2,30,1,1,allow
55651,53,17505,53,199,102,97,2,30,1,1,allow
27005,27013,41883,27013,879,126,753,2,30,1,1,allow
65431,53,63045,53,210,102,108,2,30,1,1,allow
57044,53,35705,53,197,102,95,2,30,1,1,allow
64991,53,4692,53,779,86,693,2,30,1,1,allow
50450,53,9173,53,209,110,99,2,30,1,1,allow
51795,443,38241,443,4209,2221,1988,25,157,12,13,allow
60582,53,13685,53,180,86,94,2,30,1,1,allow
49572,443,38388,443,11583,4967,6616,31,47,17,14,allow
38086,53,54095,53,199,94,105,2,30,1,1,allow
49568,53,32071,53,168,86,82,2,31,1,1,allow
59964,443,21876,443,1346200,44765,1301435,1428,128,479,949,allow
15503,61284,64885,61284,16553,6930,9623,212,6269,106,106,allow
57340,53,2776,53,216,110,106,2,30,1,1,allow
50450,53,51972,53,209,110,99,2,30,1,1,allow
51867,53,1821,53,179,86,93,2,30,1,1,allow
65184,53,13116,53,166,86,80,2,30,1,1,allow
56738,53,38791,53,821,102,719,2,30,1,1,allow
49543,53,52836,53,200,102,98,2,30,1,1,allow
56738,53,58828,53,198,102,96,2,30,1,1,allow
65152,53,32824,53,167,86,81,2,31,1,1,allow
50308,443,46748,443,44311,4535,39776,55,121,21,34,allow
37965,31483,54456,31483,4530,2856,1674,62,2421,35,27,allow
52845,443,44053,443,2082,1322,760,14,41,8,6,allow
28474,3389,28474,3389,3850,1745,2105,19,18,11,8,allow
48676,53395,48676,53395,124,60,64,3,5,2,1,allow
64957,53,41435,53,506,131,375,4,41,2,2,allow
51110,80,32972,80,23850,1662,22188,36,15,19,17,allow
50672,443,34507,443,6202,1828,4374,25,18,12,13,allow
52148,443,33858,443,375357,11451,363906,356,61,100,256,allow
41398,443,9003,443,3135,1968,1167,22,72,12,10,allow
65309,53,6020,53,227,110,117,2,30,1,1,allow
57435,53,39763,53,184,102,82,2,30,1,1,allow
50011,53,7545,53,766,102,664,2,30,1,1,allow
27005,27018,3011,27018,882,126,756,2,30,1,1,allow
50137,53,54059,53,183,94,89,2,31,1,1,allow
49677,80,37951,80,1977,921,1056,9,16,5,4,allow
57136,53,22982,53,209,110,99,2,30,1,1,allow
56626,53,17271,53,224,102,122,2,30,1,1,allow
57054,53,38199,53,164,78,86,2,30,1,1,allow
27005,27015,34659,27015,899,126,773,2,30,1,1,allow
55107,53,32486,53,193,102,91,2,30,1,1,allow
39888,53,65133,53,168,78,90,2,30,1,1,allow
50630,53,64139,53,209,110,99,2,30,1,1,allow
65515,53,15950,53,652,209,443,6,50,3,3,allow
50100,53,23176,53,216,110,106,2,30,1,1,allow
65193,53,19280,53,436,94,342,2,30,1,1,allow
27005,27444,51395,27444,893,126,767,2,30,1,1,allow
49898,53,31342,53,184,94,90,2,30,1,1,allow
56365,53,8027,53,199,102,97,2,30,1,1,allow
55830,53,46828,53,183,94,89,2,30,1,1,allow
56365,53,14208,53,199,102,97,2,30,1,1,allow
49898,53,13665,53,184,94,90,2,30,1,1,allow
17750,51965,19962,51965,150,150,0,1,1200,1,0,allow
46479,443,13902,443,5241,2026,3215,50,6660,18,32,allow
55849,53,18869,53,195,102,93,2,31,1,1,allow
65112,53,1739,53,209,110,99,2,31,1,1,allow
40040,5223,48273,5223,5386,1100,4286,27,686,10,17,allow
64655,443,35493,443,8903,2857,6046,22,135,10,12,allow
57707,443,36174,443,3150,1709,1441,26,276,13,13,allow
37965,46008,3180,46008,132,132,0,3,1200,3,0,allow
56934,53,48178,53,216,110,106,2,31,1,1,allow
37965,15357,58016,15357,481,150,331,2,1200,1,1,allow
53818,15337,22779,15337,258,70,188,4,8,2,2,allow
37612,443,3287,443,2141,1270,871,18,130,10,8,allow
53133,443,4728,443,5610,1599,4011,24,17,14,10,allow
65219,53,52496,53,197,102,95,2,31,1,1,allow
62478,443,29633,443,10391,7059,3332,27,27,15,12,allow
62479,443,46621,443,14673,3914,10759,31,27,14,17,allow
50609,80,7480,80,12986,6816,6170,26,26,12,14,allow
44086,443,28968,443,8542,4191,4351,84,616,46,38,allow
52006,49849,60139,49849,70,70,0,1,5,1,0,allow
64768,80,26612,80,18045,3544,14501,28,156,12,16,allow
49326,53,56279,53,765,102,663,2,30,1,1,allow
123,123,56817,123,184,94,90,2,30,1,1,allow
53258,53,63456,53,277,78,199,2,30,1,1,allow
59802,53,61597,53,168,78,90,2,30,1,1,allow
50418,53,14403,53,177,94,83,2,30,1,1,allow
61255,445,0,0,70,70,0,1,0,1,0,drop
45964,3111,0,0,60,60,0,1,0,1,0,deny
62424,37965,0,0,66,66,0,1,0,1,0,deny
28221,37965,0,0,62,62,0,1,0,1,0,deny
63888,57470,0,0,62,62,0,1,0,1,0,deny
61250,445,0,0,70,70,0,1,0,1,0,drop
61248,445,0,0,70,70,0,1,0,1,0,drop
3478,61463,0,0,1163,1163,0,1,0,1,0,deny
49708,445,0,0,70,70,0,1,0,1,0,drop
49705,445,0,0,70,70,0,1,0,1,0,drop
14023,37965,0,0,62,62,0,1,0,1,0,deny
50211,51050,0,0,66,66,0,1,0,1,0,deny
61463,445,0,0,66,66,0,1,0,1,0,drop
61469,445,0,0,66,66,0,1,0,1,0,drop
61462,445,0,0,66,66,0,1,0,1,0,drop
61467,445,0,0,66,66,0,1,0,1,0,drop
61464,445,0,0,66,66,0,1,0,1,0,drop
61465,445,0,0,66,66,0,1,0,1,0,drop
61468,445,0,0,66,66,0,1,0,1,0,drop
55008,21247,0,0,66,66,0,1,0,1,0,deny
61244,445,0,0,70,70,0,1,0,1,0,drop
3212,22114,0,0,62,62,0,1,0,1,0,deny
11716,37965,0,0,62,62,0,1,0,1,0,deny
3212,22114,0,0,146,146,0,1,0,1,0,deny
14696,42707,0,0,62,62,0,1,0,1,0,deny
3478,61463,0,0,451,451,0,1,0,1,0,deny
3478,61463,0,0,174,174,0,1,0,1,0,deny
61243,445,0,0,70,70,0,1,0,1,0,drop
63030,25174,0,0,146,146,0,1,0,1,0,deny
3478,61463,0,0,68,68,0,1,0,1,0,deny
39132,44847,0,0,66,66,0,1,0,1,0,deny
49701,445,0,0,70,70,0,1,0,1,0,drop
49700,445,0,0,70,70,0,1,0,1,0,drop
49695,445,0,0,70,70,0,1,0,1,0,drop
49688,445,0,0,70,70,0,1,0,1,0,drop
64543,50265,0,0,66,66,0,1,0,1,0,deny
3478,61463,0,0,944,944,0,1,0,1,0,deny
61448,445,0,0,66,66,0,1,0,1,0,drop
61449,445,0,0,66,66,0,1,0,1,0,drop
61447,445,0,0,66,66,0,1,0,1,0,drop
33405,37965,0,0,62,62,0,1,0,1,0,deny
61238,445,0,0,70,70,0,1,0,1,0,drop
10333,22114,0,0,62,62,0,1,0,1,0,deny
11136,57587,0,0,62,62,0,1,0,1,0,deny
59451,50584,0,0,66,66,0,1,0,1,0,deny
55713,25174,0,0,62,62,0,1,0,1,0,deny
49685,445,0,0,70,70,0,1,0,1,0,drop
55674,5900,0,0,60,60,0,1,0,1,0,deny
3478,61463,0,0,927,927,0,1,0,1,0,deny
49678,445,0,0,70,70,0,1,0,1,0,drop
49677,445,0,0,70,70,0,1,0,1,0,drop
49674,445,0,0,70,70,0,1,0,1,0,drop
2531,30188,0,0,62,62,0,1,0,1,0,deny
15113,25174,0,0,62,62,0,1,0,1,0,deny
49163,22114,0,0,146,146,0,1,0,1,0,deny
15266,55783,0,0,145,145,0,1,0,1,0,deny
50197,64147,0,0,66,66,0,1,0,1,0,deny
50651,25174,0,0,62,62,0,1,0,1,0,deny
63397,26467,0,0,66,66,0,1,0,1,0,deny
3478,61463,0,0,928,928,0,1,0,1,0,deny
14567,37965,0,0,62,62,0,1,0,1,0,deny
61225,445,0,0,70,70,0,1,0,1,0,drop
2886,35440,0,0,66,66,0,1,0,1,0,deny
36717,51505,0,0,146,146,0,1,0,1,0,deny
61222,445,0,0,70,70,0,1,0,1,0,drop
49664,445,0,0,70,70,0,1,0,1,0,drop
53100,443,19603,443,472,406,66,4,0,3,1,allow
49663,445,0,0,70,70,0,1,0,1,0,drop
49661,445,0,0,70,70,0,1,0,1,0,drop
61970,57866,0,0,62,62,0,1,0,1,0,deny
19699,48817,0,0,143,143,0,1,0,1,0,deny
62219,25174,0,0,146,146,0,1,0,1,0,deny
52973,57470,0,0,74,74,0,1,0,1,0,deny
3478,61463,0,0,1188,1188,0,1,0,1,0,deny
3478,61463,0,0,364,364,0,1,0,1,0,deny
3478,61463,0,0,1162,1162,0,1,0,1,0,deny
61435,445,0,0,66,66,0,1,0,1,0,drop
65249,25864,0,0,72,72,0,1,0,1,0,deny
20706,37965,0,0,62,62,0,1,0,1,0,deny
45682,37965,0,0,62,62,0,1,0,1,0,deny
61218,445,0,0,70,70,0,1,0,1,0,drop
1873,37965,0,0,62,62,0,1,0,1,0,deny
61216,445,0,0,70,70,0,1,0,1,0,drop
3478,61463,0,0,164,164,0,1,0,1,0,deny
3478,61463,0,0,214,214,0,1,0,1,0,deny
3478,61463,0,0,1292,1292,0,1,0,1,0,deny
61214,445,0,0,70,70,0,1,0,1,0,drop
49657,445,0,0,70,70,0,1,0,1,0,drop
49651,445,0,0,70,70,0,1,0,1,0,drop
61420,445,0,0,66,66,0,1,0,1,0,drop
61419,445,0,0,66,66,0,1,0,1,0,drop
3478,61463,0,0,933,933,0,1,0,1,0,deny
63460,55160,0,0,66,66,0,1,0,1,0,deny
59043,35440,0,0,62,62,0,1,0,1,0,deny
50339,25174,0,0,146,146,0,1,0,1,0,deny
56943,44847,0,0,62,62,0,1,0,1,0,deny
61207,445,0,0,70,70,0,1,0,1,0,drop
42898,25174,0,0,62,62,0,1,0,1,0,deny
6666,990,0,0,60,60,0,1,0,1,0,deny
10022,55839,0,0,145,145,0,1,0,1,0,deny
49644,445,0,0,70,70,0,1,0,1,0,drop
49646,445,0,0,70,70,0,1,0,1,0,drop
49643,445,0,0,70,70,0,1,0,1,0,drop
49641,445,0,0,70,70,0,1,0,1,0,drop
61205,445,0,0,70,70,0,1,0,1,0,drop
53143,50584,0,0,66,66,0,1,0,1,0,deny
29195,51505,0,0,146,146,0,1,0,1,0,deny
51830,42707,0,0,66,66,0,1,0,1,0,deny
3478,61463,0,0,901,901,0,1,0,1,0,deny
61415,445,0,0,66,66,0,1,0,1,0,drop
61204,445,0,0,70,70,0,1,0,1,0,drop
49540,50584,0,0,66,66,0,1,0,1,0,deny
61203,445,0,0,70,70,0,1,0,1,0,drop
61202,445,0,0,70,70,0,1,0,1,0,drop
61200,445,0,0,70,70,0,1,0,1,0,drop
61197,445,0,0,70,70,0,1,0,1,0,drop
61403,445,0,0,66,66,0,1,0,1,0,drop
61402,445,0,0,66,66,0,1,0,1,0,drop
61410,445,0,0,66,66,0,1,0,1,0,drop
61408,445,0,0,66,66,0,1,0,1,0,drop
61399,445,0,0,66,66,0,1,0,1,0,drop
61405,445,0,0,66,66,0,1,0,1,0,drop
61398,445,0,0,66,66,0,1,0,1,0,drop
52471,22114,0,0,66,66,0,1,0,1,0,deny
49632,445,0,0,70,70,0,1,0,1,0,drop
3478,61463,0,0,1103,1103,0,1,0,1,0,deny
56582,23718,0,0,62,62,0,1,0,1,0,deny
53871,37965,0,0,66,66,0,1,0,1,0,deny
49628,445,0,0,70,70,0,1,0,1,0,drop
49627,445,0,0,70,70,0,1,0,1,0,drop
49625,445,0,0,70,70,0,1,0,1,0,drop
11688,23718,0,0,62,62,0,1,0,1,0,deny
45941,23388,0,0,60,60,0,1,0,1,0,deny
19882,22114,0,0,62,62,0,1,0,1,0,deny
61184,445,0,0,70,70,0,1,0,1,0,drop
61183,445,0,0,70,70,0,1,0,1,0,drop
61181,445,0,0,70,70,0,1,0,1,0,drop
61174,445,0,0,70,70,0,1,0,1,0,drop
61173,445,0,0,70,70,0,1,0,1,0,drop
51155,56205,0,0,66,66,0,1,0,1,0,deny
63840,36829,0,0,66,66,0,1,0,1,0,deny
3478,61463,0,0,491,491,0,1,0,1,0,deny
56005,64147,0,0,62,62,0,1,0,1,0,deny
56131,37807,0,0,66,66,0,1,0,1,0,deny
63984,25174,0,0,62,62,0,1,0,1,0,deny
49624,445,0,0,70,70,0,1,0,1,0,drop
49622,445,0,0,70,70,0,1,0,1,0,drop
49620,445,0,0,70,70,0,1,0,1,0,drop
63984,25174,0,0,146,146,0,1,0,1,0,deny
49686,44847,0,0,66,66,0,1,0,1,0,deny
61394,445,0,0,66,66,0,1,0,1,0,drop
49616,445,0,0,70,70,0,1,0,1,0,drop
53756,50584,0,0,66,66,0,1,0,1,0,deny
5926,25174,0,0,146,146,0,1,0,1,0,deny
61389,445,0,0,66,66,0,1,0,1,0,drop
3478,61463,0,0,1345,1345,0,1,0,1,0,deny
3478,61463,0,0,893,893,0,1,0,1,0,deny
61162,445,0,0,70,70,0,1,0,1,0,drop
61388,445,0,0,66,66,0,1,0,1,0,drop
61386,445,0,0,66,66,0,1,0,1,0,drop
61385,445,0,0,66,66,0,1,0,1,0,drop
64124,25174,0,0,62,62,0,1,0,1,0,deny
64124,25174,0,0,146,146,0,1,0,1,0,deny
19875,30170,0,0,145,145,0,1,0,1,0,deny
7720,44847,0,0,66,66,0,1,0,1,0,deny
3478,61463,0,0,1004,1004,0,1,0,1,0,deny
62408,50584,0,0,66,66,0,1,0,1,0,deny
49333,25174,0,0,146,146,0,1,0,1,0,deny
49608,445,0,0,70,70,0,1,0,1,0,deny
61158,445,0,0,70,70,0,1,0,1,0,drop
32282,8604,0,0,62,62,0,1,0,1,0,deny
64535,37965,0,0,62,62,0,1,0,1,0,deny
49605,445,0,0,70,70,0,1,0,1,0,drop
49604,445,0,0,70,70,0,1,0,1,0,drop
52050,11392,0,0,62,62,0,1,0,1,0,deny
50949,45960,0,0,62,62,0,1,0,1,0,deny
49514,65504,0,0,162,162,0,1,0,1,0,deny
61148,445,0,0,70,70,0,1,0,1,0,drop
61147,445,0,0,70,70,0,1,0,1,0,drop
39268,443,60773,443,7691,1999,5692,35,256,18,17,allow
52803,443,59403,443,4913,751,4162,18,28,8,10,allow
50158,53,45524,53,758,96,662,2,30,1,1,allow
27005,27015,4147,27015,869,126,743,2,30,1,1,allow
50601,53,58017,53,760,97,663,2,30,1,1,allow
26900,27017,32451,27017,422,164,258,6,30,3,3,allow
36148,443,59223,443,2233,1237,996,18,75,9,9,allow
27005,27015,58222,27015,901,126,775,2,30,1,1,allow
49631,80,18406,80,1446,914,532,8,16,5,3,allow
56967,443,1130,443,9222,3148,6074,26,91,14,12,allow
50589,53,50328,53,733,85,648,2,30,1,1,allow
64823,53,49719,53,754,94,660,2,30,1,1,allow
26900,27017,11967,27017,422,164,258,6,30,3,3,allow
56006,53,14148,53,200,102,98,2,30,1,1,allow
56713,443,29098,443,373053,9725,363328,374,45,129,245,allow
50602,53,48380,53,761,100,661,2,30,1,1,allow
50152,53,50662,53,776,102,674,2,30,1,1,allow
39575,53,26625,53,198,93,105,2,30,1,1,allow
52471,443,40608,443,41966,23593,18373,89,154,42,47,allow
56912,443,18350,443,7618,2859,4759,26,17,14,12,allow
35187,443,10629,443,13057,1460,11597,28,255,14,14,allow
56710,80,31559,80,30614,1926,28688,44,45,23,21,allow
33498,443,13950,443,3672,1802,1870,25,129,10,15,allow
56711,443,22373,443,1207531,28695,1178836,1184,45,400,784,allow
53779,24874,46162,24874,70,70,0,1,5,1,0,allow
49654,80,62671,80,1506,914,592,9,16,5,4,allow
36146,443,42647,443,2514,1249,1265,19,76,9,10,allow
55380,53,27233,53,289,97,192,4,45,2,2,allow
49989,53,14607,53,778,103,675,2,30,1,1,allow
58823,443,42336,443,25195,16739,8456,60,20,35,25,allow
39251,53,9429,53,198,93,105,2,30,1,1,allow
45439,443,28530,443,24785,17234,7551,68,421,36,32,allow
56365,53,1142,53,198,101,97,2,30,1,1,allow
56068,53,2215,53,752,93,659,2,30,1,1,allow
50135,53,57045,53,774,101,673,2,30,1,1,allow
56934,53,42274,53,216,110,106,2,31,1,1,allow
33877,443,16562,443,9449,3441,6008,27,41,17,10,allow
52002,34348,46608,34348,66,66,0,1,5,1,0,allow
49429,53,29436,53,188,96,92,2,31,1,1,allow
55849,53,21168,53,190,97,93,2,31,1,1,allow
54563,443,54563,443,109880,24958,84922,154,20,83,71,allow
56709,443,60934,443,1239919,29325,1210594,1214,46,409,805,allow
53817,59216,6687,59216,258,70,188,4,8,2,2,allow
50803,443,40558,443,1590,1038,552,12,48,6,6,allow
53780,47132,52557,47132,70,70,0,1,5,1,0,allow
52001,12514,13607,12514,66,66,0,1,5,1,0,allow
65219,53,39844,53,410,99,311,4,56,2,2,allow
55651,53,31474,53,198,101,97,2,30,1,1,allow
57066,53,53308,53,778,103,675,2,30,1,1,allow
55185,53,27754,53,758,93,665,2,30,1,1,allow
56795,53,37529,53,776,102,674,2,30,1,1,allow
54262,443,59350,443,11356,5509,5847,84,544,44,40,allow
64729,53,52284,53,770,102,668,2,30,1,1,allow
55715,53,53520,53,168,86,82,2,30,1,1,allow
55791,53,26721,53,770,101,669,2,30,1,1,allow
57423,53,20278,53,774,101,673,2,30,1,1,allow
50426,53,23864,53,760,97,663,2,30,1,1,allow
27005,27015,27620,27015,880,126,754,2,30,1,1,allow
56500,53,34519,53,198,101,97,2,31,1,1,allow
57025,53,3380,53,168,86,82,2,31,1,1,allow
65313,53,63714,53,164,84,80,2,31,1,1,allow
57565,443,12958,443,3586,1074,2512,17,137,8,9,allow
64959,53,59416,53,202,103,99,2,31,1,1,allow
26900,27017,61520,27017,422,164,258,6,31,3,3,allow
57157,53,17035,53,755,94,661,2,31,1,1,allow
56290,53,40983,53,716,95,621,2,31,1,1,allow
55439,53,12410,53,738,86,652,2,30,1,1,allow
55390,53,32407,53,778,103,675,2,31,1,1,allow
64687,53,62553,53,182,93,89,2,31,1,1,allow
16387,22226,0,0,60,60,0,1,61,1,0,allow
49593,53,21447,53,762,98,664,2,31,1,1,allow
56804,53,22833,53,760,96,664,2,31,1,1,allow
55443,53,31894,53,751,95,656,2,31,1,1,allow
65112,53,30397,53,202,103,99,2,31,1,1,allow
64054,53,42745,53,182,93,89,2,31,1,1,allow
26900,27017,18355,27017,422,164,258,6,31,3,3,allow
56664,53,62279,53,774,101,673,2,31,1,1,allow
27005,27022,21223,27022,890,126,764,2,31,1,1,allow
27005,27016,17178,27016,914,126,788,2,31,1,1,allow
55262,53,28090,53,762,98,664,2,31,1,1,allow
64330,53,32772,53,186,95,91,2,31,1,1,allow
56544,53,62437,53,760,97,663,2,31,1,1,allow
56245,53,57808,53,200,102,98,2,31,1,1,allow
56624,53,13351,53,198,101,97,2,31,1,1,allow
47756,443,23688,443,8504,4770,3734,46,196,25,21,allow
27005,27015,34776,27015,882,126,756,2,31,1,1,allow
16387,26637,0,0,60,60,0,1,61,1,0,allow
27005,27015,27978,27015,888,126,762,2,31,1,1,allow
55037,443,21745,443,2639,258,2381,9,120,4,5,allow
6881,6881,46331,6881,259,150,109,2,1201,1,1,allow
61146,445,0,0,70,70,0,1,0,1,0,drop
61145,445,0,0,70,70,0,1,0,1,0,drop
61373,445,0,0,66,66,0,1,0,1,0,drop
3478,61463,0,0,918,918,0,1,0,1,0,deny
45766,35440,0,0,62,62,0,1,0,1,0,deny
61142,445,0,0,70,70,0,1,0,1,0,drop
45964,55559,0,0,60,60,0,1,0,1,0,deny
18608,11392,0,0,66,66,0,1,0,1,0,deny
58251,36237,0,0,66,66,0,1,0,1,0,deny
57604,32480,0,0,62,62,0,1,0,1,0,deny
60806,51050,0,0,66,66,0,1,0,1,0,deny
63910,44847,0,0,66,66,0,1,0,1,0,deny
55831,53,65358,53,183,94,89,2,30,1,1,allow
65311,53,5309,53,198,94,104,2,30,1,1,allow
64959,53,9017,53,209,110,99,2,30,1,1,allow
35927,443,23260,443,9102,1205,7897,25,14,14,11,allow
46271,443,30209,443,70,70,0,2,4,2,0,allow
49461,53,38932,53,198,102,96,2,29,1,1,allow
49568,53,53479,53,184,102,82,2,29,1,1,allow
56697,53,16898,53,198,102,96,2,29,1,1,allow
49543,53,5363,53,200,102,98,2,30,1,1,allow
65313,53,62981,53,166,86,80,2,30,1,1,allow
48996,443,35257,443,128299,119001,9298,178,280,103,75,allow
64113,443,11350,443,14057427,329652,13727775,13768,110,4655,9113,allow
51956,443,35785,443,5065,1658,3407,21,16,13,8,allow
60867,443,29499,443,3072,2174,898,14,317,8,6,allow
54439,443,63339,443,44294,9390,34904,167,319,83,84,allow
63901,42053,50757,42053,2980,1647,1333,16,31,10,6,allow
58855,443,45547,443,5168,700,4468,16,14,7,9,allow
53154,44645,45393,44645,320,140,180,6,5,3,3,allow
50667,443,38450,443,8536,2068,6468,36,18,16,20,allow
53823,25291,38093,25291,320,140,180,6,6,3,3,allow
55752,8060,41329,8060,70,70,0,1,4,1,0,allow
55380,53,32660,53,289,97,192,4,44,2,2,allow
55050,443,54563,443,126,60,66,3,5,2,1,allow
55651,53,8251,53,199,102,97,2,29,1,1,allow
65219,53,31087,53,197,102,95,2,29,1,1,allow
56934,53,16279,53,216,110,106,2,29,1,1,allow
49534,53,40703,53,193,102,91,2,29,1,1,allow
49461,53,21062,53,821,102,719,2,29,1,1,allow
56474,53,60230,53,209,110,99,2,29,1,1,allow
55715,53,19164,53,168,86,82,2,29,1,1,allow
49403,53,28281,53,228,102,126,2,29,1,1,allow
57136,53,60175,53,209,110,99,2,29,1,1,allow
50630,53,12018,53,209,110,99,2,29,1,1,allow
49429,53,2752,53,194,102,92,2,30,1,1,allow
55200,53,14143,53,209,110,99,2,30,1,1,allow
37048,53,15129,53,168,78,90,2,29,1,1,allow
50418,53,58072,53,185,102,83,2,30,1,1,allow
60290,53,25533,53,199,94,105,2,29,1,1,allow
42300,53,40798,53,168,78,90,2,29,1,1,allow
54998,53,32757,53,195,102,93,2,29,1,1,allow
58767,53,1096,53,168,78,90,2,29,1,1,allow
65245,53,50630,53,193,102,91,2,30,1,1,allow
55715,53,18469,53,168,86,82,2,30,1,1,allow
65116,53,63151,53,214,110,104,2,30,1,1,allow
56459,53,30479,53,209,110,99,2,30,1,1,allow
56673,53,38951,53,183,94,89,2,30,1,1,allow
49814,53,14666,53,189,102,87,2,30,1,1,allow
55200,53,50421,53,209,110,99,2,30,1,1,allow
26900,27017,38373,27017,422,164,258,6,30,3,3,allow
55712,53,64759,53,164,86,78,2,30,1,1,allow
65323,53,29690,53,816,102,714,2,30,1,1,allow
39054,443,15031,443,7772,4119,3653,31,17,16,15,allow
65116,53,4360,53,214,110,104,2,30,1,1,allow
52003,18150,63580,18150,70,70,0,1,5,1,0,allow
60460,54233,40952,54233,70,70,0,2,8,2,0,allow
55380,53,36013,53,289,97,192,4,45,2,2,allow
50671,443,30836,443,5409,1834,3575,25,17,12,13,allow
49814,53,29277,53,181,94,87,2,30,1,1,allow
42336,443,36600,443,4181,998,3183,14,26,7,7,allow
65152,53,13983,53,167,86,81,2,30,1,1,allow
51999,34619,53326,34619,70,70,0,1,5,1,0,allow
53864,443,51683,443,232,172,60,3,5,2,1,allow
65449,53,42820,53,723,102,621,2,30,1,1,allow
57802,443,19538,443,37181,32491,4690,93,81,54,39,allow
54136,443,48147,443,18716,8002,10714,100,945,51,49,allow
55830,53,32937,53,183,94,89,2,30,1,1,allow
55651,53,20940,53,199,102,97,2,30,1,1,allow
65057,53,5504,53,199,102,97,2,30,1,1,allow
55262,53,4967,53,193,102,91,2,30,1,1,allow
64905,53,62456,53,283,102,181,2,30,1,1,allow
56273,53,10176,53,200,102,98,2,30,1,1,allow
56006,53,56453,53,200,102,98,2,30,1,1,allow
55932,53,42862,53,193,102,91,2,30,1,1,allow
27005,27015,8730,27015,913,126,787,2,30,1,1,allow
56365,53,6321,53,199,102,97,2,30,1,1,allow
62415,53,36183,53,86,86,0,1,30,1,0,allow
27005,27015,31472,27015,888,126,762,2,30,1,1,allow
63951,55255,6079,55255,1277,856,421,9,15,6,3,allow
52426,443,20298,443,8760,1218,7542,25,15,14,11,allow
65245,53,59048,53,193,102,91,2,30,1,1,allow
49429,53,55360,53,194,102,92,2,30,1,1,allow
55169,53,40051,53,199,102,97,2,30,1,1,allow
63084,53,54059,53,86,86,0,1,30,1,0,allow
54966,443,5878,443,4645,2498,2147,14,135,7,7,allow
36109,443,56907,443,26538,7971,18567,70,128,38,32,allow
50614,80,59659,80,318,192,126,6,25,4,2,allow
52005,33191,35955,33191,70,70,0,1,5,1,0,allow
64338,53,13922,53,298,102,196,4,43,2,2,allow
64544,53,63880,53,199,94,105,2,30,1,1,allow
50161,53,38218,53,165,86,79,2,30,1,1,allow
27005,27001,28367,27001,883,126,757,2,30,1,1,allow
64537,53,37078,53,168,86,82,2,30,1,1,allow
64959,53,12491,53,209,110,99,2,30,1,1,allow
53394,53,24735,53,86,86,0,1,30,1,0,allow
57203,53,26707,53,199,102,97,2,30,1,1,allow
58851,443,38942,443,5166,700,4466,16,15,7,9,allow
52024,47600,56931,47600,70,70,0,2,8,2,0,allow
45458,80,54981,80,138,78,60,2,5,1,1,allow
52000,10491,1794,10491,70,70,0,1,5,1,0,allow
62059,443,14919,443,11903,6327,5576,48,15,27,21,allow
55243,443,31338,443,36501,26194,10307,76,71,47,29,allow
53808,56215,39390,56215,70,70,0,2,7,2,0,allow
41925,443,48625,443,8333,2153,6180,31,100,18,13,allow
61552,443,61552,443,38146,3555,34591,57,16,28,29,allow
53814,6725,2877,6725,70,70,0,2,7,2,0,allow
53815,17290,63882,17290,70,70,0,2,7,2,0,allow
51037,80,32981,80,134,60,74,3,4,2,1,allow
52101,443,43263,443,22696,18094,4602,41,315,25,16,allow
65060,53,21160,53,324,97,227,4,52,2,2,allow
39224,53,62138,53,168,78,90,2,29,1,1,allow
60989,443,11071,443,7592,2966,4626,26,15,15,11,allow
56474,53,9698,53,209,110,99,2,29,1,1,allow
58848,443,1963,443,5168,700,4468,16,15,7,9,allow
64943,53,17729,53,341,110,231,2,29,1,1,allow
48458,53,36064,53,289,86,203,2,29,1,1,allow
55362,53,21893,53,195,102,93,2,29,1,1,allow
49317,53,28300,53,194,102,92,2,29,1,1,allow
50137,53,58176,53,183,94,89,2,29,1,1,allow
57838,53,1470,53,70,70,0,1,29,1,0,allow
60548,53,24812,53,199,94,105,2,29,1,1,allow
8283,45858,25688,45858,130,70,60,2,30,1,1,allow
56273,53,30021,53,200,102,98,2,30,1,1,allow
58536,53,15925,53,177,86,91,2,30,1,1,allow
55362,53,39798,53,195,102,93,2,30,1,1,allow
50558,53,44600,53,733,94,639,2,30,1,1,allow
64595,53,8174,53,305,94,211,4,60,2,2,allow
56697,53,1249,53,198,102,96,2,30,1,1,allow
49885,53,38127,53,377,94,283,2,30,1,1,allow
55169,53,58327,53,199,102,97,2,30,1,1,allow
50151,53,17420,53,152,78,74,2,30,1,1,allow
50151,53,44129,53,168,94,74,2,30,1,1,allow
26900,27017,34324,27017,422,164,258,6,30,3,3,allow
27005,27016,31550,27016,884,126,758,2,30,1,1,allow
57867,27019,40046,27019,2338,634,1704,10,30,6,4,allow
56492,53,1811,53,94,94,0,1,30,1,0,allow
57860,443,46825,443,1786,172,1614,7,120,3,4,allow
55831,53,9463,53,183,94,89,2,30,1,1,allow
38288,443,40759,443,8627,2906,5721,10,121,4,6,allow
57025,53,16250,53,168,86,82,2,30,1,1,allow
26900,27017,12136,27017,422,164,258,6,30,3,3,allow
64519,53,39794,53,277,94,183,4,60,2,2,allow
65313,53,7915,53,166,86,80,2,30,1,1,allow
49898,53,22442,53,184,94,90,2,30,1,1,allow
55752,53,44697,53,200,102,98,2,30,1,1,allow
64723,53,38339,53,165,86,79,2,30,1,1,allow
55752,53,6985,53,200,102,98,2,30,1,1,allow
64575,53,5183,53,182,102,80,2,31,1,1,allow
65019,53,29209,53,195,102,93,2,31,1,1,allow
49416,53,31346,53,177,94,83,2,31,1,1,allow
56934,53,21277,53,216,110,106,2,31,1,1,allow
65219,53,20854,53,197,102,95,2,31,1,1,allow
49314,443,60912,443,8599,4862,3737,47,195,26,21,allow
43603,443,42478,443,8420,2986,5434,23,138,13,10,allow
34960,443,6692,443,7029,2223,4806,23,361,12,11,allow
56500,53,23471,53,199,102,97,2,30,1,1,allow
55170,53,27773,53,250,94,156,2,30,1,1,allow
57258,53,22772,53,821,102,719,2,30,1,1,allow
53262,443,5546,443,242149,7606,234543,260,150,92,168,allow
62058,443,34202,443,8666,2933,5733,46,15,27,19,allow
63979,49547,9568,49547,312,132,180,6,6,3,3,allow
42337,443,16716,443,4181,998,3183,14,26,7,7,allow
49402,443,59952,443,7965,4044,3921,63,464,30,33,allow
55200,53,19754,53,209,110,99,2,30,1,1,allow
65057,53,53489,53,199,102,97,2,30,1,1,allow
49689,53,60193,53,812,110,702,2,30,1,1,allow
55262,53,22053,53,193,102,91,2,30,1,1,allow
64261,53,48738,53,295,110,185,2,30,1,1,allow
65101,53,61768,53,402,118,284,2,30,1,1,allow
27005,27015,15666,27015,876,126,750,2,30,1,1,allow
58101,53,38765,53,86,86,0,1,30,1,0,allow
52142,443,7937,443,9911,2041,7870,34,120,17,17,allow
64054,53,33800,53,183,94,89,2,31,1,1,allow
53261,443,39643,443,96485,4565,91920,119,150,45,74,allow
64513,53,5790,53,336,93,243,4,33,2,2,allow
52004,55711,7662,55711,70,70,0,1,5,1,0,allow
3155,23,3155,23,66,66,0,1,5,1,0,allow
42338,443,46950,443,4181,998,3183,14,26,7,7,allow
50633,80,7997,80,1717,1247,470,9,15,5,4,allow
56673,53,13282,53,183,94,89,2,30,1,1,allow
49173,53,27694,53,214,110,104,2,30,1,1,allow
65112,53,26607,53,209,110,99,2,30,1,1,allow
49610,53,38769,53,754,94,660,2,30,1,1,allow
27005,27015,24386,27015,882,126,756,3,31,2,1,allow
49227,53,61588,53,179,94,85,2,30,1,1,allow
26900,27017,45404,27017,422,164,258,6,30,3,3,allow
42341,443,25797,443,276,70,206,5,26,2,3,allow
52425,443,43475,443,8454,978,7476,20,15,10,10,allow
56459,53,20811,53,209,110,99,2,30,1,1,allow
50100,53,17377,53,734,94,640,2,30,1,1,allow
56006,53,30347,53,200,102,98,2,30,1,1,allow
64440,53,9584,53,270,110,160,2,30,1,1,allow
26900,27017,22133,27017,422,164,258,6,30,3,3,allow
50161,53,40110,53,173,94,79,2,30,1,1,allow
49687,53,40743,53,184,102,82,2,30,1,1,allow
65323,53,20486,53,193,102,91,2,30,1,1,allow
64586,53,21236,53,173,94,79,2,30,1,1,allow
57190,53,17320,53,757,102,655,2,30,1,1,allow
48864,123,32657,123,184,94,90,2,30,1,1,allow
56500,53,60506,53,199,102,97,2,30,1,1,allow
49687,53,9331,53,184,102,82,2,30,1,1,allow
55831,53,4843,53,183,94,89,2,30,1,1,allow
56447,53,39784,53,403,110,293,2,30,1,1,allow
26900,27017,18578,27017,422,164,258,6,30,3,3,allow
64959,53,12342,53,209,110,99,2,30,1,1,allow
64330,53,5975,53,193,102,91,2,30,1,1,allow
64054,53,34990,53,183,94,89,2,30,1,1,allow
64586,53,2228,53,173,94,79,2,30,1,1,allow
49365,53,34232,53,199,94,105,2,31,1,1,allow
59191,443,56618,443,4489,2046,2443,23,121,11,12,allow
123,123,23599,123,184,94,90,2,30,1,1,allow
57258,53,32914,53,198,102,96,2,30,1,1,allow
56170,53,19497,53,198,102,96,2,30,1,1,allow
56787,53,40108,53,209,110,99,2,30,1,1,allow
56328,53,20002,53,214,102,112,2,31,1,1,allow
65328,53,29572,53,182,102,80,2,31,1,1,allow
49163,53,27365,53,167,86,81,2,31,1,1,allow
57470,29137,36773,29137,1386,1386,0,22,1610,22,0,allow
15986,8000,55980,8000,274,150,124,4,60,2,2,allow
46531,53,8725,53,209,86,123,2,30,1,1,allow
55849,53,54594,53,195,102,93,2,30,1,1,allow
57647,53,15724,53,265,78,187,2,30,1,1,allow
56697,53,34605,53,198,102,96,2,30,1,1,allow
26900,27017,41768,27017,422,164,258,6,30,3,3,allow
65384,53,4009,53,443,182,261,6,30,3,3,allow
26900,27017,50857,27017,254,82,172,4,30,2,2,allow
64519,53,52190,53,184,94,90,2,30,1,1,allow
49416,53,16616,53,185,102,83,2,30,1,1,allow
49163,53,4379,53,167,86,81,2,30,1,1,allow
56787,53,13426,53,209,110,99,2,30,1,1,allow
65398,53,64225,53,214,110,104,2,30,1,1,allow
49503,53,8833,53,167,86,81,2,30,1,1,allow
55371,53,41494,53,168,86,82,2,30,1,1,allow
64723,53,29424,53,165,86,79,2,31,1,1,allow
49218,53,12399,53,195,102,93,2,31,1,1,allow
49722,53,40518,53,200,102,98,2,31,1,1,allow
49227,53,18246,53,179,94,85,2,31,1,1,allow
64316,53,46275,53,184,94,90,2,31,1,1,allow
65112,53,6227,53,209,110,99,2,31,1,1,allow
52929,443,26411,443,8623,4829,3794,44,195,22,22,allow
50307,443,61889,443,1786,172,1614,7,120,3,4,allow
33912,443,41888,443,6288,3354,2934,9,122,5,4,allow
45558,443,51093,443,6450,1003,5447,21,360,11,10,allow
38169,443,2048,443,7841,2301,5540,18,135,8,10,allow
55070,53,47871,53,195,102,93,2,31,1,1,allow
52233,80,14705,80,1674,708,966,18,392,6,12,allow
49160,52011,11430,52011,800,150,650,4,1200,2,2,allow
63381,443,50807,443,11344,5681,5663,34,3601,20,14,allow
37965,8272,8707,8272,1577,594,983,20,1740,10,10,allow
57470,56098,25356,56098,1359,726,633,6,1199,3,3,allow
54342,80,39601,80,1515,481,1034,11,16,6,5,allow
56006,53,22097,53,200,102,98,2,30,1,1,allow
56695,53,2838,53,183,94,89,2,30,1,1,allow
55362,53,23060,53,374,97,277,4,32,2,2,allow
53807,28630,53835,28630,70,70,0,2,8,2,0,allow
64614,53,5990,53,517,179,338,6,62,3,3,allow
34720,443,52073,443,6453,2318,4135,32,84,16,16,allow
56492,53,62080,53,184,94,90,2,30,1,1,allow
56500,53,41129,53,199,102,97,2,30,1,1,allow
56170,53,52947,53,198,102,96,2,31,1,1,allow
65366,53,44706,53,458,188,270,6,31,3,3,allow
49667,53,30486,53,759,102,657,2,31,1,1,allow
64330,53,52470,53,193,102,91,2,31,1,1,allow
50278,53,13442,53,196,102,94,2,31,1,1,allow
58857,443,13362,443,3439647,103607,3336040,3670,452,1291,2379,allow
45897,443,62629,443,2267946,70852,2197094,2429,316,859,1570,allow
50731,27029,22129,27029,269,78,191,2,31,1,1,allow
50728,27029,42888,27029,269,78,191,2,31,1,1,allow
53806,37267,15309,37267,70,70,0,2,8,2,0,allow
49925,80,18933,80,12290,10150,2140,37,256,19,18,allow
46002,443,21932,443,6299,1424,4875,27,291,10,17,allow
64054,53,41905,53,1299,387,912,10,103,5,5,allow
3478,61463,0,0,1053,1053,0,1,0,1,0,deny
61366,445,0,0,66,66,0,1,0,1,0,drop
37633,44847,0,0,62,62,0,1,0,1,0,deny
49594,445,0,0,70,70,0,1,0,1,0,drop
57339,57470,0,0,66,66,0,1,0,1,0,deny
52114,64147,0,0,62,62,0,1,0,1,0,deny
80,9918,0,0,60,60,0,1,0,1,0,deny
61135,445,0,0,70,70,0,1,0,1,0,drop
63079,64147,0,0,62,62,0,1,0,1,0,deny
61363,445,0,0,66,66,0,1,0,1,0,drop
3478,61463,0,0,164,164,0,1,0,1,0,deny
46491,50584,0,0,66,66,0,1,0,1,0,deny
3478,61463,0,0,743,743,0,1,0,1,0,deny
60297,25604,0,0,62,62,0,1,0,1,0,deny
8889,42210,0,0,60,60,0,1,0,1,0,deny
61355,445,0,0,66,66,0,1,0,1,0,drop
15854,50584,0,0,146,146,0,1,0,1,0,deny
61128,445,0,0,70,70,0,1,0,1,0,drop
61127,445,0,0,70,70,0,1,0,1,0,drop
61349,445,0,0,66,66,0,1,0,1,0,drop
2717,31573,0,0,66,66,0,1,0,1,0,deny
12550,37807,0,0,62,62,0,1,0,1,0,deny
3478,61463,0,0,180,180,0,1,0,1,0,deny
3478,61463,0,0,1267,1267,0,1,0,1,0,deny
15688,56919,0,0,146,146,0,1,0,1,0,deny
61122,445,0,0,70,70,0,1,0,1,0,drop
61120,445,0,0,70,70,0,1,0,1,0,drop
6881,1707,0,0,146,146,0,1,0,1,0,deny
3478,61463,0,0,68,68,0,1,0,1,0,deny
3478,61463,0,0,1188,1188,0,1,0,1,0,deny
57825,13014,0,0,74,74,0,1,0,1,0,deny
3478,61463,0,0,252,252,0,1,0,1,0,deny
3478,61463,0,0,1273,1273,0,1,0,1,0,deny
3478,61463,0,0,156,156,0,1,0,1,0,deny
49576,445,0,0,70,70,0,1,0,1,0,drop
49578,445,0,0,70,70,0,1,0,1,0,drop
49577,445,0,0,70,70,0,1,0,1,0,drop
61334,445,0,0,66,66,0,1,0,1,0,drop
61340,445,0,0,66,66,0,1,0,1,0,drop
61341,445,0,0,66,66,0,1,0,1,0,drop
61337,445,0,0,66,66,0,1,0,1,0,drop
61339,445,0,0,66,66,0,1,0,1,0,drop
61335,445,0,0,66,66,0,1,0,1,0,drop
61336,445,0,0,66,66,0,1,0,1,0,drop
61333,445,0,0,66,66,0,1,0,1,0,drop
18091,32480,0,0,66,66,0,1,0,1,0,deny
61116,445,0,0,70,70,0,1,0,1,0,drop
24606,55783,0,0,72,72,0,1,0,1,0,deny
61115,445,0,0,70,70,0,1,0,1,0,drop
25961,55783,0,0,66,66,0,1,0,1,0,deny
51705,22114,0,0,66,66,0,1,0,1,0,deny
45981,51505,0,0,62,62,0,1,0,1,0,deny
993,54748,0,0,66,66,0,1,0,1,0,deny
23798,23,0,0,60,60,0,1,0,1,0,deny
3478,61463,0,0,935,935,0,1,0,1,0,deny
62709,57470,0,0,62,62,0,1,0,1,0,deny
49575,445,0,0,70,70,0,1,0,1,0,drop
49568,445,0,0,70,70,0,1,0,1,0,drop
49565,445,0,0,70,70,0,1,0,1,0,drop
49566,445,0,0,70,70,0,1,0,1,0,drop
29080,50265,0,0,62,62,0,1,0,1,0,deny
61110,445,0,0,70,70,0,1,0,1,0,drop
34932,38608,0,0,62,62,0,1,0,1,0,deny
61319,445,0,0,66,66,0,1,0,1,0,drop
61321,445,0,0,66,66,0,1,0,1,0,drop
61318,445,0,0,66,66,0,1,0,1,0,drop
3478,61463,0,0,982,982,0,1,0,1,0,deny
49556,445,0,0,70,70,0,1,0,1,0,drop
51999,37965,0,0,62,62,0,1,0,1,0,deny
58914,37965,0,0,66,66,0,1,0,1,0,deny
49555,445,0,0,70,70,0,1,0,1,0,drop
49550,445,0,0,70,70,0,1,0,1,0,drop
49547,445,0,0,70,70,0,1,0,1,0,drop
3478,61463,0,0,902,902,0,1,0,1,0,deny
41648,56205,0,0,66,66,0,1,0,1,0,deny
64626,50584,0,0,62,62,0,1,0,1,0,deny
51064,5529,0,0,146,146,0,1,0,1,0,deny
59618,46824,0,0,66,66,0,1,0,1,0,deny
61097,445,0,0,70,70,0,1,0,1,0,drop
51948,17372,0,0,62,62,0,1,0,1,0,deny
20864,51221,0,0,62,62,0,1,0,1,0,deny
3478,61463,0,0,164,164,0,1,0,1,0,deny
3478,61463,0,0,1118,1118,0,1,0,1,0,deny
61094,445,0,0,70,70,0,1,0,1,0,drop
63345,53,0,0,75,75,0,1,0,1,0,deny
26469,26348,0,0,66,66,0,1,0,1,0,deny
49536,445,0,0,70,70,0,1,0,1,0,drop
49534,445,0,0,70,70,0,1,0,1,0,drop
49533,445,0,0,70,70,0,1,0,1,0,drop
60438,17372,0,0,66,66,0,1,0,1,0,deny
50570,57470,0,0,66,66,0,1,0,1,0,deny
54621,26296,0,0,145,145,0,1,0,1,0,deny
30580,50265,0,0,62,62,0,1,0,1,0,deny
3478,61463,0,0,159,159,0,1,0,1,0,deny
3478,61463,0,0,1306,1306,0,1,0,1,0,deny
61088,445,0,0,70,70,0,1,0,1,0,drop
38592,57209,0,0,62,62,0,1,0,1,0,deny
61087,445,0,0,70,70,0,1,0,1,0,drop
12965,37965,0,0,66,66,0,1,0,1,0,deny
61085,445,0,0,70,70,0,1,0,1,0,drop
49203,51050,0,0,62,62,0,1,0,1,0,deny
3478,61463,0,0,1188,1188,0,1,0,1,0,deny
3478,61463,0,0,967,967,0,1,0,1,0,deny
49529,445,0,0,70,70,0,1,0,1,0,drop
49523,445,0,0,70,70,0,1,0,1,0,drop
24504,37965,0,0,62,62,0,1,0,1,0,deny
60761,51221,0,0,62,62,0,1,0,1,0,deny
58687,11392,0,0,62,62,0,1,0,1,0,deny
9588,37965,0,0,66,66,0,1,0,1,0,deny
61294,445,0,0,66,66,0,1,0,1,0,drop
61293,445,0,0,66,66,0,1,0,1,0,drop
61078,445,0,0,70,70,0,1,0,1,0,drop
3478,61463,0,0,179,179,0,1,0,1,0,deny
3478,61463,0,0,1275,1275,0,1,0,1,0,deny
0,0,0,0,210,210,0,3,0,3,0,deny
61076,445,0,0,70,70,0,1,0,1,0,drop
45304,64147,0,0,72,72,0,1,0,1,0,deny
37455,50584,0,0,66,66,0,1,0,1,0,deny
49520,445,0,0,70,70,0,1,0,1,0,drop
49516,445,0,0,70,70,0,1,0,1,0,drop
49508,445,0,0,70,70,0,1,0,1,0,drop
49511,445,0,0,70,70,0,1,0,1,0,drop
42429,22114,0,0,62,62,0,1,0,1,0,deny
61075,445,0,0,70,70,0,1,0,1,0,drop
61074,445,0,0,70,70,0,1,0,1,0,drop
61073,445,0,0,70,70,0,1,0,1,0,drop
61287,445,0,0,66,66,0,1,0,1,0,drop
61069,445,0,0,70,70,0,1,0,1,0,drop
61068,445,0,0,70,70,0,1,0,1,0,drop
3478,61463,0,0,400,400,0,1,0,1,0,deny
3478,61463,0,0,1290,1290,0,1,0,1,0,deny
25497,44847,0,0,62,62,0,1,0,1,0,deny
61282,445,0,0,66,66,0,1,0,1,0,drop
61280,445,0,0,66,66,0,1,0,1,0,drop
61281,445,0,0,66,66,0,1,0,1,0,drop
61279,445,0,0,66,66,0,1,0,1,0,drop
61271,445,0,0,66,66,0,1,0,1,0,drop
61275,445,0,0,66,66,0,1,0,1,0,drop
61276,445,0,0,66,66,0,1,0,1,0,drop
49505,445,0,0,70,70,0,1,0,1,0,drop
61055,445,0,0,70,70,0,1,0,1,0,drop
61054,445,0,0,70,70,0,1,0,1,0,drop
44117,6881,0,0,62,62,0,1,0,1,0,deny
61051,445,0,0,70,70,0,1,0,1,0,drop
49501,445,0,0,70,70,0,1,0,1,0,drop
49497,445,0,0,70,70,0,1,0,1,0,drop
49499,445,0,0,70,70,0,1,0,1,0,drop
61044,445,0,0,70,70,0,1,0,1,0,drop
61045,445,0,0,70,70,0,1,0,1,0,drop
3478,61463,0,0,217,217,0,1,0,1,0,deny
3478,61463,0,0,1305,1305,0,1,0,1,0,deny
52348,62413,0,0,66,66,0,1,0,1,0,deny
1027,57866,0,0,146,146,0,1,0,1,0,deny
27773,56205,0,0,62,62,0,1,0,1,0,deny
62273,50584,0,0,66,66,0,1,0,1,0,deny
50757,64147,0,0,66,66,0,1,0,1,0,deny
1030,64147,0,0,62,62,0,1,0,1,0,deny
3478,61463,0,0,1188,1188,0,1,0,1,0,deny
57090,51505,0,0,66,66,0,1,0,1,0,deny
56255,44847,0,0,62,62,0,1,0,1,0,deny
49277,51505,0,0,66,66,0,1,0,1,0,deny
3478,61463,0,0,328,328,0,1,0,1,0,deny
3478,61463,0,0,1162,1162,0,1,0,1,0,deny
3478,61463,0,0,1162,1162,0,1,0,1,0,deny
44117,6881,0,0,146,146,0,1,0,1,0,deny
3478,61463,0,0,1302,1302,0,1,0,1,0,deny
5223,59023,0,0,66,66,0,1,0,1,0,deny
49496,445,0,0,70,70,0,1,0,1,0,drop
49494,445,0,0,70,70,0,1,0,1,0,drop
49493,445,0,0,70,70,0,1,0,1,0,drop
61033,445,0,0,70,70,0,1,0,1,0,drop
61264,445,0,0,66,66,0,1,0,1,0,drop
58839,443,29041,443,6270,4231,2039,22,16,11,11,allow
35080,80,13868,80,71843,2833,69010,83,16,36,47,allow
50116,22,50116,22,60,60,0,1,5,1,0,allow
60903,443,60903,443,3672,2294,1378,23,17,13,10,allow
56953,443,23008,443,66324,17448,48876,86,331,39,47,allow
123,123,34455,123,184,94,90,2,30,1,1,allow
54458,443,1235,443,3885,2355,1530,26,270,13,13,allow
56695,53,39577,53,93,93,0,1,30,1,0,allow
60244,80,21449,80,1114,534,580,12,16,7,5,allow
49722,53,48716,53,200,102,98,2,30,1,1,allow
61502,443,14539,443,580643,7944,572699,475,41,86,389,allow
6580,443,39397,443,2227,1018,1209,17,16,8,9,allow
55285,53,1660,53,268,95,173,4,45,2,2,allow
37638,443,24895,443,8134,2717,5417,24,16,15,9,allow
65019,53,42326,53,190,97,93,2,31,1,1,allow
49227,53,39429,53,174,89,85,2,30,1,1,allow
51415,443,38416,443,9284,2172,7112,39,83,19,20,allow
56492,53,6474,53,184,94,90,2,30,1,1,allow
64316,53,59418,53,184,94,90,2,31,1,1,allow
55830,53,59149,53,164,84,80,2,31,1,1,allow
57208,53,63369,53,182,93,89,2,31,1,1,allow
56636,53,8907,53,168,86,82,2,30,1,1,allow
64519,53,20237,53,277,94,183,4,60,2,2,allow
56992,80,9421,80,214,140,74,4,35,3,1,allow
55098,53,22759,53,474,200,274,6,44,3,3,allow
53586,443,61806,443,8510,3207,5303,25,324,13,12,allow
57204,443,59109,443,35981,14676,21305,63,320,31,32,allow
26979,443,43734,443,7343,2586,4757,23,19,11,12,allow
58639,443,58639,443,4380,1473,2907,19,30,11,8,allow
36144,443,59381,443,8859,1662,7197,26,75,14,12,allow
58836,443,51260,443,12230,8144,4086,33,17,18,15,allow
443,10120,443,10120,64,64,0,1,5,1,0,allow
49285,6881,35710,6881,411,225,186,6,16,3,3,allow
26900,27017,37191,27017,422,164,258,6,30,3,3,allow
56320,53,27969,53,761,100,661,2,30,1,1,allow
55616,53,41127,53,776,102,674,2,30,1,1,allow
49582,80,30882,80,454222,9730,444492,425,155,119,306,allow
49390,53,24759,53,204,104,100,2,31,1,1,allow
39914,443,20492,443,26779179,169104,26610075,19911,91,1968,17943,allow
27005,23333,41916,23333,890,126,764,3,32,2,1,allow
63965,11785,23827,11785,66,66,0,2,8,2,0,allow
53803,17637,1467,17637,70,70,0,2,8,2,0,allow
58837,443,12859,443,13120,8597,4523,34,17,18,16,allow
55979,53,36976,53,186,95,91,2,31,1,1,allow
58673,443,29883,443,11116,2910,8206,30,20,16,14,allow
56994,80,47420,80,214,140,74,4,35,3,1,allow
54497,443,36894,443,10017,2436,7581,22,138,10,12,allow
26900,27017,24961,27017,168,82,86,2,30,1,1,allow
56993,80,53078,80,214,140,74,4,35,3,1,allow
49284,6881,63605,6881,411,225,186,6,16,3,3,allow
55932,53,3397,53,186,95,91,2,30,1,1,allow
61501,443,38275,443,633920,7867,626053,505,41,81,424,allow
50154,53,53091,53,756,95,661,2,30,1,1,allow
51449,443,58007,443,9602,3315,6287,25,37,15,10,allow
55539,53,7321,53,814,110,704,2,30,1,1,allow
55083,53,43737,53,751,95,656,2,30,1,1,allow
56170,53,28854,53,196,100,96,2,30,1,1,allow
51452,443,6945,443,7674,2829,4845,23,31,14,9,allow
55154,53,45659,53,184,94,90,2,30,1,1,allow
65398,53,61803,53,212,108,104,2,30,1,1,allow
65384,53,45912,53,735,88,647,2,31,1,1,allow
56658,53,11385,53,186,95,91,2,31,1,1,allow
49205,53,38111,53,188,96,92,2,31,1,1,allow
56226,53,58477,53,780,104,676,2,31,1,1,allow
37316,443,11978,443,19840,6479,13361,57,127,32,25,allow
56603,53,25992,53,1400,97,1303,4,57,2,2,allow
51204,443,55515,443,37173,3712,33461,54,74,24,30,allow
49163,53,24237,53,166,85,81,2,30,1,1,allow
49218,53,62258,53,190,97,93,2,31,1,1,allow
56723,53,2628,53,733,85,648,2,31,1,1,allow
57241,53,11880,53,760,97,663,2,31,1,1,allow
16387,57833,0,0,60,60,0,1,60,1,0,allow
57366,53,63370,53,745,93,652,2,31,1,1,allow
57398,53,10527,53,770,102,668,2,31,1,1,allow
57049,53,52014,53,755,93,662,2,31,1,1,allow
49354,53,30111,53,192,98,94,2,31,1,1,allow
56362,53,49796,53,190,97,93,2,31,1,1,allow
64380,53,29472,53,186,95,91,2,31,1,1,allow
55070,53,2161,53,190,97,93,2,31,1,1,allow
64089,53,25036,53,188,96,92,2,31,1,1,allow
49754,53,54663,53,176,90,86,2,31,1,1,allow
56344,53,27123,53,198,101,97,2,31,1,1,allow
64631,53,41468,53,186,95,91,2,31,1,1,allow
49293,53,58522,53,172,88,84,2,31,1,1,allow
56457,53,47112,53,731,91,640,2,31,1,1,allow
55919,53,57611,53,754,94,660,2,31,1,1,allow
64573,53,7328,53,184,94,90,2,31,1,1,allow
64326,53,28923,53,192,98,94,2,31,1,1,allow
56318,53,8880,53,182,93,89,2,31,1,1,allow
3175,60038,0,0,66,66,0,1,91,1,0,allow
60074,443,12733,443,3465,818,2647,11,122,5,6,allow
55356,53,43051,53,756,95,661,2,31,1,1,allow
58380,80,42000,80,3130,2290,840,15,135,8,7,allow
55976,53,37566,53,758,96,662,2,31,1,1,allow
65096,443,53521,443,2414,639,1775,9,121,5,4,allow
32921,443,5993,443,7578,2270,5308,17,123,8,9,allow
37635,443,51413,443,4883,1327,3556,18,135,9,9,allow
55646,53,39790,53,760,97,663,2,31,1,1,allow
57355,443,34540,443,16483,8545,7938,40,281,21,19,allow
56816,53,44842,53,754,94,660,2,31,1,1,allow
55463,53,53091,53,216,110,106,2,31,1,1,allow
55411,53,60848,53,182,93,89,2,31,1,1,allow
56930,53,53703,53,774,101,673,2,31,1,1,allow
60893,443,56200,443,4252,1594,2658,13,135,6,7,allow
43461,35440,0,0,62,62,0,1,0,1,0,deny
49488,445,0,0,70,70,0,1,0,1,0,drop
61261,445,0,0,66,66,0,1,0,1,0,drop
61258,445,0,0,66,66,0,1,0,1,0,drop
61259,445,0,0,66,66,0,1,0,1,0,drop
3478,61463,0,0,686,686,0,1,0,1,0,deny
53337,1433,0,0,60,60,0,1,0,1,0,deny
22094,23,0,0,60,60,0,1,0,1,0,deny
61256,445,0,0,66,66,0,1,0,1,0,drop
45964,55559,0,0,60,60,0,1,0,1,0,deny
61029,445,0,0,70,70,0,1,0,1,0,drop
49480,445,0,0,70,70,0,1,0,1,0,drop
55979,53,33606,53,193,102,91,2,30,1,1,allow
58994,443,40125,443,4989,1014,3975,16,27,9,7,allow
60981,443,40562,443,22449,19500,2949,53,21,31,22,allow
60976,443,6084,443,5027222,114898,4912324,4763,109,1375,3388,allow
53670,80,8760,80,950,502,448,12,15,7,5,allow
61332,23,0,0,60,60,0,1,0,1,0,deny
3478,61463,0,0,780,780,0,1,0,1,0,deny
49476,445,0,0,70,70,0,1,0,1,0,drop
49474,445,0,0,70,70,0,1,0,1,0,drop
1912,48817,0,0,62,62,0,1,0,1,0,deny
61020,445,0,0,70,70,0,1,0,1,0,drop
61018,445,0,0,70,70,0,1,0,1,0,drop
61017,445,0,0,70,70,0,1,0,1,0,drop
61016,445,0,0,70,70,0,1,0,1,0,drop
24589,10197,0,0,145,145,0,1,0,1,0,deny
59051,27520,0,0,62,62,0,1,0,1,0,deny
61012,445,0,0,70,70,0,1,0,1,0,drop
61140,27520,0,0,66,66,0,1,0,1,0,deny
56250,36237,0,0,66,66,0,1,0,1,0,deny
51244,1,0,0,100,100,0,1,0,1,0,deny
61246,445,0,0,66,66,0,1,0,1,0,drop
45964,3111,0,0,60,60,0,1,0,1,0,deny
3478,61463,0,0,240,240,0,1,0,1,0,deny
7184,15503,0,0,66,66,0,1,0,1,0,deny
61238,445,0,0,66,66,0,1,0,1,0,drop
49390,1433,0,0,60,60,0,1,0,1,0,deny
49464,445,0,0,70,70,0,1,0,1,0,drop
40742,2967,0,0,62,62,0,1,0,1,0,deny
55012,64147,0,0,66,66,0,1,0,1,0,deny
56658,53,53602,53,193,102,91,2,30,1,1,allow
64575,53,7510,53,182,102,80,2,30,1,1,allow
56327,53,30596,53,199,102,97,2,30,1,1,allow
50589,53,14237,53,786,110,676,2,30,1,1,allow
57344,53,11119,53,969,86,883,2,30,1,1,allow
53799,53,39316,53,213,78,135,2,30,1,1,allow
58858,443,56785,443,7413235,214811,7198424,7869,344,2785,5084,allow
58856,443,36240,443,6350667,198580,6152087,6885,451,2497,4388,allow
45896,443,32975,443,1160457,45088,1115369,1320,315,518,802,allow
40408,443,59569,443,6058,1749,4309,22,201,13,9,allow
35654,80,35654,80,7040,5744,1296,16,158,9,7,allow
49214,58485,53751,58485,70,70,0,2,8,2,0,allow
53805,34155,31252,34155,70,70,0,2,7,2,0,allow
59779,443,59854,443,568,568,0,5,10,5,0,allow
57016,53,13360,53,266,110,156,2,30,1,1,allow
53804,24067,52480,24067,70,70,0,2,7,2,0,allow
50458,443,25872,443,523577,34256,489321,1025,208,473,552,allow
50303,443,52524,443,208,60,148,4,11,2,2,allow
55042,443,45406,443,126,60,66,3,5,2,1,allow
55285,53,22135,53,268,95,173,4,45,2,2,allow
55098,53,38857,53,474,200,274,6,43,3,3,allow
63966,42532,21022,42532,66,66,0,2,7,2,0,allow
35941,443,48738,443,190,70,120,4,18,2,2,allow
53798,62166,11396,62166,258,70,188,4,7,2,2,allow
63954,60430,37652,60430,70,70,0,1,4,1,0,allow
64980,53,40885,53,274,88,186,4,35,2,2,allow
65238,53,61898,53,302,104,198,4,46,2,2,allow
50612,80,47441,80,1559,1107,452,9,24,5,4,allow
26900,27017,1081,27017,422,164,258,6,29,3,3,allow
55932,53,10932,53,193,102,91,2,29,1,1,allow
64537,53,60663,53,168,86,82,2,29,1,1,allow
55371,53,15832,53,184,102,82,2,29,1,1,allow
26900,27017,35787,27017,422,164,258,6,29,3,3,allow
56395,53,34668,53,199,102,97,2,29,1,1,allow
26900,27017,23136,27017,422,164,258,6,29,3,3,allow
26900,27017,19370,27017,422,164,258,6,29,3,3,allow
49811,53,10574,53,763,102,661,2,29,1,1,allow
57203,53,8040,53,199,102,97,2,29,1,1,allow
56450,53,8472,53,168,86,82,2,30,1,1,allow
56395,53,54170,53,199,102,97,2,29,1,1,allow
49390,53,36883,53,210,110,100,2,30,1,1,allow
56636,53,49408,53,168,86,82,2,30,1,1,allow
56151,53,10029,53,194,102,92,2,30,1,1,allow
55727,53,33963,53,335,93,242,4,32,2,2,allow
56245,53,35606,53,200,102,98,2,30,1,1,allow
49835,53,19938,53,194,102,92,2,30,1,1,allow
57299,53,60240,53,338,110,228,2,30,1,1,allow
65019,53,36796,53,195,102,93,2,30,1,1,allow
55849,53,49045,53,195,102,93,2,30,1,1,allow
44211,443,12188,443,6263,1804,4459,21,361,11,10,allow
56170,53,63567,53,198,102,96,2,30,1,1,allow
50727,27029,42555,27029,269,78,191,2,30,1,1,allow
55113,53,62631,53,177,94,83,2,30,1,1,allow
49215,52611,46200,52611,70,70,0,2,8,2,0,allow
58993,443,55872,443,416,210,206,7,26,4,3,allow
55098,53,15101,53,474,200,274,6,43,3,3,allow
56998,80,16426,80,214,140,74,4,35,3,1,allow
60971,443,16884,443,4548,2858,1690,42,111,22,20,allow
56327,53,60019,53,199,102,97,2,30,1,1,allow
57467,443,57467,443,4373,1466,2907,19,27,11,8,allow
55154,53,33060,53,184,94,90,2,30,1,1,allow
58774,443,50443,443,7254,838,6416,27,290,9,18,allow
56958,53,59654,53,816,102,714,2,30,1,1,allow
56995,80,29664,80,214,140,74,4,35,3,1,allow
56198,53,28713,53,184,102,82,2,30,1,1,allow
49372,53,16928,53,210,110,100,2,30,1,1,allow
26900,27017,30170,27017,422,164,258,6,30,3,3,allow
60780,28080,48359,28080,70,70,0,1,5,1,0,allow
64980,53,62800,53,180,94,86,2,30,1,1,allow
56001,53,33036,53,196,94,102,2,30,1,1,allow
58844,443,8325,443,5167,700,4467,16,15,7,9,allow
65328,53,18942,53,166,86,80,2,30,1,1,allow
58771,80,60976,80,3312,1569,1743,12,135,7,5,allow
64330,53,10524,53,193,102,91,2,30,1,1,allow
27005,27015,64723,27015,901,126,775,2,30,1,1,allow
48817,25636,48817,25636,481,150,331,2,1200,1,1,allow
27005,27014,60898,27014,879,126,753,2,30,1,1,allow
27005,4444,13134,4444,881,126,755,2,30,1,1,allow
51166,443,54384,443,13072,4708,8364,47,130,24,23,allow
58847,443,48579,443,5167,700,4467,16,15,7,9,allow
50465,80,51689,80,3688274,86827,3601447,3622,32,1228,2394,allow
49354,53,61914,53,196,102,94,2,30,1,1,allow
56624,53,44653,53,199,102,97,2,30,1,1,allow
56988,53,43201,53,216,110,106,2,30,1,1,allow
49205,53,61916,53,194,102,92,2,30,1,1,allow
55098,53,33176,53,474,200,274,6,44,3,3,allow
60965,443,57735,443,1439,718,721,15,111,8,7,allow
35889,443,19640,443,6982,1728,5254,23,27,13,10,allow
50581,80,61624,80,2573,1859,714,9,47,5,4,allow
58776,443,11042,443,7259,842,6417,27,290,9,18,allow
26900,27017,57594,27017,172,86,86,2,30,1,1,allow
55979,53,60691,53,193,102,91,2,30,1,1,allow
49218,53,40400,53,195,102,93,2,30,1,1,allow
56416,53,14432,53,193,102,91,2,30,1,1,allow
55684,53,56434,53,193,102,91,2,30,1,1,allow
55272,53,55902,53,198,110,88,2,30,1,1,allow
64621,53,62273,53,214,102,112,2,30,1,1,allow
50729,27029,59296,27029,269,78,191,2,30,1,1,allow
55877,1049,50494,1049,323,150,173,2,1200,1,1,allow
49212,38306,32120,38306,70,70,0,2,8,2,0,allow
49502,443,21667,443,26402,2904,23498,56,270,29,27,allow
64894,53,1246,53,550,113,437,4,46,2,2,allow
53799,6881,35241,6881,70,70,0,2,7,2,0,allow
64582,443,48743,443,24686,1935,22751,36,19,17,19,allow
49216,63752,46385,63752,70,70,0,2,8,2,0,allow
56492,53,12334,53,184,94,90,2,29,1,1,allow
37175,53,14480,53,231,86,145,2,29,1,1,allow
26900,27017,14698,27017,422,164,258,6,29,3,3,allow
56450,53,45835,53,184,102,82,2,29,1,1,allow
55932,53,12204,53,193,102,91,2,29,1,1,allow
64687,53,10483,53,183,94,89,2,29,1,1,allow
57002,80,6505,80,214,140,74,4,35,3,1,allow
56245,53,14605,53,200,102,98,2,30,1,1,allow
56997,80,45711,80,214,140,74,4,35,3,1,allow
65307,53,36094,53,811,94,717,2,29,1,1,allow
38131,443,7949,443,85590,4656,80934,111,37,47,64,allow
55712,53,52427,53,164,86,78,2,29,1,1,allow
26900,27017,43852,27017,422,164,258,6,29,3,3,allow
56395,53,56804,53,199,102,97,2,29,1,1,allow
52090,443,53299,443,45583818,387905,45195913,35736,272,5246,30490,allow
26900,27017,8503,27017,422,164,258,6,29,3,3,allow
49503,53,43089,53,167,86,81,2,29,1,1,allow
49722,53,64718,53,200,102,98,2,29,1,1,allow
123,123,48945,123,184,94,90,2,29,1,1,allow
64687,53,9775,53,183,94,89,2,29,1,1,allow
64599,53,10160,53,250,94,156,2,29,1,1,allow
26900,27017,44088,27017,250,164,86,4,30,3,1,allow
26900,27017,55434,27017,422,164,258,6,29,3,3,allow
57437,53,35666,53,193,102,91,2,30,1,1,allow
57208,53,39529,53,183,94,89,2,30,1,1,allow
55154,53,5239,53,184,94,90,2,30,1,1,allow
56344,53,2417,53,199,102,97,2,30,1,1,allow
49205,53,36921,53,194,102,92,2,30,1,1,allow
56245,53,47709,53,200,102,98,2,30,1,1,allow
55154,53,39546,53,184,94,90,2,30,1,1,allow
56344,53,47952,53,199,102,97,2,30,1,1,allow
64089,53,37654,53,194,102,92,2,30,1,1,allow
64573,53,39960,53,184,94,90,2,30,1,1,allow
56067,53,59693,53,294,102,192,2,30,1,1,allow
55463,53,9844,53,216,110,106,2,31,1,1,allow
59008,443,16532,443,10214,2669,7545,30,170,14,16,allow
45898,443,17048,443,814431,31637,782794,913,315,346,567,allow
56004,443,20130,443,53826,3670,50156,85,275,41,44,allow
45900,443,8565,443,1277649,37293,1240356,1337,303,459,878,allow
6881,37321,46991,37321,502,150,352,2,1199,1,1,allow
65398,53,27490,53,214,110,104,2,30,1,1,allow
49429,53,47373,53,194,102,92,2,30,1,1,allow
56624,53,64033,53,199,102,97,2,30,1,1,allow
57208,53,19470,53,183,94,89,2,30,1,1,allow
56988,53,29456,53,216,110,106,2,30,1,1,allow
64631,53,8154,53,193,102,91,2,30,1,1,allow
56362,53,16824,53,195,102,93,2,30,1,1,allow
64380,53,47265,53,193,102,91,2,30,1,1,allow
50730,27029,7986,27029,269,78,191,2,30,1,1,allow
55070,53,21493,53,195,102,93,2,30,1,1,allow
55975,53,27530,53,939,678,261,2,30,1,1,allow
55113,53,22722,53,177,94,83,2,30,1,1,allow
56151,53,18710,53,194,102,92,2,30,1,1,allow
56318,53,32737,53,183,94,89,2,30,1,1,allow
49390,53,56282,53,210,110,100,2,30,1,1,allow
64907,53,21503,53,247,86,161,3,31,2,1,allow
55155,53,52768,53,194,102,92,2,31,1,1,allow
40738,443,14631,443,1656,114,1542,5,120,2,3,allow
55830,53,50350,53,166,86,80,2,30,1,1,allow
56198,53,50578,53,184,102,82,2,30,1,1,allow
49211,15576,51582,15576,70,70,0,2,8,2,0,allow
48157,443,51436,443,7209,2331,4878,20,23,11,9,allow
37624,443,54201,443,471102,14016,457086,503,25,191,312,allow
53131,80,64503,80,2957,619,2338,12,15,6,6,allow
53130,80,42031,80,3683,606,3077,12,15,6,6,allow
55078,443,55078,443,4401,1494,2907,19,30,11,8,allow
53671,80,50539,80,956,502,454,12,15,7,5,allow
37641,443,55231,443,8423,2244,6179,32,15,17,15,allow
56655,80,36577,80,234,234,0,4,12,4,0,allow
64266,53,53096,53,1026,383,643,10,84,5,5,allow
55010,443,19028,443,7651,2261,5390,41,255,21,20,allow
56999,80,32577,80,214,140,74,4,35,3,1,allow
56996,80,27965,80,214,140,74,4,35,3,1,allow
57003,80,40780,80,526,304,222,8,35,5,3,allow
51554,443,48017,443,4263,671,3592,14,75,8,6,allow
57076,53,47154,53,184,94,90,2,30,1,1,allow
49878,53,52467,53,262,126,136,2,30,1,1,allow
56958,53,40535,53,193,102,91,2,30,1,1,allow
49835,53,6905,53,817,102,715,2,30,1,1,allow
64573,53,34650,53,184,94,90,2,30,1,1,allow
49372,53,57735,53,210,110,100,2,30,1,1,allow
56988,53,25747,53,216,110,106,2,30,1,1,allow
27005,27015,65078,27015,878,126,752,2,30,1,1,allow
53798,53,26638,53,224,86,138,2,30,1,1,allow
64316,53,5577,53,184,94,90,2,30,1,1,allow
50278,53,34897,53,819,102,717,2,30,1,1,allow
57409,53,6816,53,168,86,82,2,31,1,1,allow
60137,443,42633,443,10407,3966,6441,30,149,18,12,allow
61405,443,43963,443,4810,2361,2449,34,80,16,18,allow
57001,80,47227,80,214,140,74,4,35,3,1,allow
57000,80,51268,80,214,140,74,4,35,3,1,allow
48652,443,38749,443,6388,964,5424,21,255,11,10,allow
37633,443,4674,443,8493,2314,6179,33,16,18,15,allow
57437,53,57480,53,193,102,91,2,30,1,1,allow
64980,53,51851,53,180,94,86,2,30,1,1,allow
56658,53,26187,53,193,102,91,2,30,1,1,allow
57409,53,63027,53,168,86,82,2,30,1,1,allow
56416,53,30154,53,816,102,714,2,30,1,1,allow
49390,53,61910,53,210,110,100,2,30,1,1,allow
55755,53,57482,53,779,86,693,2,30,1,1,allow
50732,27029,64378,27029,269,78,191,2,30,1,1,allow
56636,53,34067,53,168,86,82,2,30,1,1,allow
50025,53,33178,53,761,102,659,2,30,1,1,allow
49354,53,16501,53,196,102,94,2,30,1,1,allow
55085,53,9873,53,301,94,207,2,30,1,1,allow
65398,53,49816,53,214,110,104,2,30,1,1,allow
65356,53,49410,53,199,102,97,2,30,1,1,allow
55979,53,21397,53,193,102,91,2,31,1,1,allow
65019,53,46989,53,195,102,93,2,31,1,1,allow
57243,53,64536,53,165,86,79,2,31,1,1,allow
35577,443,21477,443,15162,8505,6657,55,197,29,26,allow
53427,443,4839,443,9896,2040,7856,34,120,17,17,allow
58859,443,48012,443,39518,2389,37129,54,179,21,33,allow
56880,53,8683,53,209,110,99,2,31,1,1,allow
64326,53,50909,53,196,102,94,2,31,1,1,allow
41321,443,41856,443,9168,1596,7572,22,186,11,11,allow
53797,53,41009,53,260,86,174,2,30,1,1,allow
49813,53,53266,53,775,102,673,2,30,1,1,allow
53686,19010,53686,19010,70,70,0,1,30,1,0,allow
64089,53,3452,53,194,102,92,2,31,1,1,allow
57208,53,46583,53,183,94,89,2,31,1,1,allow
56344,53,6437,53,199,102,97,2,31,1,1,allow
56757,53,30520,53,167,86,81,2,31,1,1,allow
55883,53,56307,53,181,94,87,2,31,1,1,allow
36956,443,8939,443,9273,2731,6542,31,403,10,21,allow
65356,53,36098,53,199,102,97,2,30,1,1,allow
55315,53,5468,53,196,102,94,2,31,1,1,allow
57470,51413,19647,51413,740725,699740,40985,1031,1411,616,415,allow
49218,53,22762,53,195,102,93,2,31,1,1,allow
56637,53,47556,53,214,110,104,2,31,1,1,allow
55684,53,54861,53,193,102,91,2,31,1,1,allow
56318,53,47693,53,183,94,89,2,31,1,1,allow
54527,443,27649,443,13132,7107,6025,45,174,23,22,allow
61626,443,21665,443,5663,3258,2405,19,120,9,10,allow
42076,443,63627,443,22106,5214,16892,23,128,9,14,allow
63964,60705,4477,60705,312,132,180,6,7,3,3,allow
63952,50734,27783,50734,70,70,0,1,5,1,0,allow
49205,53,19317,53,194,102,92,2,31,1,1,allow
55070,53,23784,53,195,102,93,2,31,1,1,allow
64316,53,34882,53,184,94,90,2,31,1,1,allow
64519,53,15868,53,518,185,333,6,60,3,3,allow
52020,28704,45681,28704,70,70,0,2,9,2,0,allow
51995,50031,29706,50031,70,70,0,1,5,1,0,allow
57894,80,58107,80,9800,2228,7572,23,24,12,11,allow
58843,443,44716,443,6033,770,5263,18,16,8,10,allow
20570,53,52597,53,428,78,350,2,31,1,1,allow
57418,53,1554,53,165,86,79,2,31,1,1,allow
61936,443,38328,443,4348,1643,2705,14,138,6,8,allow
56487,53,61282,53,194,102,92,2,31,1,1,allow
52023,41791,61647,41791,70,70,0,2,8,2,0,allow
52018,2425,15478,2425,70,70,0,2,9,2,0,allow
57337,443,40846,443,1169,616,553,12,16,7,5,allow
50584,80,65205,80,1883,995,888,11,47,6,5,allow
25101,50584,0,0,62,62,0,1,0,1,0,deny
61007,445,0,0,70,70,0,1,0,1,0,drop
45313,64147,0,0,62,62,0,1,0,1,0,deny
3478,61463,0,0,804,804,0,1,0,1,0,deny
53816,22114,0,0,62,62,0,1,0,1,0,deny
3478,61463,0,0,164,164,0,1,0,1,0,deny
50772,35440,0,0,62,62,0,1,0,1,0,deny
61235,445,0,0,66,66,0,1,0,1,0,drop
57825,13014,0,0,74,74,0,1,0,1,0,deny
3478,61463,0,0,1292,1292,0,1,0,1,0,deny
45941,23386,0,0,60,60,0,1,0,1,0,deny
60999,445,0,0,70,70,0,1,0,1,0,drop
3478,61463,0,0,877,877,0,1,0,1,0,deny
3478,61463,0,0,68,68,0,1,0,1,0,deny
3478,61463,0,0,409,409,0,1,0,1,0,deny
58829,64147,0,0,62,62,0,1,0,1,0,deny
60997,445,0,0,70,70,0,1,0,1,0,drop
61229,445,0,0,66,66,0,1,0,1,0,drop
61226,445,0,0,66,66,0,1,0,1,0,drop
60993,445,0,0,70,70,0,1,0,1,0,drop
60991,445,0,0,70,70,0,1,0,1,0,drop
5223,14446,0,0,220,220,0,1,0,1,0,deny
60987,445,0,0,70,70,0,1,0,1,0,drop
49450,445,0,0,70,70,0,1,0,1,0,drop
49449,445,0,0,70,70,0,1,0,1,0,drop
49448,445,0,0,70,70,0,1,0,1,0,drop
61211,445,0,0,66,66,0,1,0,1,0,drop
61213,445,0,0,66,66,0,1,0,1,0,drop
61212,445,0,0,66,66,0,1,0,1,0,drop
61209,445,0,0,66,66,0,1,0,1,0,drop
61210,445,0,0,66,66,0,1,0,1,0,drop
61207,445,0,0,66,66,0,1,0,1,0,drop
61208,445,0,0,66,66,0,1,0,1,0,drop
61205,445,0,0,66,66,0,1,0,1,0,drop
3478,61463,0,0,252,252,0,1,0,1,0,deny
57011,49813,0,0,62,62,0,1,0,1,0,deny
60986,445,0,0,70,70,0,1,0,1,0,drop
59366,35440,0,0,66,66,0,1,0,1,0,deny
11005,30188,0,0,146,146,0,1,0,1,0,deny
55766,36237,0,0,62,62,0,1,0,1,0,deny
54464,56205,0,0,62,62,0,1,0,1,0,deny
51769,51505,0,0,66,66,0,1,0,1,0,deny
3478,61463,0,0,1044,1044,0,1,0,1,0,deny
3478,61463,0,0,1288,1288,0,1,0,1,0,deny
38885,21247,0,0,62,62,0,1,0,1,0,deny
60981,445,0,0,70,70,0,1,0,1,0,drop
49447,445,0,0,70,70,0,1,0,1,0,drop
49446,445,0,0,70,70,0,1,0,1,0,drop
49444,445,0,0,70,70,0,1,0,1,0,drop
49443,445,0,0,70,70,0,1,0,1,0,drop
443,62732,0,0,332,332,0,1,0,1,0,deny
61191,445,0,0,66,66,0,1,0,1,0,drop
61193,445,0,0,66,66,0,1,0,1,0,drop
61190,445,0,0,66,66,0,1,0,1,0,drop
14350,56205,0,0,62,62,0,1,0,1,0,deny
48186,51050,0,0,62,62,0,1,0,1,0,deny
3478,61463,0,0,342,342,0,1,0,1,0,deny
28378,56205,0,0,146,146,0,1,0,1,0,deny
49428,445,0,0,70,70,0,1,0,1,0,drop
48176,50584,0,0,146,146,0,1,0,1,0,deny
49423,445,0,0,70,70,0,1,0,1,0,drop
49420,445,0,0,70,70,0,1,0,1,0,drop
49421,445,0,0,70,70,0,1,0,1,0,drop
45908,33330,0,0,60,60,0,1,0,1,0,deny
45908,33330,0,0,60,60,0,1,0,1,0,deny
60968,445,0,0,70,70,0,1,0,1,0,drop
3478,61463,0,0,164,164,0,1,0,1,0,deny
3478,61463,0,0,1094,1094,0,1,0,1,0,deny
54752,31573,0,0,66,66,0,1,0,1,0,deny
58488,37965,0,0,62,62,0,1,0,1,0,deny
62153,35440,0,0,62,62,0,1,0,1,0,deny
60965,445,0,0,70,70,0,1,0,1,0,drop
59400,22114,0,0,62,62,0,1,0,1,0,deny
38664,37965,0,0,62,62,0,1,0,1,0,deny
63569,62413,0,0,66,66,0,1,0,1,0,deny
3478,61463,0,0,857,857,0,1,0,1,0,deny
3478,61463,0,0,437,437,0,1,0,1,0,deny
11136,19910,0,0,62,62,0,1,0,1,0,deny
49411,445,0,0,70,70,0,1,0,1,0,drop
49408,445,0,0,70,70,0,1,0,1,0,drop
49406,445,0,0,70,70,0,1,0,1,0,drop
60960,445,0,0,70,70,0,1,0,1,0,drop
61180,445,0,0,66,66,0,1,0,1,0,drop
60959,445,0,0,70,70,0,1,0,1,0,drop
63467,37807,0,0,62,62,0,1,0,1,0,deny
63331,51221,0,0,62,62,0,1,0,1,0,deny
443,18411,0,0,74,74,0,1,0,1,0,deny
443,60082,0,0,74,74,0,1,0,1,0,deny
443,39711,0,0,74,74,0,1,0,1,0,deny
3478,61463,0,0,814,814,0,1,0,1,0,deny
0,0,0,0,140,140,0,2,0,2,0,deny
0,0,0,0,320,320,0,5,0,5,0,allow
60957,445,0,0,70,70,0,1,0,1,0,drop
13285,29892,0,0,145,145,0,1,0,1,0,deny
443,39999,0,0,74,74,0,1,0,1,0,deny
36374,30228,0,0,145,145,0,1,0,1,0,deny
443,9313,0,0,74,74,0,1,0,1,0,deny
443,49031,0,0,74,74,0,1,0,1,0,deny
443,11817,0,0,74,74,0,1,0,1,0,deny
62493,50584,0,0,62,62,0,1,0,1,0,deny
443,23622,0,0,74,74,0,1,0,1,0,deny
30794,37965,0,0,62,62,0,1,0,1,0,deny
3478,61463,0,0,441,441,0,1,0,1,0,deny
40977,21247,0,0,66,66,0,1,0,1,0,deny
49401,445,0,0,70,70,0,1,0,1,0,drop
49395,445,0,0,70,70,0,1,0,1,0,drop
46218,23,0,0,60,60,0,1,0,1,0,deny
57459,51505,0,0,66,66,0,1,0,1,0,deny
52830,22114,0,0,62,62,0,1,0,1,0,deny
26698,57470,0,0,62,62,0,1,0,1,0,deny
60950,445,0,0,70,70,0,1,0,1,0,drop
63242,50584,0,0,66,66,0,1,0,1,0,deny
61164,445,0,0,66,66,0,1,0,1,0,drop
61163,445,0,0,66,66,0,1,0,1,0,drop
60948,445,0,0,70,70,0,1,0,1,0,drop
49511,57470,0,0,66,66,0,1,0,1,0,deny
50052,65010,0,0,60,60,0,1,0,1,0,deny
57131,8055,0,0,145,145,0,1,0,1,0,deny
3478,61463,0,0,315,315,0,1,0,1,0,deny
64697,37965,0,0,66,66,0,1,0,1,0,deny
59376,5900,0,0,60,60,0,1,0,1,0,deny
60947,445,0,0,70,70,0,1,0,1,0,drop
35291,44847,0,0,66,66,0,1,0,1,0,deny
60946,445,0,0,70,70,0,1,0,1,0,drop
60945,445,0,0,70,70,0,1,0,1,0,drop
49388,445,0,0,70,70,0,1,0,1,0,drop
12143,56205,0,0,66,66,0,1,0,1,0,deny
60939,445,0,0,70,70,0,1,0,1,0,drop
60942,445,0,0,70,70,0,1,0,1,0,drop
49386,445,0,0,70,70,0,1,0,1,0,drop
49383,445,0,0,70,70,0,1,0,1,0,drop
49380,445,0,0,70,70,0,1,0,1,0,drop
52962,35440,0,0,66,66,0,1,0,1,0,deny
14103,35440,0,0,62,62,0,1,0,1,0,deny
59679,37807,0,0,66,66,0,1,0,1,0,deny
61159,445,0,0,66,66,0,1,0,1,0,drop
58836,44847,0,0,70,70,0,1,0,1,0,deny
3478,61463,0,0,627,627,0,1,0,1,0,deny
61154,445,0,0,66,66,0,1,0,1,0,drop
61153,445,0,0,66,66,0,1,0,1,0,drop
61152,445,0,0,66,66,0,1,0,1,0,drop
61150,445,0,0,66,66,0,1,0,1,0,drop
61142,445,0,0,66,66,0,1,0,1,0,drop
61143,445,0,0,66,66,0,1,0,1,0,drop
61148,445,0,0,66,66,0,1,0,1,0,drop
64677,57470,0,0,66,66,0,1,0,1,0,deny
60927,445,0,0,70,70,0,1,0,1,0,drop
60925,445,0,0,70,70,0,1,0,1,0,drop
60923,445,0,0,70,70,0,1,0,1,0,drop
60917,445,0,0,70,70,0,1,0,1,0,drop
60916,445,0,0,70,70,0,1,0,1,0,drop
6881,61980,0,0,150,150,0,1,0,1,0,deny
49377,445,0,0,70,70,0,1,0,1,0,drop
61791,80,61791,80,16848,822,16026,23,16,9,14,allow
62324,443,62324,443,2882,1622,1260,20,86,10,10,allow
62231,443,62231,443,180730,19869,160861,239,171,103,136,allow
36881,443,36881,443,4652,1745,2907,19,28,11,8,allow
49208,6881,3930,6881,70,70,0,2,8,2,0,allow
39198,443,37054,443,6328,850,5478,26,289,9,17,allow
50621,443,42155,443,3171,1473,1698,15,93,9,6,allow
49158,443,3923,443,23613,13099,10514,79,1341,36,43,allow
52021,32202,58767,32202,70,70,0,2,8,2,0,allow
54280,3396,54280,3396,146,60,86,2,10,1,1,allow
51990,42127,1528,42127,66,66,0,1,5,1,0,allow
51202,443,46664,443,7702,2410,5292,26,34,13,13,allow
56487,53,12533,53,188,96,92,2,30,1,1,allow
56779,53,7300,53,757,98,659,2,30,1,1,allow
52017,26175,18735,26175,70,70,0,2,9,2,0,allow
58834,443,42035,443,7880,5105,2775,25,17,13,12,allow
50076,80,29026,80,26128,9214,16914,81,512,40,41,allow
51613,7000,51613,7000,2163,676,1487,14,15,7,7,allow
56169,53,42323,53,204,104,100,2,30,1,1,allow
50279,443,22072,443,21204,10998,10206,51,392,27,24,allow
60856,443,12085,443,8201,2795,5406,43,18,26,17,allow
50625,443,24719,443,9588,1204,8384,29,93,15,14,allow
43632,80,17222,80,2000,710,1290,8,15,5,3,allow
58805,443,25945,443,32148,21507,10641,72,21,42,30,allow
45319,443,29767,443,9284,2430,6854,25,82,14,11,allow
46991,443,46408,443,2809,1884,925,19,26,11,8,allow
52513,80,64881,80,39793,2026,37767,55,16,27,28,allow
55684,53,10799,53,186,95,91,2,30,1,1,allow
27005,30010,26771,30010,887,126,761,2,31,1,1,allow
57092,53,22566,53,756,95,661,2,31,1,1,allow
55155,53,65476,53,188,96,92,2,31,1,1,allow
50584,443,50316,443,36457,2308,34149,52,98,23,29,allow
60540,443,60540,443,4455,1548,2907,19,27,11,8,allow
60870,443,18926,443,8219,2676,5543,40,15,24,16,allow
50517,80,63449,80,5997,1327,4670,18,157,10,8,allow
53912,3478,54737,3478,3532,1792,1740,58,88,29,29,allow
49201,17852,9879,17852,70,70,0,2,8,2,0,allow
50660,443,1887,443,3845,1814,2031,19,38,11,8,allow
47516,80,2518,80,956,541,415,11,316,6,5,allow
49157,443,32525,443,5115,977,4138,18,18,10,8,allow
49209,52030,40486,52030,70,70,0,2,8,2,0,allow
50637,80,48925,80,1742,589,1153,10,87,6,4,allow
52022,53657,34064,53657,70,70,0,2,8,2,0,allow
57721,443,65259,443,1019,644,375,10,37,6,4,allow
51994,25509,12796,25509,66,66,0,1,5,1,0,allow
54912,443,54912,443,4401,1494,2907,19,27,11,8,allow
50092,80,20230,80,11297,8141,3156,52,508,34,18,allow
53687,19010,53687,19010,64,64,0,1,30,1,0,allow
54371,443,51699,443,6120,1305,4815,20,983,10,10,allow
50306,80,39882,80,182517,10761,171756,265,352,130,135,allow
53713,443,33766,443,9555,4200,5355,25,86,15,10,allow
55351,53,4702,53,1497,108,1389,4,53,2,2,allow
50580,443,63411,443,2604,1413,1191,15,98,9,6,allow
55986,53,53201,53,744,89,655,2,30,1,1,allow
55546,53,22275,53,1417,96,1321,4,30,2,2,allow
55315,53,41500,53,192,98,94,2,31,1,1,allow
52385,53,0,0,138,69,69,2,30,1,1,allow
56540,53,53541,53,735,88,647,2,30,1,1,allow
57409,53,7230,53,168,86,82,2,30,1,1,allow
42186,443,1253,443,3562,2096,1466,18,336,9,9,allow
56880,53,23570,53,202,103,99,2,31,1,1,allow
27005,27015,56171,27015,858,126,732,2,31,1,1,allow
55907,53,18391,53,184,94,90,2,31,1,1,allow
55068,53,58274,53,192,98,94,2,31,1,1,allow
56112,53,3199,53,198,101,97,2,31,1,1,allow
56875,53,47885,53,166,85,81,2,31,1,1,allow
46779,5228,25730,5228,3775,2029,1746,30,3637,13,17,allow
50620,443,5914,443,1277,851,426,12,92,7,5,allow
50600,443,20473,443,5035,3194,1841,23,96,12,11,allow
50629,443,47938,443,6553,1034,5519,23,87,12,11,allow
59994,53,59994,53,462,158,304,4,31,2,2,allow
56503,53,8942,53,916,86,830,2,31,1,1,allow
51968,443,14636,443,122815,48545,74270,164,95,76,88,allow
55525,53,23543,53,212,108,104,2,31,1,1,allow
50439,443,55602,443,73712,18850,54862,135,717,61,74,allow
42185,443,3806,443,15233,9395,5838,33,338,16,17,allow
56427,53,59297,53,164,84,80,2,31,1,1,allow
56676,53,4759,53,172,88,84,2,31,1,1,allow
57343,53,26142,53,178,91,87,2,31,1,1,allow
56382,53,19333,53,190,97,93,2,31,1,1,allow
60795,443,29587,443,3282,1018,2264,10,121,5,5,allow
2598,23718,0,0,66,66,0,1,0,1,0,deny
52811,44847,0,0,66,66,0,1,0,1,0,deny
49373,445,0,0,70,70,0,1,0,1,0,drop
49371,445,0,0,70,70,0,1,0,1,0,drop
49369,445,0,0,70,70,0,1,0,1,0,drop
55689,37965,0,0,66,66,0,1,0,1,0,deny
3478,61463,0,0,503,503,0,1,0,1,0,deny
65379,22114,0,0,62,62,0,1,0,1,0,deny
41348,5555,0,0,60,60,0,1,0,1,0,deny
56494,50432,0,0,146,146,0,1,0,1,0,deny
52828,51221,0,0,66,66,0,1,0,1,0,deny
60905,445,0,0,70,70,0,1,0,1,0,drop
56704,53,35730,53,210,94,116,2,30,1,1,allow
64823,53,30935,53,508,102,406,2,30,1,1,allow
55155,53,23280,53,194,102,92,2,30,1,1,allow
50535,80,27169,80,36985,3992,32993,56,151,25,31,allow
1737,80,1737,80,424934,9929,415005,411,95,129,282,allow
58057,80,12753,80,254,128,126,5,15,3,2,allow
51992,22670,31187,22670,70,70,0,1,4,1,0,allow
56105,53,14961,53,372,142,230,2,29,1,1,allow
64999,53,5804,53,178,94,84,2,29,1,1,allow
56560,53,15895,53,164,86,78,2,29,1,1,allow
55777,53,5442,53,733,94,639,2,29,1,1,allow
64999,53,33322,53,178,94,84,2,29,1,1,allow
56632,53,26751,53,200,94,106,2,29,1,1,allow
49373,443,19953,443,1857,1218,639,18,104,11,7,allow
57335,8631,57083,8631,742,298,444,11,16,5,6,allow
49372,443,30393,443,6158,3587,2571,37,104,19,18,allow
44145,443,29432,443,8746,2844,5902,26,315,13,13,allow
50139,443,27090,443,72523,5814,66709,125,255,61,64,allow
51996,41888,46821,41888,70,70,0,1,4,1,0,allow
55803,53,18638,53,261,89,172,4,32,2,2,allow
53796,48019,39849,48019,70,70,0,2,7,2,0,allow
62208,443,62208,443,4497,1590,2907,19,29,11,8,allow
50618,80,9879,80,25890,3442,22448,33,21,13,20,allow
53813,39832,19071,39832,320,140,180,6,5,3,3,allow
50562,443,53886,443,103466,11111,92355,258,140,119,139,allow
45627,443,47069,443,7092,1883,5209,21,21,12,9,allow
1736,80,1736,80,101959,5508,96451,111,95,41,70,allow
43591,443,23363,443,4680,2835,1845,33,80,16,17,allow
55358,53,33999,53,200,94,106,2,29,1,1,allow
56624,53,40354,53,199,102,97,2,29,1,1,allow
64380,53,22158,53,193,102,91,2,29,1,1,allow
55272,53,54690,53,198,110,88,2,29,1,1,allow
64326,53,30580,53,196,102,94,2,29,1,1,allow
50311,443,2014,443,133674,20935,112739,206,350,105,101,allow
56639,53,47791,53,168,86,82,2,32,1,1,allow
1735,80,1735,80,78576,5218,73358,91,95,36,55,allow
54506,80,60844,80,254,128,126,5,15,3,2,allow
56655,53,1875,53,210,110,100,2,30,1,1,allow
57211,53,8547,53,258,110,148,2,30,1,1,allow
57419,53,26611,53,196,102,94,2,30,1,1,allow
55582,53,15587,53,168,86,82,2,30,1,1,allow
39205,53,46384,53,489,94,395,2,30,1,1,allow
55068,53,54785,53,196,102,94,2,30,1,1,allow
15680,53,61838,53,464,287,177,3,30,2,1,allow
65108,53,40239,53,215,94,121,2,30,1,1,allow
55427,53,22421,53,200,102,98,2,33,1,1,allow
34170,53,0,0,82,82,0,2,40,2,0,allow
64424,53,30245,53,211,102,109,2,30,1,1,allow
57593,28678,11489,28678,1806,1806,0,22,225,22,0,allow
49198,64509,42217,64509,70,70,0,2,8,2,0,allow
64721,443,45723,443,5552,927,4625,16,15,10,6,allow
49200,38001,36048,38001,70,70,0,2,8,2,0,allow
55260,53,35785,53,183,94,89,2,30,1,1,allow
58841,443,62984,443,5168,700,4468,16,15,7,9,allow
50057,53,32757,53,718,94,624,2,30,1,1,allow
64104,53,19823,53,288,101,187,4,57,2,2,allow
55411,53,33954,53,183,94,89,2,30,1,1,allow
56107,53,50537,53,817,102,715,2,30,1,1,allow
49924,53,19826,53,718,94,624,2,30,1,1,allow
50574,443,9752,443,9191,2003,7188,25,100,13,12,allow
49293,53,24281,53,178,94,84,2,30,1,1,allow
56487,53,32287,53,194,102,92,2,30,1,1,allow
56995,443,35339,443,8721,2518,6203,29,159,13,16,allow
49935,53,50105,53,177,94,83,2,30,1,1,allow
56757,53,39521,53,167,86,81,2,30,1,1,allow
56107,53,24230,53,194,102,92,2,30,1,1,allow
55411,53,25352,53,183,94,89,2,30,1,1,allow
49754,53,60786,53,180,94,86,2,30,1,1,allow
65391,53,47962,53,720,94,626,2,30,1,1,allow
55427,53,31506,53,200,102,98,2,30,1,1,allow
55411,53,47570,53,183,94,89,2,30,1,1,allow
56111,53,56414,53,152,78,74,2,30,1,1,allow
55791,53,4698,53,811,94,717,2,30,1,1,allow
57243,53,20159,53,173,94,79,2,30,1,1,allow
56667,53,19814,53,244,94,150,2,30,1,1,allow
55261,53,19627,53,173,94,79,2,30,1,1,allow
64326,53,26486,53,196,102,94,2,30,1,1,allow
56941,53,32595,53,212,102,110,2,30,1,1,allow
49625,53,64446,53,251,102,149,2,30,1,1,allow
56362,53,49455,53,195,102,93,2,30,1,1,allow
56860,53,63586,53,184,102,82,2,30,1,1,allow
56888,443,59232,443,10384,2236,8148,28,186,15,13,allow
54953,53,51225,53,289,134,155,2,30,1,1,allow
55250,53,30475,53,416,102,314,2,30,1,1,allow
50567,443,13850,443,1202,720,482,12,139,7,5,allow
50588,443,8589,443,2460,1267,1193,16,98,9,7,allow
49206,12242,32509,12242,70,70,0,2,8,2,0,allow
49210,33757,53103,33757,70,70,0,2,8,2,0,allow
48024,443,44709,443,9194,1066,8128,21,27,12,9,allow
50526,80,52180,80,259593,12828,246765,308,156,118,190,allow
52207,443,22846,443,74711,8646,66065,150,89,70,80,allow
62226,443,62226,443,130836,22940,107896,161,170,72,89,allow
55676,28694,59367,28694,316,190,126,5,15,3,2,allow
52415,443,3677,443,14050,4805,9245,30,158,17,13,allow
57000,53,37935,53,193,94,99,2,30,1,1,allow
63941,53,42926,53,253,102,151,2,30,1,1,allow
55883,53,20281,53,189,102,87,2,30,1,1,allow
56880,53,27129,53,209,110,99,2,30,1,1,allow
56319,53,40959,53,455,94,361,2,30,1,1,allow
49890,443,37248,443,9545,2433,7112,24,142,10,14,allow
1738,80,1738,80,87958,5378,82580,100,95,39,61,allow
50587,443,51277,443,1198,716,482,12,98,7,5,allow
55671,53,24025,53,196,102,94,2,33,1,1,allow
64089,53,43918,53,340,96,244,4,35,2,2,allow
55729,53,3835,53,256,96,160,4,42,2,2,allow
43096,443,6267,443,7098,2628,4470,20,16,12,8,allow
50625,443,48490,443,3090,1707,1383,15,19,9,6,allow
58838,443,31088,443,5167,700,4467,16,15,7,9,allow
40992,443,49820,443,8705,3570,5135,35,100,20,15,allow
55907,53,49379,53,184,94,90,2,30,1,1,allow
57679,443,35639,443,13034,3324,9710,35,120,15,20,allow
60081,443,25599,443,10893,4674,6219,43,121,19,24,allow
27005,27080,21162,27080,926,126,800,2,31,1,1,allow
49293,53,18352,53,294,88,206,4,57,2,2,allow
50528,80,29237,80,66430,7013,59417,93,156,40,53,allow
14438,443,5069,443,2556,1470,1086,17,15,8,9,allow
56787,443,11653,443,5639,846,4793,18,27,10,8,allow
50525,80,36119,80,152171,9332,142839,189,156,78,111,allow
51797,80,10283,80,9897,4338,5559,27,58,16,11,allow
54196,80,31560,80,2640,540,2100,12,45,6,6,allow
27005,29999,55945,29999,887,126,761,2,31,1,1,allow
50595,443,49114,443,2862,1587,1275,15,95,9,6,allow
35549,443,45483,443,9032,2244,6788,36,255,17,19,allow
33643,443,12343,443,163835,28514,135321,310,153,162,148,allow
57340,443,31175,443,1169,616,553,12,16,7,5,allow
53810,8999,16528,8999,320,140,180,6,5,3,3,allow
35196,8635,35196,8635,138,78,60,2,5,1,1,allow
38695,443,12020,443,1185199,19993,1165206,1088,16,289,799,allow
50266,443,54511,443,21634,11226,10408,54,402,35,19,allow
49227,53,40527,53,340,89,251,4,44,2,2,allow
58001,443,15727,443,300,180,120,6,28,4,2,allow
55414,443,59075,443,6053,4104,1949,31,84,17,14,allow
50573,443,20479,443,6575,1995,4580,26,100,13,13,allow
50354,443,37764,443,71226,18632,52594,137,318,63,74,allow
56991,80,27805,80,1638,1324,314,10,15,5,5,allow
56362,53,31120,53,195,102,93,2,29,1,1,allow
55463,53,33769,53,216,110,106,2,29,1,1,allow
50649,443,16928,443,15295,1755,13540,31,77,15,16,allow
56560,53,37508,53,172,94,78,2,29,1,1,allow
50463,80,10843,80,287874,13215,274659,346,204,136,210,allow
55329,53,39839,53,210,102,108,2,29,1,1,allow
56636,53,35098,53,372,86,286,4,54,2,2,allow
55684,53,19288,53,193,102,91,2,29,1,1,allow
56111,53,50559,53,168,94,74,2,30,1,1,allow
49163,53,13314,53,167,86,81,2,29,1,1,allow
64631,53,29007,53,193,102,91,2,29,1,1,allow
55260,53,54111,53,183,94,89,2,30,1,1,allow
51766,443,63491,443,5462,1305,4157,22,121,10,12,allow
34428,443,49184,443,21512,4620,16892,22,127,8,14,allow
64104,53,54315,53,288,101,187,4,58,2,2,allow
27260,443,46156,443,4329,2374,1955,23,520,8,15,allow
60994,443,7195,443,13145,6129,7016,37,34,19,18,allow
65503,53,13139,53,177,94,83,2,30,1,1,allow
56427,53,59591,53,166,86,80,2,30,1,1,allow
56860,53,58794,53,168,86,82,2,30,1,1,allow
56658,53,32323,53,193,102,91,2,30,1,1,allow
56700,53,42094,53,443,182,261,6,30,3,3,allow
56169,53,21391,53,210,110,100,2,30,1,1,allow
56110,53,15545,53,508,102,406,2,30,1,1,allow
56050,53,62054,53,178,94,84,2,30,1,1,allow
55803,53,62058,53,179,94,85,2,30,1,1,allow
65160,53,39178,53,198,94,104,2,30,1,1,allow
57092,53,56689,53,445,86,359,2,30,1,1,allow
55525,53,56574,53,214,110,104,2,30,1,1,allow
56382,53,27838,53,195,102,93,2,30,1,1,allow
65106,53,60145,53,438,180,258,6,30,3,3,allow
56487,53,4784,53,194,102,92,2,30,1,1,allow
27005,27015,3826,27015,876,126,750,2,31,1,1,allow
56917,53,28057,53,194,102,92,2,31,1,1,allow
64631,53,5606,53,193,102,91,2,30,1,1,allow
57419,53,1217,53,819,102,717,2,30,1,1,allow
56847,53,58381,53,252,102,150,2,30,1,1,allow
33836,443,3806,443,18875,13913,4962,116,788,60,56,allow
49387,53,43855,53,323,102,221,2,30,1,1,allow
55030,53,38017,53,185,102,83,2,30,1,1,allow
27005,29999,22693,29999,876,126,750,2,31,1,1,allow
56261,53,47864,53,184,94,90,2,31,1,1,allow
59582,443,37348,443,22106,5214,16892,23,127,9,14,allow
54977,443,65082,443,263411,11905,251506,318,144,118,200,allow
55315,53,24638,53,196,102,94,2,31,1,1,allow
40204,40021,21562,40021,148,86,62,2,31,1,1,allow
1739,80,1739,80,198357,5070,193287,197,95,63,134,allow
57022,443,20898,443,4228,1470,2758,19,131,9,10,allow
1734,80,1734,80,318813,10418,308395,314,95,102,212,allow
50524,80,58944,80,102242,12176,90066,149,156,68,81,allow
57602,443,23488,443,2614,1689,925,18,20,10,8,allow
49202,31719,45347,31719,70,70,0,2,8,2,0,allow
52019,40689,48482,40689,70,70,0,2,8,2,0,allow
64266,53,26877,53,180,94,86,2,35,1,1,allow
50467,80,31924,80,197269,14917,182352,254,204,107,147,allow
50566,443,4143,443,2064,1287,777,16,139,9,7,allow
56571,53,42202,53,325,102,223,2,30,1,1,allow
56655,53,35529,53,210,110,100,2,30,1,1,allow
57428,53,16884,53,198,94,104,2,30,1,1,allow
56637,53,51918,53,214,110,104,2,30,1,1,allow
57396,53,17014,53,212,102,110,2,30,1,1,allow
56637,53,18660,53,214,110,104,2,30,1,1,allow
56169,53,53942,53,210,110,100,2,30,1,1,allow
49935,53,46528,53,177,94,83,2,30,1,1,allow
64573,53,51074,53,184,94,90,2,30,1,1,allow
64992,53,64992,53,180,82,98,2,30,1,1,allow
63948,80,9193,80,314,192,122,6,15,4,2,allow
57021,443,9946,443,4697,1470,3227,20,131,9,11,allow
50527,80,17326,80,261781,16421,245360,330,156,137,193,allow
62227,443,62227,443,197342,62255,135087,232,170,110,122,allow
60866,443,47757,443,14519,9445,5074,35,15,20,15,allow
50592,443,18630,443,1304,878,426,12,96,7,5,allow
64292,53,10616,53,387,94,293,4,51,2,2,allow
55582,53,34252,53,168,86,82,2,30,1,1,allow
65503,53,29061,53,177,94,83,2,30,1,1,allow
55315,53,15960,53,196,102,94,2,30,1,1,allow
49354,53,25819,53,196,102,94,2,30,1,1,allow
64380,53,5955,53,193,102,91,2,30,1,1,allow
55030,53,46316,53,177,94,83,2,30,1,1,allow
39945,80,32105,80,1948,728,1220,11,150,6,5,allow
53267,443,33925,443,6156,2009,4147,26,18,14,12,allow
56786,443,13825,443,5698,906,4792,19,27,11,8,allow
49207,58751,6797,58751,70,70,0,2,8,2,0,allow
58840,443,27383,443,5108,700,4408,15,15,7,8,allow
60865,443,14969,443,9934,4897,5037,43,15,25,18,allow
50462,80,37104,80,113965,10014,103951,154,204,65,89,allow
50222,443,25494,443,178347,31093,147254,290,446,140,150,allow
53431,80,15544,80,1638,1324,314,10,15,5,5,allow
55973,53,5208,53,939,678,261,2,30,1,1,allow
10097,53,3471,53,259,86,173,2,30,1,1,allow
56160,53,10248,53,94,94,0,1,30,1,0,allow
55525,53,5634,53,214,110,104,2,30,1,1,allow
56875,53,43240,53,167,86,81,2,30,1,1,allow
57253,53,58310,53,199,102,97,2,30,1,1,allow
56050,53,60245,53,178,94,84,2,30,1,1,allow
49884,53,8513,53,252,102,150,2,30,1,1,allow
55421,53,47278,53,200,102,98,2,30,1,1,allow
57343,53,25885,53,181,94,87,2,30,1,1,allow
27065,53,10980,53,822,466,356,3,30,2,1,allow
58695,53,54969,53,392,86,306,2,30,1,1,allow
57418,53,45442,53,165,86,79,2,30,1,1,allow
56427,53,42294,53,166,86,80,2,30,1,1,allow
57082,53,9901,53,239,94,145,2,30,1,1,allow
27005,37569,6063,37569,880,126,754,2,31,1,1,allow
56382,53,5952,53,195,102,93,2,31,1,1,allow
27005,27001,35440,27001,887,126,761,2,31,1,1,allow
15503,51508,42580,51508,481,150,331,2,1200,1,1,allow
6881,6881,37919,6881,238,118,120,2,1200,1,1,allow
50230,80,65071,80,12572,8562,4010,48,442,26,22,allow
14437,443,4301,443,2589,1443,1146,18,16,8,10,allow
55276,53,37772,53,215,94,121,2,30,1,1,allow
56167,53,20756,53,461,94,367,2,30,1,1,allow
55463,53,21645,53,216,110,106,2,30,1,1,allow
55666,53,45375,53,211,102,109,2,30,1,1,allow
56112,53,63106,53,199,102,97,2,30,1,1,allow
55934,53,0,0,86,86,0,1,30,1,0,allow
56676,53,9987,53,178,94,84,2,30,1,1,allow
56875,53,55228,53,167,86,81,2,30,1,1,allow
56676,53,39365,53,178,94,84,2,31,1,1,allow
27005,27015,4428,27015,884,126,758,2,31,1,1,allow
57343,53,32639,53,181,94,87,2,31,1,1,allow
56556,53,18816,53,184,94,90,2,31,1,1,allow
55155,53,35899,53,194,102,92,2,31,1,1,allow
55321,53,4307,53,193,102,91,2,31,1,1,allow
43514,443,45895,443,9643,2462,7181,26,146,11,15,allow
55727,53,2697,53,195,102,93,2,31,1,1,allow
57470,12383,34199,12383,5728,4818,910,87,4485,74,13,allow
58453,443,9103,443,9972,2138,7834,39,130,19,20,allow
65238,443,5223,443,26538,8416,18122,54,121,25,29,allow
43130,443,2379,443,207714,9731,197983,267,193,120,147,allow
55002,53,42728,53,196,102,94,2,31,1,1,allow
60822,443,31127,443,4435,2482,1953,10,121,6,4,allow
56297,53,38652,53,228,75,153,4,31,2,2,allow
57032,53,17045,53,166,86,80,2,31,1,1,allow
57409,53,32069,53,168,86,82,2,31,1,1,allow
55645,443,7018,443,9213,3751,5462,17,121,8,9,allow
64824,443,53612,443,2442,356,2086,12,120,5,7,allow
52152,443,39969,443,433460,26631,406829,595,147,224,371,allow
55834,53,32935,53,184,94,90,2,31,1,1,allow
38694,443,56498,443,90289,3481,86808,96,16,31,65,allow
50593,443,18063,443,1745,1068,677,18,95,10,8,allow
50544,443,24381,443,8592,1152,7440,25,150,13,12,allow
59955,80,59955,80,16324,808,15516,25,59,11,14,allow
58761,443,45887,443,318,192,126,6,26,4,2,allow
39342,80,30469,80,1638,1324,314,10,16,5,5,allow
33705,80,63150,80,1288,496,792,8,43,5,3,allow
50547,443,55787,443,5895,1068,4827,22,149,12,10,allow
50657,443,9730,443,3339,2205,1134,21,38,13,8,allow
53801,47933,40487,47933,320,140,180,6,6,3,3,allow
59936,80,54096,80,1281,399,882,10,16,6,4,allow
53129,80,16654,80,5318,685,4633,14,15,7,7,allow
50626,443,22681,443,1604,987,617,16,93,9,7,allow
53802,59932,27956,59932,320,140,180,6,6,3,3,allow
53790,21011,61681,21011,70,70,0,2,8,2,0,allow
3478,61463,0,0,585,585,0,1,0,1,0,deny
46844,34567,0,0,60,60,0,1,0,1,0,deny
49367,445,0,0,70,70,0,1,0,1,0,drop
49366,445,0,0,70,70,0,1,0,1,0,drop
49365,445,0,0,70,70,0,1,0,1,0,drop
50514,52752,0,0,146,146,0,1,0,1,0,deny
61138,445,0,0,66,66,0,1,0,1,0,drop
49360,445,0,0,70,70,0,1,0,1,0,drop
61133,445,0,0,66,66,0,1,0,1,0,drop
6666,16010,0,0,60,60,0,1,0,1,0,deny
61132,445,0,0,66,66,0,1,0,1,0,drop
61130,445,0,0,66,66,0,1,0,1,0,drop
61128,445,0,0,66,66,0,1,0,1,0,drop
3478,61463,0,0,1148,1148,0,1,0,1,0,deny
3478,61463,0,0,431,431,0,1,0,1,0,deny
60899,445,0,0,70,70,0,1,0,1,0,drop
54737,50584,0,0,66,66,0,1,0,1,0,deny
45964,3111,0,0,60,60,0,1,0,1,0,deny
54280,3398,0,0,60,60,0,1,0,1,0,deny
61550,5529,0,0,145,145,0,1,0,1,0,deny
60888,445,0,0,70,70,0,1,0,1,0,drop
60889,445,0,0,70,70,0,1,0,1,0,drop
60887,445,0,0,70,70,0,1,0,1,0,drop
49352,445,0,0,70,70,0,1,0,1,0,drop
36369,51505,0,0,62,62,0,1,0,1,0,deny
60886,445,0,0,70,70,0,1,0,1,0,drop
3341,23117,0,0,66,66,0,1,0,1,0,deny
49351,445,0,0,70,70,0,1,0,1,0,drop
49348,445,0,0,70,70,0,1,0,1,0,drop
60883,445,0,0,70,70,0,1,0,1,0,drop
11716,37965,0,0,62,62,0,1,0,1,0,deny
26553,57470,0,0,66,66,0,1,0,1,0,deny
3478,61463,0,0,252,252,0,1,0,1,0,deny
61589,21247,0,0,66,66,0,1,0,1,0,deny
25448,36827,0,0,62,62,0,1,0,1,0,deny
12285,61248,0,0,139,139,0,1,0,1,0,reset-both
59592,37965,0,0,62,62,0,1,0,1,0,deny
61117,445,0,0,66,66,0,1,0,1,0,drop
3478,61463,0,0,164,164,0,1,0,1,0,deny
3478,61463,0,0,343,343,0,1,0,1,0,deny
3478,61463,0,0,68,68,0,1,0,1,0,deny
11136,17500,0,0,62,62,0,1,0,1,0,deny
60877,445,0,0,70,70,0,1,0,1,0,drop
54614,37807,0,0,66,66,0,1,0,1,0,deny
61110,445,0,0,66,66,0,1,0,1,0,drop
49335,445,0,0,70,70,0,1,0,1,0,drop
3478,61463,0,0,1109,1109,0,1,0,1,0,deny
3478,61463,0,0,64,64,0,1,0,1,0,deny
14618,6881,0,0,66,66,0,1,0,1,0,deny
7246,59858,0,0,66,66,0,1,0,1,0,deny
12709,51505,0,0,62,62,0,1,0,1,0,deny
61108,445,0,0,66,66,0,1,0,1,0,drop
60869,445,0,0,70,70,0,1,0,1,0,drop
60868,445,0,0,70,70,0,1,0,1,0,drop
11859,64147,0,0,62,62,0,1,0,1,0,deny
59736,51505,0,0,62,62,0,1,0,1,0,deny
61100,445,0,0,66,66,0,1,0,1,0,drop
50478,51505,0,0,66,66,0,1,0,1,0,deny
61096,445,0,0,66,66,0,1,0,1,0,drop
60863,445,0,0,70,70,0,1,0,1,0,drop
2886,35440,0,0,66,66,0,1,0,1,0,deny
60861,445,0,0,70,70,0,1,0,1,0,drop
57131,7774,0,0,145,145,0,1,0,1,0,deny
18029,50584,0,0,66,66,0,1,0,1,0,deny
14183,26467,0,0,62,62,0,1,0,1,0,deny
12651,62413,0,0,62,62,0,1,0,1,0,deny
60857,445,0,0,70,70,0,1,0,1,0,drop
62415,57470,0,0,66,66,0,1,0,1,0,deny
49322,445,0,0,70,70,0,1,0,1,0,drop
49320,445,0,0,70,70,0,1,0,1,0,drop
49321,445,0,0,70,70,0,1,0,1,0,drop
13166,57470,0,0,62,62,0,1,0,1,0,deny
60856,445,0,0,70,70,0,1,0,1,0,drop
61082,445,0,0,66,66,0,1,0,1,0,drop
61077,445,0,0,66,66,0,1,0,1,0,drop
61085,445,0,0,66,66,0,1,0,1,0,drop
61083,445,0,0,66,66,0,1,0,1,0,drop
61078,445,0,0,66,66,0,1,0,1,0,drop
61079,445,0,0,66,66,0,1,0,1,0,drop
61080,445,0,0,66,66,0,1,0,1,0,drop
61081,445,0,0,66,66,0,1,0,1,0,drop
3792,52700,0,0,62,62,0,1,0,1,0,deny
24219,1900,0,0,60,60,0,1,0,1,0,deny
34775,5900,0,0,60,60,0,1,0,1,0,deny
62973,51505,0,0,62,62,0,1,0,1,0,deny
55488,57470,0,0,145,145,0,1,0,1,0,deny
60851,445,0,0,70,70,0,1,0,1,0,drop
41744,37965,0,0,62,62,0,1,0,1,0,deny
60155,23718,0,0,66,66,0,1,0,1,0,deny
61430,37965,0,0,66,66,0,1,0,1,0,deny
49316,445,0,0,70,70,0,1,0,1,0,drop
49310,445,0,0,70,70,0,1,0,1,0,drop
49311,445,0,0,70,70,0,1,0,1,0,drop
49305,445,0,0,70,70,0,1,0,1,0,drop
33062,17,0,0,60,60,0,1,0,1,0,deny
61065,445,0,0,66,66,0,1,0,1,0,drop
61064,445,0,0,66,66,0,1,0,1,0,drop
61063,445,0,0,66,66,0,1,0,1,0,drop
59210,50584,0,0,62,62,0,1,0,1,0,deny
57917,44847,0,0,66,66,0,1,0,1,0,deny
62824,37807,0,0,62,62,0,1,0,1,0,deny
3478,61463,0,0,164,164,0,1,0,1,0,deny
50,64147,0,0,62,62,0,1,0,1,0,deny
11136,57587,0,0,62,62,0,1,0,1,0,deny
49300,445,0,0,70,70,0,1,0,1,0,drop
59422,51221,0,0,66,66,0,1,0,1,0,deny
60838,445,0,0,70,70,0,1,0,1,0,drop
49298,445,0,0,70,70,0,1,0,1,0,drop
49290,445,0,0,70,70,0,1,0,1,0,drop
49289,445,0,0,70,70,0,1,0,1,0,drop
19634,64147,0,0,62,62,0,1,0,1,0,deny
59842,62413,0,0,62,62,0,1,0,1,0,deny
3512,23,0,0,60,60,0,1,0,1,0,deny
50799,37807,0,0,62,62,0,1,0,1,0,deny
60835,445,0,0,70,70,0,1,0,1,0,drop
29697,51221,0,0,62,62,0,1,0,1,0,deny
60818,37965,0,0,66,66,0,1,0,1,0,deny
45682,37965,0,0,62,62,0,1,0,1,0,deny
55862,62413,0,0,62,62,0,1,0,1,0,deny
60070,44847,0,0,66,66,0,1,0,1,0,deny
45682,37965,0,0,145,145,0,1,0,1,0,deny
51903,26467,0,0,62,62,0,1,0,1,0,deny
59663,37965,0,0,66,66,0,1,0,1,0,deny
54365,64147,0,0,62,62,0,1,0,1,0,deny
42252,33303,0,0,60,60,0,1,0,1,0,deny
60830,445,0,0,70,70,0,1,0,1,0,drop
5223,14446,0,0,220,220,0,1,0,1,0,deny
49280,445,0,0,70,70,0,1,0,1,0,drop
49278,445,0,0,70,70,0,1,0,1,0,drop
49277,445,0,0,70,70,0,1,0,1,0,drop
57114,35440,0,0,146,146,0,1,0,1,0,deny
64368,22114,0,0,62,62,0,1,0,1,0,deny
60829,445,0,0,70,70,0,1,0,1,0,drop
6703,21247,0,0,62,62,0,1,0,1,0,deny
44681,31573,0,0,146,146,0,1,0,1,0,deny
60827,445,0,0,70,70,0,1,0,1,0,drop
61050,445,0,0,66,66,0,1,0,1,0,drop
15466,41864,0,0,148,148,0,1,0,1,0,deny
62341,26467,0,0,66,66,0,1,0,1,0,deny
24271,52700,0,0,66,66,0,1,0,1,0,deny
49686,44847,0,0,66,66,0,1,0,1,0,deny
53756,50584,0,0,66,66,0,1,0,1,0,deny
37875,55108,0,0,148,148,0,1,0,1,0,deny
49274,445,0,0,70,70,0,1,0,1,0,drop
49266,445,0,0,70,70,0,1,0,1,0,drop
60820,445,0,0,70,70,0,1,0,1,0,drop
60818,445,0,0,70,70,0,1,0,1,0,drop
30948,50584,0,0,146,146,0,1,0,1,0,deny
61038,445,0,0,66,66,0,1,0,1,0,drop
61037,445,0,0,66,66,0,1,0,1,0,drop
27824,51505,0,0,62,62,0,1,0,1,0,deny
63822,14037,0,0,145,145,0,1,0,1,0,deny
60817,445,0,0,70,70,0,1,0,1,0,drop
18608,11392,0,0,66,66,0,1,0,1,0,deny
47910,7454,0,0,60,60,0,1,0,1,0,deny
55421,53,44471,53,200,102,98,2,30,1,1,allow
55756,53,41764,53,747,90,657,2,30,1,1,allow
50630,443,47610,443,5013,968,4045,20,87,11,9,allow
55834,53,38945,53,184,94,90,2,31,1,1,allow
16384,443,23910,443,2227,1018,1209,17,16,8,9,allow
53794,39607,29958,39607,70,70,0,2,8,2,0,allow
49205,29020,24277,29020,316,136,180,6,7,3,3,allow
49791,443,35792,443,20149,14507,5642,40,355,24,16,allow
56261,53,22541,53,184,94,90,2,31,1,1,allow
56072,80,56072,80,23248,1600,21648,35,31,17,18,allow
53795,22719,37217,22719,258,70,188,4,8,2,2,allow
52016,58318,32216,58318,70,70,0,2,9,2,0,allow
61427,443,64293,443,7288,1763,5525,22,77,12,10,allow
61430,443,43160,443,7288,1763,5525,22,77,12,10,allow
58035,80,60635,80,130,70,60,2,15,1,1,allow
60999,53,14276,53,578,286,292,9,16,5,4,allow
53789,47191,44143,47191,70,70,0,2,8,2,0,allow
53793,20468,60935,20468,70,70,0,2,8,2,0,allow
52013,35185,52958,35185,70,70,0,2,9,2,0,allow
56556,53,58365,53,184,94,90,2,31,1,1,allow
50265,31240,10906,31240,726,726,0,12,1200,12,0,allow
57262,53,44073,53,176,90,86,2,30,1,1,allow
58824,443,46343,443,11863,7694,4169,33,17,17,16,allow
34746,80,56625,80,1299,793,506,12,15,6,6,allow
56639,53,16587,53,168,86,82,2,36,1,1,allow
63962,10115,10126,10115,66,66,0,2,8,2,0,allow
61429,443,58099,443,9504,3379,6125,28,77,15,13,allow
53788,1,8231,1,70,70,0,2,8,2,0,allow
43818,80,62769,80,2005,715,1290,8,15,5,3,allow
41650,443,33832,443,6356,1857,4499,48,229,20,28,allow
51988,32239,13198,32239,66,66,0,1,5,1,0,allow
34942,443,50978,443,4317,2189,2128,29,82,15,14,allow
55803,53,28022,53,174,89,85,3,36,2,1,allow
50576,80,50576,80,24419,8463,15956,49,19,25,24,allow
55321,53,43693,53,186,95,91,2,31,1,1,allow
61428,443,21919,443,7276,1763,5513,22,77,12,10,allow
61426,443,49528,443,7348,1763,5585,23,77,12,11,allow
57193,80,36563,80,2235,1055,1180,12,16,7,5,allow
58821,443,62939,443,16200,10803,5397,42,18,24,18,allow
60929,80,45754,80,2235,1055,1180,12,15,7,5,allow
53791,16881,62073,16881,70,70,0,2,8,2,0,allow
61510,80,61510,80,17105,750,16355,21,15,7,14,allow
42650,3389,42650,3389,4930,2691,2239,24,19,14,10,allow
49990,443,43414,443,622,210,412,10,21,4,6,allow
62620,3389,62620,3389,4410,2321,2089,22,18,12,10,allow
60593,80,43950,80,130,70,60,2,15,1,1,allow
56297,53,44253,53,168,86,82,2,30,1,1,allow
55727,53,51328,53,190,97,93,2,30,1,1,allow
55433,443,16673,443,72759,18547,54212,120,137,49,71,allow
49454,80,13717,80,3920,2138,1782,23,135,12,11,allow
27005,12345,8943,12345,898,126,772,2,31,1,1,allow
44847,31105,50353,31105,324,150,174,2,1200,1,1,allow
53930,443,55523,443,33489,2768,30721,44,121,17,27,allow
56917,53,47484,53,188,96,92,2,31,1,1,allow
57176,53,65163,53,793,101,692,2,31,1,1,allow
55002,53,54595,53,192,98,94,2,31,1,1,allow
54712,443,60548,443,5158,2609,2549,11,121,6,5,allow
48886,443,65287,443,8468,2867,5601,23,144,10,13,allow
60816,445,0,0,70,70,0,1,0,1,0,drop
60815,445,0,0,70,70,0,1,0,1,0,drop
45766,35440,0,0,62,62,0,1,0,1,0,deny
60812,445,0,0,70,70,0,1,0,1,0,drop
60811,445,0,0,70,70,0,1,0,1,0,drop
51756,64147,0,0,66,66,0,1,0,1,0,deny
51655,26467,0,0,62,62,0,1,0,1,0,deny
49259,445,0,0,70,70,0,1,0,1,0,drop
49257,445,0,0,70,70,0,1,0,1,0,drop
49256,445,0,0,70,70,0,1,0,1,0,drop
49252,445,0,0,70,70,0,1,0,1,0,drop
15899,37807,0,0,146,146,0,1,0,1,0,deny
51989,29736,26603,29736,160,70,90,2,5,1,1,allow
60018,443,30525,443,8127,1796,6331,21,79,12,9,allow
52278,443,55005,443,7196,1791,5405,18,31,11,7,allow
56297,53,58728,53,168,86,82,2,30,1,1,allow
56783,53,44308,53,193,102,91,2,30,1,1,allow
39742,80,38417,80,1569,593,976,10,44,6,4,allow
59585,443,47956,443,4815,2461,2354,47,58,26,21,allow
59900,443,59900,443,5980,1122,4858,18,58,9,9,allow
50659,443,57690,443,7128,2589,4539,25,37,15,10,allow
9202,80,37636,80,2949,546,2403,11,25,6,5,allow
51540,443,24638,443,957715,36759,920956,1075,161,378,697,allow
50704,80,48490,80,1082,896,186,18,214,15,3,allow
50498,53,36030,53,751,94,657,2,29,1,1,allow
57032,53,53093,53,166,86,80,2,29,1,1,allow
50598,443,44338,443,1653,1010,643,16,94,9,7,allow
54201,443,42354,443,6500,1064,5436,22,255,12,10,allow
50609,443,29620,443,1738,1061,677,18,94,10,8,allow
50640,443,7427,443,1533,950,583,14,85,8,6,allow
57098,80,38453,80,819,530,289,8,40,5,3,allow
50537,443,21381,443,6250,1595,4655,23,150,12,11,allow
39175,80,7841,80,1712,1324,388,11,16,5,6,allow
60858,443,17492,443,64658,47775,16883,115,16,63,52,allow
53797,14550,19741,14550,320,140,180,6,5,3,3,allow
39724,443,26600,443,6128,1344,4784,19,87,12,7,allow
50645,443,5664,443,1514,852,662,16,86,9,7,allow
50585,443,60446,443,1594,951,643,15,97,8,7,allow
50703,80,64252,80,1082,896,186,18,214,15,3,allow
60785,40010,47744,40010,316,136,180,6,5,3,3,allow
5588,5588,0,0,3354,1792,1562,46,192,23,23,allow
53785,33324,40281,33324,70,70,0,2,7,2,0,allow
59994,53,59994,53,86,86,0,1,29,1,0,allow
43014,443,37896,443,134,60,74,3,5,2,1,allow
22278,53,34234,53,806,458,348,3,29,2,1,allow
56169,53,27417,53,210,110,100,2,29,1,1,allow
56109,53,59181,53,323,102,221,2,29,1,1,allow
55387,53,15050,53,195,94,101,2,29,1,1,allow
55907,53,31154,53,184,94,90,2,29,1,1,allow
49444,443,41469,443,2293735,61874,2231861,2321,87,764,1557,allow
55261,53,55428,53,165,86,79,2,29,1,1,allow
57253,53,25140,53,199,102,97,2,29,1,1,allow
58101,53,12737,53,83,83,0,2,31,2,0,allow
64887,53,53065,53,209,110,99,2,30,1,1,allow
55907,53,18173,53,184,94,90,2,30,1,1,allow
55421,53,56436,53,200,102,98,2,30,1,1,allow
52015,25487,58605,25487,70,70,0,2,8,2,0,allow
64219,53,14756,53,403,94,309,4,38,2,2,allow
41279,443,39948,443,8119,1411,6708,20,200,11,9,allow
65439,53,10579,53,228,110,118,2,30,1,1,allow
55002,53,6216,53,196,102,94,2,30,1,1,allow
49207,443,35081,443,2643240,203689,2439551,3285,576,1237,2048,allow
63084,53,39134,53,86,86,0,2,31,2,0,allow
51984,54606,27351,54606,70,70,0,1,5,1,0,allow
51214,443,63195,443,7924,3247,4677,32,71,19,13,allow
58759,443,21160,443,6012,873,5139,18,25,9,9,allow
57326,53,16719,53,180,94,86,2,35,1,1,allow
58432,443,22620,443,26845,11746,15099,187,161,104,83,allow
61422,443,38584,443,8360,1781,6579,23,77,12,11,allow
51997,14398,36359,14398,130,70,60,2,5,1,1,allow
57131,443,18384,443,6489,1065,5424,22,255,12,10,allow
55679,1024,59914,1024,70,70,0,2,8,2,0,allow
56968,443,61875,443,5649,2005,3644,21,186,11,10,allow
15760,53,32222,53,497,83,414,4,30,2,2,allow
49879,53,57267,53,517,95,422,4,44,2,2,allow
49662,53,37093,53,268,93,175,4,59,2,2,allow
56676,53,50057,53,178,94,84,2,30,1,1,allow
63239,443,35910,443,5725,3290,2435,34,125,19,15,allow
55656,53,30150,53,413,102,311,2,30,1,1,allow
57262,53,58338,53,180,94,86,2,30,1,1,allow
52010,443,6265,443,7722,2568,5154,26,63,15,11,allow
58322,53,48798,53,320,94,226,2,30,1,1,allow
45977,53,27186,53,164,78,86,2,30,1,1,allow
48308,443,61860,443,4654,2499,2155,17,31,9,8,allow
56556,53,50468,53,184,94,90,2,30,1,1,allow
57053,53,14001,53,211,102,109,2,30,1,1,allow
59923,53,29358,53,197,78,119,2,30,1,1,allow
56940,80,57845,80,606,70,536,10,278,2,8,allow
56112,53,18781,53,199,102,97,2,30,1,1,allow
55321,53,63193,53,193,102,91,2,30,1,1,allow
51986,41982,32620,41982,70,70,0,1,5,1,0,allow
49991,443,60218,443,622,210,412,10,21,4,6,allow
41052,80,7228,80,1056,682,374,10,15,6,4,allow
49568,80,26293,80,1515,481,1034,11,15,6,5,allow
56297,53,12569,53,168,86,82,2,30,1,1,allow
56561,443,57452,443,341343,9074,332269,353,121,122,231,allow
50811,443,33324,443,2719275,48822,2670453,2459,127,689,1770,allow
61409,443,48164,443,7839,1726,6113,21,77,11,10,allow
55803,53,42450,53,261,89,172,4,38,2,2,allow
50575,80,50575,80,44569,12221,32348,81,19,42,39,allow
56438,53,21882,53,312,94,218,2,30,1,1,allow
56810,53,20653,53,438,180,258,6,30,3,3,allow
53686,19010,53686,19010,70,70,0,1,30,1,0,allow
56653,53,34935,53,78,78,0,1,30,1,0,allow
56740,443,11618,443,456259,379546,76713,1179,364,656,523,allow
63925,53,36572,53,682,199,483,6,46,3,3,allow
49502,80,22198,80,2300864,53111,2247753,2242,18,755,1487,allow
58835,443,42835,443,5166,700,4466,16,15,7,9,allow
64999,53,20323,53,515,86,429,4,45,2,2,allow
37395,443,29125,443,16590,1630,14960,33,199,15,18,allow
50618,443,39503,443,11054,1724,9330,28,91,15,13,allow
50613,443,53382,443,1512,850,662,16,93,9,7,allow
50644,443,24533,443,1514,852,662,16,86,9,7,allow
58760,443,37477,443,5927,794,5133,17,25,8,9,allow
57342,443,57537,443,10761,5724,5037,43,15,25,18,allow
50606,443,59722,443,1511,849,662,16,94,9,7,allow
50611,443,62610,443,11152,2086,9066,33,93,17,16,allow
55681,31948,3131,31948,70,70,0,2,8,2,0,allow
47052,80,21524,80,1217,486,731,8,43,5,3,allow
55677,16588,6838,16588,70,70,0,1,5,1,0,allow
55399,53,4452,53,405,99,306,4,41,2,2,allow
55729,53,41477,53,256,96,160,4,41,2,2,allow
65466,53,9762,53,298,102,196,4,39,2,2,allow
50610,443,21425,443,9469,1273,8196,29,93,15,14,allow
53792,1,12742,1,70,70,0,2,7,2,0,allow
53784,16671,49140,16671,70,70,0,2,7,2,0,allow
51987,23136,41339,23136,70,70,0,1,5,1,0,allow
54828,443,63990,443,70,70,0,1,5,1,0,allow
58885,443,6031,443,152,86,66,2,5,1,1,allow
63240,443,14470,443,1433,734,699,18,125,10,8,allow
59723,443,10674,443,70,70,0,2,5,2,0,allow
49385,53,59773,53,241,102,139,2,29,1,1,allow
64017,53,10978,53,461,94,367,2,29,1,1,allow
55675,49271,26954,49271,504,318,186,8,16,5,3,allow
49500,53,31434,53,248,118,130,2,29,1,1,allow
45344,53,14086,53,538,328,210,3,29,2,1,allow
64775,53,35140,53,445,86,359,2,29,1,1,allow
55727,53,2459,53,195,102,93,2,29,1,1,allow
55068,53,59463,53,196,102,94,2,29,1,1,allow
56112,53,63692,53,199,102,97,2,29,1,1,allow
40204,40034,20615,40034,164,102,62,2,30,1,1,allow
56318,53,21992,53,183,94,89,2,29,1,1,allow
55421,53,33025,53,200,102,98,2,29,1,1,allow
56880,53,13587,53,209,110,99,2,30,1,1,allow
65071,53,37727,53,93,93,0,2,60,2,0,allow
55868,53,39236,53,458,188,270,6,29,3,3,allow
56261,53,2901,53,184,94,90,2,30,1,1,allow
55525,53,3773,53,214,110,104,2,30,1,1,allow
59923,53,7241,53,197,78,119,2,30,1,1,allow
56556,53,6278,53,184,94,90,2,31,1,1,allow
49450,443,1753,443,2319947,69322,2250625,2464,70,870,1594,allow
45753,80,11896,80,48495,10969,37526,83,477,39,44,allow
61418,443,63876,443,7741,1614,6127,21,77,11,10,allow
58096,443,10840,443,7252,1150,6102,22,199,11,11,allow
55678,52879,22607,52879,70,70,0,1,5,1,0,allow
50580,80,50580,80,18727,8262,10465,44,18,23,21,allow
50258,5228,5532,5228,6764,1575,5189,25,157,14,11,allow
59381,53,5162,53,189,78,111,2,30,1,1,allow
55834,53,17845,53,184,94,90,2,30,1,1,allow
56875,53,33833,53,167,86,81,2,30,1,1,allow
59699,443,10810,443,9015,2221,6794,27,421,13,14,allow
50306,443,42473,443,2474,735,1739,11,120,6,5,allow
51221,6889,53258,6889,481,150,331,2,1200,1,1,allow
50265,32988,60132,32988,1488,930,558,21,1200,12,9,allow
36617,443,29137,443,16276,14463,1813,33,95,20,13,allow
56819,443,59951,443,79878,10479,69399,138,120,68,70,allow
49447,443,42024,443,790501,27378,763123,858,86,322,536,allow
46209,443,22477,443,4900,2781,2119,25,95,13,12,allow
45754,80,23823,80,47137,10210,36927,80,477,38,42,allow
9195,80,8495,80,2819,541,2278,12,31,6,6,allow
58758,443,49380,443,4889,1079,3810,15,25,8,7,allow
51982,56306,51670,56306,70,70,0,1,5,1,0,allow
52837,443,26069,443,843201,50940,792261,1191,159,451,740,allow
57130,443,40605,443,6489,1065,5424,22,255,12,10,allow
56917,53,28541,53,194,102,92,2,30,1,1,allow
56427,53,19551,53,166,86,80,2,30,1,1,allow
57262,53,33477,53,180,94,86,2,30,1,1,allow
57683,53,53315,53,243,94,149,2,30,1,1,allow
57343,53,33500,53,181,94,87,2,30,1,1,allow
57262,53,12912,53,180,94,86,2,30,1,1,allow
62415,53,11045,53,86,86,0,2,31,2,0,allow
49451,443,37319,443,1855625,57182,1798443,1981,70,703,1278,allow
57132,443,41283,443,6489,1065,5424,22,255,12,10,allow
65497,443,27033,443,392197,11800,380397,406,16,143,263,allow
58762,443,39294,443,318,192,126,6,25,4,2,allow
52014,20524,1318,20524,70,70,0,2,8,2,0,allow
55680,23711,23434,23711,70,70,0,2,8,2,0,allow
56864,15646,51512,15646,70,70,0,2,8,2,0,allow
51985,38904,1159,38904,70,70,0,1,5,1,0,allow
51983,30472,5988,30472,70,70,0,1,5,1,0,allow
65498,443,2400,443,92290,4799,87491,107,16,43,64,allow
57206,123,21797,123,184,94,90,2,30,1,1,allow
59381,53,57847,53,189,78,111,2,30,1,1,allow
56639,53,41760,53,168,86,82,2,30,1,1,allow
46000,53,44521,53,164,78,86,2,31,1,1,allow
55068,53,43226,53,196,102,94,2,31,1,1,allow
27005,26259,41193,26259,889,126,763,2,31,1,1,allow
51304,443,39350,443,5839,3609,2230,25,361,13,12,allow
30188,23453,55935,23453,502,150,352,2,1200,1,1,allow
50265,14107,11611,14107,132,132,0,3,1200,3,0,allow
55817,53,30944,53,392,102,290,2,30,1,1,allow
64709,53,47288,53,353,118,235,2,30,1,1,allow
48444,53,53992,53,164,78,86,2,30,1,1,allow
53796,53,64571,53,213,78,135,2,30,1,1,allow
37965,58609,35622,58609,15544,7978,7566,132,3153,72,60,allow
55321,53,21988,53,193,102,91,2,31,1,1,allow
55002,53,11641,53,196,102,94,2,31,1,1,allow
27005,33056,50628,33056,885,126,759,2,31,1,1,allow
64500,53,31734,53,212,102,110,2,30,1,1,allow
56419,53,45684,53,199,102,97,2,30,1,1,allow
56279,53,33232,53,228,110,118,2,30,1,1,allow
27005,27015,32670,27015,912,126,786,2,31,1,1,allow
53746,53,62050,53,164,78,86,2,31,1,1,allow
56544,53,44845,53,183,86,97,2,31,1,1,allow
27005,33058,40872,33058,884,126,758,2,31,1,1,allow
65239,443,50519,443,5780,2572,3208,23,120,11,12,allow
55719,443,5079,443,2936,343,2593,12,120,5,7,allow
25,55987,25,55987,118,118,0,1,120,1,0,allow
36685,443,19672,443,10753,1585,9168,24,120,10,14,allow
10151,27715,29644,27715,460,150,310,2,1200,1,1,allow
57346,443,28545,443,72170,4208,67962,102,186,48,54,allow
50584,20824,62214,20824,324,150,174,2,1200,1,1,allow
27005,27015,23860,27015,871,126,745,2,31,1,1,allow
55582,53,48223,53,344,107,237,4,54,2,2,allow
53771,64351,48425,64351,70,70,0,1,5,1,0,allow
5588,5588,0,0,3354,1792,1562,46,193,23,23,allow
62800,80,25172,80,1437,659,778,11,45,6,5,allow
57945,443,56695,443,3522,1763,1759,31,32,16,15,allow
49662,53,31424,53,268,93,175,4,58,2,2,allow
53782,42855,41001,42855,70,70,0,2,8,2,0,allow
49550,80,26667,80,3531,1965,1566,14,29,8,6,allow
60987,443,57213,443,9029,2323,6706,31,16,17,14,allow
55834,53,8445,53,429,94,335,4,52,2,2,allow
56783,53,44833,53,193,102,91,2,30,1,1,allow
59759,53,58276,53,211,78,133,2,30,1,1,allow
55142,53,43974,53,889,404,485,10,30,5,5,allow
55680,53,53324,53,198,94,104,2,30,1,1,allow
44133,53,62526,53,164,78,86,2,30,1,1,allow
61030,445,0,0,66,66,0,1,0,1,0,drop
58251,36237,0,0,66,66,0,1,0,1,0,deny
1330,53567,0,0,146,146,0,1,0,1,0,deny
60797,445,0,0,70,70,0,1,0,1,0,drop
60795,445,0,0,70,70,0,1,0,1,0,drop
60792,445,0,0,70,70,0,1,0,1,0,drop
63910,44847,0,0,66,66,0,1,0,1,0,deny
1903,43890,0,0,62,62,0,1,0,1,0,deny
60787,445,0,0,70,70,0,1,0,1,0,drop
60786,445,0,0,70,70,0,1,0,1,0,drop
61026,445,0,0,66,66,0,1,0,1,0,drop
61024,445,0,0,66,66,0,1,0,1,0,drop
61019,445,0,0,66,66,0,1,0,1,0,drop
61017,445,0,0,66,66,0,1,0,1,0,drop
61020,445,0,0,66,66,0,1,0,1,0,drop
61022,445,0,0,66,66,0,1,0,1,0,drop
61015,445,0,0,66,66,0,1,0,1,0,drop
37633,44847,0,0,62,62,0,1,0,1,0,deny
49245,445,0,0,70,70,0,1,0,1,0,drop
45964,55559,0,0,60,60,0,1,0,1,0,deny
49242,445,0,0,70,70,0,1,0,1,0,drop
49240,445,0,0,70,70,0,1,0,1,0,drop
49238,445,0,0,70,70,0,1,0,1,0,drop
35232,36602,0,0,74,74,0,1,0,1,0,deny
2990,64147,0,0,66,66,0,1,0,1,0,deny
56462,37965,0,0,62,62,0,1,0,1,0,deny
51732,50934,0,0,146,146,0,1,0,1,0,deny
60775,445,0,0,70,70,0,1,0,1,0,drop
7664,2149,0,0,62,62,0,1,0,1,0,deny
2717,31573,0,0,66,66,0,1,0,1,0,deny
58962,23,0,0,60,60,0,1,0,1,0,deny
49234,445,0,0,70,70,0,1,0,1,0,drop
49232,445,0,0,70,70,0,1,0,1,0,drop
49230,445,0,0,70,70,0,1,0,1,0,drop
61009,445,0,0,66,66,0,1,0,1,0,drop
49227,445,0,0,70,70,0,1,0,1,0,drop
38281,37807,0,0,62,62,0,1,0,1,0,deny
61006,445,0,0,66,66,0,1,0,1,0,drop
61004,445,0,0,66,66,0,1,0,1,0,drop
61002,445,0,0,66,66,0,1,0,1,0,drop
60771,445,0,0,70,70,0,1,0,1,0,drop
61001,445,0,0,66,66,0,1,0,1,0,drop
60761,445,0,0,70,70,0,1,0,1,0,drop
60760,445,0,0,70,70,0,1,0,1,0,drop
60762,445,0,0,70,70,0,1,0,1,0,drop
18091,32480,0,0,66,66,0,1,0,1,0,deny
60756,445,0,0,70,70,0,1,0,1,0,drop
57604,32480,0,0,62,62,0,1,0,1,0,deny
60754,445,0,0,70,70,0,1,0,1,0,drop
26092,23,0,0,60,60,0,1,0,1,0,deny
49218,445,0,0,70,70,0,1,0,1,0,drop
25961,55783,0,0,66,66,0,1,0,1,0,deny
24606,55783,0,0,72,72,0,1,0,1,0,deny
31675,23,0,0,60,60,0,1,0,1,0,deny
53469,36237,0,0,66,66,0,1,0,1,0,deny
17489,50584,0,0,146,146,0,1,0,1,0,deny
49214,445,0,0,70,70,0,1,0,1,0,drop
49189,445,0,0,70,70,0,1,0,1,0,drop
10738,50584,0,0,62,62,0,1,0,1,0,deny
57894,44847,0,0,66,66,0,1,0,1,0,deny
60989,445,0,0,66,66,0,1,0,1,0,drop
60748,445,0,0,70,70,0,1,0,1,0,drop
49629,26467,0,0,66,66,0,1,0,1,0,deny
60982,445,0,0,66,66,0,1,0,1,0,drop
49182,445,0,0,70,70,0,1,0,1,0,drop
23349,30188,0,0,146,146,0,1,0,1,0,deny
64346,51505,0,0,66,66,0,1,0,1,0,deny
60740,445,0,0,70,70,0,1,0,1,0,drop
53012,51050,0,0,66,66,0,1,0,1,0,deny
52050,11392,0,0,62,62,0,1,0,1,0,deny
60738,445,0,0,70,70,0,1,0,1,0,drop
60979,445,0,0,66,66,0,1,0,1,0,drop
51414,22,0,0,60,60,0,1,0,1,0,deny
1059,44847,0,0,62,62,0,1,0,1,0,deny
60734,445,0,0,70,70,0,1,0,1,0,drop
5223,14446,0,0,66,66,0,1,0,1,0,deny
60970,445,0,0,66,66,0,1,0,1,0,drop
45682,25604,0,0,62,62,0,1,0,1,0,deny
60732,445,0,0,70,70,0,1,0,1,0,drop
32551,51221,0,0,66,66,0,1,0,1,0,deny
60969,445,0,0,66,66,0,1,0,1,0,drop
51948,17372,0,0,62,62,0,1,0,1,0,deny
43063,57470,0,0,62,62,0,1,0,1,0,deny
58338,3369,0,0,60,60,0,1,0,1,0,deny
60728,445,0,0,70,70,0,1,0,1,0,drop
60438,17372,0,0,66,66,0,1,0,1,0,deny
58475,11392,0,0,66,66,0,1,0,1,0,deny
62709,57470,0,0,62,62,0,1,0,1,0,deny
60727,445,0,0,70,70,0,1,0,1,0,drop
49169,445,0,0,70,70,0,1,0,1,0,drop
49168,445,0,0,70,70,0,1,0,1,0,drop
49170,445,0,0,70,70,0,1,0,1,0,drop
60949,445,0,0,66,66,0,1,0,1,0,drop
60956,445,0,0,66,66,0,1,0,1,0,drop
60951,445,0,0,66,66,0,1,0,1,0,drop
60953,445,0,0,66,66,0,1,0,1,0,drop
60955,445,0,0,66,66,0,1,0,1,0,drop
60954,445,0,0,66,66,0,1,0,1,0,drop
60952,445,0,0,66,66,0,1,0,1,0,drop
60948,445,0,0,66,66,0,1,0,1,0,drop
56386,50584,0,0,62,62,0,1,0,1,0,deny
49203,51050,0,0,62,62,0,1,0,1,0,deny
59763,25604,0,0,62,62,0,1,0,1,0,deny
3478,61463,0,0,164,164,0,1,0,1,0,deny
60722,445,0,0,70,70,0,1,0,1,0,drop
48706,23393,0,0,60,60,0,1,0,1,0,deny
48706,23393,0,0,60,60,0,1,0,1,0,deny
61230,22114,0,0,66,66,0,1,0,1,0,deny
24504,37965,0,0,62,62,0,1,0,1,0,deny
9588,37965,0,0,66,66,0,1,0,1,0,deny
49166,445,0,0,70,70,0,1,0,1,0,drop
49163,445,0,0,70,70,0,1,0,1,0,drop
65528,445,0,0,70,70,0,1,0,1,0,drop
65526,445,0,0,70,70,0,1,0,1,0,drop
0,0,0,0,480,244,236,4,0,2,2,allow
33582,44847,0,0,66,66,0,1,0,1,0,deny
37455,50584,0,0,66,66,0,1,0,1,0,deny
60933,445,0,0,66,66,0,1,0,1,0,drop
60936,445,0,0,66,66,0,1,0,1,0,drop
60934,445,0,0,66,66,0,1,0,1,0,drop
12965,37965,0,0,66,66,0,1,0,1,0,deny
1045,36237,0,0,62,62,0,1,0,1,0,deny
60709,445,0,0,70,70,0,1,0,1,0,drop
56278,52752,0,0,62,62,0,1,0,1,0,deny
65522,445,0,0,70,70,0,1,0,1,0,drop
65515,445,0,0,70,70,0,1,0,1,0,drop
65516,445,0,0,70,70,0,1,0,1,0,drop
65511,445,0,0,70,70,0,1,0,1,0,drop
60706,445,0,0,70,70,0,1,0,1,0,drop
63461,51505,0,0,66,66,0,1,0,1,0,deny
55496,64097,0,0,66,66,0,1,0,1,0,deny
34400,39004,0,0,74,74,0,1,0,1,0,deny
19875,30170,0,0,145,145,0,1,0,1,0,deny
443,62732,0,0,332,332,0,1,0,1,0,deny
56718,50584,0,0,66,66,0,1,0,1,0,deny
2636,11392,0,0,62,62,0,1,0,1,0,deny
14659,11392,0,0,146,146,0,1,0,1,0,deny
60701,445,0,0,70,70,0,1,0,1,0,drop
23483,57470,0,0,109,109,0,1,0,1,0,deny
60700,445,0,0,70,70,0,1,0,1,0,drop
56015,56205,0,0,66,66,0,1,0,1,0,deny
2305,35440,0,0,62,62,0,1,0,1,0,deny
39460,23117,0,0,66,66,0,1,0,1,0,deny
3585,64147,0,0,62,62,0,1,0,1,0,deny
65502,445,0,0,70,70,0,1,0,1,0,drop
65501,445,0,0,70,70,0,1,0,1,0,drop
65498,445,0,0,70,70,0,1,0,1,0,drop
24972,27262,0,0,60,60,0,1,0,1,0,deny
60698,445,0,0,70,70,0,1,0,1,0,drop
60922,445,0,0,66,66,0,1,0,1,0,drop
42366,57470,0,0,66,66,0,1,0,1,0,deny
55123,64097,0,0,66,66,0,1,0,1,0,deny
10329,7774,0,0,143,143,0,1,0,1,0,deny
56638,64147,0,0,62,62,0,1,0,1,0,deny
54999,443,63007,443,6430,1513,4917,26,40,14,12,allow
55012,443,43376,443,7249,1797,5452,29,32,17,12,allow
41170,443,30807,443,8837,1938,6899,21,17,12,9,allow
41169,443,56459,443,8805,1938,6867,21,17,12,9,allow
41730,443,24945,443,760,422,338,12,28,7,5,allow
27005,37579,44292,37579,886,126,760,2,30,1,1,allow
41164,443,60993,443,8949,1938,7011,21,17,12,9,allow
58294,443,58294,443,7356,1014,6342,20,76,10,10,allow
40970,80,47105,80,1052,612,440,10,15,5,5,allow
40858,53,40858,53,200,90,110,2,30,1,1,allow
56783,53,3501,53,186,95,91,2,30,1,1,allow
56419,53,8331,53,198,101,97,2,30,1,1,allow
41168,443,17875,443,8949,1938,7011,21,17,12,9,allow
58815,443,6132,443,11773,7687,4086,31,17,16,15,allow
58829,443,11100,443,2576,1549,1027,15,15,7,8,allow
47167,15000,34015,15000,130,70,60,2,6,1,1,allow
56101,53,1484,53,188,96,92,2,40,1,1,allow
38504,443,56099,443,2227,1018,1209,17,15,8,9,allow
44628,80,44628,80,2898,1485,1413,10,15,6,4,allow
38367,15000,50286,15000,130,70,60,2,5,1,1,allow
53778,6881,15801,6881,70,70,0,1,5,1,0,allow
56014,53,32746,53,711,87,624,2,30,1,1,allow
50710,443,45536,443,1786,172,1614,7,120,3,4,allow
41165,443,56150,443,8949,1938,7011,21,17,12,9,allow
54327,7000,54327,7000,3310,1535,1775,15,15,8,7,allow
53837,15000,29903,15000,130,70,60,2,6,1,1,allow
39058,443,50860,443,70,70,0,1,5,1,0,allow
58832,443,5090,443,3862,2458,1404,16,15,8,8,allow
39057,443,14567,443,70,70,0,1,5,1,0,allow
53772,14132,42222,14132,70,70,0,1,5,1,0,allow
27005,37569,24806,37569,892,126,766,2,30,1,1,allow
26763,443,27928,443,7343,2586,4757,23,20,11,12,allow
58062,443,59135,443,2257,1225,1032,15,18,8,7,allow
54735,443,61550,443,12507,6114,6393,30,90,18,12,allow
50577,80,50577,80,18679,9115,9564,45,18,24,21,allow
48274,15000,32911,15000,130,70,60,2,6,1,1,allow
57748,15000,46693,15000,130,70,60,2,5,1,1,allow
55806,80,22467,80,1248,755,493,7,81,5,2,allow
5588,5588,0,0,3354,1792,1562,46,196,23,23,allow
9104,443,36522,443,6240,1399,4841,24,44,12,12,allow
35173,53,0,0,82,82,0,1,30,1,0,allow
58825,443,1318,443,6357,4318,2039,22,16,11,11,allow
2839,53,2839,53,229,94,135,2,30,1,1,allow
41167,443,51918,443,8869,1938,6931,21,17,12,9,allow
49662,53,40322,53,268,93,175,4,58,2,2,allow
59779,443,18781,443,6055,3602,2453,16,136,8,8,allow
62333,443,30059,443,3170,1556,1614,7,121,3,4,allow
61937,443,25012,443,24420,19966,4454,64,136,35,29,allow
41317,443,52322,443,4555,2276,2279,27,244,9,18,allow
59556,443,25166,443,3888,1169,2719,13,136,6,7,allow
55483,443,25400,443,4496,2369,2127,15,136,7,8,allow
58890,53,0,0,180,82,98,2,31,1,1,allow
61935,443,10080,443,5214,2561,2653,14,136,7,7,allow
41580,443,42075,443,4354,2166,2188,14,136,7,7,allow
63944,30188,0,0,66,66,0,1,0,1,0,deny
7347,56205,0,0,62,62,0,1,0,1,0,deny
57555,35440,0,0,62,62,0,1,0,1,0,deny
16013,35253,0,0,66,66,0,1,0,1,0,deny
60691,445,0,0,70,70,0,1,0,1,0,drop
65493,445,0,0,70,70,0,1,0,1,0,drop
52141,443,17579,443,15637,4217,11420,42,83,19,23,allow
52450,443,7964,443,9648,3653,5995,37,155,19,18,allow
47773,53,42715,53,236,86,150,2,30,1,1,allow
53794,53,8818,53,260,86,174,2,30,1,1,allow
65487,445,0,0,70,70,0,1,0,1,0,drop
60689,445,0,0,70,70,0,1,0,1,0,drop
31780,11392,0,0,146,146,0,1,0,1,0,deny
64957,5555,0,0,60,60,0,1,0,1,0,deny
46640,8880,0,0,60,60,0,1,0,1,0,deny
60688,445,0,0,70,70,0,1,0,1,0,drop
60908,445,0,0,66,66,0,1,0,1,0,drop
60904,445,0,0,66,66,0,1,0,1,0,drop
60687,445,0,0,70,70,0,1,0,1,0,drop
60686,445,0,0,70,70,0,1,0,1,0,drop
60681,445,0,0,70,70,0,1,0,1,0,drop
60680,445,0,0,70,70,0,1,0,1,0,drop
56494,30228,0,0,146,146,0,1,0,1,0,deny
6927,52752,0,0,100,100,0,1,0,1,0,deny
6927,4660,0,0,100,100,0,1,0,1,0,deny
65484,445,0,0,70,70,0,1,0,1,0,drop
14084,43890,0,0,146,146,0,1,0,1,0,deny
60668,445,0,0,70,70,0,1,0,1,0,drop
2572,35440,0,0,62,62,0,1,0,1,0,deny
60666,445,0,0,70,70,0,1,0,1,0,drop
65479,445,0,0,70,70,0,1,0,1,0,drop
65477,445,0,0,70,70,0,1,0,1,0,drop
65472,445,0,0,70,70,0,1,0,1,0,drop
7184,15503,0,0,66,66,0,1,0,1,0,deny
60665,445,0,0,70,70,0,1,0,1,0,drop
7087,23,0,0,60,60,0,1,0,1,0,deny
60900,445,0,0,66,66,0,1,0,1,0,drop
60658,445,0,0,70,70,0,1,0,1,0,drop
60657,445,0,0,70,70,0,1,0,1,0,drop
15320,30188,0,0,146,146,0,1,0,1,0,deny
13062,52752,0,0,66,66,0,1,0,1,0,deny
25101,50584,0,0,62,62,0,1,0,1,0,deny
5223,14446,0,0,66,66,0,1,0,1,0,deny
5223,14446,0,0,119,119,0,1,0,1,0,deny
5223,14446,0,0,167,167,0,1,0,1,0,deny
60897,445,0,0,66,66,0,1,0,1,0,drop
49662,53,17327,53,268,93,175,4,57,2,2,allow
53773,15459,17716,15459,70,70,0,1,4,1,0,allow
58833,443,6455,443,5167,700,4467,16,14,7,9,allow
55010,443,35131,443,9023,4071,4952,30,35,17,13,allow
49204,54530,41547,54530,316,136,180,6,6,3,3,allow
59933,80,46618,80,1756,414,1342,12,15,6,6,allow
51107,80,41417,80,8827,4961,3866,34,47,18,16,allow
65332,53,55664,53,94,94,0,1,30,1,0,allow
51534,443,19846,443,262,70,192,5,21,2,3,allow
49682,53,35686,53,341,110,231,2,29,1,1,allow
56419,53,27801,53,199,102,97,2,30,1,1,allow
37148,53,21111,53,164,78,86,2,30,1,1,allow
63954,53,25119,53,352,102,250,2,29,1,1,allow
56382,53,40376,53,195,102,93,2,29,1,1,allow
37540,443,32914,443,6749,2315,4434,24,46,14,10,allow
56917,53,8537,53,424,104,320,4,30,2,2,allow
27005,30008,37635,30008,881,126,755,2,30,1,1,allow
56419,53,51375,53,199,102,97,2,30,1,1,allow
60475,443,52273,443,585392,18731,566661,623,119,209,414,allow
56261,53,26001,53,184,94,90,2,29,1,1,allow
37965,8999,11644,8999,402,132,270,6,1208,3,3,allow
45755,80,26274,80,52352,11192,41160,90,476,44,46,allow
56119,53,14584,53,199,102,97,2,33,1,1,allow
58831,443,26619,443,5167,700,4467,16,15,7,9,allow
64539,53,38642,53,276,126,150,2,30,1,1,allow
50613,80,37228,80,21942,2323,19619,28,21,11,17,allow
56161,80,10423,80,2670,799,1871,13,46,8,5,allow
55030,443,37524,443,5372,1221,4151,23,18,14,9,allow
4781,443,51838,443,1191,692,499,12,40,7,5,allow
39042,443,16986,443,19733,3606,16127,43,16,22,21,allow
64561,53,25485,53,270,94,176,2,30,1,1,allow
49459,443,10186,443,10166,3392,6774,35,133,18,17,allow
41480,443,25670,443,6004,1688,4316,22,29,13,9,allow
55081,443,63191,443,19866,7188,12678,18,151,7,11,allow
55548,53,39542,53,197,102,95,2,35,1,1,allow
48346,80,10787,80,1878,1444,434,14,15,7,7,allow
49912,53,25675,53,246,102,144,2,30,1,1,allow
63945,28291,25473,28291,504,382,122,8,15,6,2,allow
43286,80,30144,80,1638,1324,314,10,15,5,5,allow
55281,53,62349,53,94,94,0,1,30,1,0,allow
57915,443,51000,443,4103,2950,1153,26,131,16,10,allow
64811,53,63660,53,446,93,353,4,55,2,2,allow
28618,53,13005,53,236,86,150,2,30,1,1,allow
55972,53,37415,53,699,438,261,2,30,1,1,allow
40207,80,3053,80,1364,860,504,13,32,8,5,allow
37155,443,46832,443,7303,2206,5097,23,255,12,11,allow
49219,53,24039,53,264,102,162,2,30,1,1,allow
43659,443,24456,443,17592,11518,6074,51,248,26,25,allow
60093,443,38976,443,292,172,120,4,15,2,2,allow
51547,443,7780,443,202,70,132,3,11,1,2,allow
53764,6881,51389,6881,1463,821,642,15,15,8,7,allow
58830,443,23946,443,5168,700,4468,16,15,7,9,allow
51538,443,33433,443,262,70,192,5,21,2,3,allow
57910,443,61063,443,1853,1214,639,18,156,11,7,allow
57912,443,23938,443,7953,5153,2800,33,142,19,14,allow
45756,80,2776,80,41602,9508,32094,72,476,36,36,allow
64819,53,53319,53,198,94,104,2,30,1,1,allow
48300,443,42844,443,7762,2247,5515,21,31,11,10,allow
51912,45007,7239,45007,1345,679,666,9,30,5,4,allow
56119,53,4548,53,199,102,97,2,30,1,1,allow
64660,53,61374,53,278,94,184,2,30,1,1,allow
64924,53,49056,53,292,126,166,2,30,1,1,allow
65269,53,14472,53,237,94,143,2,30,1,1,allow
39040,443,45031,443,25034,7042,17992,58,21,29,29,allow
39043,443,33177,443,4832,3054,1778,27,16,14,13,allow
64121,443,64564,443,1411,852,559,13,24,7,6,allow
60359,443,21791,443,9607,3847,5760,51,134,26,25,allow
35628,443,42437,443,7840,1829,6011,24,85,14,10,allow
51260,80,52216,80,23175,13071,10104,134,1929,67,67,allow
51106,80,9259,80,9767,6194,3573,40,47,21,19,allow
51108,80,61739,80,6504,3994,2510,26,47,14,12,allow
60782,20010,60186,20010,70,70,0,2,8,2,0,allow
53787,1,62839,1,320,140,180,6,6,3,3,allow
53777,62955,56420,62955,70,70,0,1,4,1,0,allow
53776,37650,38223,37650,70,70,0,1,4,1,0,allow
53266,443,13911,443,12822,4426,8396,42,18,24,18,allow
49261,80,5363,80,3802643,113349,3689294,3463,206,982,2481,allow
42166,443,20816,443,5309,3110,2199,36,81,18,18,allow
55475,53,3330,53,381,102,279,4,44,2,2,allow
50629,80,39121,80,1658,1247,411,8,15,5,3,allow
55002,443,46892,443,6953,2447,4506,26,37,15,11,allow
57913,443,41913,443,1853,1214,639,18,142,11,7,allow
55013,443,19104,443,7531,1773,5758,30,32,17,13,allow
27005,27056,32268,27056,908,126,782,2,30,1,1,allow
45052,443,46441,443,6084,1723,4361,23,201,13,10,allow
53795,53,11623,53,224,86,138,2,30,1,1,allow
64127,53,10956,53,471,182,289,6,57,3,3,allow
49438,443,56354,443,13740,5392,8348,35,134,18,17,allow
54161,443,65319,443,3157,1827,1330,23,15,11,12,allow
59722,443,18746,443,70,70,0,2,5,2,0,allow
51539,443,19176,443,262,70,192,5,21,2,3,allow
58828,443,9559,443,5166,700,4466,16,15,7,9,allow
55673,54815,52506,54815,316,190,126,5,15,3,2,allow
52467,443,14984,443,5343,1102,4241,22,152,11,11,allow
60854,443,16841,443,10447,2417,8030,26,16,15,11,allow
49419,443,41592,443,318,192,126,6,15,4,2,allow
55014,80,6896,80,1573,1145,428,13,32,8,5,allow
54996,443,52291,443,8637,2889,5748,40,41,23,17,allow
27651,53,46551,53,225,78,147,2,30,1,1,allow
64567,443,55637,443,272081,11032,261049,304,139,107,197,allow
51619,443,27223,443,13526,2192,11334,32,141,16,16,allow
40888,8434,40888,8434,156,156,0,3,8,3,0,allow
60453,24369,51749,24369,70,70,0,2,8,2,0,allow
57911,443,43789,443,10141,5997,4144,56,156,28,28,allow
56783,53,7045,53,193,102,91,2,30,1,1,allow
49356,443,28911,443,5946,1254,4692,20,33,10,10,allow
43661,443,21697,443,11255,7612,3643,36,248,19,17,allow
58057,443,19504,443,6821,1076,5745,21,38,12,9,allow
60452,62582,61377,62582,70,70,0,2,8,2,0,allow
9517,23,9517,23,66,66,0,1,5,1,0,allow
34734,5222,46866,5222,7064,2904,4160,68,88,33,35,allow
47166,443,47166,443,4567,1660,2907,19,28,11,8,allow
65444,53,15259,53,86,86,0,1,30,1,0,allow
32299,40015,58130,40015,148,86,62,2,30,1,1,allow
55747,53,24250,53,258,102,156,2,30,1,1,allow
55377,53,7280,53,164,78,86,2,30,1,1,allow
64119,53,14375,53,259,102,157,2,30,1,1,allow
59762,80,15903,80,1278,774,504,12,361,7,5,allow
65511,53,1627,53,212,102,110,2,30,1,1,allow
57470,22468,25297,22468,726,726,0,12,1200,12,0,allow
57240,53,57857,53,215,94,121,2,30,1,1,allow
5497,53,2342,53,208,78,130,2,30,1,1,allow
49222,53,15691,53,199,94,105,2,30,1,1,allow
49296,443,49940,443,20862040,250452,20611588,16880,170,1832,15048,allow
55739,443,29426,443,10875114,348643,10526471,11702,194,3853,7849,allow
42263,443,55947,443,6431,1665,4766,22,275,12,10,allow
19473,53813,59984,53813,481,150,331,2,1200,1,1,allow
57470,43323,55435,43323,2292,332,1960,11,1200,5,6,allow
9122,80,61976,80,98161,5033,93128,125,37,45,80,allow
51980,45478,64521,45478,70,70,0,1,5,1,0,allow
60983,443,50042,443,7458,2832,4626,26,16,15,11,allow
50610,80,53401,80,3726,1504,2222,13,21,7,6,allow
9123,80,23605,80,65336,2808,62528,73,37,28,45,allow
61415,80,27732,80,28257,2893,25364,64,138,30,34,allow
61408,80,60964,80,420720,29056,391664,771,159,325,446,allow
49418,443,14696,443,318,192,126,6,16,4,2,allow
58827,443,27580,443,5167,700,4467,16,15,7,9,allow
55023,443,26981,443,8527,2218,6309,30,26,17,13,allow
58056,443,24409,443,6821,1076,5745,21,38,12,9,allow
50025,53,20225,53,215,94,121,2,30,1,1,allow
64615,53,13915,53,386,134,252,2,30,1,1,allow
64726,53,22205,53,231,94,137,2,30,1,1,allow
49604,53,53151,53,179,94,85,2,30,1,1,allow
33965,443,25810,443,1409634,52704,1356930,1536,173,533,1003,allow
55006,443,44050,443,2900,2007,893,20,36,12,8,allow
61418,80,59402,80,31954,2972,28982,71,138,36,35,allow
50510,443,23339,443,2259313,91208,2168105,2847,1409,1118,1729,allow
9150,443,24673,443,16023,3677,12346,42,37,21,21,allow
55003,443,26179,443,7925,2114,5811,27,37,16,11,allow
32805,80,38439,80,7450,2372,5078,26,24,15,11,allow
49167,443,26021,443,8271,1357,6914,26,17,12,14,allow
49513,443,49513,443,140969,40311,100658,180,68,92,88,allow
49512,53,64595,53,210,102,108,2,30,1,1,allow
27910,53,18233,53,211,94,117,2,30,1,1,allow
49289,53,50733,53,322,118,204,2,30,1,1,allow
62334,443,24621,443,3244,1630,1614,8,120,4,4,allow
60896,445,0,0,66,66,0,1,0,1,0,drop
60895,445,0,0,66,66,0,1,0,1,0,drop
60894,445,0,0,66,66,0,1,0,1,0,drop
60891,445,0,0,66,66,0,1,0,1,0,drop
60887,445,0,0,66,66,0,1,0,1,0,drop
60885,445,0,0,66,66,0,1,0,1,0,drop
52184,22114,0,0,66,66,0,1,0,1,0,deny
53816,22114,0,0,62,62,0,1,0,1,0,deny
65422,26467,0,0,62,62,0,1,0,1,0,deny
65470,445,0,0,70,70,0,1,0,1,0,drop
65465,445,0,0,70,70,0,1,0,1,0,drop
65463,445,0,0,70,70,0,1,0,1,0,drop
65461,445,0,0,70,70,0,1,0,1,0,drop
65012,32468,0,0,62,62,0,1,0,1,0,deny
40598,23,0,0,60,60,0,1,0,1,0,deny
62079,30188,0,0,66,66,0,1,0,1,0,deny
60646,445,0,0,70,70,0,1,0,1,0,drop
28317,35776,0,0,146,146,0,1,0,1,0,deny
58276,43890,0,0,66,66,0,1,0,1,0,deny
39600,5900,0,0,60,60,0,1,0,1,0,deny
11136,19910,0,0,62,62,0,1,0,1,0,deny
3529,25773,0,0,143,143,0,1,0,1,0,reset-both
65259,37965,0,0,62,62,0,1,0,1,0,deny
65460,445,0,0,70,70,0,1,0,1,0,drop
12986,64147,0,0,62,62,0,1,0,1,0,deny
65459,445,0,0,70,70,0,1,0,1,0,drop
65456,445,0,0,70,70,0,1,0,1,0,drop
60311,56205,0,0,66,66,0,1,0,1,0,deny
60879,445,0,0,66,66,0,1,0,1,0,drop
65452,445,0,0,70,70,0,1,0,1,0,drop
60641,445,0,0,70,70,0,1,0,1,0,drop
40742,2967,0,0,62,62,0,1,0,1,0,deny
60876,445,0,0,66,66,0,1,0,1,0,drop
17786,44847,0,0,62,62,0,1,0,1,0,deny
60873,445,0,0,66,66,0,1,0,1,0,drop
60874,445,0,0,66,66,0,1,0,1,0,drop
60872,445,0,0,66,66,0,1,0,1,0,drop
60632,445,0,0,70,70,0,1,0,1,0,drop
60633,445,0,0,70,70,0,1,0,1,0,drop
60631,445,0,0,70,70,0,1,0,1,0,drop
60628,445,0,0,70,70,0,1,0,1,0,drop
60625,445,0,0,70,70,0,1,0,1,0,drop
59366,35440,0,0,66,66,0,1,0,1,0,deny
65444,445,0,0,70,70,0,1,0,1,0,drop
65441,445,0,0,70,70,0,1,0,1,0,drop
65437,445,0,0,70,70,0,1,0,1,0,drop
38885,21247,0,0,62,62,0,1,0,1,0,deny
60861,445,0,0,66,66,0,1,0,1,0,drop
64104,53,45169,53,288,101,187,4,28,2,2,allow
58195,38303,0,0,66,66,0,1,0,1,0,deny
60619,445,0,0,70,70,0,1,0,1,0,drop
22194,31573,0,0,146,146,0,1,0,1,0,deny
59934,35440,0,0,66,66,0,1,0,1,0,deny
48186,51050,0,0,62,62,0,1,0,1,0,deny
54973,1433,0,0,60,60,0,1,0,1,0,deny
57393,48983,0,0,146,146,0,1,0,1,0,deny
29577,64147,0,0,62,62,0,1,0,1,0,deny
33651,36237,0,0,62,62,0,1,0,1,0,deny
60853,445,0,0,66,66,0,1,0,1,0,drop
55524,46232,0,0,66,66,0,1,0,1,0,deny
60612,445,0,0,70,70,0,1,0,1,0,drop
65424,445,0,0,70,70,0,1,0,1,0,drop
60609,445,0,0,70,70,0,1,0,1,0,drop
24127,56205,0,0,66,66,0,1,0,1,0,deny
14693,64147,0,0,66,66,0,1,0,1,0,deny
7364,50584,0,0,66,66,0,1,0,1,0,deny
44344,23,0,0,60,60,0,1,0,1,0,deny
54752,31573,0,0,66,66,0,1,0,1,0,deny
60851,445,0,0,66,66,0,1,0,1,0,drop
14487,38303,0,0,146,146,0,1,0,1,0,deny
60606,445,0,0,70,70,0,1,0,1,0,drop
60604,445,0,0,70,70,0,1,0,1,0,drop
52459,33890,0,0,60,60,0,1,0,1,0,deny
16985,57866,0,0,66,66,0,1,0,1,0,deny
10736,35440,0,0,62,62,0,1,0,1,0,deny
60842,445,0,0,66,66,0,1,0,1,0,drop
59886,64147,0,0,72,72,0,1,0,1,0,deny
51453,64147,0,0,66,66,0,1,0,1,0,deny
60839,445,0,0,66,66,0,1,0,1,0,drop
10834,50584,0,0,62,62,0,1,0,1,0,deny
3478,61463,0,0,164,164,0,1,0,1,0,deny
60600,445,0,0,70,70,0,1,0,1,0,drop
60599,445,0,0,70,70,0,1,0,1,0,drop
443,60496,0,0,60,60,0,1,0,1,0,deny
3597,11392,0,0,62,62,0,1,0,1,0,deny
65415,445,0,0,70,70,0,1,0,1,0,drop
65412,445,0,0,70,70,0,1,0,1,0,drop
65413,445,0,0,70,70,0,1,0,1,0,drop
60822,445,0,0,66,66,0,1,0,1,0,drop
60828,445,0,0,66,66,0,1,0,1,0,drop
60825,445,0,0,66,66,0,1,0,1,0,drop
60826,445,0,0,66,66,0,1,0,1,0,drop
60823,445,0,0,66,66,0,1,0,1,0,drop
60821,445,0,0,66,66,0,1,0,1,0,drop
60824,445,0,0,66,66,0,1,0,1,0,drop
60820,445,0,0,66,66,0,1,0,1,0,drop
63848,64147,0,0,66,66,0,1,0,1,0,deny
60594,445,0,0,70,70,0,1,0,1,0,drop
40977,21247,0,0,66,66,0,1,0,1,0,deny
57459,51505,0,0,66,66,0,1,0,1,0,deny
51287,26467,0,0,66,66,0,1,0,1,0,deny
52830,22114,0,0,62,62,0,1,0,1,0,deny
7310,44847,0,0,62,62,0,1,0,1,0,deny
65419,26467,0,0,62,62,0,1,0,1,0,deny
1026,8305,0,0,148,148,0,1,0,1,0,deny
65406,445,0,0,70,70,0,1,0,1,0,drop
65404,445,0,0,70,70,0,1,0,1,0,drop
65405,445,0,0,70,70,0,1,0,1,0,drop
65396,445,0,0,70,70,0,1,0,1,0,drop
7372,61248,0,0,139,139,0,1,0,1,0,reset-both
51934,36180,0,0,62,62,0,1,0,1,0,deny
56460,22114,0,0,146,146,0,1,0,1,0,deny
60807,445,0,0,66,66,0,1,0,1,0,drop
60806,445,0,0,66,66,0,1,0,1,0,drop
60805,445,0,0,66,66,0,1,0,1,0,drop
35291,44847,0,0,66,66,0,1,0,1,0,deny
60581,445,0,0,70,70,0,1,0,1,0,drop
3375,35253,0,0,66,66,0,1,0,1,0,deny
44411,37965,0,0,62,62,0,1,0,1,0,deny
61461,50584,0,0,66,66,0,1,0,1,0,deny
60771,58414,0,0,62,62,0,1,0,1,0,deny
60578,445,0,0,70,70,0,1,0,1,0,drop
65390,445,0,0,70,70,0,1,0,1,0,drop
65385,445,0,0,70,70,0,1,0,1,0,drop
65381,445,0,0,70,70,0,1,0,1,0,drop
2598,23718,0,0,66,66,0,1,0,1,0,deny
37168,443,59171,443,17716,5150,12566,48,21,25,23,allow
52288,443,59643,443,38314,11683,26631,76,34,38,38,allow
56964,443,49041,443,8085,2164,5921,22,86,12,10,allow
9185,80,20640,80,17855,1067,16788,26,35,11,15,allow
51617,15000,54264,15000,130,70,60,2,5,1,1,allow
21585,443,21585,443,14344,1146,13198,25,19,11,14,allow
58814,443,65401,443,6508,4230,2278,22,16,12,10,allow
55019,443,55019,443,3773,2325,1448,24,18,13,11,allow
47090,15000,28011,15000,138,78,60,2,5,1,1,allow
58566,443,36573,443,34405,7602,26803,53,35,24,29,allow
56168,53,62337,53,745,93,652,2,30,1,1,allow
43708,53,62627,53,168,78,90,2,30,1,1,allow
46081,443,10510,443,125213,5113,120100,153,96,58,95,allow
51588,80,26710,80,2016,1050,966,21,300,11,10,allow
41163,443,48910,443,9045,1938,7107,21,16,12,9,allow
9142,80,13917,80,54219,1884,52335,61,37,23,38,allow
20147,53,20147,53,219,87,132,2,30,1,1,allow
37651,443,37651,443,4659,1752,2907,19,30,11,8,allow
55022,60100,63915,60100,1550,1130,420,15,25,9,6,allow
55427,53,54288,53,200,102,98,2,30,1,1,allow
52012,63475,43517,63475,316,136,180,6,7,3,3,allow
34100,443,31456,443,2044,1024,1020,17,80,9,8,allow
49826,443,3257,443,102548,19098,83450,140,35,60,80,allow
55807,80,52839,80,73021,1232,71789,66,80,14,52,allow
53781,36366,44419,36366,70,70,0,2,8,2,0,allow
57388,53,36277,53,732,89,643,2,30,1,1,allow
57326,53,28871,53,90,90,0,1,30,1,0,allow
53751,443,64587,443,61501,14276,47225,91,35,39,52,allow
21519,443,21519,443,14483,1152,13331,27,19,12,15,allow
47820,443,39799,443,1132,596,536,17,28,9,8,allow
44722,80,3568,80,3162,1159,2003,14,16,8,6,allow
19052,7000,19052,7000,2205,815,1390,13,16,7,6,allow
58507,80,58507,80,348,132,216,6,26,3,3,allow
49169,443,62824,443,11168,3827,7341,42,16,20,22,allow
50248,443,36330,443,8882,3013,5869,29,137,14,15,allow
40022,443,32042,443,6073,1628,4445,23,15,12,11,allow
9187,443,51654,443,158704,5074,153630,184,34,69,115,allow
21839,443,21839,443,13003,1226,11777,25,19,12,13,allow
9186,80,65016,80,17643,1063,16580,26,35,11,15,allow
21716,443,21716,443,10913,762,10151,17,19,7,10,allow
41166,443,62560,443,8933,1938,6995,21,16,12,9,allow
53769,8999,60336,8999,70,70,0,1,5,1,0,allow
58811,443,3266,443,10704,7055,3649,29,17,15,14,allow
45121,15000,17487,15000,130,70,60,2,5,1,1,allow
50193,3389,50193,3389,3473,1518,1955,17,19,9,8,allow
55840,53,9224,53,170,87,83,2,30,1,1,allow
32486,443,32486,443,5497,2520,2977,20,16,11,9,allow
50288,53,0,0,82,82,0,1,30,1,0,allow
58813,443,14180,443,6475,4197,2278,22,16,12,10,allow
56501,53,62547,53,711,87,624,2,31,1,1,allow
64116,53,59357,53,87,87,0,1,31,1,0,allow
53568,443,10135,443,12646,7169,5477,53,198,25,28,allow
54472,443,49806,443,6732,2308,4424,21,141,9,12,allow
56629,53,58033,53,182,93,89,2,30,1,1,allow
64980,53,39962,53,90,90,0,1,31,1,0,allow
53713,443,10339,443,33323,3349,29974,45,123,18,27,allow
41937,53,0,0,82,82,0,1,31,1,0,allow
50017,3389,50017,3389,3428,1714,1714,16,34,8,8,allow
57293,443,21825,443,5161,2421,2740,14,122,7,7,allow
6881,43642,35387,43642,150,150,0,1,1201,1,0,allow
62417,443,4381,443,79513,7480,72033,106,122,39,67,allow
49288,443,26857,443,7332,2907,4425,50,122,22,28,allow
32996,443,27619,443,160,69,91,2,120,1,1,allow
54678,443,37690,443,84066,79714,4352,98,125,66,32,allow
30960,45746,57659,45746,330,330,0,6,3609,6,0,allow
21133,51413,31456,51413,459,149,310,2,1200,1,1,allow
26713,64147,0,0,62,62,0,1,0,1,0,deny
33886,39127,0,0,162,162,0,1,0,1,0,deny
55689,37965,0,0,66,66,0,1,0,1,0,deny
60574,445,0,0,70,70,0,1,0,1,0,drop
58488,37965,0,0,62,62,0,1,0,1,0,deny
60572,445,0,0,70,70,0,1,0,1,0,drop
4581,23,0,0,60,60,0,1,0,1,0,deny
60570,445,0,0,70,70,0,1,0,1,0,drop
25901,50265,0,0,62,62,0,1,0,1,0,deny
26330,26348,0,0,62,62,0,1,0,1,0,deny
65374,445,0,0,70,70,0,1,0,1,0,drop
65372,445,0,0,70,70,0,1,0,1,0,drop
49236,53,51973,53,377,94,283,2,30,1,1,allow
65368,445,0,0,70,70,0,1,0,1,0,drop
60794,445,0,0,66,66,0,1,0,1,0,drop
443,62732,0,0,332,332,0,1,0,1,0,deny
62493,50584,0,0,62,62,0,1,0,1,0,deny
60180,31573,0,0,146,146,0,1,0,1,0,deny
4581,23,0,0,60,60,0,1,0,1,0,deny
35232,36602,0,0,74,74,0,1,0,1,0,deny
60563,445,0,0,70,70,0,1,0,1,0,drop
53519,64147,0,0,66,66,0,1,0,1,0,deny
60560,445,0,0,70,70,0,1,0,1,0,drop
65365,445,0,0,70,70,0,1,0,1,0,drop
65359,445,0,0,70,70,0,1,0,1,0,drop
6666,16010,0,0,60,60,0,1,0,1,0,deny
60559,445,0,0,70,70,0,1,0,1,0,drop
60558,445,0,0,70,70,0,1,0,1,0,drop
60557,445,0,0,70,70,0,1,0,1,0,drop
60555,445,0,0,70,70,0,1,0,1,0,drop
60554,445,0,0,70,70,0,1,0,1,0,drop
60777,445,0,0,66,66,0,1,0,1,0,drop
60778,445,0,0,66,66,0,1,0,1,0,drop
26553,57470,0,0,66,66,0,1,0,1,0,deny
61589,21247,0,0,66,66,0,1,0,1,0,deny
26698,57470,0,0,62,62,0,1,0,1,0,deny
63672,22114,0,0,62,62,0,1,0,1,0,deny
63963,50584,0,0,66,66,0,1,0,1,0,deny
3341,23117,0,0,66,66,0,1,0,1,0,deny
48080,22,0,0,60,60,0,1,0,1,0,deny
52938,64097,0,0,66,66,0,1,0,1,0,deny
50135,50584,0,0,62,62,0,1,0,1,0,deny
60539,445,0,0,70,70,0,1,0,1,0,drop
60537,445,0,0,70,70,0,1,0,1,0,drop
60536,445,0,0,70,70,0,1,0,1,0,drop
28580,64147,0,0,62,62,0,1,0,1,0,deny
65357,445,0,0,70,70,0,1,0,1,0,drop
60528,445,0,0,70,70,0,1,0,1,0,drop
60529,445,0,0,70,70,0,1,0,1,0,drop
13334,41615,0,0,145,145,0,1,0,1,0,deny
64543,50265,0,0,66,66,0,1,0,1,0,deny
65344,445,0,0,70,70,0,1,0,1,0,drop
65347,445,0,0,70,70,0,1,0,1,0,drop
65343,445,0,0,70,70,0,1,0,1,0,drop
60774,445,0,0,66,66,0,1,0,1,0,drop
14696,42707,0,0,62,62,0,1,0,1,0,deny
54614,37807,0,0,66,66,0,1,0,1,0,deny
55616,56205,0,0,62,62,0,1,0,1,0,deny
33405,37965,0,0,62,62,0,1,0,1,0,deny
61639,37965,0,0,66,66,0,1,0,1,0,deny
60757,445,0,0,66,66,0,1,0,1,0,drop
65404,53,13922,53,256,94,162,2,30,1,1,allow
57983,443,8445,443,315701,12378,303323,358,137,129,229,allow
61409,80,63776,80,201243,14555,186688,357,158,145,212,allow
9119,80,62063,80,8732,2438,6294,23,36,11,12,allow
49197,2710,8644,2710,70,70,0,2,7,2,0,allow
62071,443,12103,443,134,60,74,3,4,2,1,allow
55548,53,2209,53,197,102,95,2,29,1,1,allow
55027,53,44978,53,177,94,83,2,29,1,1,allow
56056,53,42855,53,164,86,78,2,29,1,1,allow
50480,443,52040,443,14848,6716,8132,32,30,17,15,allow
50611,80,6797,80,2933,1237,1696,12,20,7,5,allow
36562,443,34526,443,3452,1535,1917,18,82,10,8,allow
58554,80,58554,80,348,132,216,6,26,3,3,allow
55027,443,20215,443,19367,11346,8021,47,19,26,21,allow
56727,443,57540,443,7889,1900,5989,20,14,11,9,allow
65514,53,61722,53,291,98,193,4,33,2,2,allow
9120,80,19755,80,326320,11951,314369,346,36,122,224,allow
52011,10722,20939,10722,70,70,0,2,7,2,0,allow
55001,443,43698,443,8182,3793,4389,27,37,16,11,allow
56726,443,29318,443,7941,1952,5989,20,15,11,9,allow
51589,80,62521,80,2091,1098,993,21,300,11,10,allow
9146,443,17435,443,10056,2310,7746,27,36,14,13,allow
9184,80,49214,80,2066,651,1415,11,35,6,5,allow
62050,443,56297,443,7955,2503,5452,33,16,19,14,allow
35180,443,55162,443,13838,1370,12468,26,34,13,13,allow
56629,53,53878,53,183,94,89,2,30,1,1,allow
65438,53,17432,53,332,94,238,2,29,1,1,allow
56056,53,12861,53,172,94,78,2,29,1,1,allow
55840,53,55617,53,177,94,83,2,30,1,1,allow
64730,53,52714,53,1152,86,1066,2,29,1,1,allow
54496,53,1798,53,164,86,78,2,29,1,1,allow
49698,443,62719,443,14762,1871,12891,30,34,16,14,allow
64703,53,47599,53,306,142,164,2,30,1,1,allow
36394,443,29956,443,8714,1606,7108,24,34,12,12,allow
56724,443,37476,443,7941,1952,5989,20,15,11,9,allow
49432,53,61997,53,312,94,218,2,30,1,1,allow
42894,443,60082,443,448,78,370,6,25,1,5,allow
60730,443,25640,443,5518,1221,4297,16,90,10,6,allow
56541,53,2371,53,294,142,152,2,30,1,1,allow
52601,443,40695,443,2046,1026,1020,17,80,9,8,allow
52599,443,49618,443,2044,1024,1020,17,80,9,8,allow
40386,443,23622,443,600,156,444,8,25,2,6,allow
123,123,35980,123,184,94,90,2,30,1,1,allow
56629,53,25209,53,183,94,89,2,30,1,1,allow
57773,443,16393,443,11544,6888,4656,32,125,17,15,allow
48575,123,43562,123,184,94,90,2,30,1,1,allow
51978,57496,57419,57496,70,70,0,1,5,1,0,allow
51976,11816,28383,11816,70,70,0,1,5,1,0,allow
5588,5588,0,0,3354,1792,1562,46,194,23,23,allow
55840,53,28820,53,177,94,83,2,30,1,1,allow
60848,53,46740,53,168,78,90,2,30,1,1,allow
53158,443,62480,443,4940,2342,2598,21,135,10,11,allow
56429,443,13104,443,227145,7409,219736,252,146,86,166,allow
49160,6886,47580,6886,854,150,704,4,1200,2,2,allow
54269,53,35881,53,86,86,0,1,30,1,0,allow
55527,80,13344,80,20513,1960,18553,39,21,18,21,allow
38274,443,9313,443,600,156,444,8,25,2,6,allow
64638,53,19660,53,397,102,295,2,30,1,1,allow
54460,443,28221,443,7372,1764,5608,27,547,15,12,allow
55024,443,7164,443,6986,1578,5408,26,25,15,11,allow
55000,443,57257,443,16063,2691,13372,38,38,18,20,allow
45546,80,52456,80,1213,471,742,10,255,6,4,allow
55004,443,44724,443,7960,2219,5741,27,35,16,11,allow
58826,443,32981,443,5168,700,4468,16,15,7,9,allow
49193,443,41261,443,11773,2390,9383,29,19,15,14,allow
61411,80,31645,80,145440,11034,134406,292,158,135,157,allow
61413,80,4426,80,283970,23419,260551,574,158,255,319,allow
9103,443,27886,443,7876,1511,6365,29,42,14,15,allow
52008,49383,8718,49383,70,70,0,2,8,2,0,allow
51981,38274,61701,38274,206,136,70,4,13,3,1,allow
49170,443,23155,443,7743,1601,6142,18,16,10,8,allow
45549,80,33456,80,1117,762,355,10,255,6,4,allow
55029,443,11495,443,7682,3198,4484,27,17,16,11,allow
61416,80,26249,80,2366,764,1602,10,137,5,5,allow
44519,443,58426,443,716,428,288,11,26,7,4,allow
54998,443,38889,443,10151,2256,7895,32,39,17,15,allow
50628,80,46976,80,1658,1247,411,8,14,5,3,allow
49168,443,13015,443,17765,1565,16200,29,16,12,17,allow
61414,80,32431,80,22368,2947,19421,53,137,24,29,allow
61410,80,27494,80,297783,19995,277788,543,158,229,314,allow
55021,443,61578,443,8042,2104,5938,27,26,15,12,allow
9140,80,58869,80,49165,1785,47380,56,36,21,35,allow
53150,43918,23563,43918,320,140,180,6,6,3,3,allow
56652,80,38597,80,234,234,0,4,12,4,0,allow
33201,443,28063,443,21805,2081,19724,38,34,19,19,allow
51979,55803,3042,55803,70,70,0,1,4,1,0,allow
64665,53,55262,53,181,94,87,2,31,1,1,allow
42895,443,18411,443,600,156,444,8,25,2,6,allow
55027,53,14460,53,177,94,83,2,29,1,1,allow
52007,37732,15176,37732,70,70,0,2,8,2,0,allow
56379,53,17881,53,94,94,0,1,29,1,0,allow
50380,53,4521,53,737,94,643,2,29,1,1,allow
49604,53,54196,53,179,94,85,2,29,1,1,allow
32804,80,61447,80,7454,2436,5018,26,23,16,10,allow
51977,18504,5519,18504,70,70,0,1,5,1,0,allow
42892,443,39711,443,448,78,370,6,25,1,5,allow
50560,443,29461,443,408090,25873,382217,748,137,354,394,allow
39844,443,3106,443,2042,1022,1020,17,80,9,8,allow
55323,53,29422,53,279,94,185,2,30,1,1,allow
56058,53,33400,53,200,94,106,2,30,1,1,allow
62856,443,62856,443,3743,1654,2089,10,120,5,5,allow
56219,53,57925,53,177,94,83,2,30,1,1,allow
64642,53,2609,53,307,94,213,2,30,1,1,allow
64116,53,59887,53,177,94,83,2,31,1,1,allow
57470,64430,53438,64430,1386,1386,0,22,1526,22,0,allow
53147,26330,24592,26330,70,70,0,1,5,1,0,allow
55672,45682,1314,45682,70,70,0,1,5,1,0,allow
47758,443,3505,443,299614,32024,267590,587,115,304,283,allow
9205,443,26795,443,318,192,126,6,18,4,2,allow
30188,63236,11932,63236,11247,4773,6474,66,1454,32,34,allow
56725,443,10503,443,7889,1900,5989,20,15,11,9,allow
49195,8108,53972,8108,70,70,0,1,5,1,0,allow
38278,443,39999,443,448,78,370,6,25,1,5,allow
52396,443,30033,443,1253628,61672,1191956,1875,220,939,936,allow
58820,443,32869,443,5167,700,4467,16,15,7,9,allow
34165,443,24288,443,14923,1978,12945,32,49,17,15,allow
55840,53,8081,53,177,94,83,2,30,1,1,allow
52667,80,1897,80,1272,633,639,9,150,5,4,allow
43715,443,63901,443,81803,3159,78644,93,20,33,60,allow
54270,443,64669,443,29945,19086,10859,98,736,50,48,allow
58822,443,37574,443,5166,700,4466,16,15,7,9,allow
61295,443,30551,443,134322,10347,123975,220,304,77,143,allow
49772,80,38136,80,70,70,0,2,8,2,0,allow
55674,48870,28202,48870,70,70,0,1,5,1,0,allow
38276,443,11817,443,600,156,444,8,25,2,6,allow
38275,443,49031,443,448,78,370,6,25,1,5,allow
38774,80,38774,80,369073,4523,364550,316,142,59,257,allow
53751,22266,31272,22266,754,502,252,11,20,7,4,allow
65216,53,41251,53,292,94,198,2,30,1,1,allow
60399,123,27117,123,184,94,90,2,30,1,1,allow
64310,53,12682,53,404,102,302,2,30,1,1,allow
53216,443,19039,443,26702,3270,23432,40,136,16,24,allow
56586,53,33852,53,177,94,83,2,31,1,1,allow
50943,443,64250,443,29452,1988,27464,37,3619,10,27,allow
56219,53,60572,53,177,94,83,2,30,1,1,allow
6881,35156,27681,35156,509,150,359,2,1199,1,1,allow
57470,31114,57905,31114,528,528,0,9,1199,9,0,allow
53765,16178,2985,16178,70,70,0,1,5,1,0,allow
62049,443,56388,443,7856,2410,5446,30,17,16,14,allow
60783,40010,46411,40010,316,136,180,6,6,3,3,allow
55490,80,37170,80,186387,10616,175771,243,33,116,127,allow
63944,8999,41992,8999,70,70,0,1,5,1,0,allow
33793,80,7506,80,1286,782,504,12,361,7,5,allow
55752,8060,62936,8060,70,70,0,2,8,2,0,allow
60762,445,0,0,66,66,0,1,0,1,0,drop
60763,445,0,0,66,66,0,1,0,1,0,drop
60768,445,0,0,66,66,0,1,0,1,0,drop
60764,445,0,0,66,66,0,1,0,1,0,drop
60765,445,0,0,66,66,0,1,0,1,0,drop
60756,445,0,0,66,66,0,1,0,1,0,drop
48706,23393,0,0,60,60,0,1,0,1,0,deny
48706,23393,0,0,60,60,0,1,0,1,0,deny
56275,65348,0,0,142,142,0,1,0,1,0,deny
28040,64147,0,0,62,62,0,1,0,1,0,deny
65339,445,0,0,70,70,0,1,0,1,0,drop
37168,5900,0,0,60,60,0,1,0,1,0,deny
2531,30188,0,0,66,66,0,1,0,1,0,deny
59736,51505,0,0,62,62,0,1,0,1,0,deny
14618,6881,0,0,66,66,0,1,0,1,0,deny
65337,445,0,0,70,70,0,1,0,1,0,drop
65336,445,0,0,70,70,0,1,0,1,0,drop
65335,445,0,0,70,70,0,1,0,1,0,drop
60517,445,0,0,70,70,0,1,0,1,0,drop
63397,26467,0,0,66,66,0,1,0,1,0,deny
55255,37965,0,0,146,146,0,1,0,1,0,deny
50478,51505,0,0,66,66,0,1,0,1,0,deny
56442,11392,0,0,62,62,0,1,0,1,0,deny
33503,5529,0,0,146,146,0,1,0,1,0,deny
18029,50584,0,0,66,66,0,1,0,1,0,deny
16327,55442,0,0,66,66,0,1,0,1,0,deny
61537,57866,0,0,66,66,0,1,0,1,0,deny
60513,445,0,0,70,70,0,1,0,1,0,drop
65330,445,0,0,70,70,0,1,0,1,0,drop
65329,445,0,0,70,70,0,1,0,1,0,drop
65327,445,0,0,70,70,0,1,0,1,0,drop
47827,67,0,0,60,60,0,1,0,1,0,deny
60752,445,0,0,66,66,0,1,0,1,0,drop
65324,445,0,0,70,70,0,1,0,1,0,drop
5222,48709,0,0,66,66,0,1,0,1,0,deny
60748,445,0,0,66,66,0,1,0,1,0,drop
25565,52284,0,0,60,60,0,1,0,1,0,deny
59592,37965,0,0,62,62,0,1,0,1,0,deny
60502,445,0,0,70,70,0,1,0,1,0,drop
60501,445,0,0,70,70,0,1,0,1,0,drop
60504,445,0,0,70,70,0,1,0,1,0,drop
60746,445,0,0,66,66,0,1,0,1,0,drop
60745,445,0,0,66,66,0,1,0,1,0,drop
60499,445,0,0,70,70,0,1,0,1,0,drop
60743,445,0,0,66,66,0,1,0,1,0,drop
60496,445,0,0,70,70,0,1,0,1,0,drop
55421,57470,0,0,74,74,0,1,0,1,0,deny
65316,445,0,0,70,70,0,1,0,1,0,drop
65312,445,0,0,70,70,0,1,0,1,0,drop
65307,445,0,0,70,70,0,1,0,1,0,drop
60155,23718,0,0,66,66,0,1,0,1,0,deny
24285,26467,0,0,62,62,0,1,0,1,0,deny
11859,64147,0,0,62,62,0,1,0,1,0,deny
60491,445,0,0,70,70,0,1,0,1,0,drop
60731,445,0,0,66,66,0,1,0,1,0,drop
59043,35440,0,0,66,66,0,1,0,1,0,deny
29697,51221,0,0,62,62,0,1,0,1,0,deny
59422,51221,0,0,66,66,0,1,0,1,0,deny
53143,50584,0,0,66,66,0,1,0,1,0,deny
57917,44847,0,0,66,66,0,1,0,1,0,deny
60483,445,0,0,70,70,0,1,0,1,0,drop
1873,37965,0,0,62,62,0,1,0,1,0,deny
60481,445,0,0,70,70,0,1,0,1,0,drop
61030,21247,0,0,62,62,0,1,0,1,0,deny
51830,42707,0,0,66,66,0,1,0,1,0,deny
60724,445,0,0,66,66,0,1,0,1,0,drop
65299,445,0,0,70,70,0,1,0,1,0,drop
11136,17500,0,0,62,62,0,1,0,1,0,deny
443,43990,0,0,74,74,0,1,0,1,0,deny
49734,23,0,0,60,60,0,1,0,1,0,deny
443,62732,0,0,332,332,0,1,0,1,0,deny
8999,15503,0,0,146,146,0,1,0,1,0,deny
60477,445,0,0,70,70,0,1,0,1,0,drop
13285,29892,0,0,145,145,0,1,0,1,0,deny
14567,37965,0,0,62,62,0,1,0,1,0,deny
60722,445,0,0,66,66,0,1,0,1,0,drop
56582,23718,0,0,66,66,0,1,0,1,0,deny
60475,445,0,0,70,70,0,1,0,1,0,drop
60818,37965,0,0,66,66,0,1,0,1,0,deny
53871,37965,0,0,66,66,0,1,0,1,0,deny
11688,23718,0,0,146,146,0,1,0,1,0,deny
45964,2225,0,0,60,60,0,1,0,1,0,deny
60714,445,0,0,66,66,0,1,0,1,0,drop
60471,445,0,0,70,70,0,1,0,1,0,drop
60710,445,0,0,66,66,0,1,0,1,0,drop
60470,445,0,0,70,70,0,1,0,1,0,drop
6703,21247,0,0,62,62,0,1,0,1,0,deny
62341,26467,0,0,66,66,0,1,0,1,0,deny
65286,445,0,0,70,70,0,1,0,1,0,drop
65284,445,0,0,70,70,0,1,0,1,0,drop
65285,445,0,0,70,70,0,1,0,1,0,drop
61550,5529,0,0,145,145,0,1,0,1,0,deny
60465,445,0,0,70,70,0,1,0,1,0,drop
60696,445,0,0,66,66,0,1,0,1,0,drop
60699,445,0,0,66,66,0,1,0,1,0,drop
60695,445,0,0,66,66,0,1,0,1,0,drop
60692,445,0,0,66,66,0,1,0,1,0,drop
60697,445,0,0,66,66,0,1,0,1,0,drop
60698,445,0,0,66,66,0,1,0,1,0,drop
60693,445,0,0,66,66,0,1,0,1,0,drop
60691,445,0,0,66,66,0,1,0,1,0,drop
51903,26467,0,0,62,62,0,1,0,1,0,deny
56005,64147,0,0,62,62,0,1,0,1,0,deny
50052,65008,0,0,60,60,0,1,0,1,0,deny
64535,37965,0,0,66,66,0,1,0,1,0,deny
59663,37965,0,0,66,66,0,1,0,1,0,deny
50626,80,27963,80,1366,865,501,8,15,5,3,allow
58806,443,62353,443,10442,6793,3649,30,17,16,14,allow
52180,443,15332,443,11127,1324,9803,24,75,12,12,allow
28025,443,15107,443,5578,1390,4188,19,15,9,10,allow
55098,53,8835,53,176,90,86,2,30,1,1,allow
58734,443,48413,443,1413,876,537,12,26,6,6,allow
58809,443,34899,443,4054,2590,1464,18,16,9,9,allow
51975,11998,29831,11998,66,66,0,1,5,1,0,allow
53780,47132,22525,47132,70,70,0,2,8,2,0,allow
28024,443,28708,443,5516,1388,4128,18,15,9,9,allow
58795,443,29024,443,19700,12992,6708,44,18,23,21,allow
53763,50144,49298,50144,492,306,186,8,16,5,3,allow
55835,53,7338,53,176,90,86,2,31,1,1,allow
52182,443,53611,443,10422,1313,9109,23,75,12,11,allow
52009,1035,48428,1035,316,136,180,6,7,3,3,allow
55069,443,55069,443,4517,1610,2907,19,27,11,8,allow
49846,53,37794,53,763,101,662,2,31,1,1,allow
21903,443,21903,443,29203,1859,27344,37,18,14,23,allow
63464,443,46979,443,24271,2640,21631,38,123,16,22,allow
52183,443,6084,443,10107,1324,8783,22,75,12,10,allow
42716,443,52714,443,12561,2901,9660,29,17,15,14,allow
44384,80,20153,80,51651,48866,2785,74,19,38,36,allow
64751,443,49226,443,507753,8795,498958,463,195,122,341,allow
40039,80,11580,80,1112,534,578,12,16,7,5,allow
53768,19067,20998,19067,70,70,0,1,5,1,0,allow
5588,5588,0,0,3354,1792,1562,46,195,23,23,allow
51971,20347,9073,20347,66,66,0,1,5,1,0,allow
52927,443,29135,443,5582,1388,4194,19,15,9,10,allow
56586,53,23269,53,170,87,83,2,30,1,1,allow
56024,53,53250,53,711,87,624,2,30,1,1,allow
52807,443,39495,443,67984,17257,50727,121,148,50,71,allow
52928,443,44110,443,5584,1390,4194,19,15,9,10,allow
14829,443,14829,443,214215,11945,202270,260,94,110,150,allow
53977,443,23449,443,3330,1694,1636,15,30,8,7,allow
53779,24874,26263,24874,70,70,0,2,8,2,0,allow
55021,443,46013,443,31237,2116,29121,57,195,24,33,allow
58735,443,63211,443,1413,876,537,12,26,6,6,allow
51422,443,51422,443,4399,1492,2907,19,27,11,8,allow
64749,443,34361,443,10750,1814,8936,37,195,17,20,allow
45912,443,22419,443,4306,1107,3199,17,30,9,8,allow
64743,443,34069,443,31480,1953,29527,54,196,20,34,allow
42955,80,63046,80,72023,4897,67126,97,115,46,51,allow
52512,80,4200,80,10889,1117,9772,22,16,12,10,allow
65500,443,41851,443,8177,3420,4757,23,124,11,12,allow
58673,443,8091,443,3330,737,2593,10,121,5,5,allow
57470,50321,35732,50321,490,149,341,2,1201,1,1,allow
35833,443,20943,443,5524,1857,3667,27,3652,9,18,allow
65283,445,0,0,70,70,0,1,0,1,0,drop
65274,445,0,0,70,70,0,1,0,1,0,drop
65276,445,0,0,70,70,0,1,0,1,0,drop
65269,445,0,0,70,70,0,1,0,1,0,drop
8999,57470,0,0,146,146,0,1,0,1,0,deny
56494,3033,0,0,146,146,0,1,0,1,0,deny
54365,64147,0,0,62,62,0,1,0,1,0,deny
32282,8604,0,0,66,66,0,1,0,1,0,deny
60452,445,0,0,70,70,0,1,0,1,0,drop
60678,445,0,0,66,66,0,1,0,1,0,drop
60677,445,0,0,66,66,0,1,0,1,0,drop
60675,445,0,0,66,66,0,1,0,1,0,drop
50949,45960,0,0,62,62,0,1,0,1,0,deny
49514,39127,0,0,162,162,0,1,0,1,0,deny
443,62732,0,0,332,332,0,1,0,1,0,deny
56494,15503,0,0,146,146,0,1,0,1,0,deny
8999,57470,0,0,146,146,0,1,0,1,0,deny
60449,445,0,0,70,70,0,1,0,1,0,drop
52605,443,40382,443,3523,518,3005,12,15,6,6,allow
59775,443,26264,443,5024,2538,2486,23,15,13,10,allow
44074,443,54425,443,5498,3406,2092,28,95,16,12,allow
58359,64147,0,0,72,72,0,1,0,1,0,deny
57339,57470,0,0,66,66,0,1,0,1,0,deny
56494,15503,0,0,146,146,0,1,0,1,0,deny
65265,445,0,0,70,70,0,1,0,1,0,drop
38477,5900,0,0,60,60,0,1,0,1,0,deny
65253,445,0,0,70,70,0,1,0,1,0,drop
65254,445,0,0,70,70,0,1,0,1,0,drop
65252,445,0,0,70,70,0,1,0,1,0,drop
55450,64147,0,0,66,66,0,1,0,1,0,deny
56494,57587,0,0,146,146,0,1,0,1,0,deny
58131,15503,0,0,146,146,0,1,0,1,0,deny
2990,64147,0,0,66,66,0,1,0,1,0,deny
63079,64147,0,0,66,66,0,1,0,1,0,deny
60444,445,0,0,70,70,0,1,0,1,0,drop
35232,36602,0,0,74,74,0,1,0,1,0,deny
60443,445,0,0,70,70,0,1,0,1,0,drop
60441,445,0,0,70,70,0,1,0,1,0,drop
56494,1,0,0,146,146,0,1,0,1,0,deny
51655,26467,0,0,62,62,0,1,0,1,0,deny
21213,23,0,0,60,60,0,1,0,1,0,deny
443,62732,0,0,199,199,0,1,0,1,0,deny
65247,445,0,0,70,70,0,1,0,1,0,drop
65245,445,0,0,70,70,0,1,0,1,0,drop
65242,445,0,0,70,70,0,1,0,1,0,drop
48706,23393,0,0,60,60,0,1,0,1,0,deny
48706,23393,0,0,60,60,0,1,0,1,0,deny
3074,64147,0,0,62,62,0,1,0,1,0,deny
15333,44847,0,0,146,146,0,1,0,1,0,deny
60665,445,0,0,66,66,0,1,0,1,0,drop
60297,25604,0,0,62,62,0,1,0,1,0,deny
60434,445,0,0,70,70,0,1,0,1,0,drop
14148,1,0,0,62,62,0,1,0,1,0,deny
54593,51505,0,0,62,62,0,1,0,1,0,deny
2049,23,0,0,60,60,0,1,0,1,0,deny
60431,445,0,0,70,70,0,1,0,1,0,drop
60430,445,0,0,70,70,0,1,0,1,0,drop
65237,445,0,0,70,70,0,1,0,1,0,drop
65231,445,0,0,70,70,0,1,0,1,0,drop
60429,445,0,0,70,70,0,1,0,1,0,drop
47788,1879,0,0,146,146,0,1,0,1,0,deny
60423,445,0,0,70,70,0,1,0,1,0,drop
60424,445,0,0,70,70,0,1,0,1,0,drop
55206,53,49621,53,196,94,102,2,30,1,1,allow
64988,53,16723,53,196,94,102,2,30,1,1,allow
53238,80,59852,80,1726,940,786,8,55,5,3,allow
52006,49849,11177,49849,70,70,0,2,7,2,0,allow
50919,443,16242,443,5962,1621,4341,16,75,9,7,allow
51419,443,59979,443,13049,4849,8200,31,31,15,16,allow
52179,443,33825,443,7439,1156,6283,19,75,11,8,allow
53855,443,61273,443,134631,7253,127378,176,171,79,97,allow
49514,443,49514,443,234110,36300,197810,309,66,160,149,allow
53767,10004,19496,10004,70,70,0,1,4,1,0,allow
55494,80,14370,80,188544,9826,178718,241,32,113,128,allow
51974,54759,44353,54759,70,70,0,1,4,1,0,allow
56723,443,2144,443,7889,1900,5989,20,15,11,9,allow
36100,443,53812,443,812,440,372,14,25,8,6,allow
34657,443,29815,443,3521,516,3005,12,15,6,6,allow
63937,53,8865,53,183,94,89,2,30,1,1,allow
53766,3596,6099,3596,70,70,0,1,4,1,0,allow
60786,80,13349,80,1638,1324,314,10,15,5,5,allow
56367,53,12261,53,900,110,790,2,29,1,1,allow
56405,53,42424,53,226,102,124,2,30,1,1,allow
64477,443,32832,443,8965,3771,5194,33,124,14,19,allow
51108,80,16411,80,2794,2075,719,15,30,9,6,allow
56184,53,63317,53,215,94,121,2,30,1,1,allow
55835,53,25257,53,180,94,86,2,30,1,1,allow
49932,53,2052,53,289,94,195,2,30,1,1,allow
34658,443,51529,443,3521,516,3005,12,15,6,6,allow
50522,443,6531,443,1579,988,591,13,45,7,6,allow
58903,80,49363,80,22851,3171,19680,39,147,20,19,allow
60438,53,9919,53,77,77,0,2,31,2,0,allow
35667,80,40101,80,1638,1324,314,10,15,5,5,allow
52004,55711,12562,55711,70,70,0,2,7,2,0,allow
56722,443,4374,443,7941,1952,5989,20,15,11,9,allow
59758,53,7104,53,211,78,133,2,30,1,1,allow
39748,80,44062,80,1638,1324,314,10,15,5,5,allow
64648,53,9787,53,215,94,121,2,30,1,1,allow
52295,53,54282,53,322,102,220,2,30,1,1,allow
57303,53,6094,53,177,94,83,2,30,1,1,allow
61637,53,32273,53,82,82,0,2,31,2,0,allow
57159,53,30985,53,292,94,198,2,30,1,1,allow
57303,53,43423,53,177,94,83,2,30,1,1,allow
56951,443,25621,443,4679,2071,2608,14,135,7,7,allow
55835,53,39257,53,180,94,86,2,30,1,1,allow
55243,53,43461,53,356,118,238,2,30,1,1,allow
17750,55265,61135,55265,481,150,331,2,1200,1,1,allow
46939,443,46939,443,4657,1750,2907,19,28,11,8,allow
50726,443,27589,443,12350,2504,9846,41,137,21,20,allow
62995,53,59527,53,101,101,0,2,31,2,0,allow
52003,18150,42315,18150,70,70,0,2,7,2,0,allow
29972,53,62142,53,300,94,206,2,30,1,1,allow
65355,53,22974,53,321,102,219,2,30,1,1,allow
53791,53,14073,53,102,102,0,2,31,2,0,allow
60449,28260,32141,28260,70,70,0,1,5,1,0,allow
53761,54363,63571,54363,618,432,186,9,16,6,3,allow
50663,443,57930,443,7732,3046,4686,22,26,12,10,allow
59629,80,40534,80,1652,1264,388,10,17,4,6,allow
58736,443,28275,443,7978,1143,6835,19,26,9,10,allow
56721,443,14378,443,7889,1900,5989,20,15,11,9,allow
53848,443,21534,443,7015200,135026,6880174,6063,438,1252,4811,allow
49194,443,5495,443,605037,246018,359019,1735,1300,846,889,allow
59011,443,8442,443,9619,6442,3177,33,122,15,18,allow
55553,443,62763,443,6639,3918,2721,16,135,8,8,allow
59180,443,21871,443,2592,1486,1106,20,275,10,10,allow
50265,38978,6940,38978,481,150,331,2,1200,1,1,allow
54553,53,43102,53,101,101,0,2,31,2,0,allow
50523,443,11789,443,1579,988,591,13,45,7,6,allow
43494,443,46566,443,670,382,288,10,133,6,4,allow
55305,53,15624,53,88,88,0,2,31,2,0,allow
34656,443,55937,443,3521,516,3005,12,15,6,6,allow
58812,443,22392,443,5167,700,4467,16,15,7,9,allow
52005,33191,61687,33191,70,70,0,2,7,2,0,allow
58816,443,57126,443,5168,700,4468,16,15,7,9,allow
53237,80,8152,80,194,128,66,4,55,3,1,allow
34220,80,10366,80,672,300,372,12,30,6,6,allow
58819,443,22154,443,5168,700,4468,16,14,7,9,allow
54744,443,54744,443,4737,2854,1883,25,117,13,12,allow
54259,443,22869,443,7508,2864,4644,18,75,11,7,allow
53799,3478,23545,3478,3736,1944,1792,58,91,29,29,allow
36661,443,26709,443,16244,2265,13979,35,262,19,16,allow
39674,443,32592,443,2828,1800,1028,27,184,15,12,allow
51972,13604,43742,13604,160,70,90,2,5,1,1,allow
56629,53,45116,53,183,94,89,2,29,1,1,allow
55318,53,29370,53,215,102,113,2,30,1,1,allow
49988,443,8213,443,642,582,60,2,5,1,1,allow
55034,443,40095,443,14671,2953,11718,31,31,17,14,allow
49509,443,49509,443,242669,43830,198839,310,67,159,151,allow
55248,443,36636,443,30281,3919,26362,44,62,21,23,allow
52993,53,60182,53,70,70,0,1,29,1,0,allow
57152,53,56256,53,720,94,626,2,30,1,1,allow
55098,53,14805,53,180,94,86,2,30,1,1,allow
49153,53,32682,53,214,102,112,2,29,1,1,allow
59757,53,47514,53,260,86,174,2,30,1,1,allow
64199,53,4669,53,215,102,113,2,30,1,1,allow
56586,53,39065,53,177,94,83,2,30,1,1,allow
51106,80,64772,80,14616,6227,8389,32,31,16,16,allow
38970,443,29135,443,4144,2479,1665,19,361,10,9,allow
56621,53,30051,53,177,94,83,2,31,1,1,allow
53434,53,34860,53,87,87,0,2,31,2,0,allow
54138,443,3905,443,5702,1212,4490,19,139,10,9,allow
49983,53,19113,53,267,110,157,2,30,1,1,allow
5176,53,35292,53,86,86,0,1,30,1,0,allow
63931,443,46072,443,103248,6121,97127,124,144,47,77,allow
40685,80,25851,80,1278,774,504,12,360,7,5,allow
62617,443,37156,443,3931,678,3253,15,140,6,9,allow
64406,53,8536,53,102,102,0,2,31,2,0,allow
60450,56494,22389,56494,70,70,0,1,5,1,0,allow
64714,53,5629,53,250,86,164,4,36,2,2,allow
65183,53,12672,53,381,89,292,4,43,2,2,allow
50326,443,38402,443,552885,34781,518104,733,245,314,419,allow
64201,53,54602,53,434,96,338,4,30,2,2,allow
54267,53,33061,53,86,86,0,1,30,1,0,allow
61566,53,28325,53,86,86,0,1,30,1,0,allow
54983,53,35853,53,728,102,626,2,30,1,1,allow
56654,53,54903,53,102,102,0,2,31,2,0,allow
65466,53,31281,53,200,102,98,2,33,1,1,allow
55492,80,58922,80,164902,9835,155067,227,32,114,113,allow
51970,18752,15573,18752,70,70,0,1,5,1,0,allow
54080,443,47688,443,1173681,52597,1121084,1428,177,642,786,allow
54079,443,33342,443,1050267,44816,1005451,1276,177,580,696,allow
53853,443,32341,443,1966450,57437,1909013,1885,338,544,1341,allow
49771,53,61386,53,86,86,0,1,30,1,0,allow
49165,53,19244,53,379,94,285,2,30,1,1,allow
64505,53,53732,53,388,134,254,2,30,1,1,allow
57189,53,13765,53,78,78,0,1,30,1,0,allow
56621,53,19745,53,177,94,83,2,30,1,1,allow
6881,55980,18375,55980,226,118,108,2,1199,1,1,allow
58311,443,32362,443,6128,1394,4734,24,146,10,14,allow
48320,80,28314,80,12110,3853,8257,35,1075,13,22,allow
55101,443,55990,443,1786,172,1614,7,120,3,4,allow
60423,443,39132,443,11488,7258,4230,47,122,27,20,allow
55445,53,54858,53,96,96,0,2,31,2,0,allow
34357,443,9724,443,33131,26333,6798,49,121,28,21,allow
56950,443,1900,443,4391,2171,2220,14,135,7,7,allow
60403,443,22407,443,3802,1769,2033,15,135,7,8,allow
55489,80,62350,80,180504,12712,167792,229,32,105,124,allow
56720,443,57174,443,7941,1952,5989,20,15,11,9,allow
55199,53,62103,53,196,94,102,2,30,1,1,allow
63954,60430,18529,60430,66,66,0,2,8,2,0,allow
63937,53,33435,53,183,94,89,2,30,1,1,allow
56075,53,1883,53,215,102,113,2,30,1,1,allow
56020,53,51205,53,199,102,97,2,32,1,1,allow
35292,8100,23509,8100,78,78,0,1,5,1,0,allow
55225,53,24302,53,199,102,97,2,30,1,1,allow
55225,53,48958,53,822,102,720,2,30,1,1,allow
34662,443,60147,443,50100,46087,4013,73,121,43,30,allow
57894,44847,0,0,66,66,0,1,0,1,0,deny
28878,51505,0,0,62,62,0,1,0,1,0,deny
443,62732,0,0,199,199,0,1,0,1,0,deny
53469,36237,0,0,66,66,0,1,0,1,0,deny
60649,445,0,0,66,66,0,1,0,1,0,drop
60648,445,0,0,66,66,0,1,0,1,0,drop
6889,48817,0,0,143,143,0,1,0,1,0,deny
10738,50584,0,0,62,62,0,1,0,1,0,deny
63988,50584,0,0,62,62,0,1,0,1,0,deny
60411,445,0,0,70,70,0,1,0,1,0,drop
60410,445,0,0,70,70,0,1,0,1,0,drop
60408,445,0,0,70,70,0,1,0,1,0,drop
29080,50265,0,0,62,62,0,1,0,1,0,deny
51414,22,0,0,60,60,0,1,0,1,0,deny
60401,445,0,0,70,70,0,1,0,1,0,drop
60400,445,0,0,70,70,0,1,0,1,0,drop
65227,445,0,0,70,70,0,1,0,1,0,drop
16630,44847,0,0,62,62,0,1,0,1,0,deny
65219,445,0,0,70,70,0,1,0,1,0,drop
65220,445,0,0,70,70,0,1,0,1,0,drop
65216,445,0,0,70,70,0,1,0,1,0,drop
60644,445,0,0,66,66,0,1,0,1,0,drop
49629,26467,0,0,66,66,0,1,0,1,0,deny
60633,445,0,0,66,66,0,1,0,1,0,drop
60636,445,0,0,66,66,0,1,0,1,0,drop
60635,445,0,0,66,66,0,1,0,1,0,drop
60634,445,0,0,66,66,0,1,0,1,0,drop
60630,445,0,0,66,66,0,1,0,1,0,drop
60632,445,0,0,66,66,0,1,0,1,0,drop
60629,445,0,0,66,66,0,1,0,1,0,drop
14336,64147,0,0,62,62,0,1,0,1,0,deny
53012,51050,0,0,66,66,0,1,0,1,0,deny
65211,445,0,0,70,70,0,1,0,1,0,drop
60389,445,0,0,70,70,0,1,0,1,0,drop
27824,51505,0,0,62,62,0,1,0,1,0,deny
20864,51221,0,0,62,62,0,1,0,1,0,deny
65209,445,0,0,70,70,0,1,0,1,0,drop
65208,445,0,0,70,70,0,1,0,1,0,drop
65205,445,0,0,70,70,0,1,0,1,0,drop
41648,56205,0,0,66,66,0,1,0,1,0,deny
64626,50584,0,0,66,66,0,1,0,1,0,deny
59618,46824,0,0,66,66,0,1,0,1,0,deny
17378,44847,0,0,62,62,0,1,0,1,0,deny
24910,64147,0,0,66,66,0,1,0,1,0,deny
32551,51221,0,0,66,66,0,1,0,1,0,deny
60385,445,0,0,70,70,0,1,0,1,0,drop
59365,42873,0,0,74,74,0,1,0,1,0,deny
65204,445,0,0,70,70,0,1,0,1,0,drop
65202,445,0,0,70,70,0,1,0,1,0,drop
65201,445,0,0,70,70,0,1,0,1,0,drop
60141,62413,0,0,66,66,0,1,0,1,0,deny
443,61686,0,0,1484,1484,0,1,0,1,0,deny
60621,445,0,0,66,66,0,1,0,1,0,drop
60375,445,0,0,70,70,0,1,0,1,0,drop
60376,445,0,0,70,70,0,1,0,1,0,drop
60374,445,0,0,70,70,0,1,0,1,0,drop
65196,445,0,0,70,70,0,1,0,1,0,drop
60372,445,0,0,70,70,0,1,0,1,0,drop
60619,445,0,0,66,66,0,1,0,1,0,drop
60368,445,0,0,70,70,0,1,0,1,0,drop
60617,445,0,0,66,66,0,1,0,1,0,drop
60616,445,0,0,66,66,0,1,0,1,0,drop
60614,445,0,0,66,66,0,1,0,1,0,drop
23478,1433,0,0,60,60,0,1,0,1,0,deny
6881,6881,0,0,146,146,0,1,0,1,0,deny
30580,50265,0,0,66,66,0,1,0,1,0,deny
50806,51505,0,0,66,66,0,1,0,1,0,deny
65188,445,0,0,70,70,0,1,0,1,0,drop
61230,22114,0,0,66,66,0,1,0,1,0,deny
11136,15503,0,0,145,145,0,1,0,1,0,deny
58825,44847,0,0,146,146,0,1,0,1,0,deny
65184,445,0,0,70,70,0,1,0,1,0,drop
65179,445,0,0,70,70,0,1,0,1,0,drop
60362,445,0,0,70,70,0,1,0,1,0,drop
58687,11392,0,0,66,66,0,1,0,1,0,deny
60761,51221,0,0,66,66,0,1,0,1,0,deny
38281,37807,0,0,62,62,0,1,0,1,0,deny
52252,46314,0,0,62,62,0,1,0,1,0,deny
60603,445,0,0,66,66,0,1,0,1,0,drop
5087,22114,0,0,62,62,0,1,0,1,0,deny
60355,445,0,0,70,70,0,1,0,1,0,drop
60354,445,0,0,70,70,0,1,0,1,0,drop
42094,35440,0,0,146,146,0,1,0,1,0,deny
48706,23393,0,0,60,60,0,1,0,1,0,deny
60595,445,0,0,66,66,0,1,0,1,0,drop
65171,445,0,0,70,70,0,1,0,1,0,drop
60349,445,0,0,70,70,0,1,0,1,0,drop
60347,445,0,0,70,70,0,1,0,1,0,drop
60593,445,0,0,66,66,0,1,0,1,0,drop
19698,502,0,0,60,60,0,1,0,1,0,deny
55496,64097,0,0,66,66,0,1,0,1,0,deny
58114,11119,0,0,148,148,0,1,0,1,0,deny
60343,445,0,0,70,70,0,1,0,1,0,drop
52348,62413,0,0,66,66,0,1,0,1,0,deny
33582,44847,0,0,66,66,0,1,0,1,0,deny
60584,445,0,0,66,66,0,1,0,1,0,drop
56718,50584,0,0,66,66,0,1,0,1,0,deny
57131,7774,0,0,145,145,0,1,0,1,0,deny
60342,445,0,0,70,70,0,1,0,1,0,drop
60575,445,0,0,66,66,0,1,0,1,0,drop
49276,51505,0,0,66,66,0,1,0,1,0,deny
56255,44847,0,0,66,66,0,1,0,1,0,deny
56015,56205,0,0,66,66,0,1,0,1,0,deny
2305,35440,0,0,62,62,0,1,0,1,0,deny
39460,23117,0,0,66,66,0,1,0,1,0,deny
3585,64147,0,0,62,62,0,1,0,1,0,deny
6666,5000,0,0,60,60,0,1,0,1,0,deny
13062,52752,0,0,66,66,0,1,0,1,0,deny
56281,53,50630,53,170,87,83,2,31,1,1,allow
51970,443,63530,443,17072,6138,10934,33,85,18,15,allow
58801,443,36000,443,8937,5785,3152,26,16,14,12,allow
52002,34348,16658,34348,70,70,0,2,7,2,0,allow
54816,3389,54816,3389,3413,1458,1955,16,17,8,8,allow
55624,53,27462,53,701,88,613,2,30,1,1,allow
58045,80,55044,80,62067,24127,37940,79,34,33,46,allow
58055,80,48571,80,3791,2804,987,14,31,8,6,allow
38661,15000,5688,15000,138,78,60,2,5,1,1,allow
51966,18716,18361,18716,66,66,0,1,5,1,0,allow
49503,443,13223,443,9678,4552,5126,22,76,12,10,allow
49270,53,43465,53,216,110,106,2,30,1,1,allow
58034,443,53963,443,10192,3621,6571,24,36,12,12,allow
2885,443,2885,443,28717,3437,25280,45,23,23,22,allow
2359,443,2359,443,8209,1695,6514,21,23,13,8,allow
37554,443,12881,443,13220,4632,8588,32,37,19,13,allow
41628,15000,25474,15000,130,70,60,2,6,1,1,allow
56982,80,33665,80,3817,829,2988,11,16,7,4,allow
58672,443,27008,443,4649,2114,2535,11,120,6,5,allow
2434,443,2434,443,8209,1695,6514,21,23,13,8,allow
52013,443,52013,443,43964,6675,37289,60,49,25,35,allow
57157,443,64238,443,1647,1375,272,9,48,5,4,allow
49270,53,27956,53,216,110,106,2,31,1,1,allow
53974,443,28676,443,3330,1694,1636,15,30,8,7,allow
47207,443,60906,443,11085,2554,8531,48,19,24,24,allow
55576,443,55576,443,4665,1758,2907,19,28,11,8,allow
44687,443,14376,443,3054,1741,1313,20,27,8,12,allow
65418,443,32664,443,2494,1643,851,17,26,9,8,allow
52016,443,52016,443,219803,9390,210413,222,49,72,150,allow
58053,80,60672,80,3751,3009,742,14,31,8,6,allow
51216,22,51216,22,5806,2153,3653,33,24,18,15,allow
5908,3389,5908,3389,3850,1745,2105,19,18,11,8,allow
63937,53,56505,53,182,93,89,2,30,1,1,allow
50583,53,30118,53,783,96,687,2,30,1,1,allow
55071,53,28115,53,711,87,624,2,30,1,1,allow
65442,443,8292,443,3783,1087,2696,11,120,5,6,allow
55307,53,50101,53,1415,101,1314,4,51,2,2,allow
55810,80,19012,80,11093,1415,9678,18,18,8,10,allow
60165,80,45319,80,1982,692,1290,8,15,5,3,allow
39644,80,29707,80,2631,1207,1424,14,16,9,5,allow
52001,12514,64945,12514,70,70,0,2,7,2,0,allow
58799,443,29874,443,7899,5184,2715,24,16,13,11,allow
58054,80,39200,80,3561,3028,533,14,31,8,6,allow
58796,443,44743,443,14463,9503,4960,34,17,17,17,allow
47120,443,47120,443,4380,1473,2907,19,29,11,8,allow
56621,53,42291,53,170,87,83,2,30,1,1,allow
51307,80,27411,80,5912,5182,730,15,23,9,6,allow
63936,14832,6153,14832,312,190,122,5,16,3,2,allow
2252,443,2252,443,11489,1827,9662,25,23,15,10,allow
2226,443,2226,443,46743,4890,41853,69,23,35,34,allow
2506,443,2506,443,35555,4646,30909,59,23,33,26,allow
56119,53,42460,53,198,101,97,2,30,1,1,allow
59115,443,45739,443,30048,2775,27273,41,137,16,25,allow
62623,443,47203,443,5311,1546,3765,15,122,7,8,allow
36099,443,40194,443,48494,10293,38201,71,129,26,45,allow
55199,443,36951,443,4086,1248,2838,24,140,11,13,allow
50319,53,41804,53,188,96,92,2,31,1,1,allow
56138,53,1894,53,783,96,687,2,31,1,1,allow
52426,53,52426,53,310,94,216,2,31,1,1,allow
55563,53,56094,53,188,96,92,2,31,1,1,allow
59715,443,21725,443,3420,983,2437,15,121,7,8,allow
35776,443,4893,443,7500,2339,5161,18,136,8,10,allow
54667,443,17668,443,3989,1104,2885,12,122,5,7,allow
58386,443,54159,443,17470103,920642,16549461,18410,181,6438,11972,allow
55021,53,4080,53,174,89,85,2,31,1,1,allow
49845,443,54304,443,8518,2260,6258,32,806,12,20,allow
54944,443,7511,443,4891,2237,2654,12,121,6,6,allow
49937,443,1883,443,240,240,0,5,338,5,0,allow
54344,443,13534,443,10015,6047,3968,22,122,12,10,allow
46554,5228,16651,5228,4520,2520,2000,40,3961,20,20,allow
34997,22,0,0,60,60,0,1,0,1,0,deny
60337,445,0,0,70,70,0,1,0,1,0,drop
1059,44847,0,0,62,62,0,1,0,1,0,deny
56278,52752,0,0,62,62,0,1,0,1,0,deny
65157,445,0,0,70,70,0,1,0,1,0,drop
65158,445,0,0,70,70,0,1,0,1,0,drop
65156,445,0,0,70,70,0,1,0,1,0,drop
38891,64147,0,0,145,145,0,1,0,1,0,deny
55123,64097,0,0,66,66,0,1,0,1,0,deny
60568,445,0,0,66,66,0,1,0,1,0,drop
60561,445,0,0,66,66,0,1,0,1,0,drop
60569,445,0,0,66,66,0,1,0,1,0,drop
60566,445,0,0,66,66,0,1,0,1,0,drop
60563,445,0,0,66,66,0,1,0,1,0,drop
60565,445,0,0,66,66,0,1,0,1,0,drop
60564,445,0,0,66,66,0,1,0,1,0,drop
23415,11392,0,0,62,62,0,1,0,1,0,deny
8592,35993,0,0,62,62,0,1,0,1,0,deny
63944,30188,0,0,66,66,0,1,0,1,0,deny
50052,65008,0,0,60,60,0,1,0,1,0,deny
60324,445,0,0,70,70,0,1,0,1,0,drop
2695,48817,0,0,62,62,0,1,0,1,0,deny
65155,445,0,0,70,70,0,1,0,1,0,drop
65153,445,0,0,70,70,0,1,0,1,0,drop
49270,53,46560,53,322,110,212,4,30,2,2,allow
65146,445,0,0,70,70,0,1,0,1,0,drop
65143,445,0,0,70,70,0,1,0,1,0,drop
56250,36237,0,0,66,66,0,1,0,1,0,deny
1912,48817,0,0,62,62,0,1,0,1,0,deny
56098,55442,0,0,66,66,0,1,0,1,0,deny
60549,445,0,0,66,66,0,1,0,1,0,drop
60548,445,0,0,66,66,0,1,0,1,0,drop
60546,445,0,0,66,66,0,1,0,1,0,drop
56218,43890,0,0,62,62,0,1,0,1,0,deny
53902,67,0,0,60,60,0,1,0,1,0,deny
60319,445,0,0,70,70,0,1,0,1,0,drop
26601,22114,0,0,62,62,0,1,0,1,0,deny
45304,64147,0,0,72,72,0,1,0,1,0,deny
9445,56205,0,0,62,62,0,1,0,1,0,deny
3052,7302,0,0,66,66,0,1,0,1,0,deny
65136,445,0,0,70,70,0,1,0,1,0,drop
51779,31652,0,0,62,62,0,1,0,1,0,reset-both
65134,445,0,0,70,70,0,1,0,1,0,drop
53759,40826,3442,40826,492,306,186,8,15,5,3,allow
56718,443,49535,443,7940,1951,5989,20,15,11,9,allow
56281,53,4042,53,177,94,83,2,30,1,1,allow
39945,443,42447,443,5446,805,4641,17,26,9,8,allow
37542,443,40273,443,13299,2872,10427,34,41,19,15,allow
37559,443,47158,443,9845,2815,7030,26,37,15,11,allow
52010,23685,49442,23685,316,136,180,6,5,3,3,allow
51968,43622,30970,43622,70,70,0,1,4,1,0,allow
53721,443,6188,443,70,70,0,1,4,1,0,allow
55835,53,15423,53,180,94,86,2,29,1,1,allow
56020,53,34140,53,199,102,97,2,29,1,1,allow
57350,53,53074,53,257,94,163,2,30,1,1,allow
49344,443,51198,443,272627,89686,182941,461,149,220,241,allow
64191,443,64191,443,18608,1844,16764,31,16,16,15,allow
49365,443,7020,443,442336,371266,71070,1143,762,651,492,allow
37546,80,60597,80,10438,979,9459,21,38,11,10,allow
55493,80,50792,80,133558,8265,125293,186,31,93,93,allow
47495,443,53611,443,490,210,280,8,28,4,4,allow
60572,80,35245,80,556,280,276,9,28,5,4,allow
37552,443,42195,443,9959,2495,7464,27,37,15,12,allow
63937,53,1528,53,183,94,89,2,29,1,1,allow
64919,53,28952,53,199,102,97,2,29,1,1,allow
64919,53,63713,53,822,102,720,2,29,1,1,allow
5588,5588,0,0,3354,1792,1562,46,193,23,23,allow
56586,53,17774,53,177,94,83,2,29,1,1,allow
57438,53,26523,53,340,110,230,2,29,1,1,allow
65514,53,51532,53,177,94,83,2,30,1,1,allow
50288,80,24804,80,2032,600,1432,10,45,6,4,allow
52014,443,52014,443,16507,6060,10447,32,49,16,16,allow
54069,443,6998,443,887350,41179,846171,1082,210,487,595,allow
38692,443,1550,443,1188751,17817,1170934,1053,16,255,798,allow
60742,443,40207,443,2258,559,1699,22,120,6,16,allow
49270,53,44798,53,216,110,106,2,30,1,1,allow
44732,80,44732,80,369759,9557,360202,388,22,137,251,allow
9199,80,13955,80,60838,1648,59190,68,27,25,43,allow
53146,50393,43018,50393,70,70,0,1,5,1,0,allow
58810,443,59123,443,5167,700,4467,16,15,7,9,allow
60448,8106,52879,8106,3105,1298,1807,20,16,10,10,allow
49264,80,49264,80,698,366,332,12,44,7,5,allow
55862,53,15902,53,177,94,83,2,30,1,1,allow
27242,443,3447,443,19477,14323,5154,45,309,22,23,allow
58139,443,5557,443,9521,5450,4071,30,120,15,15,allow
64170,53,8544,53,355,118,237,2,30,1,1,allow
56119,53,10048,53,199,102,97,2,33,1,1,allow
57852,7635,57852,7635,216,156,60,4,8,3,1,allow
52009,443,52009,443,588633,17490,571143,578,51,186,392,allow
52011,443,52011,443,110812,7779,103033,122,49,44,78,allow
54078,443,47563,443,1060654,45683,1014971,1265,176,560,705,allow
49194,65100,3468,65100,624,318,306,10,15,5,5,allow
53858,53,53858,53,832,106,726,2,30,1,1,allow
63313,443,9713,443,1786,172,1614,7,120,3,4,allow
47657,443,24927,443,502,140,362,8,140,3,5,allow
50287,80,60290,80,3325,607,2718,11,45,6,5,allow
36754,443,35340,443,1320,822,498,16,41,9,7,allow
45350,443,10693,443,918,358,560,14,40,6,8,allow
56650,80,32144,80,234,234,0,4,12,4,0,allow
64984,53,22465,53,177,94,83,2,30,1,1,allow
57837,443,45626,443,9767,2606,7161,23,120,11,12,allow
10037,443,24188,443,6061,1884,4177,27,16,15,12,allow
51824,80,16784,80,15487,8701,6786,29,44,17,12,allow
55289,53,47764,53,446,94,352,4,44,2,2,allow
55491,80,9905,80,204936,10932,194004,277,31,140,137,allow
55172,443,53179,443,25605,3359,22246,47,82,26,21,allow
42889,443,3091,443,3961,1595,2366,21,15,12,9,allow
60899,443,59717,443,847673,42767,804906,1045,89,441,604,allow
37544,443,15194,443,23647,9422,14225,52,40,28,24,allow
56719,443,65516,443,7888,1899,5989,20,15,11,9,allow
37551,443,6245,443,9381,2351,7030,26,37,15,11,allow
37557,443,30973,443,9824,2477,7347,27,37,16,11,allow
51967,12110,53548,12110,70,70,0,1,4,1,0,allow
60780,28080,29726,28080,70,70,0,2,8,2,0,allow
58718,443,59357,443,1129,599,530,12,25,6,6,allow
49863,8100,2379,8100,78,78,0,1,4,1,0,allow
51969,37558,33450,37558,70,70,0,1,4,1,0,allow
58807,443,28426,443,6033,770,5263,18,15,8,10,allow
65321,53,63779,53,283,103,180,4,54,2,2,allow
59433,53,26803,53,218,78,140,2,29,1,1,allow
49886,53,25717,53,275,94,181,2,30,1,1,allow
48082,443,55722,443,5619,885,4734,17,26,9,8,allow
55862,53,22118,53,177,94,83,2,30,1,1,allow
57113,53,7922,53,215,102,113,2,30,1,1,allow
49256,53,15315,53,212,102,110,2,30,1,1,allow
56621,53,63745,53,177,94,83,2,29,1,1,allow
45099,123,62953,123,184,94,90,2,30,1,1,allow
50319,53,7471,53,194,102,92,2,30,1,1,allow
49741,53,12587,53,211,102,109,2,30,1,1,allow
48941,443,53829,443,10085,3487,6598,21,120,9,12,allow
55641,443,52887,443,6133,1655,4478,12,119,5,7,allow
6881,6881,48136,6881,238,118,120,2,1200,1,1,allow
54081,443,47129,443,444890,27602,417288,580,176,265,315,allow
51459,443,30706,443,6779,2365,4414,19,15,10,9,allow
54070,443,51450,443,828875,45659,783216,1020,210,456,564,allow
50722,80,43079,80,7550,5292,2258,13,29,7,6,allow
52000,10491,3122,10491,70,70,0,2,8,2,0,allow
58808,443,58470,443,5167,700,4467,16,15,7,9,allow
46845,443,36578,443,5506,878,4628,16,26,9,7,allow
55958,53,14478,53,212,102,110,2,30,1,1,allow
50319,53,65506,53,194,102,92,2,30,1,1,allow
51764,443,27947,443,5660,3864,1796,27,95,14,13,allow
60969,443,65231,443,1373,712,661,14,105,8,6,allow
43841,443,59699,443,6516,3085,3431,33,80,17,16,allow
64917,53,19019,53,718,94,624,2,30,1,1,allow
64984,53,54223,53,177,94,83,2,30,1,1,allow
50287,53,47633,53,177,94,83,2,30,1,1,allow
56281,53,7565,53,177,94,83,2,30,1,1,allow
57513,443,18231,443,4346,1212,3134,13,120,6,7,allow
63941,80,15778,80,314,192,122,6,15,4,2,allow
60966,443,26414,443,60331,12765,47566,119,105,57,62,allow
52015,443,52015,443,32358,7474,24884,49,49,23,26,allow
47130,80,63322,80,613,539,74,7,15,6,1,allow
43865,443,4892,443,560,280,280,9,26,5,4,allow
64642,53,25504,53,718,94,624,2,30,1,1,allow
50287,53,45385,53,177,94,83,2,30,1,1,allow
49173,53,47440,53,234,94,140,2,30,1,1,allow
55871,443,13590,443,21179,8150,13029,46,153,25,21,allow
123,123,44210,123,184,94,90,2,30,1,1,allow
55563,53,47239,53,194,102,92,2,31,1,1,allow
55221,443,37010,443,12954,2333,10621,20,120,9,11,allow
62624,443,17860,443,6990,2057,4933,19,121,9,10,allow
59976,80,48173,80,890,469,421,10,360,5,5,allow
37965,35771,32766,35771,481,150,331,2,1199,1,1,allow
54538,443,10842,443,2936,1546,1390,17,70,10,7,allow
63952,50734,54501,50734,66,66,0,2,8,2,0,allow
51963,21638,43079,21638,70,70,0,1,5,1,0,allow
58804,443,5956,443,5167,700,4467,16,15,7,9,allow
60934,80,21512,80,1212,774,438,11,81,7,4,allow
56281,53,38618,53,177,94,83,2,31,1,1,allow
56388,443,34459,443,70,70,0,1,5,1,0,allow
59928,53,64195,53,168,78,90,2,30,1,1,allow
58744,53,27095,53,368,86,282,2,30,1,1,allow
50140,53,14261,53,177,94,83,2,30,1,1,allow
56578,53,41828,53,219,86,133,2,31,1,1,allow
56717,443,27833,443,8006,1986,6020,20,15,11,9,allow
55028,443,57444,443,7196,2834,4362,28,17,16,12,allow
50735,443,6692,443,22676,8150,14526,33,16,17,16,allow
64113,53,33491,53,294,134,160,2,30,1,1,allow
56056,53,19190,53,184,86,98,2,30,1,1,allow
60442,53,50367,53,184,78,106,2,30,1,1,allow
65133,445,0,0,70,70,0,1,0,1,0,drop
65125,445,0,0,70,70,0,1,0,1,0,drop
46837,57470,0,0,62,62,0,1,0,1,0,deny
60315,445,0,0,70,70,0,1,0,1,0,drop
60313,445,0,0,70,70,0,1,0,1,0,drop
60311,445,0,0,70,70,0,1,0,1,0,drop
50321,23684,0,0,143,143,0,1,0,1,0,deny
50772,35440,0,0,66,66,0,1,0,1,0,deny
62079,30188,0,0,66,66,0,1,0,1,0,deny
58829,64147,0,0,66,66,0,1,0,1,0,deny
11907,57470,0,0,66,66,0,1,0,1,0,deny
58276,43890,0,0,66,66,0,1,0,1,0,deny
65118,445,0,0,70,70,0,1,0,1,0,drop
34417,50265,0,0,145,145,0,1,0,1,0,deny
65112,445,0,0,70,70,0,1,0,1,0,drop
65114,445,0,0,70,70,0,1,0,1,0,drop
33003,28543,0,0,62,62,0,1,0,1,0,deny
60304,445,0,0,70,70,0,1,0,1,0,drop
60537,445,0,0,66,66,0,1,0,1,0,drop
20280,30188,0,0,146,146,0,1,0,1,0,deny
60311,56205,0,0,66,66,0,1,0,1,0,deny
60302,445,0,0,70,70,0,1,0,1,0,drop
17786,44847,0,0,62,62,0,1,0,1,0,deny
49522,21247,0,0,62,62,0,1,0,1,0,deny
60301,445,0,0,70,70,0,1,0,1,0,drop
60300,445,0,0,70,70,0,1,0,1,0,drop
60299,445,0,0,70,70,0,1,0,1,0,drop
60297,445,0,0,70,70,0,1,0,1,0,drop
60295,445,0,0,70,70,0,1,0,1,0,drop
57011,49813,0,0,66,66,0,1,0,1,0,deny
65111,445,0,0,70,70,0,1,0,1,0,drop
65110,445,0,0,70,70,0,1,0,1,0,drop
65398,7129,0,0,62,62,0,1,0,1,0,deny
54464,56205,0,0,66,66,0,1,0,1,0,deny
60281,445,0,0,70,70,0,1,0,1,0,drop
60280,445,0,0,70,70,0,1,0,1,0,drop
53856,443,18832,443,495,421,74,4,0,3,1,allow
60521,445,0,0,66,66,0,1,0,1,0,drop
60520,445,0,0,66,66,0,1,0,1,0,drop
60278,445,0,0,70,70,0,1,0,1,0,drop
60271,445,0,0,70,70,0,1,0,1,0,drop
60270,445,0,0,70,70,0,1,0,1,0,drop
10445,46824,0,0,62,62,0,1,0,1,0,deny
59413,51505,0,0,62,62,0,1,0,1,0,deny
18252,18242,0,0,62,62,0,1,0,1,0,reset-both
60557,23117,0,0,62,62,0,1,0,1,0,deny
58195,38303,0,0,66,66,0,1,0,1,0,deny
65099,445,0,0,70,70,0,1,0,1,0,drop
38741,37965,0,0,146,146,0,1,0,1,0,deny
59934,35440,0,0,66,66,0,1,0,1,0,deny
65095,445,0,0,70,70,0,1,0,1,0,drop
65091,445,0,0,70,70,0,1,0,1,0,drop
65092,445,0,0,70,70,0,1,0,1,0,drop
60516,445,0,0,66,66,0,1,0,1,0,drop
24127,56205,0,0,66,66,0,1,0,1,0,deny
55524,46232,0,0,66,66,0,1,0,1,0,deny
60259,445,0,0,70,70,0,1,0,1,0,drop
60508,445,0,0,66,66,0,1,0,1,0,drop
60509,445,0,0,66,66,0,1,0,1,0,drop
60504,445,0,0,66,66,0,1,0,1,0,drop
60506,445,0,0,66,66,0,1,0,1,0,drop
60502,445,0,0,66,66,0,1,0,1,0,drop
60498,445,0,0,66,66,0,1,0,1,0,drop
60500,445,0,0,66,66,0,1,0,1,0,drop
12986,64147,0,0,62,62,0,1,0,1,0,deny
65085,445,0,0,70,70,0,1,0,1,0,drop
14693,64147,0,0,66,66,0,1,0,1,0,deny
62153,35440,0,0,66,66,0,1,0,1,0,deny
65081,445,0,0,70,70,0,1,0,1,0,drop
65079,445,0,0,70,70,0,1,0,1,0,drop
65077,445,0,0,70,70,0,1,0,1,0,drop
59400,22114,0,0,66,66,0,1,0,1,0,deny
60255,445,0,0,70,70,0,1,0,1,0,drop
51453,64147,0,0,66,66,0,1,0,1,0,deny
48706,23393,0,0,60,60,0,1,0,1,0,deny
38664,37965,0,0,62,62,0,1,0,1,0,deny
59886,64147,0,0,72,72,0,1,0,1,0,deny
11136,19910,0,0,62,62,0,1,0,1,0,deny
1114,46824,0,0,62,62,0,1,0,1,0,deny
60243,445,0,0,70,70,0,1,0,1,0,drop
60244,445,0,0,70,70,0,1,0,1,0,drop
60246,445,0,0,70,70,0,1,0,1,0,drop
65075,445,0,0,70,70,0,1,0,1,0,drop
65073,445,0,0,70,70,0,1,0,1,0,drop
65072,445,0,0,70,70,0,1,0,1,0,drop
60241,445,0,0,70,70,0,1,0,1,0,drop
60493,445,0,0,66,66,0,1,0,1,0,drop
60238,445,0,0,70,70,0,1,0,1,0,drop
65068,445,0,0,70,70,0,1,0,1,0,drop
60489,445,0,0,66,66,0,1,0,1,0,drop
54389,28543,0,0,62,62,0,1,0,1,0,deny
0,0,0,0,320,320,0,5,0,5,0,allow
60486,445,0,0,66,66,0,1,0,1,0,drop
60487,445,0,0,66,66,0,1,0,1,0,drop
60485,445,0,0,66,66,0,1,0,1,0,drop
63331,51221,0,0,62,62,0,1,0,1,0,deny
65344,46824,0,0,62,62,0,1,0,1,0,deny
48513,44847,0,0,62,62,0,1,0,1,0,deny
60232,445,0,0,70,70,0,1,0,1,0,drop
65060,445,0,0,70,70,0,1,0,1,0,drop
63344,53,0,0,73,73,0,1,0,1,0,deny
30794,37965,0,0,62,62,0,1,0,1,0,deny
65058,445,0,0,70,70,0,1,0,1,0,drop
65059,445,0,0,70,70,0,1,0,1,0,drop
57365,38303,0,0,62,62,0,1,0,1,0,deny
26085,8305,0,0,148,148,0,1,0,1,0,deny
64697,37965,0,0,66,66,0,1,0,1,0,deny
60474,445,0,0,66,66,0,1,0,1,0,drop
60223,445,0,0,70,70,0,1,0,1,0,drop
59679,37807,0,0,66,66,0,1,0,1,0,deny
3608,25773,0,0,146,146,0,1,0,1,0,reset-both
3375,35253,0,0,66,66,0,1,0,1,0,deny
19875,30170,0,0,145,145,0,1,0,1,0,deny
60219,445,0,0,70,70,0,1,0,1,0,drop
52390,2323,0,0,60,60,0,1,0,1,0,deny
11821,64147,0,0,62,62,0,1,0,1,0,deny
60466,445,0,0,66,66,0,1,0,1,0,drop
58836,44847,0,0,74,74,0,1,0,1,0,deny
60217,445,0,0,70,70,0,1,0,1,0,drop
65041,445,0,0,70,70,0,1,0,1,0,drop
64677,57470,0,0,66,66,0,1,0,1,0,deny
23553,37965,0,0,62,62,0,1,0,1,0,deny
60463,445,0,0,66,66,0,1,0,1,0,drop
61461,50584,0,0,66,66,0,1,0,1,0,deny
13413,44847,0,0,62,62,0,1,0,1,0,deny
49604,53,29103,53,89,89,0,1,30,1,0,allow
54202,53,3615,53,578,286,292,9,16,5,4,allow
40801,443,33203,443,3289,1265,2024,13,32,7,6,allow
51965,48708,36849,48708,66,66,0,1,5,1,0,allow
44799,443,2515,443,3467,2186,1281,16,15,9,7,allow
49322,443,25281,443,3005,2082,923,18,28,9,9,allow
38469,80,38469,80,555104,4582,550522,446,20,60,386,allow
57987,3478,61463,3478,60483,25857,34626,136,47,63,73,allow
55877,14966,41407,14966,480,149,331,2,1200,1,1,allow
33856,443,15583,443,7298,2661,4637,21,21,11,10,allow
53145,44634,36222,44634,70,70,0,1,5,1,0,allow
5588,5588,0,0,3354,1792,1562,46,193,23,23,allow
58800,443,5645,443,3874,2470,1404,17,15,9,8,allow
44794,443,36304,443,11158,3338,7820,27,16,16,11,allow
49307,443,35042,443,245382,6838,238544,214,31,44,170,allow
65514,53,50854,53,170,87,83,2,30,1,1,allow
57470,43611,57055,43611,3960,3960,0,61,3411,61,0,allow
64540,53,58172,53,174,89,85,2,30,1,1,allow
23683,53,23683,53,338,225,113,3,30,2,1,allow
51932,443,23132,443,3207,2430,777,21,26,11,10,allow
26805,443,51812,443,7343,2586,4757,23,20,11,12,allow
44798,443,42874,443,3239,2220,1019,16,15,9,7,allow
35440,443,40080,443,7419,2136,5283,23,255,11,12,allow
55913,53,58939,53,170,87,83,2,31,1,1,allow
49914,53,39261,53,815,95,720,2,30,1,1,allow
53370,443,49689,443,6877,1694,5183,24,306,13,11,allow
58792,443,15545,443,9278,6126,3152,27,16,15,12,allow
55230,443,41463,443,39555,12054,27501,78,66,41,37,allow
63931,16528,26745,16528,376,254,122,6,17,4,2,allow
58888,15000,44683,15000,138,78,60,2,5,1,1,allow
58048,80,12048,80,5171,3018,2153,16,30,8,8,allow
53701,8999,10439,8999,1328,960,368,10,32,5,5,allow
55249,53,63785,53,711,87,624,2,30,1,1,allow
55034,443,55034,443,154907,10748,144159,217,20,101,116,allow
36714,80,19257,80,1792,703,1089,12,16,7,5,allow
59040,24184,0,0,62,62,0,1,60,1,0,allow
56020,53,53467,53,198,101,97,2,31,1,1,allow
54539,443,59530,443,4867,1208,3659,16,23,10,6,allow
55336,443,52055,443,209596,37190,172406,378,79,184,194,allow
53264,443,22628,443,7424,1825,5599,25,18,13,12,allow
51994,25509,30907,25509,70,70,0,2,8,2,0,allow
49321,443,15064,443,3005,2082,923,18,28,9,9,allow
49044,443,55687,443,5150,853,4297,16,27,9,7,allow
51387,443,34318,443,5795,3322,2473,22,93,13,9,allow
39629,53,0,0,82,82,0,1,30,1,0,allow
6882,16276,42707,16276,150,150,0,1,1200,1,0,allow
58789,443,17140,443,14261,9361,4900,35,16,19,16,allow
40802,443,39888,443,3321,1297,2024,13,32,7,6,allow
55504,53,5700,53,711,87,624,2,30,1,1,allow
57275,53,65357,53,170,87,83,2,31,1,1,allow
62873,443,13983,443,3049,988,2061,14,135,7,7,allow
63593,443,12181,443,36819,3967,32852,59,152,30,29,allow
50362,53,31941,53,181,98,83,2,31,1,1,allow
64915,53,25917,53,98,98,0,1,31,1,0,allow
51494,443,60286,443,8140,5384,2756,15,122,8,7,allow
30960,45744,39744,45744,330,330,0,6,3609,6,0,allow
60213,445,0,0,70,70,0,1,0,1,0,drop
46839,51050,0,0,62,62,0,1,0,1,0,deny
26835,47993,0,0,62,62,0,1,0,1,0,deny
65379,22114,0,0,66,66,0,1,0,1,0,deny
60212,445,0,0,70,70,0,1,0,1,0,drop
60455,445,0,0,66,66,0,1,0,1,0,drop
60446,445,0,0,66,66,0,1,0,1,0,drop
22784,9571,0,0,62,62,0,1,0,1,0,deny
33651,36237,0,0,62,62,0,1,0,1,0,deny
26330,26348,0,0,62,62,0,1,0,1,0,deny
58745,30188,0,0,66,66,0,1,0,1,0,deny
52828,51221,0,0,66,66,0,1,0,1,0,deny
57275,53,56267,53,177,94,83,2,30,1,1,allow
65495,443,43238,443,418463,12360,406103,430,16,151,279,allow
49604,53,12616,53,179,94,85,2,30,1,1,allow
56161,53,11132,53,199,94,105,2,30,1,1,allow
60472,443,5896,443,3779,2809,970,23,47,12,11,allow
35743,443,39300,443,560,280,280,9,28,5,4,allow
9197,80,56702,80,1701,883,818,14,26,7,7,allow
52643,6881,27552,6881,719,413,306,10,14,5,5,allow
49840,53,47224,53,463,87,376,4,38,2,2,allow
65061,53,50134,53,297,101,196,4,33,2,2,allow
49339,443,31744,443,208,70,138,4,25,2,2,allow
49604,53,14213,53,86,86,0,1,29,1,0,allow
56876,53,26048,53,283,110,173,2,29,1,1,allow
35628,443,46062,443,8414,4131,4283,36,64,16,20,allow
54148,443,30287,443,272587,11910,260677,336,76,140,196,allow
54151,443,32501,443,1749,966,783,13,75,8,5,allow
35617,443,43217,443,2981,1719,1262,17,79,10,7,allow
56716,443,64304,443,8058,2038,6020,20,15,11,9,allow
36834,443,25361,443,7251,5852,1399,34,75,18,16,allow
48992,443,21581,443,5952,1328,4624,19,76,11,8,allow
57435,443,34425,443,13536,5529,8007,55,18,24,31,allow
42587,443,6188,443,7733,1203,6530,21,15,12,9,allow
55425,5222,24173,5222,9151,4417,4734,84,77,44,40,allow
51996,41888,55881,41888,70,70,0,2,7,2,0,allow
43628,53,19035,53,168,78,90,2,29,1,1,allow
65514,53,17473,53,177,94,83,2,29,1,1,allow
25237,53,25237,53,216,82,134,2,33,1,1,allow
65153,53,31638,53,184,86,98,2,29,1,1,allow
65492,53,51377,53,707,94,613,2,29,1,1,allow
65014,53,11511,53,718,94,624,2,29,1,1,allow
49198,53,16713,53,261,94,167,2,29,1,1,allow
64145,53,4283,53,177,94,83,2,31,1,1,allow
55021,53,44725,53,179,94,85,2,30,1,1,allow
49646,53,41795,53,209,102,107,2,30,1,1,allow
28237,443,25955,443,7876,1540,6336,21,124,10,11,allow
56352,53,18136,53,177,94,83,2,30,1,1,allow
55021,53,50748,53,179,94,85,2,30,1,1,allow
59636,443,44710,443,3197,1047,2150,15,120,8,7,allow
58249,443,38085,443,4192,2267,1925,12,120,6,6,allow
55330,53,64550,53,194,102,92,2,31,1,1,allow
64540,53,24153,53,179,94,85,2,30,1,1,allow
60036,53,52040,53,86,86,0,1,30,1,0,allow
64768,53,30874,53,78,78,0,1,30,1,0,allow
60903,443,18682,443,333062,18123,314939,420,88,182,238,allow
64714,53,29165,53,168,86,82,2,32,1,1,allow
51170,443,40281,443,9894856,232425,9662431,9829,90,3300,6529,allow
52588,443,7205,443,3523,518,3005,12,15,6,6,allow
48282,8080,0,0,184,78,106,3,9,2,1,allow
50233,80,29881,80,2388,1066,1322,16,135,8,8,allow
28236,443,42527,443,9686,2335,7351,28,124,13,15,allow
58803,443,12977,443,5166,700,4466,16,15,7,9,allow
55671,17758,7518,17758,422,140,282,6,15,3,3,allow
36668,443,55888,443,142299,120615,21684,348,336,180,168,allow
54336,443,1774,443,172701,6397,166304,202,246,72,130,allow
9206,443,23255,443,5043,432,4611,12,15,6,6,allow
65124,53,4615,53,353,118,235,2,30,1,1,allow
32927,443,11670,443,5746,1079,4667,17,27,10,7,allow
64889,53,50666,53,215,102,113,2,30,1,1,allow
55872,53,55616,53,177,94,83,2,30,1,1,allow
58798,443,46435,443,5167,700,4467,16,15,7,9,allow
56352,53,39464,53,177,94,83,2,30,1,1,allow
55343,53,44963,53,366,94,272,2,30,1,1,allow
54924,443,20791,443,53816,22991,30825,139,306,71,68,allow
55021,53,26465,53,94,94,0,1,30,1,0,allow
46261,80,62301,80,3578,1673,1905,16,186,9,7,allow
46597,53,0,0,86,86,0,1,30,1,0,allow
55913,53,60589,53,177,94,83,2,30,1,1,allow
47765,443,53985,443,8035,2176,5859,25,331,12,13,allow
60971,443,2878,443,2732,1359,1373,29,193,16,13,allow
33136,443,16239,443,6648,1556,5092,23,29,13,10,allow
37906,443,31579,443,416,210,206,7,26,4,3,allow
57149,53,29225,53,612,114,498,4,52,2,2,allow
65158,53,9153,53,728,102,626,2,30,1,1,allow
52847,53,50629,53,86,86,0,1,30,1,0,allow
64145,53,46343,53,177,94,83,2,30,1,1,allow
64475,53,57543,53,314,99,215,4,39,2,2,allow
59925,80,15613,80,2287,1534,753,11,16,6,5,allow
64108,53,41542,53,296,126,170,2,30,1,1,allow
55667,53,30119,53,305,126,179,2,30,1,1,allow
48817,51413,48817,51413,460,150,310,2,1200,1,1,allow
35967,443,11420,443,3870,1743,2127,13,120,6,7,allow
54535,443,39884,443,9859,3252,6607,24,74,12,12,allow
55033,443,56054,443,13944,2069,11875,28,30,15,13,allow
54150,443,60800,443,230997,10675,220322,291,75,122,169,allow
64694,53,58763,53,361,107,254,4,37,2,2,allow
54534,443,41952,443,7153,2581,4572,28,74,15,13,allow
64956,53,28840,53,322,84,238,4,36,2,2,allow
51995,50031,39289,50031,70,70,0,2,8,2,0,allow
51964,1103,26830,1103,70,70,0,1,4,1,0,allow
51961,40373,22472,40373,70,70,0,1,5,1,0,allow
38693,443,10334,443,90177,3481,86696,96,15,31,65,allow
49777,53,2324,53,485,79,406,4,31,2,2,allow
37965,33149,27231,33149,3957,2324,1633,51,1732,29,22,allow
58802,443,8176,443,5167,700,4467,16,15,7,9,allow
30188,55886,45541,55886,502,150,352,2,1200,1,1,allow
56715,443,60472,443,8005,1985,6020,20,15,11,9,allow
50140,53,8390,53,177,94,83,2,30,1,1,allow
49512,443,49512,443,217225,47956,169269,284,64,149,135,allow
65496,443,16540,443,92799,4939,87860,111,16,45,66,allow
28235,443,3343,443,8830,2388,6442,29,124,14,15,allow
49383,53,63729,53,226,110,116,2,30,1,1,allow
55872,53,18177,53,177,94,83,2,30,1,1,allow
30651,53,22880,53,86,86,0,1,30,1,0,allow
27988,40040,49340,40040,148,86,62,2,30,1,1,allow
55913,53,2700,53,177,94,83,2,30,1,1,allow
50495,53,47068,53,195,102,93,2,30,1,1,allow
36567,53,0,0,86,86,0,1,30,1,0,allow
57275,53,32208,53,177,94,83,2,31,1,1,allow
55565,443,12183,443,21087,4784,16303,25,146,7,18,allow
44780,80,17326,80,120,120,0,3,122,3,0,allow
44847,23628,55980,23628,509,150,359,2,1200,1,1,allow
61806,443,30997,443,7439,1156,6283,19,75,11,8,allow
51960,58601,34616,58601,70,70,0,1,5,1,0,allow
64540,53,45439,53,179,94,85,2,30,1,1,allow
49519,53,62256,53,264,94,170,2,30,1,1,allow
50495,53,56662,53,195,102,93,2,30,1,1,allow
49369,53,17790,53,246,94,152,2,30,1,1,allow
57990,443,7309,443,3182,1568,1614,8,120,4,4,allow
62759,443,5744,443,9928,5183,4745,34,134,17,17,allow
46258,80,9234,80,3711,1806,1905,17,186,10,7,allow
10103,443,54343,443,6334,910,5424,20,360,10,10,allow
46410,443,3591,443,4568,2057,2511,17,62,9,8,allow
62338,443,61578,443,13396186,148566,13247620,10474,59,1498,8976,allow
38663,443,44632,443,16002,4305,11697,60,138,29,31,allow
60904,443,17681,443,2356,1309,1047,16,31,9,7,allow
49285,53,46992,53,94,94,0,1,30,1,0,allow
55563,53,39714,53,194,102,92,2,30,1,1,allow
46260,80,59881,80,3459,1620,1839,16,186,10,6,allow
46259,80,22858,80,3574,1669,1905,17,186,10,7,allow
57985,443,21475,443,140109,5229,134880,159,46,59,100,allow
44220,443,37375,443,2709,1698,1011,20,1143,11,9,allow
53143,24796,50959,24796,698,320,378,10,16,6,4,allow
59859,443,33487,443,10266,7336,2930,49,222,24,25,allow
56434,80,3931,80,17128,1499,15629,24,25,9,15,allow
56714,443,39694,443,8057,2037,6020,20,15,11,9,allow
57736,443,25293,443,3345,823,2522,12,120,6,6,allow
50584,2775,5247,2775,150,150,0,1,1200,1,0,allow
55686,443,35273,443,319563,13365,306198,344,123,119,225,allow
10102,443,2452,443,5415,864,4551,19,360,9,10,allow
50365,443,19679,443,712,374,338,11,28,6,5,allow
53758,63975,2179,63975,2016,1076,940,14,17,8,6,allow
56580,443,55118,443,2343,1296,1047,17,196,10,7,allow
56410,443,52137,443,16167,1392,14775,25,105,12,13,allow
47211,80,37416,80,1638,1324,314,10,16,5,5,allow
56639,53,13077,53,168,86,82,2,31,1,1,allow
63937,43443,65141,43443,160,70,90,2,5,1,1,allow
56409,443,57180,443,25302,1733,23569,35,121,16,19,allow
57275,53,14863,53,177,94,83,2,30,1,1,allow
61016,443,27858,443,56191,3435,52756,81,271,37,44,allow
42283,443,51990,443,16831,14003,2828,31,63,18,13,allow
64204,53,12423,53,211,102,109,2,30,1,1,allow
59950,53,40733,53,168,78,90,2,31,1,1,allow
57470,19853,37734,19853,132,132,0,3,1200,3,0,allow
57455,443,26313,443,9124,5296,3828,54,120,29,25,allow
33633,443,34965,443,5698,1585,4113,23,1108,13,10,allow
55589,53,12456,53,177,94,83,2,30,1,1,allow
59998,53,31845,53,481,110,371,2,31,1,1,allow
60207,445,0,0,70,70,0,1,0,1,0,drop
43323,1,0,0,62,62,0,1,0,1,0,deny
10026,50584,0,0,146,146,0,1,0,1,0,deny
59876,44847,0,0,62,62,0,1,0,1,0,deny
65029,445,0,0,70,70,0,1,0,1,0,drop
65030,445,0,0,70,70,0,1,0,1,0,drop
65028,445,0,0,70,70,0,1,0,1,0,drop
60435,445,0,0,66,66,0,1,0,1,0,drop
60436,445,0,0,66,66,0,1,0,1,0,drop
60438,445,0,0,66,66,0,1,0,1,0,drop
60432,445,0,0,66,66,0,1,0,1,0,drop
60437,445,0,0,66,66,0,1,0,1,0,drop
60439,445,0,0,66,66,0,1,0,1,0,drop
60433,445,0,0,66,66,0,1,0,1,0,drop
60440,445,0,0,66,66,0,1,0,1,0,drop
64104,22114,0,0,62,62,0,1,0,1,0,deny
54737,50584,0,0,66,66,0,1,0,1,0,deny
61550,5529,0,0,145,145,0,1,0,1,0,deny
3170,53567,0,0,66,66,0,1,0,1,0,deny
59483,23,0,0,60,60,0,1,0,1,0,deny
51743,64147,0,0,62,62,0,1,0,1,0,deny
25901,50265,0,0,62,62,0,1,0,1,0,deny
25054,36827,0,0,66,66,0,1,0,1,0,deny
36369,51505,0,0,66,66,0,1,0,1,0,deny
51148,9571,0,0,66,66,0,1,0,1,0,deny
60194,445,0,0,70,70,0,1,0,1,0,drop
53500,1,0,0,66,66,0,1,0,1,0,deny
26301,22114,0,0,62,62,0,1,0,1,0,deny
65027,445,0,0,70,70,0,1,0,1,0,drop
65026,445,0,0,70,70,0,1,0,1,0,drop
65024,445,0,0,70,70,0,1,0,1,0,drop
65012,445,0,0,70,70,0,1,0,1,0,drop
9227,9000,0,0,60,60,0,1,0,1,0,deny
60191,445,0,0,70,70,0,1,0,1,0,drop
50052,65008,0,0,60,60,0,1,0,1,0,deny
60419,445,0,0,66,66,0,1,0,1,0,drop
60417,445,0,0,66,66,0,1,0,1,0,drop
60416,445,0,0,66,66,0,1,0,1,0,drop
39681,37965,0,0,62,62,0,1,0,1,0,deny
64543,50265,0,0,66,66,0,1,0,1,0,deny
13938,64147,0,0,145,145,0,1,0,1,0,deny
31235,22114,0,0,146,146,0,1,0,1,0,deny
65008,445,0,0,70,70,0,1,0,1,0,drop
60186,445,0,0,70,70,0,1,0,1,0,drop
60185,445,0,0,70,70,0,1,0,1,0,drop
65000,445,0,0,70,70,0,1,0,1,0,drop
65002,445,0,0,70,70,0,1,0,1,0,drop
60183,445,0,0,70,70,0,1,0,1,0,drop
2531,30188,0,0,66,66,0,1,0,1,0,deny
12709,51505,0,0,62,62,0,1,0,1,0,deny
45964,3111,0,0,60,60,0,1,0,1,0,deny
7246,59858,0,0,66,66,0,1,0,1,0,deny
45908,3383,0,0,60,60,0,1,0,1,0,deny
63397,26467,0,0,66,66,0,1,0,1,0,deny
63041,50584,0,0,62,62,0,1,0,1,0,deny
40571,26467,0,0,62,62,0,1,0,1,0,deny
17643,50584,0,0,62,62,0,1,0,1,0,deny
27908,23,0,0,60,60,0,1,0,1,0,deny
60176,445,0,0,70,70,0,1,0,1,0,drop
64986,445,0,0,70,70,0,1,0,1,0,drop
64987,445,0,0,70,70,0,1,0,1,0,drop
64988,445,0,0,70,70,0,1,0,1,0,drop
61537,57866,0,0,66,66,0,1,0,1,0,deny
60174,445,0,0,70,70,0,1,0,1,0,drop
32520,47993,0,0,62,62,0,1,0,1,0,deny
60406,445,0,0,66,66,0,1,0,1,0,drop
65081,26467,0,0,66,66,0,1,0,1,0,deny
12663,62413,0,0,66,66,0,1,0,1,0,deny
60173,445,0,0,70,70,0,1,0,1,0,drop
27828,56205,0,0,146,146,0,1,0,1,0,deny
60172,445,0,0,70,70,0,1,0,1,0,drop
60171,445,0,0,70,70,0,1,0,1,0,drop
60169,445,0,0,70,70,0,1,0,1,0,drop
60167,445,0,0,70,70,0,1,0,1,0,drop
14343,6881,0,0,62,62,0,1,0,1,0,deny
3792,52700,0,0,62,62,0,1,0,1,0,deny
64982,445,0,0,70,70,0,1,0,1,0,drop
64975,445,0,0,70,70,0,1,0,1,0,drop
57034,44847,0,0,62,62,0,1,0,1,0,deny
60786,51505,0,0,62,62,0,1,0,1,0,deny
60153,445,0,0,70,70,0,1,0,1,0,drop
60151,445,0,0,70,70,0,1,0,1,0,drop
60150,445,0,0,70,70,0,1,0,1,0,drop
59365,42873,0,0,74,74,0,1,0,1,0,deny
22975,23,0,0,60,60,0,1,0,1,0,deny
60142,445,0,0,70,70,0,1,0,1,0,drop
60143,445,0,0,70,70,0,1,0,1,0,drop
24809,52700,0,0,66,66,0,1,0,1,0,deny
60388,445,0,0,66,66,0,1,0,1,0,drop
60387,445,0,0,66,66,0,1,0,1,0,drop
61430,37965,0,0,66,66,0,1,0,1,0,deny
45908,33330,0,0,60,60,0,1,0,1,0,deny
41744,37965,0,0,62,62,0,1,0,1,0,deny
62973,51505,0,0,62,62,0,1,0,1,0,deny
64969,445,0,0,70,70,0,1,0,1,0,drop
64967,445,0,0,70,70,0,1,0,1,0,drop
64965,445,0,0,70,70,0,1,0,1,0,drop
64964,445,0,0,70,70,0,1,0,1,0,drop
59043,35440,0,0,66,66,0,1,0,1,0,deny
13090,36237,0,0,62,62,0,1,0,1,0,deny
53143,50584,0,0,66,66,0,1,0,1,0,deny
11878,37807,0,0,146,146,0,1,0,1,0,deny
62824,37807,0,0,66,66,0,1,0,1,0,deny
14696,42707,0,0,62,62,0,1,0,1,0,deny
51830,42707,0,0,66,66,0,1,0,1,0,deny
60383,445,0,0,66,66,0,1,0,1,0,drop
60131,445,0,0,70,70,0,1,0,1,0,drop
50,64147,0,0,66,66,0,1,0,1,0,deny
60371,445,0,0,66,66,0,1,0,1,0,drop
60370,445,0,0,66,66,0,1,0,1,0,drop
60380,445,0,0,66,66,0,1,0,1,0,drop
60375,445,0,0,66,66,0,1,0,1,0,drop
60369,445,0,0,66,66,0,1,0,1,0,drop
60373,445,0,0,66,66,0,1,0,1,0,drop
60372,445,0,0,66,66,0,1,0,1,0,drop
58858,15503,0,0,66,66,0,1,0,1,0,deny
33405,37965,0,0,62,62,0,1,0,1,0,deny
53871,37965,0,0,66,66,0,1,0,1,0,deny
59210,50584,0,0,66,66,0,1,0,1,0,deny
64957,445,0,0,70,70,0,1,0,1,0,drop
59842,62413,0,0,66,66,0,1,0,1,0,deny
64953,445,0,0,70,70,0,1,0,1,0,drop
64952,445,0,0,70,70,0,1,0,1,0,drop
64949,445,0,0,70,70,0,1,0,1,0,drop
56582,23718,0,0,66,66,0,1,0,1,0,deny
50799,37807,0,0,66,66,0,1,0,1,0,deny
0,0,0,0,98,98,0,1,0,1,0,deny
0,0,0,0,98,98,0,1,0,1,0,deny
0,0,0,0,98,98,0,1,0,1,0,deny
0,0,0,0,98,98,0,1,0,1,0,deny
0,0,0,0,98,98,0,1,0,1,0,deny
0,0,0,0,98,98,0,1,0,1,0,deny
0,0,0,0,98,98,0,1,0,1,0,deny
0,0,0,0,244,244,0,2,0,2,0,allow
0,0,0,0,98,98,0,1,0,1,0,deny
0,0,0,0,156,156,0,2,0,2,0,allow
50135,50584,0,0,62,62,0,1,0,1,0,deny
8403,46824,0,0,62,62,0,1,0,1,0,deny
60127,445,0,0,70,70,0,1,0,1,0,drop
55862,62413,0,0,66,66,0,1,0,1,0,deny
11562,30188,0,0,62,62,0,1,0,1,0,deny
6289,44847,0,0,66,66,0,1,0,1,0,deny
60118,445,0,0,70,70,0,1,0,1,0,drop
60117,445,0,0,70,70,0,1,0,1,0,drop
60116,445,0,0,70,70,0,1,0,1,0,drop
60114,445,0,0,70,70,0,1,0,1,0,drop
56191,22114,0,0,62,62,0,1,0,1,0,deny
60110,445,0,0,70,70,0,1,0,1,0,drop
38306,51221,0,0,62,62,0,1,0,1,0,deny
64948,445,0,0,70,70,0,1,0,1,0,drop
64947,445,0,0,70,70,0,1,0,1,0,drop
64944,445,0,0,70,70,0,1,0,1,0,drop
58972,57866,0,0,62,62,0,1,0,1,0,deny
64368,22114,0,0,66,66,0,1,0,1,0,deny
60364,445,0,0,66,66,0,1,0,1,0,drop
64940,445,0,0,70,70,0,1,0,1,0,drop
60360,445,0,0,66,66,0,1,0,1,0,drop
24271,52700,0,0,66,66,0,1,0,1,0,deny
14183,26467,0,0,62,62,0,1,0,1,0,deny
60357,445,0,0,66,66,0,1,0,1,0,drop
60356,445,0,0,66,66,0,1,0,1,0,drop
1114,46824,0,0,62,62,0,1,0,1,0,deny
60355,445,0,0,66,66,0,1,0,1,0,drop
43578,15503,0,0,74,74,0,1,0,1,0,deny
46149,23,0,0,60,60,0,1,0,1,0,deny
17781,50265,0,0,62,62,0,1,0,1,0,deny
60105,445,0,0,70,70,0,1,0,1,0,drop
50424,55777,0,0,62,62,0,1,0,1,0,deny
64932,445,0,0,70,70,0,1,0,1,0,drop
14567,37965,0,0,62,62,0,1,0,1,0,deny
64927,445,0,0,70,70,0,1,0,1,0,drop
64926,445,0,0,70,70,0,1,0,1,0,drop
1873,37965,0,0,62,62,0,1,0,1,0,deny
64535,37965,0,0,66,66,0,1,0,1,0,deny
60097,445,0,0,70,70,0,1,0,1,0,drop
60094,445,0,0,70,70,0,1,0,1,0,drop
30315,57470,0,0,145,145,0,1,0,1,0,deny
32282,8604,0,0,66,66,0,1,0,1,0,deny
54886,443,54886,443,136775,6729,130046,181,18,82,99,allow
47111,80,20951,80,162355,7124,155231,207,27,96,111,allow
51988,32239,6773,32239,70,70,0,2,8,2,0,allow
53144,58987,40200,58987,70,70,0,1,5,1,0,allow
51827,443,46992,443,11946,8904,3042,42,42,26,16,allow
56419,80,4193,80,34098,808,33290,34,104,9,25,allow
54849,22448,0,0,66,66,0,1,90,1,0,allow
33569,443,7892,443,7418,1880,5538,28,396,9,19,allow
54644,443,54644,443,103968,5475,98493,141,18,63,78,allow
58765,443,24675,443,26158,17265,8893,57,19,31,26,allow
55670,31056,27603,31056,70,70,0,1,5,1,0,allow
56420,80,57757,80,34636,928,33708,37,104,11,26,allow
56413,80,48301,80,31432,748,30684,32,104,8,24,allow
56412,80,47207,80,34476,818,33658,35,104,9,26,allow
55921,53,30522,53,711,87,624,2,30,1,1,allow
56733,53,13870,53,170,87,83,2,30,1,1,allow
54470,443,54470,443,101021,6173,94848,142,18,65,77,allow
51990,42127,13506,42127,70,70,0,2,8,2,0,allow
47279,443,50478,443,7948,1520,6428,21,16,13,8,allow
44795,443,55624,443,9608,1958,7650,21,15,11,10,allow
56423,80,12556,80,33937,628,33309,31,104,6,25,allow
58790,443,27687,443,3558,2453,1105,17,15,9,8,allow
52479,443,9730,443,11052,4417,6635,19,137,10,9,allow
56561,443,49349,443,26334,2210,24124,49,66,22,27,allow
56025,53,63426,53,761,100,661,2,30,1,1,allow
65449,53,25371,53,170,87,83,2,31,1,1,allow
56417,80,64869,80,38188,688,37500,35,104,7,28,allow
59920,443,3699,443,7359,2050,5309,18,16,10,8,allow
44792,443,44086,443,9700,2137,7563,21,16,12,9,allow
62413,6881,56796,6881,311,311,0,3,1200,3,0,allow
55230,443,46201,443,42376115,1180708,41195407,45399,148,13976,31423,allow
54952,443,11665,443,61842,4466,57376,109,293,46,63,allow
49570,443,15727,443,8058,1806,6252,22,15,12,10,allow
56427,443,19838,443,9901,1298,8603,19,79,10,9,allow
58785,443,24870,443,11873,7787,4086,32,16,17,15,allow
58786,443,62467,443,13240,8717,4523,33,16,17,16,allow
56418,80,22380,80,39249,938,38311,40,104,11,29,allow
51956,36995,10789,36995,66,66,0,1,5,1,0,allow
56414,80,4969,80,33712,928,32784,36,104,11,25,allow
50436,443,10408,443,18959,3307,15652,33,19,16,17,allow
37420,443,37420,443,4624,1717,2907,19,27,11,8,allow
53245,443,26528,443,7705,2005,5700,26,120,13,13,allow
39496,80,39496,80,2898,1485,1413,10,15,6,4,allow
64145,53,55779,53,170,87,83,2,30,1,1,allow
53114,443,28454,443,3796,1523,2273,20,135,10,10,allow
64742,443,6500,443,6372,1582,4790,32,195,15,17,allow
45913,443,64072,443,4046,967,3079,13,27,7,6,allow
56416,80,36682,80,33755,928,32827,36,104,11,25,allow
56421,80,51921,80,34300,868,33432,35,104,10,25,allow
56422,80,3635,80,35833,938,34895,37,104,11,26,allow
56411,80,44029,80,35574,868,34706,36,104,10,26,allow
56415,80,5751,80,38339,808,37531,37,104,9,28,allow
50734,80,62871,80,3498,2696,802,9,26,5,4,allow
55660,42459,61425,42459,1717,1129,588,17,25,10,7,allow
1319,443,12846,443,448,256,192,8,25,5,3,allow
56368,53,19422,53,817,98,719,2,30,1,1,allow
55548,53,25199,53,194,99,95,2,30,1,1,allow
65048,443,9174,443,3283,1019,2264,10,120,5,5,allow
40151,5228,21276,5228,19172,3089,16083,43,3601,20,23,allow
60342,445,0,0,66,66,0,1,0,1,0,drop
6666,80,0,0,60,60,0,1,0,1,0,deny
27368,22114,0,0,146,146,0,1,0,1,0,deny
40308,67,0,0,60,60,0,1,0,1,0,deny
19634,64147,0,0,62,62,0,1,0,1,0,deny
50949,45960,0,0,62,62,0,1,0,1,0,deny
16376,35440,0,0,146,146,0,1,0,1,0,deny
32704,46824,0,0,66,66,0,1,0,1,0,deny
57339,57470,0,0,66,66,0,1,0,1,0,deny
36453,23,0,0,60,60,0,1,0,1,0,deny
60091,445,0,0,70,70,0,1,0,1,0,drop
33886,39127,0,0,162,162,0,1,0,1,0,deny
60089,445,0,0,70,70,0,1,0,1,0,drop
60335,445,0,0,66,66,0,1,0,1,0,drop
64914,445,0,0,70,70,0,1,0,1,0,drop
6666,138,0,0,60,60,0,1,0,1,0,deny
12969,55777,0,0,66,66,0,1,0,1,0,deny
58359,64147,0,0,72,72,0,1,0,1,0,deny
65024,53,8030,53,295,101,194,4,33,2,2,allow
55678,52879,10322,52879,70,70,0,2,8,2,0,allow
57456,443,23040,443,1857,1218,639,18,119,11,7,allow
40182,443,51089,443,6865,1958,4907,21,16,13,8,allow
49262,80,49262,80,515211,10976,504235,506,49,169,337,allow
63938,26204,59342,26204,70,70,0,1,4,1,0,allow
46408,443,13228,443,15452,3787,11665,36,62,19,17,allow
53006,443,3727,443,2651,1504,1147,24,68,13,11,allow
56405,443,6737,443,12470,1570,10900,21,125,10,11,allow
56408,443,36804,443,17704,1456,16248,25,123,11,14,allow
56713,443,15450,443,8006,1986,6020,20,15,11,9,allow
60716,443,33650,443,6898,2843,4055,21,17,11,10,allow
58797,443,17991,443,5167,700,4467,16,15,7,9,allow
50299,443,56417,443,86,86,0,1,4,1,0,allow
63932,63241,5696,63241,436,254,182,7,15,4,3,allow
51959,42269,61621,42269,70,70,0,1,4,1,0,allow
51958,51322,1745,51322,70,70,0,1,4,1,0,allow
55589,53,33223,53,177,94,83,2,29,1,1,allow
33857,123,20930,123,184,94,90,2,30,1,1,allow
64634,53,6012,53,211,102,109,2,29,1,1,allow
51441,443,56551,443,642,582,60,2,15,1,1,allow
53142,47933,51357,47933,698,320,378,10,17,6,4,allow
57226,53,37479,53,178,94,84,2,30,1,1,allow
59823,443,6570,443,27406,15466,11940,123,188,62,61,allow
58788,443,39752,443,5166,700,4466,16,15,7,9,allow
37587,443,9282,443,6912,1841,5071,33,27,17,16,allow
58794,443,62373,443,5166,700,4466,16,15,7,9,allow
60713,443,57689,443,6287,1742,4545,17,19,10,7,allow
35001,53,37388,53,78,78,0,1,30,1,0,allow
56648,80,59981,80,234,234,0,4,12,4,0,allow
55677,16588,61905,16588,70,70,0,2,8,2,0,allow
51955,39871,39902,39871,70,70,0,1,5,1,0,allow
51952,50967,20758,50967,70,70,0,1,5,1,0,allow
52126,443,32440,443,12096,3734,8362,53,102,25,28,allow
37739,443,17741,443,138037,13843,124194,197,206,94,103,allow
64145,53,59140,53,177,94,83,2,30,1,1,allow
59049,53,37929,53,199,94,105,2,30,1,1,allow
61838,443,61838,443,36811,5190,31621,60,150,24,36,allow
56887,53,15011,53,312,94,218,2,30,1,1,allow
60184,443,52371,443,26293,7740,18553,55,121,26,29,allow
65449,53,31955,53,177,94,83,2,30,1,1,allow
33070,80,34842,80,3483,1578,1905,17,186,10,7,allow
56733,53,1965,53,177,94,83,2,30,1,1,allow
15503,19168,41378,19168,481,150,331,2,1200,1,1,allow
64161,53,62669,53,261,102,159,2,30,1,1,allow
52310,53,0,0,247,76,171,2,30,1,1,allow
49987,443,39263,443,426,180,246,8,21,4,4,allow
51985,38904,27850,38904,70,70,0,2,8,2,0,allow
51987,23136,59906,23136,70,70,0,2,8,2,0,allow
33830,443,43990,443,448,78,370,6,25,1,5,allow
52090,443,7071,443,6383,5237,1146,19,16,11,8,allow
58791,443,11218,443,5167,700,4467,16,15,7,9,allow
37736,443,40675,443,498507,26210,472297,544,207,200,344,allow
55545,53,1793,53,821,102,719,2,30,1,1,allow
56712,443,63256,443,8058,2038,6020,20,15,11,9,allow
39426,443,8694,443,903603,21528,882075,858,57,234,624,allow
34454,80,32778,80,1638,1324,314,10,14,5,5,allow
43693,443,24547,443,6389,1439,4950,22,18,11,11,allow
56406,443,10804,443,8328,1391,6937,18,123,10,8,allow
41850,443,17792,443,6714,1515,5199,23,196,13,10,allow
57887,443,20597,443,6938,1531,5407,23,195,13,10,allow
51715,80,53478,80,3309,2152,1157,18,150,10,8,allow
50617,80,45162,80,1658,1247,411,8,14,5,3,allow
51985,80,53937,80,14233438,253696,13979742,12752,54,3515,9237,allow
51998,1877,49263,1877,316,136,180,6,6,3,3,allow
63931,53,21564,53,380,105,275,4,35,2,2,allow
55548,53,43983,53,197,102,95,2,33,1,1,allow
49638,53,28303,53,331,88,243,4,32,2,2,allow
51992,22670,60663,22670,70,70,0,2,7,2,0,allow
53760,45682,20604,45682,70,70,0,1,4,1,0,allow
55545,53,34965,53,196,100,96,3,33,2,1,allow
58793,443,26304,443,5167,700,4467,16,15,7,9,allow
53762,9587,5160,9587,70,70,0,1,4,1,0,allow
37738,443,40273,443,296068,21814,274254,358,206,150,208,allow
64456,53,28818,53,341,110,231,2,29,1,1,allow
55913,53,19739,53,177,94,83,2,30,1,1,allow
65449,53,22193,53,177,94,83,2,30,1,1,allow
64509,53,38948,53,385,134,251,2,30,1,1,allow
56733,53,65238,53,177,94,83,2,30,1,1,allow
41126,53,30186,53,199,94,105,2,30,1,1,allow
64657,53,12172,53,312,94,218,2,30,1,1,allow
50362,53,19652,53,177,94,83,2,30,1,1,allow
33255,53,27087,53,86,86,0,1,30,1,0,allow
55796,53,34450,53,214,94,120,2,30,1,1,allow
56020,53,46192,53,199,102,97,2,30,1,1,allow
46026,443,9317,443,8908,3897,5011,19,135,9,10,allow
49342,53,61829,53,402,118,284,2,30,1,1,allow
33071,443,36886,443,4234,2185,2049,36,1099,16,20,allow
42604,443,37985,443,3243,2026,1217,16,15,8,8,allow
51993,55279,27826,55279,316,136,180,6,7,3,3,allow
51989,29736,40433,29736,258,70,188,4,8,2,2,allow
51954,12380,41427,12380,70,70,0,1,5,1,0,allow
39918,443,58004,443,7542,1235,6307,23,15,12,11,allow
57226,53,25603,53,178,94,84,2,30,1,1,allow
41267,8245,14045,8245,280,214,66,2,30,1,1,allow
49761,53,37619,53,382,94,288,2,30,1,1,allow
22539,53,19206,53,86,86,0,1,30,1,0,allow
49396,80,45610,80,13738839,196158,13542681,11272,248,2231,9041,allow
63928,61494,31292,61494,1691,446,1245,10,15,7,3,allow
65418,53,5528,53,197,94,103,2,30,1,1,allow
37757,53,12221,53,86,86,0,1,30,1,0,allow
38496,5228,27256,5228,3397,1506,1891,26,640,8,18,allow
33684,443,39270,443,6829,1261,5568,21,197,11,10,allow
51986,41982,47346,41982,70,70,0,2,8,2,0,allow
56711,443,47786,443,8005,1985,6020,20,15,11,9,allow
49321,53,65339,53,225,102,123,2,30,1,1,allow
37737,443,61948,443,190013,14784,175229,238,206,101,137,allow
55526,53,8264,53,250,86,164,2,30,1,1,allow
55815,443,3642,443,8602,1050,7552,16,120,7,9,allow
43275,443,50486,443,9093,4719,4374,52,310,24,28,allow
55207,443,50638,443,1803,1029,774,16,185,9,7,allow
54159,443,5303,443,10945,2478,8467,39,18,19,20,allow
65449,53,26123,53,315,87,228,4,40,2,2,allow
52635,443,48519,443,8993,5205,3788,48,167,25,23,allow
42601,443,52311,443,3238,2021,1217,16,16,8,8,allow
43288,443,20649,443,11123,2634,8489,22,121,10,12,allow
53756,61137,24650,61137,672,306,366,11,16,5,6,allow
55025,443,11622,443,7599,3113,4486,30,20,17,13,allow
53771,64351,44787,64351,70,70,0,2,8,2,0,allow
57069,53,3710,53,177,94,83,2,30,1,1,allow
57069,53,52685,53,177,94,83,2,31,1,1,allow
1903,43890,0,0,66,66,0,1,0,1,0,deny
53906,44512,0,0,62,62,0,1,0,1,0,deny
56462,37965,0,0,66,66,0,1,0,1,0,deny
60085,445,0,0,70,70,0,1,0,1,0,drop
8313,51505,0,0,62,62,0,1,0,1,0,deny
51346,51221,0,0,70,70,0,1,0,1,0,deny
60332,445,0,0,66,66,0,1,0,1,0,drop
56005,64147,0,0,62,62,0,1,0,1,0,deny
63079,64147,0,0,66,66,0,1,0,1,0,deny
60297,25604,0,0,62,62,0,1,0,1,0,deny
60083,445,0,0,70,70,0,1,0,1,0,drop
54305,39004,0,0,62,62,0,1,0,1,0,deny
55450,64147,0,0,66,66,0,1,0,1,0,deny
60324,445,0,0,66,66,0,1,0,1,0,drop
27402,37628,0,0,62,62,0,1,0,1,0,deny
60316,445,0,0,66,66,0,1,0,1,0,drop
37911,443,2261,443,466,392,74,4,0,3,1,allow
7664,2149,0,0,66,66,0,1,0,1,0,deny
60079,445,0,0,70,70,0,1,0,1,0,drop
48706,23393,0,0,60,60,0,1,0,1,0,deny
20012,444,0,0,60,60,0,1,0,1,0,deny
6666,6001,0,0,60,60,0,1,0,1,0,deny
24768,22114,0,0,146,146,0,1,0,1,0,deny
64903,445,0,0,70,70,0,1,0,1,0,drop
64901,445,0,0,70,70,0,1,0,1,0,drop
64900,445,0,0,70,70,0,1,0,1,0,drop
60310,445,0,0,66,66,0,1,0,1,0,drop
60308,445,0,0,66,66,0,1,0,1,0,drop
60304,445,0,0,66,66,0,1,0,1,0,drop
60306,445,0,0,66,66,0,1,0,1,0,drop
60309,445,0,0,66,66,0,1,0,1,0,drop
60307,445,0,0,66,66,0,1,0,1,0,drop
60303,445,0,0,66,66,0,1,0,1,0,drop
60302,445,0,0,66,66,0,1,0,1,0,drop
61078,57470,0,0,145,145,0,1,0,1,0,deny
60066,445,0,0,70,70,0,1,0,1,0,drop
28878,51505,0,0,62,62,0,1,0,1,0,deny
54276,37628,0,0,66,66,0,1,0,1,0,deny
40512,57470,0,0,74,74,0,1,0,1,0,deny
60063,445,0,0,70,70,0,1,0,1,0,drop
64891,445,0,0,70,70,0,1,0,1,0,drop
64890,445,0,0,70,70,0,1,0,1,0,drop
64886,445,0,0,70,70,0,1,0,1,0,drop
64883,445,0,0,70,70,0,1,0,1,0,drop
33098,443,16704,443,466,392,74,4,0,3,1,allow
28413,64147,0,0,62,62,0,1,0,1,0,deny
60288,445,0,0,66,66,0,1,0,1,0,drop
60290,445,0,0,66,66,0,1,0,1,0,drop
60287,445,0,0,66,66,0,1,0,1,0,drop
60058,445,0,0,70,70,0,1,0,1,0,drop
60057,445,0,0,70,70,0,1,0,1,0,drop
64880,445,0,0,70,70,0,1,0,1,0,drop
60055,445,0,0,70,70,0,1,0,1,0,drop
50245,44847,0,0,62,62,0,1,0,1,0,deny
64877,445,0,0,70,70,0,1,0,1,0,drop
64872,445,0,0,70,70,0,1,0,1,0,drop
64874,445,0,0,70,70,0,1,0,1,0,drop
64346,51505,0,0,66,66,0,1,0,1,0,deny
55111,39004,0,0,66,66,0,1,0,1,0,deny
57173,44847,0,0,62,62,0,1,0,1,0,deny
13840,37965,0,0,146,146,0,1,0,1,0,deny
41648,56205,0,0,66,66,0,1,0,1,0,deny
59618,46824,0,0,66,66,0,1,0,1,0,deny
1114,46824,0,0,62,62,0,1,0,1,0,deny
64626,50584,0,0,66,66,0,1,0,1,0,deny
443,28215,0,0,60,60,0,1,0,1,0,deny
24110,23,0,0,60,60,0,1,0,1,0,deny
60048,445,0,0,70,70,0,1,0,1,0,drop
60046,445,0,0,70,70,0,1,0,1,0,drop
64862,445,0,0,70,70,0,1,0,1,0,drop
64860,445,0,0,70,70,0,1,0,1,0,drop
64857,445,0,0,70,70,0,1,0,1,0,drop
20830,1433,0,0,60,60,0,1,0,1,0,deny
59365,42873,0,0,74,74,0,1,0,1,0,deny
29080,50265,0,0,62,62,0,1,0,1,0,deny
52094,22114,0,0,146,146,0,1,0,1,0,deny
60045,445,0,0,70,70,0,1,0,1,0,drop
60276,445,0,0,66,66,0,1,0,1,0,drop
60044,445,0,0,70,70,0,1,0,1,0,drop
58475,11392,0,0,66,66,0,1,0,1,0,deny
30580,50265,0,0,66,66,0,1,0,1,0,deny
60043,445,0,0,70,70,0,1,0,1,0,drop
60038,445,0,0,70,70,0,1,0,1,0,drop
60037,445,0,0,70,70,0,1,0,1,0,drop
45682,25604,0,0,62,62,0,1,0,1,0,deny
43063,57470,0,0,62,62,0,1,0,1,0,deny
47910,7454,0,0,60,60,0,1,0,1,0,deny
21750,39004,0,0,62,62,0,1,0,1,0,deny
3068,36237,0,0,62,62,0,1,0,1,0,deny
59763,25604,0,0,66,66,0,1,0,1,0,deny
56386,50584,0,0,66,66,0,1,0,1,0,deny
60025,445,0,0,70,70,0,1,0,1,0,drop
60024,445,0,0,70,70,0,1,0,1,0,drop
60018,445,0,0,70,70,0,1,0,1,0,drop
20864,51221,0,0,62,62,0,1,0,1,0,deny
64853,445,0,0,70,70,0,1,0,1,0,drop
64847,445,0,0,70,70,0,1,0,1,0,drop
58791,30188,0,0,146,146,0,1,0,1,0,deny
60015,445,0,0,70,70,0,1,0,1,0,drop
60014,445,0,0,70,70,0,1,0,1,0,drop
56035,1310,0,0,62,62,0,1,0,1,0,deny
58021,17,0,0,60,60,0,1,0,1,0,deny
60761,51221,0,0,66,66,0,1,0,1,0,deny
60263,445,0,0,66,66,0,1,0,1,0,drop
60260,445,0,0,66,66,0,1,0,1,0,drop
58687,11392,0,0,66,66,0,1,0,1,0,deny
30602,36237,0,0,146,146,0,1,0,1,0,deny
13285,29892,0,0,145,145,0,1,0,1,0,deny
0,0,0,0,185,185,0,1,0,1,0,deny
64844,445,0,0,70,70,0,1,0,1,0,drop
60003,445,0,0,70,70,0,1,0,1,0,drop
64839,445,0,0,70,70,0,1,0,1,0,drop
64838,445,0,0,70,70,0,1,0,1,0,drop
64837,445,0,0,70,70,0,1,0,1,0,drop
36679,443,65477,443,466,392,74,4,0,3,1,allow
1045,36237,0,0,66,66,0,1,0,1,0,deny
60257,445,0,0,66,66,0,1,0,1,0,drop
60249,445,0,0,66,66,0,1,0,1,0,drop
60251,445,0,0,66,66,0,1,0,1,0,drop
60240,445,0,0,66,66,0,1,0,1,0,drop
60245,445,0,0,66,66,0,1,0,1,0,drop
60246,445,0,0,66,66,0,1,0,1,0,drop
60241,445,0,0,66,66,0,1,0,1,0,drop
60239,445,0,0,66,66,0,1,0,1,0,drop
28370,23,0,0,60,60,0,1,0,1,0,deny
65166,62413,0,0,62,62,0,1,0,1,0,deny
80,63761,0,0,66,66,0,1,0,1,0,deny
64827,445,0,0,70,70,0,1,0,1,0,drop
63461,51505,0,0,66,66,0,1,0,1,0,deny
59999,445,0,0,70,70,0,1,0,1,0,drop
64825,445,0,0,70,70,0,1,0,1,0,drop
64823,445,0,0,70,70,0,1,0,1,0,drop
64821,445,0,0,70,70,0,1,0,1,0,drop
45238,44847,0,0,62,62,0,1,0,1,0,deny
16630,44847,0,0,62,62,0,1,0,1,0,deny
34400,39004,0,0,74,74,0,1,0,1,0,deny
16630,44847,0,0,146,146,0,1,0,1,0,deny
59989,445,0,0,70,70,0,1,0,1,0,drop
59987,445,0,0,70,70,0,1,0,1,0,drop
59990,445,0,0,70,70,0,1,0,1,0,drop
59985,445,0,0,70,70,0,1,0,1,0,drop
51731,57470,0,0,78,78,0,1,0,1,0,deny
443,10010,0,0,60,60,0,1,0,1,0,deny
1091,37965,0,0,62,62,0,1,0,1,0,deny
49276,51505,0,0,66,66,0,1,0,1,0,deny
59982,445,0,0,70,70,0,1,0,1,0,drop
56255,44847,0,0,66,66,0,1,0,1,0,deny
64819,445,0,0,70,70,0,1,0,1,0,drop
64818,445,0,0,70,70,0,1,0,1,0,drop
64817,445,0,0,70,70,0,1,0,1,0,drop
2636,11392,0,0,66,66,0,1,0,1,0,deny
60232,445,0,0,66,66,0,1,0,1,0,drop
57302,62413,0,0,66,66,0,1,0,1,0,deny
64812,445,0,0,70,70,0,1,0,1,0,drop
52348,62413,0,0,66,66,0,1,0,1,0,deny
60228,445,0,0,66,66,0,1,0,1,0,drop
60226,445,0,0,66,66,0,1,0,1,0,drop
42366,57470,0,0,66,66,0,1,0,1,0,deny
51148,443,4211,443,4942,2409,2533,11,120,6,5,allow
56450,53,26592,53,170,87,83,2,30,1,1,allow
58907,80,55384,80,694,350,344,11,28,6,5,allow
61129,443,47713,443,3854,1233,2621,19,120,9,10,allow
4651,443,4651,443,14579,1280,13299,25,16,9,16,allow
55101,53,3206,53,711,87,624,2,30,1,1,allow
50820,53,0,0,371,77,294,2,30,1,1,allow
59283,80,59283,80,72354,14398,57956,123,15,40,83,allow
58775,443,62135,443,9017,5865,3152,26,16,14,12,allow
55671,53,32686,53,98,98,0,1,30,1,0,allow
50224,443,62141,443,9530,2104,7426,18,121,9,9,allow
49510,443,40862,443,9571,3757,5814,48,221,26,22,allow
56734,53,17479,53,751,95,656,2,30,1,1,allow
58781,443,48906,443,6673,4335,2338,22,16,11,11,allow
53772,14132,16590,14132,70,70,0,2,8,2,0,allow
54326,7000,54326,7000,2958,1567,1391,15,15,8,7,allow
6881,30279,63096,30279,150,150,0,1,1200,1,0,allow
64477,3478,36622,3478,189,79,110,2,301,1,1,allow
50110,53,49491,53,172,88,84,2,31,1,1,allow
51950,17499,60701,17499,66,66,0,1,5,1,0,allow
59282,80,59282,80,181627,17128,164499,277,15,79,198,allow
55531,53,64298,53,216,110,106,2,30,1,1,allow
58777,443,42281,443,2577,1550,1027,15,16,7,8,allow
53263,443,15903,443,14269,5761,8508,43,18,23,20,allow
58764,443,5482,443,21960,14378,7582,49,18,26,23,allow
53257,443,51156,443,8715,1814,6901,26,29,15,11,allow
48513,443,48513,443,4566,1659,2907,19,27,11,8,allow
59281,80,59281,80,108922,4633,104289,194,16,66,128,allow
58012,53,0,0,82,82,0,1,30,1,0,allow
56997,53,59115,53,711,87,624,2,30,1,1,allow
55711,53,2553,53,728,96,632,2,30,1,1,allow
64763,53,29524,53,728,96,632,2,30,1,1,allow
38634,443,57626,443,9398,4241,5157,22,135,11,11,allow
58782,443,19890,443,5397,3496,1901,20,16,10,10,allow
65024,53,40250,53,198,101,97,2,32,1,1,allow
51991,56980,61136,56980,316,136,180,6,7,3,3,allow
58768,443,60756,443,18568,12357,6211,43,18,24,19,allow
53778,6881,23099,6881,70,70,0,2,8,2,0,allow
51409,443,64493,443,36713,3193,33520,57,623,23,34,allow
54325,7000,54325,7000,755529,16895,738634,785,16,264,521,allow
5416,53,5416,53,213,79,134,2,33,1,1,allow
60342,7000,60342,7000,3114,1659,1455,17,15,9,8,allow
61504,443,15507,443,16708,2331,14377,31,21,14,17,allow
52150,443,44913,443,5481,3086,2395,26,49,13,13,allow
58936,443,47053,443,9081,3368,5713,42,76,24,18,allow
59279,80,59279,80,108786,4563,104223,192,16,65,127,allow
50466,53,25118,53,295,101,194,4,30,2,2,allow
55330,53,46578,53,188,96,92,2,30,1,1,allow
55720,443,32771,443,2494,719,1775,9,120,5,4,allow
55531,53,31789,53,216,110,106,2,30,1,1,allow
58776,443,47713,443,3991,2587,1404,17,16,9,8,allow
57238,53,18077,53,701,88,613,2,31,1,1,allow
55850,53,22849,53,711,87,624,2,31,1,1,allow
55655,53,43785,53,754,94,660,2,31,1,1,allow
58906,80,61612,80,742,350,392,12,28,6,6,allow
64788,53,8538,53,749,94,655,2,31,1,1,allow
57143,53,34750,53,184,94,90,2,31,1,1,allow
49454,53,56383,53,762,97,665,2,31,1,1,allow
36657,443,2188,443,10985,3186,7799,29,204,14,15,allow
61349,443,14011,443,1786,172,1614,7,120,3,4,allow
47966,443,16155,443,10895,2151,8744,26,362,11,15,allow
34357,443,37129,443,17372,10352,7020,91,422,52,39,allow
51221,51413,63036,51413,459,149,310,2,1200,1,1,allow
10151,34592,23117,34592,480,149,331,2,1200,1,1,allow
35051,53,35051,53,194,87,107,2,31,1,1,allow
55705,53,6400,53,281,101,180,4,60,2,2,allow
64792,53,58723,53,768,99,669,2,31,1,1,allow
56612,53,23653,53,172,88,84,2,31,1,1,allow
60435,443,42755,443,38888447,473172,38415275,31568,128,5708,25860,allow
33877,53,33877,53,643,88,555,2,31,1,1,allow
57470,62314,37389,62314,1188,1188,0,19,2338,19,0,allow
49160,16919,59131,16919,868,150,718,4,1200,2,2,allow
51382,56205,0,0,62,62,0,1,0,1,0,deny
59977,445,0,0,70,70,0,1,0,1,0,drop
60224,445,0,0,66,66,0,1,0,1,0,drop
57555,35440,0,0,66,66,0,1,0,1,0,deny
16013,35253,0,0,66,66,0,1,0,1,0,deny
2464,50584,0,0,62,62,0,1,0,1,0,deny
57940,24748,0,0,148,148,0,1,0,1,0,deny
49514,39127,0,0,162,162,0,1,0,1,0,deny
64804,445,0,0,70,70,0,1,0,1,0,drop
59969,445,0,0,70,70,0,1,0,1,0,drop
1912,48817,0,0,62,62,0,1,0,1,0,deny
64797,445,0,0,70,70,0,1,0,1,0,drop
64795,445,0,0,70,70,0,1,0,1,0,drop
59967,445,0,0,70,70,0,1,0,1,0,drop
7347,56205,0,0,66,66,0,1,0,1,0,deny
54866,37965,0,0,62,62,0,1,0,1,0,deny
10480,26467,0,0,62,62,0,1,0,1,0,deny
42717,5900,0,0,60,60,0,1,0,1,0,deny
37607,443,8291,443,499,425,74,4,0,3,1,allow
37609,443,19871,443,499,425,74,4,0,3,1,allow
37610,443,1253,443,499,425,74,4,0,3,1,allow
37612,443,15502,443,499,425,74,4,0,3,1,allow
37611,443,44824,443,499,425,74,4,0,3,1,allow
37608,443,17459,443,499,425,74,4,0,3,1,allow
60214,445,0,0,66,66,0,1,0,1,0,drop
62348,48817,0,0,145,145,0,1,0,1,0,deny
56250,36237,0,0,66,66,0,1,0,1,0,deny
59962,445,0,0,70,70,0,1,0,1,0,drop
59961,445,0,0,70,70,0,1,0,1,0,drop
2572,35440,0,0,66,66,0,1,0,1,0,deny
56638,64147,0,0,62,62,0,1,0,1,0,deny
51429,22114,0,0,62,62,0,1,0,1,0,deny
60206,445,0,0,66,66,0,1,0,1,0,drop
64785,445,0,0,70,70,0,1,0,1,0,drop
15978,50584,0,0,146,146,0,1,0,1,0,deny
59957,445,0,0,70,70,0,1,0,1,0,drop
47201,44847,0,0,66,66,0,1,0,1,0,deny
59956,445,0,0,70,70,0,1,0,1,0,drop
3830,26467,0,0,66,66,0,1,0,1,0,deny
52184,22114,0,0,66,66,0,1,0,1,0,deny
60204,445,0,0,66,66,0,1,0,1,0,drop
65012,32468,0,0,66,66,0,1,0,1,0,deny
28136,443,42266,443,8805,3429,5376,33,475,16,17,allow
50466,53,28614,53,199,102,97,2,30,1,1,allow
62062,443,21250,443,134,60,74,3,5,2,1,allow
55026,443,23738,443,11413,6823,4590,34,18,19,15,allow
49493,53,48045,53,241,118,123,2,30,1,1,allow
62043,80,35524,80,3466,665,2801,14,16,7,7,allow
40244,443,63008,443,21525,15159,6366,43,315,25,18,allow
56199,53,11587,53,79,79,0,2,33,2,0,allow
53777,62955,35330,62955,70,70,0,2,7,2,0,allow
57436,66,1487,66,70,70,0,1,4,1,0,allow
56832,53,34537,53,214,102,112,2,29,1,1,allow
64747,53,39095,53,216,94,122,2,29,1,1,allow
65082,53,4469,53,718,94,624,2,29,1,1,allow
56312,53,57178,53,214,102,112,2,29,1,1,allow
55330,53,28011,53,194,102,92,2,29,1,1,allow
55126,53,7380,53,177,94,83,2,30,1,1,allow
64374,53,21299,53,194,94,100,2,30,1,1,allow
62961,53,49359,53,209,102,107,2,30,1,1,allow
52932,443,50755,443,3032,1082,1950,9,120,5,4,allow
46883,443,30067,443,40443,5300,35143,88,134,38,50,allow
42600,443,64399,443,3137,1986,1151,15,15,8,7,allow
63907,54218,37939,54218,696,452,244,11,21,7,4,allow
56450,53,63813,53,177,94,83,2,30,1,1,allow
55126,53,57162,53,177,94,83,2,30,1,1,allow
48745,443,43215,443,229628,10653,218975,263,49,103,160,allow
38000,443,20816,443,13123,6654,6469,29,135,15,14,allow
51982,56306,48759,56306,70,70,0,2,8,2,0,allow
51179,53,60232,53,86,86,0,1,30,1,0,allow
57646,443,57646,443,4492,1585,2907,19,30,11,8,allow
56361,53,48019,53,816,102,714,2,30,1,1,allow
56707,443,22633,443,8005,1985,6020,20,15,11,9,allow
36498,80,36498,80,161054,3432,157622,140,158,24,116,allow
51983,30472,23592,30472,70,70,0,2,8,2,0,allow
51951,65387,33774,65387,70,70,0,1,5,1,0,allow
58780,443,38511,443,5971,706,5265,17,15,7,10,allow
56101,53,11714,53,194,102,92,2,30,1,1,allow
56708,443,4344,443,8059,2039,6020,20,15,11,9,allow
49183,53,38350,53,177,94,83,2,30,1,1,allow
64937,53,49091,53,94,94,0,1,30,1,0,allow
53496,3389,53496,3389,3624,1910,1714,19,33,11,8,allow
54429,53,0,0,195,70,125,2,30,1,1,allow
56450,53,31149,53,177,94,83,2,30,1,1,allow
45939,5228,13443,5228,7528,1416,6112,29,811,11,18,allow
64172,53,37844,53,197,102,95,2,33,1,1,allow
56969,443,46839,443,6431,1792,4639,22,80,13,9,allow
35568,443,33534,443,5383,3710,1673,27,309,14,13,allow
53753,46790,44362,46790,492,306,186,8,15,5,3,allow
64729,53,36616,53,262,94,168,2,30,1,1,allow
33421,443,28800,443,9917,3184,6733,30,91,12,18,allow
56986,53,20950,53,259,87,172,4,37,2,2,allow
53249,443,22744,443,12082,5745,6337,32,61,16,16,allow
9203,443,1918,443,318,192,126,6,17,4,2,allow
43666,443,10694,443,13212,9431,3781,41,238,21,20,allow
50466,53,34951,53,199,102,97,2,30,1,1,allow
34998,443,4497,443,9114,2208,6906,36,120,19,17,allow
49266,53,11642,53,330,97,233,4,33,2,2,allow
53773,15459,13024,15459,70,70,0,2,7,2,0,allow
56710,443,25252,443,8057,2037,6020,20,15,11,9,allow
54820,443,53134,443,16366,4160,12206,41,55,20,21,allow
52636,443,34549,443,1309,670,639,16,166,9,7,allow
35913,443,5129,443,14329,8250,6079,26,22,16,10,allow
35804,443,35654,443,232,172,60,3,5,2,1,allow
48541,80,51953,80,812,672,140,6,28,4,2,allow
37339,443,37972,443,130,70,60,3,5,2,1,allow
53265,443,57484,443,4995,1414,3581,21,15,12,9,allow
44236,80,40314,80,2982,2565,417,12,15,7,5,allow
55671,53,40091,53,196,102,94,2,33,1,1,allow
53752,35446,60472,35446,492,306,186,8,15,5,3,allow
37907,443,63465,443,9227,2999,6228,64,616,35,29,allow
60781,40010,23139,40010,316,136,180,6,5,3,3,allow
39774,443,8618,443,69542,11991,57551,139,157,60,79,allow
53776,37650,27111,37650,70,70,0,2,7,2,0,allow
58783,443,56867,443,5166,700,4466,16,15,7,9,allow
41246,443,49001,443,78,78,0,1,5,1,0,allow
63823,51558,31200,51558,1518,1396,122,12,45,10,2,allow
32970,443,36092,443,8910,2660,6250,24,18,13,11,allow
64981,53,62988,53,214,102,112,2,29,1,1,allow
56733,53,5825,53,177,94,83,2,29,1,1,allow
50336,53,8935,53,102,102,0,1,30,1,0,allow
58856,443,44646,443,4552,2750,1802,27,95,15,12,allow
51877,53,28972,53,254,78,176,2,29,1,1,allow
48606,443,28779,443,4160,2675,1485,25,95,14,11,allow
49668,53,14674,53,214,102,112,2,29,1,1,allow
55531,53,2010,53,322,110,212,4,30,2,2,allow
64192,53,23253,53,308,110,198,2,29,1,1,allow
56446,443,39205,443,15813,5998,9815,30,120,14,16,allow
49183,53,55748,53,177,94,83,2,30,1,1,allow
57772,443,4338,443,6783,3270,3513,22,120,11,11,allow
65510,53,46580,53,229,102,127,2,30,1,1,allow
37965,61282,39357,61282,402,132,270,6,1208,3,3,allow
55531,53,46307,53,216,110,106,2,30,1,1,allow
60985,443,15568,443,30399,22692,7707,57,144,31,26,allow
54870,443,33932,443,424,210,214,7,131,4,3,allow
39004,443,10788,443,38459,27564,10895,97,189,49,48,allow
58779,443,44782,443,5166,700,4466,16,15,7,9,allow
55067,443,38448,443,3136,2025,1111,19,26,10,9,allow
64000,53,28661,53,241,102,139,2,30,1,1,allow
50252,53,45062,53,173,94,79,2,30,1,1,allow
49981,53,44663,53,360,102,258,2,30,1,1,allow
49688,53,10693,53,782,110,672,2,30,1,1,allow
56273,53,37875,53,330,126,204,2,30,1,1,allow
50010,53,28513,53,330,126,204,2,31,1,1,allow
56177,53,3037,53,807,94,713,2,31,1,1,allow
49812,53,26847,53,193,102,91,2,31,1,1,allow
39009,443,34628,443,12197,2338,9859,34,122,14,20,allow
49948,53,31894,53,755,102,653,2,30,1,1,allow
65049,53,34852,53,199,102,97,2,30,1,1,allow
56709,443,54114,443,8007,1987,6020,20,15,11,9,allow
51984,54606,5412,54606,70,70,0,2,8,2,0,allow
60287,80,59923,80,10135,7433,2702,28,164,19,9,allow
49328,53,46932,53,748,94,654,2,30,1,1,allow
50110,53,63137,53,178,94,84,2,30,1,1,allow
2890,53,28510,53,78,78,0,1,30,1,0,allow
56361,53,14867,53,193,102,91,2,30,1,1,allow
57019,53,54333,53,193,102,91,2,30,1,1,allow
1934,53,51604,53,210,78,132,2,30,1,1,allow
49896,53,58946,53,772,102,670,2,30,1,1,allow
57241,53,26543,53,224,102,122,2,30,1,1,allow
50466,53,18896,53,199,102,97,2,30,1,1,allow
56628,80,40916,80,1359,435,924,13,30,7,6,allow
58784,443,22318,443,5168,700,4468,16,15,7,9,allow
58787,443,18932,443,5107,700,4407,15,15,7,8,allow
49190,443,44351,443,568536,16389,552147,598,19,224,374,allow
51999,34619,15741,34619,70,70,0,1,5,1,0,allow
60286,80,21753,80,5836,2829,3007,19,164,14,5,allow
64226,53,55510,53,211,102,109,2,30,1,1,allow
56101,53,64581,53,194,102,92,2,30,1,1,allow
65206,53,13449,53,330,118,212,2,30,1,1,allow
42819,443,36580,443,10837,3411,7426,34,272,17,17,allow
65212,53,36121,53,230,102,128,2,30,1,1,allow
64097,443,12441,443,6372,1893,4479,15,120,8,7,allow
52933,443,12830,443,3517,993,2524,12,120,6,6,allow
55007,443,13149,443,14030,7043,6987,32,123,18,14,allow
33044,443,19147,443,268582,23654,244928,341,190,128,213,allow
51566,53,46943,53,239,102,137,2,30,1,1,allow
49587,53,25936,53,229,102,127,2,30,1,1,allow
58805,53,42120,53,237,86,151,2,30,1,1,allow
36701,53,35437,53,199,94,105,2,30,1,1,allow
55334,53,17897,53,199,102,97,2,31,1,1,allow
49708,443,3133,443,7772,2563,5209,18,121,9,9,allow
39064,443,7055,443,11356,4341,7015,33,128,16,17,allow
54299,443,30059,443,9986,2440,7546,17,120,8,9,allow
56000,53,26233,53,177,94,83,2,30,1,1,allow
57019,53,50222,53,193,102,91,2,30,1,1,allow
65277,53,2071,53,775,102,673,2,30,1,1,allow
65275,53,62237,53,184,94,90,2,30,1,1,allow
55330,53,61986,53,194,102,92,2,31,1,1,allow
44881,53,62824,53,212,78,134,2,30,1,1,allow
59982,443,10585,443,3640,870,2770,13,120,6,7,allow
50468,443,35607,443,227265,6450,220815,225,124,63,162,allow
63930,44330,31365,44330,70,70,0,1,5,1,0,allow
51949,5484,40071,5484,70,70,0,1,5,1,0,allow
61832,80,61832,80,2221,1482,739,11,149,6,5,allow
65114,443,65114,443,4480,1573,2907,19,30,11,8,allow
65275,53,60428,53,807,94,713,2,30,1,1,allow
46985,53,9920,53,199,94,105,2,30,1,1,allow
49348,53,64482,53,214,94,120,2,31,1,1,allow
56000,53,8849,53,177,94,83,2,31,1,1,allow
64475,443,53340,443,251092,8989,242103,282,123,98,184,allow
61860,10443,7961,10443,10811,2571,8240,27,48,15,12,allow
64665,53,12742,53,181,94,87,2,32,1,1,allow
63929,48477,13540,48477,70,70,0,1,5,1,0,allow
60195,445,0,0,66,66,0,1,0,1,0,drop
59951,445,0,0,70,70,0,1,0,1,0,drop
60193,445,0,0,66,66,0,1,0,1,0,drop
62257,2767,0,0,66,66,0,1,0,1,0,deny
58829,64147,0,0,66,66,0,1,0,1,0,deny
45304,64147,0,0,72,72,0,1,0,1,0,deny
65259,37965,0,0,66,66,0,1,0,1,0,deny
50772,35440,0,0,66,66,0,1,0,1,0,deny
64773,445,0,0,70,70,0,1,0,1,0,drop
64774,445,0,0,70,70,0,1,0,1,0,drop
64772,445,0,0,70,70,0,1,0,1,0,drop
60174,445,0,0,66,66,0,1,0,1,0,drop
60180,445,0,0,66,66,0,1,0,1,0,drop
60175,445,0,0,66,66,0,1,0,1,0,drop
60179,445,0,0,66,66,0,1,0,1,0,drop
60177,445,0,0,66,66,0,1,0,1,0,drop
60181,445,0,0,66,66,0,1,0,1,0,drop
60178,445,0,0,66,66,0,1,0,1,0,drop
60176,445,0,0,66,66,0,1,0,1,0,drop
45908,33330,0,0,60,60,0,1,0,1,0,deny
59938,445,0,0,70,70,0,1,0,1,0,drop
57011,49813,0,0,66,66,0,1,0,1,0,deny
59935,445,0,0,70,70,0,1,0,1,0,drop
16826,22,0,0,60,60,0,1,0,1,0,deny
54464,56205,0,0,66,66,0,1,0,1,0,deny
64765,445,0,0,70,70,0,1,0,1,0,drop
64763,445,0,0,70,70,0,1,0,1,0,drop
64758,445,0,0,70,70,0,1,0,1,0,drop
64755,445,0,0,70,70,0,1,0,1,0,drop
7889,48817,0,0,146,146,0,1,0,1,0,deny
37603,443,61350,443,573,425,148,5,1,3,2,allow
37602,443,57970,443,573,425,148,5,0,3,2,allow
37601,443,50258,443,573,425,148,5,0,3,2,allow
54251,443,43085,443,499,425,74,4,0,3,1,allow
54252,443,11078,443,499,425,74,4,0,3,1,allow
54250,443,54030,443,499,425,74,4,0,3,1,allow
60161,445,0,0,66,66,0,1,0,1,0,drop
60160,445,0,0,66,66,0,1,0,1,0,drop
60159,445,0,0,66,66,0,1,0,1,0,drop
59930,445,0,0,70,70,0,1,0,1,0,drop
59929,445,0,0,70,70,0,1,0,1,0,drop
6817,23,0,0,60,60,0,1,0,1,0,deny
59927,445,0,0,70,70,0,1,0,1,0,drop
65422,26467,0,0,62,62,0,1,0,1,0,deny
64752,445,0,0,70,70,0,1,0,1,0,drop
50920,60182,0,0,62,62,0,1,0,1,0,deny
64747,445,0,0,70,70,0,1,0,1,0,drop
64746,445,0,0,70,70,0,1,0,1,0,drop
54249,443,37595,443,499,425,74,4,0,3,1,allow
37605,443,2336,443,573,425,148,5,0,3,2,allow
37604,443,27839,443,573,425,148,5,0,3,2,allow
54248,443,24435,443,499,425,74,4,0,3,1,allow
37606,443,60055,443,499,425,74,4,0,3,1,allow
54245,443,40246,443,499,425,74,4,0,3,1,allow
64743,445,0,0,70,70,0,1,0,1,0,drop
64824,36829,0,0,62,62,0,1,0,1,0,deny
63956,38211,0,0,62,62,0,1,0,1,0,deny
7364,50584,0,0,66,66,0,1,0,1,0,deny
20217,8333,0,0,60,60,0,1,0,1,0,deny
4110,35440,0,0,62,62,0,1,0,1,0,deny
443,61686,0,0,1484,1484,0,1,0,1,0,deny
59920,445,0,0,70,70,0,1,0,1,0,drop
16905,57866,0,0,66,66,0,1,0,1,0,deny
25565,27960,0,0,60,60,0,1,0,1,0,deny
10736,35440,0,0,66,66,0,1,0,1,0,deny
62153,35440,0,0,66,66,0,1,0,1,0,deny
59400,22114,0,0,66,66,0,1,0,1,0,deny
59918,445,0,0,70,70,0,1,0,1,0,drop
64735,445,0,0,70,70,0,1,0,1,0,drop
64729,445,0,0,70,70,0,1,0,1,0,drop
64730,445,0,0,70,70,0,1,0,1,0,drop
59917,445,0,0,70,70,0,1,0,1,0,drop
48706,23393,0,0,60,60,0,1,0,1,0,deny
11136,19910,0,0,62,62,0,1,0,1,0,deny
59916,445,0,0,70,70,0,1,0,1,0,drop
11136,19910,0,0,145,145,0,1,0,1,0,deny
59915,445,0,0,70,70,0,1,0,1,0,drop
59911,445,0,0,70,70,0,1,0,1,0,drop
59910,445,0,0,70,70,0,1,0,1,0,drop
60149,445,0,0,66,66,0,1,0,1,0,drop
48513,44847,0,0,62,62,0,1,0,1,0,deny
3597,11392,0,0,66,66,0,1,0,1,0,deny
16477,37807,0,0,66,66,0,1,0,1,0,deny
10834,50584,0,0,66,66,0,1,0,1,0,deny
38664,37965,0,0,62,62,0,1,0,1,0,deny
59897,445,0,0,70,70,0,1,0,1,0,drop
59896,445,0,0,70,70,0,1,0,1,0,drop
59891,445,0,0,70,70,0,1,0,1,0,drop
1024,48817,0,0,148,148,0,1,0,1,0,deny
59886,445,0,0,70,70,0,1,0,1,0,drop
59887,445,0,0,70,70,0,1,0,1,0,drop
52022,52752,0,0,74,74,0,1,0,1,0,deny
64725,445,0,0,70,70,0,1,0,1,0,drop
64719,445,0,0,70,70,0,1,0,1,0,drop
50,38211,0,0,66,66,0,1,0,1,0,deny
7310,44847,0,0,66,66,0,1,0,1,0,deny
8889,26330,0,0,60,60,0,1,0,1,0,deny
60134,445,0,0,66,66,0,1,0,1,0,drop
60132,445,0,0,66,66,0,1,0,1,0,drop
25497,44847,0,0,146,146,0,1,0,1,0,deny
52062,443,35040,443,466,392,74,4,0,3,1,allow
23461,34021,0,0,62,62,0,1,0,1,0,reset-both
59875,445,0,0,70,70,0,1,0,1,0,drop
51934,36180,0,0,66,66,0,1,0,1,0,deny
64697,37965,0,0,66,66,0,1,0,1,0,deny
30794,37965,0,0,62,62,0,1,0,1,0,deny
64714,445,0,0,70,70,0,1,0,1,0,drop
64709,445,0,0,70,70,0,1,0,1,0,drop
64708,445,0,0,70,70,0,1,0,1,0,drop
64707,445,0,0,70,70,0,1,0,1,0,drop
60125,445,0,0,66,66,0,1,0,1,0,drop
60771,58414,0,0,66,66,0,1,0,1,0,deny
58836,44847,0,0,74,74,0,1,0,1,0,deny
60120,445,0,0,66,66,0,1,0,1,0,drop
60122,445,0,0,66,66,0,1,0,1,0,drop
60114,445,0,0,66,66,0,1,0,1,0,drop
60118,445,0,0,66,66,0,1,0,1,0,drop
60111,445,0,0,66,66,0,1,0,1,0,drop
60110,445,0,0,66,66,0,1,0,1,0,drop
59871,445,0,0,70,70,0,1,0,1,0,drop
49113,50584,0,0,62,62,0,1,0,1,0,deny
64701,445,0,0,70,70,0,1,0,1,0,drop
55387,53,17527,53,761,100,661,2,31,1,1,allow
57311,53,52829,53,768,99,669,2,31,1,1,allow
45550,80,42274,80,890,420,470,14,27,7,7,allow
49904,80,22359,80,1647,508,1139,8,138,5,3,allow
54990,443,49240,443,20961,10306,10655,49,48,25,24,allow
54617,443,54617,443,3186,1836,1350,16,17,10,6,allow
58769,443,51640,443,3923,2459,1464,17,17,8,9,allow
62905,443,5789,443,8426,2893,5533,27,16,15,12,allow
53774,58433,12540,58433,320,140,180,6,7,3,3,allow
56654,53,59245,53,202,103,99,2,31,1,1,allow
57444,53,22248,53,170,87,83,2,30,1,1,allow
54604,80,54604,80,2244,1549,695,11,18,7,4,allow
35439,443,50661,443,3730,2455,1275,18,256,10,8,allow
50036,80,50018,80,1665,923,742,7,32,4,3,allow
45552,80,5282,80,890,420,470,14,27,7,7,allow
65251,53,54208,53,183,98,85,3,36,2,1,allow
64665,53,63171,53,91,91,0,1,30,1,0,allow
55196,53,52555,53,711,87,624,2,30,1,1,allow
65266,53,41690,53,216,110,106,2,31,1,1,allow
52326,443,52326,443,5433,2251,3182,23,86,12,11,allow
52332,443,52332,443,960,539,421,9,52,5,4,allow
50578,80,53375,80,1114,534,580,12,16,7,5,allow
57259,443,65344,443,6439,1702,4737,21,68,13,8,allow
45551,80,20742,80,694,350,344,11,27,6,5,allow
52616,80,52616,80,3366,2547,819,15,49,8,7,allow
52946,80,25585,80,2043,1331,712,13,17,7,6,allow
52667,80,52667,80,2011,1422,589,12,48,6,6,allow
65061,53,34099,53,297,101,196,4,31,2,2,allow
48867,443,13159,443,6107,2079,4028,19,68,11,8,allow
56440,53,14356,53,742,88,654,2,30,1,1,allow
57106,443,27171,443,38893,31305,7588,107,101,55,52,allow
55949,53,62692,53,774,101,673,2,30,1,1,allow
53769,8999,35608,8999,70,70,0,2,8,2,0,allow
56169,53,29884,53,749,94,655,2,30,1,1,allow
49515,443,49515,443,102168,31819,70349,140,62,75,65,allow
57019,53,12115,53,186,95,91,2,30,1,1,allow
56479,53,28725,53,775,103,672,2,30,1,1,allow
58773,443,53074,443,3854,2390,1464,17,15,8,9,allow
59670,443,52276,443,11549,6152,5397,28,156,16,12,allow
42920,443,33787,443,883886,26396,857490,947,444,340,607,allow
24463,3389,24463,3389,3910,1805,2105,20,18,12,8,allow
54415,443,40112,443,7129,4391,2738,32,196,16,16,allow
55019,53,16040,53,299,110,189,4,32,2,2,allow
48245,443,12754,443,7417,1760,5657,21,256,12,9,allow
56986,53,50579,53,259,87,172,4,37,2,2,allow
40736,443,40736,443,4380,1473,2907,19,26,11,8,allow
5588,5588,0,0,3354,1792,1562,46,195,23,23,allow
62460,443,33310,443,4608,3133,1475,18,35,10,8,allow
52329,443,52329,443,4453,1546,2907,21,86,11,10,allow
19473,20467,44164,20467,480,149,331,2,1200,1,1,allow
56240,53,50619,53,748,95,653,2,30,1,1,allow
65244,53,43768,53,170,87,83,2,30,1,1,allow
64016,53,54219,53,184,94,90,2,31,1,1,allow
45987,443,65054,443,3160640,65300,3095340,2786,144,547,2239,allow
49552,53,40374,53,760,97,663,2,31,1,1,allow
60184,443,18301,443,3915,1934,1981,14,122,7,7,allow
44355,443,45033,443,354,140,214,6,131,3,3,allow
55066,53,26532,53,815,95,720,2,31,1,1,allow
65180,53,32141,53,198,101,97,2,31,1,1,allow
50089,53,38993,53,752,93,659,2,31,1,1,allow
50621,53,54722,53,256,93,163,2,31,1,1,allow
42867,443,28433,443,15769,1619,14150,17,137,4,13,allow
62618,443,27342,443,6939,2970,3969,19,144,9,10,allow
51334,443,42102,443,8407,2034,6373,19,121,8,11,allow
56755,53,37076,53,184,94,90,2,31,1,1,allow
51338,443,48161,443,424,210,214,7,131,4,3,allow
45995,443,45995,443,1494,898,596,12,142,6,6,allow
30960,45721,23609,45721,66,66,0,1,3600,1,0,allow
43300,18242,0,0,62,62,0,1,60,1,0,allow
64697,445,0,0,70,70,0,1,0,1,0,drop
64695,445,0,0,70,70,0,1,0,1,0,drop
64693,445,0,0,70,70,0,1,0,1,0,drop
44411,37965,0,0,62,62,0,1,0,1,0,deny
59861,445,0,0,70,70,0,1,0,1,0,drop
59862,445,0,0,70,70,0,1,0,1,0,drop
59860,445,0,0,70,70,0,1,0,1,0,deny
64677,57470,0,0,66,66,0,1,0,1,0,deny
1025,50584,0,0,62,62,0,1,0,1,0,deny
39287,57470,0,0,62,62,0,1,0,1,0,deny
59856,445,0,0,70,70,0,1,0,1,0,drop
46839,51050,0,0,62,62,0,1,0,1,0,deny
65379,22114,0,0,66,66,0,1,0,1,0,deny
59855,445,0,0,70,70,0,1,0,1,0,drop
26713,64147,0,0,62,62,0,1,0,1,0,deny
29577,64147,0,0,62,62,0,1,0,1,0,deny
64689,445,0,0,70,70,0,1,0,1,0,drop
64688,445,0,0,70,70,0,1,0,1,0,drop
57074,53,2955,53,195,102,93,2,30,1,1,allow
64580,443,64391,443,24686,1935,22751,36,20,17,19,allow
56612,53,28216,53,178,94,84,2,30,1,1,allow
56681,53,9758,53,195,102,93,2,30,1,1,allow
64156,53,39777,53,409,92,317,4,30,2,2,allow
56986,53,34763,53,259,87,172,4,36,2,2,allow
51980,45478,12123,45478,70,70,0,2,7,2,0,allow
51997,14398,23393,14398,130,70,60,2,4,1,1,allow
62053,443,33820,443,134,60,74,3,5,2,1,allow
65251,53,36655,53,277,98,179,4,36,2,2,allow
57265,443,12728,443,9633,4368,5265,32,71,18,14,allow
55334,53,36263,53,199,102,97,2,30,1,1,allow
56706,443,32876,443,8057,2037,6020,20,15,11,9,allow
55665,44235,23820,44235,504,318,186,8,15,5,3,allow
51100,443,10929,443,9429,1978,7451,27,46,14,13,allow
49945,53,62137,53,198,102,96,2,30,1,1,allow
49942,443,49942,443,29781,5947,23834,63,47,32,31,allow
65049,53,13947,53,199,102,97,2,29,1,1,allow
40349,443,1831,443,7128,1336,5792,22,83,11,11,allow
51979,55803,35511,55803,70,70,0,2,7,2,0,allow
56450,53,17647,53,177,94,83,2,29,1,1,allow
64345,53,39290,53,499,94,405,2,29,1,1,allow
65435,53,59924,53,196,94,102,2,29,1,1,allow
64561,53,50313,53,209,110,99,2,30,1,1,allow
56654,53,7307,53,209,110,99,2,30,1,1,allow
64578,443,29592,443,9156,2109,7047,27,32,15,12,allow
37384,443,22279,443,416,210,206,7,29,4,3,allow
59014,443,31435,443,27298,11122,16176,59,31,30,29,allow
49918,80,19931,80,751,455,296,8,125,5,3,allow
64561,53,6022,53,209,110,99,2,30,1,1,allow
53940,53,37682,53,70,70,0,1,30,1,0,allow
65244,53,54645,53,177,94,83,2,30,1,1,allow
49945,53,22837,53,821,102,719,2,30,1,1,allow
55019,53,27465,53,299,110,189,4,31,2,2,allow
37995,49152,51662,49152,156,156,0,3,8,3,0,allow
51947,16935,4514,16935,70,70,0,1,5,1,0,allow
65224,53,18679,53,197,102,95,2,30,1,1,allow
52572,80,52572,80,1899,1310,589,12,48,6,6,allow
52328,443,52328,443,5438,2255,3183,23,86,12,11,allow
56717,53,2347,53,178,94,84,2,30,1,1,allow
52325,443,52325,443,17806,3169,14637,41,86,18,23,allow
48768,443,48768,443,4398,1491,2907,19,27,11,8,allow
38693,443,23499,443,16959,8920,8039,46,33,24,22,allow
52333,443,52333,443,960,539,421,9,52,5,4,allow
65127,443,50841,443,48029,4540,43489,91,120,40,51,allow
49919,80,15298,80,992,524,468,10,125,6,4,allow
64266,53,18916,53,180,94,86,2,31,1,1,allow
53437,6057,55735,6057,245,245,0,2,30,2,0,allow
50169,53,12431,53,211,78,133,2,30,1,1,allow
51977,18504,24364,18504,70,70,0,2,8,2,0,allow
56177,53,33735,53,184,94,90,2,30,1,1,allow
57143,53,42791,53,184,94,90,2,30,1,1,allow
37581,443,19620,443,13435,2441,10994,30,26,16,14,allow
55938,53,31705,53,209,110,99,2,30,1,1,allow
65224,53,46834,53,197,102,95,2,30,1,1,allow
55770,53,22601,53,177,94,83,2,30,1,1,allow
57444,53,32931,53,177,94,83,2,30,1,1,allow
49812,53,34841,53,193,102,91,2,30,1,1,allow
57444,53,54223,53,177,94,83,2,30,1,1,allow
39060,443,26337,443,8554,2353,6201,29,138,14,15,allow
64125,53,55658,53,370,94,276,2,30,1,1,allow
50920,443,1716,443,24070,16123,7947,82,6308,42,40,allow
56717,53,46335,53,178,94,84,2,31,1,1,allow
53301,11000,8510,11000,1642,822,820,5,30,1,4,allow
52330,443,52330,443,11451,5432,6019,34,86,17,17,allow
55705,53,9254,53,281,101,180,4,58,2,2,allow
56035,53,45102,53,173,94,79,2,30,1,1,allow
38832,443,4622,443,23292,17154,6138,141,522,79,62,allow
58774,443,43846,443,5167,700,4467,16,15,7,9,allow
57601,443,61546,443,2614,1689,925,18,20,10,8,allow
55672,45682,48139,45682,70,70,0,2,8,2,0,allow
51976,11816,61215,11816,70,70,0,2,8,2,0,allow
49195,8108,11315,8108,70,70,0,2,8,2,0,allow
51666,443,12470,443,30210,2106,28104,46,201,17,29,allow
52251,80,52251,80,1838,1319,519,11,48,6,5,allow
56704,443,41939,443,8125,2039,6086,21,15,11,10,allow
62337,443,30628,443,3908576,93181,3815395,3743,56,1160,2583,allow
63939,53,40762,53,226,110,116,2,30,1,1,allow
49258,53,9142,53,228,102,126,2,30,1,1,allow
56938,9600,62767,9600,86,86,0,1,30,1,0,allow
55019,53,59602,53,299,110,189,4,31,2,2,allow
60130,443,10266,443,16291,9102,7189,94,508,42,52,allow
55063,80,20796,80,2776,1333,1443,12,37,7,5,allow
52986,443,58135,443,280,140,140,5,130,3,2,allow
48738,443,11931,443,131514,7190,124324,183,53,72,111,allow
63912,18318,13803,18318,1295,926,369,13,17,9,4,allow
65244,53,26357,53,177,94,83,2,31,1,1,allow
43220,5222,35739,5222,5415,2041,3374,53,467,23,30,allow
65061,53,31774,53,299,103,196,4,33,2,2,allow
61027,80,42775,80,9483,767,8716,18,14,10,8,allow
55065,80,56775,80,306,180,126,6,28,4,2,allow
64174,53,47378,53,438,130,308,4,35,2,2,allow
55674,48870,19113,48870,70,70,0,2,8,2,0,allow
49749,443,51214,443,54416,3219,51197,76,240,30,46,allow
56647,80,55289,80,234,234,0,4,12,4,0,allow
62461,443,18805,443,14832,3978,10854,32,34,15,17,allow
62463,443,34613,443,4203,2748,1455,18,33,10,8,allow
53123,443,38611,443,1630,1089,541,14,15,8,6,allow
58772,443,9884,443,5106,700,4406,15,15,7,8,allow
1933,53,18812,53,210,78,132,2,29,1,1,allow
50252,53,7370,53,165,86,79,2,30,1,1,allow
57143,53,50787,53,184,94,90,2,30,1,1,allow
56789,443,21644,443,257154,11550,245604,303,54,121,182,allow
56654,53,36546,53,209,110,99,2,30,1,1,allow
49786,53,64235,53,209,110,99,2,30,1,1,allow
49927,53,25486,53,763,102,661,2,30,1,1,allow
56929,53,14776,53,177,94,83,2,30,1,1,allow
57074,53,22735,53,195,102,93,2,30,1,1,allow
56357,53,35688,53,270,110,160,2,30,1,1,allow
65256,53,14067,53,213,102,111,2,30,1,1,allow
64016,53,18748,53,184,94,90,2,31,1,1,allow
56855,443,28597,443,8114,2511,5603,19,135,9,10,allow
57019,53,31067,53,193,102,91,2,31,1,1,allow
57377,443,4552,443,5553,927,4626,16,15,10,6,allow
59658,443,21276,443,6695,1617,5078,23,200,13,10,allow
62464,443,10700,443,4595,3120,1475,18,33,10,8,allow
52327,443,52327,443,5444,2263,3181,23,86,12,11,allow
51234,80,58624,80,6798,4486,2312,42,107,22,20,allow
39931,443,19532,443,4464,2847,1617,29,80,15,14,allow
55705,53,13969,53,281,101,180,4,58,2,2,allow
64064,53,52675,53,257,94,163,2,30,1,1,allow
64114,53,8208,53,251,102,149,2,30,1,1,allow
56705,443,63668,443,8007,1987,6020,20,15,11,9,allow
58778,443,47598,443,5168,700,4468,16,15,7,9,allow
51978,57496,25018,57496,70,70,0,2,8,2,0,allow
55668,80,57634,80,70,70,0,1,5,1,0,allow
52712,80,52712,80,2012,1423,589,12,48,6,6,allow
52341,80,52341,80,1928,1339,589,12,48,6,6,allow
14432,443,31078,443,7420,1078,6342,21,75,11,10,allow
50393,443,41486,443,7356,1014,6342,20,75,10,10,allow
56035,53,24305,53,173,94,79,2,30,1,1,allow
64524,53,53824,53,235,102,133,2,30,1,1,allow
52647,443,40426,443,46502,33690,12812,93,234,55,38,allow
56796,443,3501,443,5475,1610,3865,19,255,11,8,allow
53147,26330,14316,26330,70,70,0,2,8,2,0,allow
37996,49152,50684,49152,156,156,0,3,8,3,0,allow
56986,53,7478,53,259,87,172,4,37,2,2,allow
37579,443,40926,443,7982,2392,5590,25,26,14,11,allow
55603,32520,10079,32520,5982,1890,4092,30,75,15,15,allow
54977,443,46620,443,322265,12756,309509,409,270,173,236,allow
55705,53,27815,53,281,101,180,4,59,2,2,allow
56681,53,26694,53,195,102,93,2,30,1,1,allow
55938,53,44450,53,209,110,99,2,30,1,1,allow
50411,53,28874,53,86,86,0,1,30,1,0,allow
55770,53,9659,53,177,94,83,2,30,1,1,allow
65266,53,21692,53,216,110,106,2,30,1,1,allow
64313,53,9214,53,226,110,116,2,30,1,1,allow
62711,443,43946,443,266781,12334,254447,323,161,119,204,allow
45996,443,45996,443,1494,898,596,12,142,6,6,allow
64556,53,40982,53,195,102,93,2,30,1,1,allow
51784,8245,58196,8245,280,214,66,2,31,1,1,allow
35832,443,44222,443,17110,4513,12597,42,121,19,23,allow
57275,443,62988,443,45483074,398771,45084303,36307,333,3386,32921,allow
6881,6881,1541,6881,237,118,119,2,1200,1,1,allow
59701,443,37154,443,6155,1819,4336,18,181,8,10,allow
56766,443,14480,443,10137,4019,6118,42,8169,24,18,allow
55019,53,16750,53,299,110,189,4,31,2,2,allow
6881,52563,53881,52563,228,118,110,2,1199,1,1,allow
45992,443,45992,443,1494,898,596,12,142,6,6,allow
49557,53,61895,53,1298,100,1198,4,32,2,2,allow
60204,80,20326,80,70,70,0,2,8,2,0,allow
63944,8999,33141,8999,66,66,0,2,8,2,0,allow
55846,53,27827,53,198,102,96,2,30,1,1,allow
49774,53,49900,53,225,110,115,2,30,1,1,allow
56755,53,26920,53,184,94,90,2,31,1,1,allow
57201,53,17693,53,195,102,93,2,31,1,1,allow
45997,443,45997,443,1494,898,596,12,142,6,6,allow
45994,443,45994,443,1494,898,596,12,142,6,6,allow
45993,443,45993,443,1494,898,596,12,142,6,6,allow
53766,3596,64680,3596,70,70,0,2,8,2,0,allow
53757,1,5970,1,70,70,0,1,5,1,0,allow
53749,53572,44841,53572,492,306,186,8,15,5,3,allow
55475,80,10225,80,350,210,140,6,27,4,2,allow
62904,80,35309,80,1515,481,1034,11,16,6,5,allow
43095,443,34288,443,6513,2043,4470,20,17,12,8,allow
49518,53,34385,53,299,90,209,4,49,2,2,allow
65180,53,7905,53,199,102,97,2,30,1,1,allow
55968,53,21608,53,243,94,149,2,30,1,1,allow
57143,53,17926,53,184,94,90,2,30,1,1,allow
56929,53,47625,53,177,94,83,2,30,1,1,allow
56654,53,22372,53,209,110,99,2,30,1,1,allow
64191,53,5419,53,197,94,103,2,30,1,1,allow
49536,53,5228,53,239,94,145,2,30,1,1,allow
64690,445,0,0,70,70,0,1,0,1,0,drop
63331,51221,0,0,62,62,0,1,0,1,0,deny
52828,51221,0,0,66,66,0,1,0,1,0,deny
60104,445,0,0,66,66,0,1,0,1,0,drop
64684,445,0,0,70,70,0,1,0,1,0,drop
60100,445,0,0,66,66,0,1,0,1,0,drop
59848,445,0,0,70,70,0,1,0,1,0,drop
60097,445,0,0,66,66,0,1,0,1,0,drop
60098,445,0,0,66,66,0,1,0,1,0,drop
60095,445,0,0,66,66,0,1,0,1,0,drop
64449,30188,0,0,62,62,0,1,0,1,0,deny
59679,37807,0,0,66,66,0,1,0,1,0,deny
54737,50584,0,0,66,66,0,1,0,1,0,deny
59841,445,0,0,70,70,0,1,0,1,0,drop
65419,26467,0,0,62,62,0,1,0,1,0,deny
59840,445,0,0,70,70,0,1,0,1,0,drop
33416,23,0,0,60,60,0,1,0,1,0,deny
64676,445,0,0,70,70,0,1,0,1,0,drop
24662,26467,0,0,66,66,0,1,0,1,0,deny
63963,50584,0,0,66,66,0,1,0,1,0,deny
64669,445,0,0,70,70,0,1,0,1,0,drop
64671,445,0,0,70,70,0,1,0,1,0,drop
36369,51505,0,0,66,66,0,1,0,1,0,deny
59834,445,0,0,70,70,0,1,0,1,0,drop
59191,35440,0,0,62,62,0,1,0,1,0,deny
63672,22114,0,0,66,66,0,1,0,1,0,deny
59833,445,0,0,70,70,0,1,0,1,0,drop
25054,36827,0,0,66,66,0,1,0,1,0,deny
60085,445,0,0,66,66,0,1,0,1,0,drop
52938,64097,0,0,66,66,0,1,0,1,0,deny
59829,445,0,0,70,70,0,1,0,1,0,drop
60077,445,0,0,66,66,0,1,0,1,0,drop
41996,5900,0,0,60,60,0,1,0,1,0,deny
64659,445,0,0,70,70,0,1,0,1,0,drop
59828,445,0,0,70,70,0,1,0,1,0,drop
55616,56205,0,0,66,66,0,1,0,1,0,deny
443,39947,0,0,74,74,0,1,0,1,0,deny
61639,37965,0,0,66,66,0,1,0,1,0,deny
60075,445,0,0,66,66,0,1,0,1,0,drop
12709,51505,0,0,62,62,0,1,0,1,0,deny
7246,59858,0,0,66,66,0,1,0,1,0,deny
28040,64147,0,0,66,66,0,1,0,1,0,deny
59823,445,0,0,70,70,0,1,0,1,0,drop
11821,64147,0,0,62,62,0,1,0,1,0,deny
60066,445,0,0,66,66,0,1,0,1,0,drop
60059,445,0,0,66,66,0,1,0,1,0,drop
25237,57470,0,0,62,62,0,1,0,1,0,deny
32770,51505,0,0,62,62,0,1,0,1,0,deny
57468,57470,0,0,66,66,0,1,0,1,0,deny
8889,34659,0,0,60,60,0,1,0,1,0,deny
50927,44847,0,0,62,62,0,1,0,1,0,deny
56442,11392,0,0,66,66,0,1,0,1,0,deny
31500,34729,0,0,146,146,0,1,0,1,0,deny
54280,3398,0,0,60,60,0,1,0,1,0,deny
26810,5033,0,0,145,145,0,1,0,1,0,deny
60357,5900,0,0,60,60,0,1,0,1,0,deny
62757,44847,0,0,146,146,0,1,0,1,0,deny
16693,36237,0,0,62,62,0,1,0,1,0,deny
12663,62413,0,0,66,66,0,1,0,1,0,deny
64646,445,0,0,70,70,0,1,0,1,0,drop
64645,445,0,0,70,70,0,1,0,1,0,drop
64644,445,0,0,70,70,0,1,0,1,0,drop
61005,50584,0,0,146,146,0,1,0,1,0,deny
60052,445,0,0,66,66,0,1,0,1,0,drop
60049,445,0,0,66,66,0,1,0,1,0,drop
60051,445,0,0,66,66,0,1,0,1,0,drop
60048,445,0,0,66,66,0,1,0,1,0,drop
60046,445,0,0,66,66,0,1,0,1,0,drop
60045,445,0,0,66,66,0,1,0,1,0,drop
60050,445,0,0,66,66,0,1,0,1,0,drop
60044,445,0,0,66,66,0,1,0,1,0,drop
59810,445,0,0,70,70,0,1,0,1,0,drop
7524,23,0,0,60,60,0,1,0,1,0,deny
49168,57470,0,0,66,66,0,1,0,1,0,deny
59807,445,0,0,70,70,0,1,0,1,0,drop
55421,57470,0,0,74,74,0,1,0,1,0,deny
54578,64147,0,0,66,66,0,1,0,1,0,deny
27209,25198,0,0,145,145,0,1,0,1,0,deny
64640,445,0,0,70,70,0,1,0,1,0,drop
64641,445,0,0,70,70,0,1,0,1,0,drop
64634,445,0,0,70,70,0,1,0,1,0,drop
64629,445,0,0,70,70,0,1,0,1,0,drop
59802,445,0,0,70,70,0,1,0,1,0,drop
61430,37965,0,0,66,66,0,1,0,1,0,deny
59801,445,0,0,70,70,0,1,0,1,0,drop
60030,445,0,0,66,66,0,1,0,1,0,drop
60032,445,0,0,66,66,0,1,0,1,0,drop
60029,445,0,0,66,66,0,1,0,1,0,drop
13285,29892,0,0,145,145,0,1,0,1,0,deny
61477,57470,0,0,62,62,0,1,0,1,0,deny
59799,445,0,0,70,70,0,1,0,1,0,drop
61030,21247,0,0,66,66,0,1,0,1,0,deny
50,64147,0,0,66,66,0,1,0,1,0,deny
64624,445,0,0,70,70,0,1,0,1,0,drop
62824,37807,0,0,66,66,0,1,0,1,0,deny
26301,22114,0,0,62,62,0,1,0,1,0,deny
64616,445,0,0,70,70,0,1,0,1,0,drop
64617,445,0,0,70,70,0,1,0,1,0,drop
64612,445,0,0,70,70,0,1,0,1,0,drop
59842,62413,0,0,66,66,0,1,0,1,0,deny
28580,64147,0,0,62,62,0,1,0,1,0,deny
59792,445,0,0,70,70,0,1,0,1,0,drop
0,0,0,0,102,102,0,1,0,1,0,deny
50799,37807,0,0,66,66,0,1,0,1,0,deny
59790,445,0,0,70,70,0,1,0,1,0,drop
55862,62413,0,0,66,66,0,1,0,1,0,deny
47453,6881,0,0,146,146,0,1,0,1,0,deny
11562,30188,0,0,62,62,0,1,0,1,0,deny
61059,32480,0,0,146,146,0,1,0,1,0,deny
62973,51505,0,0,62,62,0,1,0,1,0,deny
54280,3398,0,0,60,60,0,1,0,1,0,deny
52022,52752,0,0,74,74,0,1,0,1,0,deny
59210,50584,0,0,66,66,0,1,0,1,0,deny
59789,445,0,0,70,70,0,1,0,1,0,drop
60070,44847,0,0,66,66,0,1,0,1,0,deny
5538,23,0,0,60,60,0,1,0,1,0,deny
59788,445,0,0,70,70,0,1,0,1,0,drop
59787,445,0,0,70,70,0,1,0,1,0,drop
59785,445,0,0,70,70,0,1,0,1,0,drop
59783,445,0,0,70,70,0,1,0,1,0,drop
64606,445,0,0,70,70,0,1,0,1,0,drop
64605,445,0,0,70,70,0,1,0,1,0,drop
64600,445,0,0,70,70,0,1,0,1,0,drop
3792,52700,0,0,62,62,0,1,0,1,0,deny
24271,52700,0,0,66,66,0,1,0,1,0,deny
64368,22114,0,0,66,66,0,1,0,1,0,deny
60020,445,0,0,66,66,0,1,0,1,0,drop
26048,21,0,0,60,60,0,1,0,1,0,deny
59769,445,0,0,70,70,0,1,0,1,0,drop
59767,445,0,0,70,70,0,1,0,1,0,drop
59763,445,0,0,70,70,0,1,0,1,0,drop
59758,445,0,0,70,70,0,1,0,1,0,drop
59759,445,0,0,70,70,0,1,0,1,0,drop
16327,55442,0,0,66,66,0,1,0,1,0,deny
19875,30170,0,0,145,145,0,1,0,1,0,deny
63041,50584,0,0,62,62,0,1,0,1,0,deny
64598,445,0,0,70,70,0,1,0,1,0,drop
64591,445,0,0,70,70,0,1,0,1,0,drop
48676,53393,0,0,60,60,0,1,0,1,0,deny
48676,53399,0,0,60,60,0,1,0,1,0,deny
29136,31652,0,0,145,145,0,1,0,1,0,reset-both
21492,51505,0,0,146,146,0,1,0,1,0,deny
62819,56205,0,0,62,62,0,1,0,1,0,deny
60002,445,0,0,66,66,0,1,0,1,0,drop
60001,445,0,0,66,66,0,1,0,1,0,drop
29922,2750,0,0,145,145,0,1,0,1,0,deny
59747,445,0,0,70,70,0,1,0,1,0,drop
9128,80,3849,80,318,192,126,6,30,4,2,allow
64647,3389,64647,3389,3327,1438,1889,15,17,8,7,allow
26778,443,2994,443,7407,2650,4757,24,20,12,12,allow
51971,20347,9863,20347,70,70,0,2,8,2,0,allow
56203,53,21719,53,751,95,656,2,30,1,1,allow
51081,443,34616,443,8192,2781,5411,22,374,12,10,allow
49297,443,47840,443,5341,3636,1705,30,76,16,14,allow
9132,80,49560,80,318,192,126,6,30,4,2,allow
39724,443,28049,443,45852,4123,41729,61,17,25,36,allow
58755,443,8030,443,11839,7753,4086,30,17,15,15,allow
53768,19067,41942,19067,70,70,0,2,8,2,0,allow
51945,1587,2517,1587,66,66,0,1,5,1,0,allow
57330,443,48576,443,36551,3569,32982,57,46,28,29,allow
9130,80,10198,80,318,192,126,6,30,4,2,allow
38428,443,25567,443,9483,2964,6519,23,17,13,10,allow
48551,443,15020,443,7433,2086,5347,26,316,12,14,allow
64892,53,1067,53,751,95,656,2,30,1,1,allow
61488,53,0,0,314,93,221,2,30,1,1,allow
64154,53,29072,53,188,96,92,2,30,1,1,allow
2088,7010,2088,7010,10300,8829,1471,24,15,13,11,allow
9133,80,26542,80,318,192,126,6,30,4,2,allow
56563,53,31162,53,751,95,656,2,30,1,1,allow
55962,53,39113,53,186,95,91,2,31,1,1,allow
7871,3389,7871,3389,4166,2141,2025,18,18,9,9,allow
49966,80,31375,80,1210,788,422,9,33,5,4,allow
52474,443,15526,443,14908,4027,10881,28,136,11,17,allow
51975,11998,3978,11998,70,70,0,2,8,2,0,allow
58060,80,29313,80,1854,735,1119,8,16,5,3,allow
9126,80,52469,80,318,192,126,6,30,4,2,allow
36361,80,36361,80,514,246,268,9,76,5,4,allow
55081,80,13620,80,1680,697,983,10,52,6,4,allow
9144,80,51086,80,378,192,186,7,30,4,3,allow
36548,80,36548,80,514,246,268,9,76,5,4,allow
58726,443,45284,443,39202,21598,17604,72,20,39,33,allow
9129,80,33910,80,318,192,126,6,30,4,2,allow
36132,80,36132,80,514,246,268,9,76,5,4,allow
9145,80,20559,80,318,192,126,6,30,4,2,allow
5588,5588,0,0,3354,1792,1562,46,194,23,23,allow
5588,5588,0,0,3354,1792,1562,46,195,23,23,allow
5588,5588,0,0,3354,1792,1562,46,195,23,23,allow
56579,53,34186,53,711,87,624,2,30,1,1,allow
56929,53,5055,53,170,87,83,2,30,1,1,allow
56717,53,51715,53,172,88,84,2,31,1,1,allow
53587,3389,53587,3389,3504,1790,1714,17,31,9,8,allow
51838,443,42521,443,9329,3898,5431,21,39,12,9,allow
42665,443,42665,443,4620,1713,2907,19,26,11,8,allow
27005,27021,28946,27021,879,126,753,2,31,1,1,allow
57424,2258,57424,2258,156,156,0,3,8,3,0,allow
36084,80,36084,80,514,246,268,9,76,5,4,allow
5588,5588,0,0,3354,1792,1562,46,193,23,23,allow
61942,3389,61942,3389,3347,1458,1889,15,18,8,7,allow
56811,53,1928,53,762,97,665,2,30,1,1,allow
49009,53,49009,53,172,76,96,2,30,1,1,allow
57074,53,56571,53,190,97,93,2,30,1,1,allow
56417,53,44124,53,752,93,659,2,30,1,1,allow
65491,53,39082,53,186,95,91,2,30,1,1,allow
61732,3389,61732,3389,3380,1730,1650,15,33,8,7,allow
55840,53,25093,53,711,87,624,2,30,1,1,allow
36866,443,19337,443,6798,2901,3897,22,151,13,9,allow
52475,443,47203,443,14713,3210,11503,24,135,9,15,allow
57385,53,40272,53,194,99,95,2,31,1,1,allow
21133,26205,8150,26205,480,149,331,2,1200,1,1,allow
56422,53,35593,53,716,95,621,2,30,1,1,allow
55343,53,13186,53,770,101,669,2,31,1,1,allow
55752,53,35033,53,170,87,83,2,31,1,1,allow
54084,443,63980,443,37440,7952,29488,67,128,28,39,allow
55192,53,1273,53,760,97,663,2,31,1,1,allow
50209,53,45881,53,780,104,676,2,31,1,1,allow
27005,30007,42736,30007,890,126,764,2,31,1,1,allow
57365,53,10039,53,780,104,676,2,31,1,1,allow
55890,53,50894,53,186,95,91,2,31,1,1,allow
65485,53,57081,53,184,94,90,2,31,1,1,allow
49949,53,60223,53,186,95,91,2,31,1,1,allow
65220,53,55552,53,172,88,84,2,31,1,1,allow
50584,53743,42258,53743,1356,300,1056,6,1201,3,3,allow
57122,53,5518,53,295,101,194,4,31,2,2,allow
57128,53,45410,53,755,93,662,2,31,1,1,allow
27005,30006,22484,30006,890,126,764,2,31,1,1,allow
55197,53,53428,53,701,88,613,2,31,1,1,allow
55808,53,19839,53,182,93,89,2,31,1,1,allow
64786,53,39238,53,810,108,702,2,31,1,1,allow
43514,5223,35160,5223,3651,1103,2548,17,1802,10,7,allow
64792,443,39397,443,16199,7657,8542,58,127,28,30,allow
56529,53,60444,53,711,87,624,2,31,1,1,allow
65303,53,22620,53,760,96,664,2,31,1,1,allow
64793,53,59763,53,168,86,82,2,31,1,1,allow
55064,53,40731,53,774,101,673,2,31,1,1,allow
55934,53,55732,53,192,98,94,2,31,1,1,allow
55878,53,54979,53,760,97,663,2,31,1,1,allow
49421,53,15245,53,744,89,655,2,31,1,1,allow
33013,443,50966,443,88895,4807,84088,104,136,37,67,allow
57043,53,5828,53,735,88,647,2,31,1,1,allow
30960,45743,2927,45743,330,330,0,6,3609,6,0,allow
37965,46994,50866,46994,4089,2456,1633,53,1773,31,22,allow
23030,30170,0,0,159,159,0,1,0,1,0,deny
43461,35440,0,0,146,146,0,1,0,1,0,deny
13996,56205,0,0,62,62,0,1,0,1,0,deny
64589,445,0,0,70,70,0,1,0,1,0,drop
24285,26467,0,0,62,62,0,1,0,1,0,deny
64582,445,0,0,70,70,0,1,0,1,0,drop
64583,445,0,0,70,70,0,1,0,1,0,drop
64580,445,0,0,70,70,0,1,0,1,0,drop
53746,36237,0,0,66,66,0,1,0,1,0,deny
59997,445,0,0,66,66,0,1,0,1,0,drop
59743,445,0,0,70,70,0,1,0,1,0,drop
59991,445,0,0,66,66,0,1,0,1,0,drop
65047,53,39231,53,645,185,460,6,40,3,3,allow
50552,53,61704,53,757,102,655,2,30,1,1,allow
65206,53,7490,53,816,102,714,2,30,1,1,allow
56929,53,59011,53,177,94,83,2,30,1,1,allow
64950,53,10318,53,765,102,663,2,30,1,1,allow
64977,53,18612,53,334,94,240,2,30,1,1,allow
65443,53,21010,53,164,86,78,2,30,1,1,allow
55727,53,48303,53,177,94,83,2,30,1,1,allow
64227,53,63621,53,302,92,210,4,30,2,2,allow
53775,8999,38559,8999,320,140,180,6,5,3,3,allow
55666,36653,34073,36653,70,70,0,1,5,1,0,allow
51946,9407,60623,9407,70,70,0,1,4,1,0,allow
65123,53,59199,53,816,102,714,2,29,1,1,allow
65474,53,42125,53,197,94,103,2,29,1,1,allow
57424,53,63565,53,197,102,95,2,30,1,1,allow
43136,443,64659,443,9329,2900,6429,27,135,15,12,allow
55476,80,7666,80,498,280,218,8,26,5,3,allow
57051,53,10858,53,354,90,264,4,50,2,2,allow
51823,80,56758,80,4456,1889,2567,11,39,6,5,allow
37578,443,36969,443,7534,2392,5142,25,25,14,11,allow
53750,27352,15975,27352,70,70,0,1,4,1,0,allow
53765,16178,52610,16178,70,70,0,2,7,2,0,allow
50607,80,15942,80,1657,1247,410,8,14,5,3,allow
53767,10004,34912,10004,70,70,0,2,7,2,0,allow
55477,80,28863,80,498,280,218,8,26,5,3,allow
51942,22272,28402,22272,140,70,70,2,5,1,1,allow
64556,53,11651,53,195,102,93,2,29,1,1,allow
55337,53,41001,53,198,102,96,2,29,1,1,allow
57424,53,59355,53,197,102,95,2,29,1,1,allow
55846,53,44796,53,821,102,719,2,29,1,1,allow
50001,53,34185,53,239,94,145,2,29,1,1,allow
56755,53,13799,53,184,94,90,2,29,1,1,allow
64741,53,21274,53,198,86,112,2,29,1,1,allow
57444,53,35555,53,177,94,83,2,29,1,1,allow
64255,53,12895,53,200,94,106,2,29,1,1,allow
55593,53,62454,53,193,102,91,2,30,1,1,allow
49607,53,13201,53,259,102,157,2,29,1,1,allow
65266,53,57275,53,216,110,106,2,29,1,1,allow
56496,53,21788,53,164,86,78,2,30,1,1,allow
56702,443,53688,443,8058,2038,6020,20,15,11,9,allow
36731,80,36731,80,514,246,268,9,75,5,4,allow
51079,80,14506,80,19699,2094,17605,32,229,14,18,allow
9170,80,30007,80,318,192,126,6,29,4,2,allow
64639,3389,64639,3389,3409,1454,1955,16,16,8,8,allow
65180,53,35991,53,199,102,97,2,30,1,1,allow
49393,53,14583,53,183,86,97,2,30,1,1,allow
65213,53,57292,53,198,94,104,2,30,1,1,allow
64257,53,4953,53,261,94,167,2,30,1,1,allow
49675,53,53697,53,199,102,97,2,30,1,1,allow
55444,53,60851,53,193,102,91,2,30,1,1,allow
50265,443,41315,443,10788,6022,4766,36,144,20,16,allow
48436,53,48436,53,216,82,134,2,32,1,1,allow
51972,13604,16172,13604,258,70,188,4,8,2,2,allow
35615,443,10957,443,6179,1242,4937,22,42,11,11,allow
38690,443,51124,443,1107678,21465,1086213,1058,16,312,746,allow
9154,443,7257,443,6258,843,5415,19,29,10,9,allow
9149,443,28137,443,6128,763,5365,17,29,9,8,allow
9151,443,63028,443,6128,763,5365,17,29,9,8,allow
9148,443,13581,443,6334,840,5494,19,29,10,9,allow
27005,50019,16642,50019,877,126,751,2,30,1,1,allow
65206,53,37251,53,193,102,91,2,30,1,1,allow
64714,53,3550,53,168,86,82,2,31,1,1,allow
64433,53,29795,53,214,102,112,2,30,1,1,allow
59788,443,42215,443,162,102,60,2,5,1,1,allow
56814,53,9627,53,193,102,91,2,30,1,1,allow
50599,80,5247,80,8601,6265,2336,18,26,10,8,allow
55962,53,37019,53,193,102,91,2,30,1,1,allow
42597,443,16661,443,8533,2023,6510,23,15,12,11,allow
9175,443,52821,443,6331,837,5494,19,28,10,9,allow
65330,53,53724,53,723,102,621,2,30,1,1,allow
9177,443,23456,443,6331,837,5494,19,28,10,9,allow
64385,53,21883,53,307,105,202,4,47,2,2,allow
49228,53,7287,53,193,102,91,2,30,1,1,allow
65443,53,23920,53,172,94,78,2,30,1,1,allow
49876,53,41654,53,199,102,97,2,30,1,1,allow
65280,53,36660,53,213,102,111,2,30,1,1,allow
49228,53,30182,53,193,102,91,2,30,1,1,allow
55727,53,61818,53,177,94,83,2,30,1,1,allow
27005,28002,21197,28002,918,126,792,2,30,1,1,allow
56138,53,42749,53,259,86,173,2,30,1,1,allow
61128,80,61128,80,1382,855,527,11,20,6,5,allow
9169,80,55933,80,318,192,126,6,29,4,2,allow
9117,80,20757,80,318,192,126,6,29,4,2,allow
9138,80,8999,80,318,192,126,6,29,4,2,allow
50086,53,16389,53,193,102,91,2,30,1,1,allow
49876,53,54830,53,199,102,97,2,30,1,1,allow
55043,53,56264,53,274,110,164,2,30,1,1,allow
51943,55464,52953,55464,70,70,0,1,5,1,0,allow
55663,19994,24256,19994,70,70,0,1,5,1,0,allow
45435,443,1325,443,8034,400,7634,14,193,2,12,allow
9134,80,9239,80,318,192,126,6,29,4,2,allow
7100,53,7100,53,644,90,554,2,30,1,1,allow
49555,53,24625,53,193,102,91,2,30,1,1,allow
65024,53,20074,53,199,102,97,2,30,1,1,allow
64569,53,52034,53,258,102,156,2,30,1,1,allow
33084,443,45325,443,15474,4188,11286,14,139,4,10,allow
64154,53,27741,53,194,102,92,2,31,1,1,allow
46299,443,43257,443,648083,28117,619966,751,30,323,428,allow
27005,32036,10706,32036,876,126,750,2,30,1,1,allow
52027,443,40345,443,8698,1393,7305,22,16,12,10,allow
56703,443,53583,443,8006,1986,6020,20,15,11,9,allow
47552,443,59060,443,6268,1904,4364,30,119,16,14,allow
38692,443,23262,443,10335,2523,7812,42,32,20,22,allow
34979,80,8756,80,1150,465,685,14,268,5,9,allow
42598,443,46015,443,3134,1983,1151,15,15,8,7,allow
51941,19333,59185,19333,70,70,0,1,5,1,0,allow
60450,56494,22867,56494,70,70,0,2,8,2,0,allow
51974,54759,44030,54759,70,70,0,2,7,2,0,allow
41980,443,47669,443,11377,7703,3674,26,162,19,7,allow
41741,443,53387,443,5379,1424,3955,19,507,11,8,allow
9171,80,16073,80,318,192,126,6,29,4,2,allow
40125,443,1221,443,7000,1799,5201,20,256,12,8,allow
55080,80,25795,80,2305712,80795,2224917,2771,52,1293,1478,allow
9121,80,6298,80,318,192,126,6,29,4,2,allow
56701,443,57052,443,8007,1987,6020,20,15,11,9,allow
34419,443,53851,443,2713,1386,1327,18,316,10,8,allow
9141,80,1670,80,378,192,186,7,29,4,3,allow
64892,53,50035,53,252,102,150,2,29,1,1,allow
55593,53,42641,53,193,102,91,2,29,1,1,allow
55562,53,27476,53,239,94,145,2,29,1,1,allow
65123,53,3182,53,193,102,91,2,29,1,1,allow
56884,53,31028,53,177,94,83,2,30,1,1,allow
56884,53,27069,53,177,94,83,2,30,1,1,allow
54996,53,30248,53,252,102,150,2,29,1,1,allow
49687,53,63012,53,241,94,147,2,29,1,1,allow
64154,53,35293,53,194,102,92,2,29,1,1,allow
64195,53,9148,53,270,110,160,2,29,1,1,allow
65180,53,28162,53,199,102,97,2,30,1,1,allow
65491,53,7417,53,193,102,91,2,30,1,1,allow
65266,53,39575,53,216,110,106,2,30,1,1,allow
57029,53,63160,53,246,94,152,2,30,1,1,allow
49555,53,29992,53,193,102,91,2,30,1,1,allow
56521,53,59104,53,310,126,184,2,30,1,1,allow
49876,53,33233,53,199,102,97,2,30,1,1,allow
27005,32056,3703,32056,886,126,760,2,30,1,1,allow
56212,53,11758,53,168,86,82,2,31,1,1,allow
55742,53,55832,53,193,102,91,2,30,1,1,allow
64491,53,54856,53,244,94,150,2,30,1,1,allow
55752,53,39716,53,177,94,83,2,30,1,1,allow
49355,53,45330,53,184,102,82,2,30,1,1,allow
27005,27055,18786,27055,915,126,789,2,30,1,1,allow
55580,53,57711,53,195,102,93,2,31,1,1,allow
49920,443,59929,443,6489,2137,4352,28,143,14,14,allow
51970,18752,54925,18752,70,70,0,2,8,2,0,allow
55667,19667,61736,19667,70,70,0,1,5,1,0,allow
65061,53,60210,53,733,204,529,6,40,3,3,allow
62896,993,54480,993,178,118,60,2,15,1,1,allow
9153,443,27123,443,6059,773,5286,17,29,9,8,allow
9147,443,1443,443,6334,840,5494,19,29,10,9,allow
49961,53,12419,53,377,107,270,4,45,2,2,allow
50011,53,8163,53,272,110,162,2,30,1,1,allow
65416,53,1423,53,758,102,656,2,30,1,1,allow
57385,53,34809,53,197,102,95,2,30,1,1,allow
56393,53,59869,53,197,94,103,2,30,1,1,allow
49696,53,15575,53,200,94,106,2,30,1,1,allow
55133,53,36178,53,184,102,82,2,31,1,1,allow
65485,53,34553,53,184,94,90,2,31,1,1,allow
27005,27054,38944,27054,921,126,795,2,30,1,1,allow
27005,27058,35794,27058,908,126,782,2,30,1,1,allow
63919,80,26463,80,314,192,122,6,15,4,2,allow
49359,53,64327,53,412,122,290,4,45,2,2,allow
9176,443,40179,443,6331,837,5494,19,28,10,9,allow
49856,443,13732,443,18685,4528,14157,31,151,13,18,allow
1039,53,1039,53,644,90,554,2,30,1,1,allow
64940,53,17775,53,758,102,656,2,30,1,1,allow
49684,53,44986,53,265,110,155,2,30,1,1,allow
57074,53,64644,53,195,102,93,2,30,1,1,allow
49291,53,21649,53,771,102,669,2,30,1,1,allow
55444,53,54146,53,193,102,91,2,30,1,1,allow
62758,443,37429,443,22187,14208,7979,52,130,25,27,allow
45210,443,36516,443,1699,1038,661,16,276,9,7,allow
55742,53,11069,53,193,102,91,2,31,1,1,allow
55358,53,28706,53,183,94,89,2,31,1,1,allow
60449,28260,44457,28260,70,70,0,2,8,2,0,allow
51854,80,4415,80,5438,1822,3616,17,38,11,6,allow
9166,443,13455,443,5242,902,4340,16,29,8,8,allow
58771,443,23708,443,5167,700,4467,16,15,7,9,allow
64540,53,29410,53,94,94,0,1,30,1,0,allow
50086,53,18970,53,816,102,714,2,30,1,1,allow
56814,53,30689,53,816,102,714,2,30,1,1,allow
57201,53,63092,53,195,102,93,2,30,1,1,allow
55898,53,25351,53,757,102,655,2,30,1,1,allow
51261,53,15838,53,259,86,173,2,30,1,1,allow
55890,53,43973,53,193,102,91,2,30,1,1,allow
63970,53,14367,53,200,94,106,2,30,1,1,allow
49229,53,47924,53,183,94,89,2,30,1,1,allow
65466,53,32995,53,200,102,98,2,30,1,1,allow
55962,53,28186,53,193,102,91,2,30,1,1,allow
56755,53,24589,53,184,94,90,2,30,1,1,allow
55580,53,20402,53,195,102,93,2,30,1,1,allow
57385,53,56308,53,197,102,95,2,30,1,1,allow
56212,53,23655,53,184,102,82,2,30,1,1,allow
57275,53,22195,53,199,102,97,2,31,1,1,allow
49966,53,5626,53,168,78,90,2,30,1,1,allow
55890,53,44710,53,193,102,91,2,31,1,1,allow
57226,53,39140,53,178,94,84,2,31,1,1,allow
64955,53,63777,53,210,110,100,2,30,1,1,allow
55752,53,65323,53,177,94,83,2,30,1,1,allow
64526,53,11461,53,377,94,283,2,30,1,1,allow
55337,53,8844,53,198,102,96,2,31,1,1,allow
55391,53,35560,53,210,110,100,2,31,1,1,allow
56892,53,51389,53,199,102,97,2,31,1,1,allow
56004,53,52519,53,178,94,84,2,31,1,1,allow
6881,6881,2586,6881,237,118,119,2,1200,1,1,allow
65304,53,24960,53,195,102,93,2,31,1,1,allow
53258,443,49616,443,26995,3729,23266,40,137,16,24,allow
64016,53,59779,53,184,94,90,2,31,1,1,allow
57464,443,33460,443,7715,1772,5943,25,275,13,12,allow
57470,22796,55699,22796,2224,1852,372,33,1565,27,6,allow
65491,53,33767,53,193,102,91,2,31,1,1,allow
55441,53,20150,53,216,110,106,2,31,1,1,allow
55776,53,14354,53,271,93,178,4,31,2,2,allow
57470,26247,60262,26247,1320,1320,0,21,1624,21,0,allow
57228,53,47856,53,199,102,97,2,31,1,1,allow
35186,443,1570,443,130,70,60,3,5,2,1,allow
58767,443,20066,443,5167,700,4467,16,15,7,9,allow
52441,53,0,0,86,86,0,1,30,1,0,allow
51968,43622,9817,43622,70,70,0,2,8,2,0,allow
51969,37558,21407,37558,70,70,0,2,8,2,0,allow
43109,80,31634,80,7607,3563,4044,18,20,9,9,allow
56704,53,49275,53,177,94,83,2,31,1,1,allow
57591,53,13897,53,165,78,87,2,31,1,1,allow
55934,53,39869,53,196,102,94,2,31,1,1,allow
6882,27032,16689,27032,1200,1200,0,9,1201,9,0,allow
56700,443,13069,443,8059,2039,6020,20,16,11,9,allow
58770,443,24221,443,6033,770,5263,18,15,8,10,allow
53748,51413,19666,51413,70,70,0,1,5,1,0,allow
46771,80,6345,80,2066,1369,697,13,84,7,6,allow
34418,443,25762,443,6402,1595,4807,23,316,12,11,allow
59982,445,0,0,66,66,0,1,0,1,0,drop
59989,445,0,0,66,66,0,1,0,1,0,drop
59986,445,0,0,66,66,0,1,0,1,0,drop
59985,445,0,0,66,66,0,1,0,1,0,drop
59984,445,0,0,66,66,0,1,0,1,0,drop
59979,445,0,0,66,66,0,1,0,1,0,drop
1903,43890,0,0,66,66,0,1,0,1,0,deny
64573,445,0,0,70,70,0,1,0,1,0,drop
1034,26296,0,0,159,159,0,1,0,1,0,deny
59734,445,0,0,70,70,0,1,0,1,0,drop
59732,445,0,0,70,70,0,1,0,1,0,drop
59733,445,0,0,70,70,0,1,0,1,0,drop
64569,445,0,0,70,70,0,1,0,1,0,drop
64567,445,0,0,70,70,0,1,0,1,0,drop
64565,445,0,0,70,70,0,1,0,1,0,drop
59728,445,0,0,70,70,0,1,0,1,0,drop
22409,55442,0,0,74,74,0,1,0,1,0,deny
59726,445,0,0,70,70,0,1,0,1,0,drop
12458,161,0,0,85,85,0,1,0,1,0,deny
51414,22,0,0,60,60,0,1,0,1,0,deny
41744,37965,0,0,62,62,0,1,0,1,0,deny
45908,33330,0,0,60,60,0,1,0,1,0,deny
12737,35440,0,0,62,62,0,1,0,1,0,deny
56462,37965,0,0,66,66,0,1,0,1,0,deny
14042,22114,0,0,62,62,0,1,0,1,0,deny
16387,8455,0,0,60,60,0,1,0,1,0,deny
16387,49252,0,0,60,60,0,1,0,1,0,deny
16387,35244,0,0,60,60,0,1,0,1,0,deny
7664,2149,0,0,66,66,0,1,0,1,0,deny
64563,445,0,0,70,70,0,1,0,1,0,drop
64561,445,0,0,70,70,0,1,0,1,0,drop
64557,445,0,0,70,70,0,1,0,1,0,drop
36237,23,0,0,60,60,0,1,0,1,0,deny
59718,445,0,0,70,70,0,1,0,1,0,drop
59974,445,0,0,66,66,0,1,0,1,0,drop
64556,445,0,0,70,70,0,1,0,1,0,drop
59970,445,0,0,66,66,0,1,0,1,0,drop
3074,64147,0,0,62,62,0,1,0,1,0,deny
59969,445,0,0,66,66,0,1,0,1,0,drop
59967,445,0,0,66,66,0,1,0,1,0,drop
21759,51505,0,0,62,62,0,1,0,1,0,deny
19617,39004,0,0,62,62,0,1,0,1,0,deny
14148,1,0,0,66,66,0,1,0,1,0,deny
7655,23,0,0,60,60,0,1,0,1,0,deny
59965,445,0,0,66,66,0,1,0,1,0,drop
62731,21247,0,0,62,62,0,1,0,1,0,deny
59711,445,0,0,70,70,0,1,0,1,0,drop
59710,445,0,0,70,70,0,1,0,1,0,drop
54593,51505,0,0,66,66,0,1,0,1,0,deny
57131,26296,0,0,145,145,0,1,0,1,0,deny
14183,26467,0,0,62,62,0,1,0,1,0,deny
62912,26467,0,0,62,62,0,1,0,1,0,deny
31500,1,0,0,146,146,0,1,0,1,0,deny
64548,445,0,0,70,70,0,1,0,1,0,drop
5859,11392,0,0,62,62,0,1,0,1,0,deny
64544,445,0,0,70,70,0,1,0,1,0,drop
64540,445,0,0,70,70,0,1,0,1,0,drop
59705,445,0,0,70,70,0,1,0,1,0,drop
59703,445,0,0,70,70,0,1,0,1,0,drop
59954,445,0,0,66,66,0,1,0,1,0,drop
19634,64147,0,0,62,62,0,1,0,1,0,deny
54351,23,0,0,60,60,0,1,0,1,0,deny
59699,445,0,0,70,70,0,1,0,1,0,drop
12262,22114,0,0,146,146,0,1,0,1,0,deny
59698,445,0,0,70,70,0,1,0,1,0,drop
41249,50584,0,0,62,62,0,1,0,1,0,deny
59947,445,0,0,66,66,0,1,0,1,0,drop
64530,445,0,0,70,70,0,1,0,1,0,drop
64346,51505,0,0,66,66,0,1,0,1,0,deny
53906,44512,0,0,62,62,0,1,0,1,0,deny
59944,445,0,0,66,66,0,1,0,1,0,drop
35015,17,0,0,60,60,0,1,0,1,0,deny
59693,445,0,0,70,70,0,1,0,1,0,drop
55600,22,0,0,60,60,0,1,0,1,0,deny
44466,443,54385,443,466,392,74,4,0,3,1,allow
54779,50584,0,0,62,62,0,1,0,1,0,deny
59936,445,0,0,66,66,0,1,0,1,0,drop
59935,445,0,0,66,66,0,1,0,1,0,drop
24910,64147,0,0,66,66,0,1,0,1,0,deny
60514,39004,0,0,62,62,0,1,0,1,0,deny
46640,4443,0,0,60,60,0,1,0,1,0,deny
17378,44847,0,0,66,66,0,1,0,1,0,deny
60141,62413,0,0,66,66,0,1,0,1,0,deny
58475,11392,0,0,66,66,0,1,0,1,0,deny
59680,445,0,0,70,70,0,1,0,1,0,drop
1024,22114,0,0,146,146,0,1,0,1,0,deny
64518,445,0,0,70,70,0,1,0,1,0,deny
64516,445,0,0,70,70,0,1,0,1,0,drop
64517,445,0,0,70,70,0,1,0,1,0,drop
59919,445,0,0,66,66,0,1,0,1,0,drop
59922,445,0,0,66,66,0,1,0,1,0,drop
59917,445,0,0,66,66,0,1,0,1,0,drop
59920,445,0,0,66,66,0,1,0,1,0,drop
59921,445,0,0,66,66,0,1,0,1,0,drop
59918,445,0,0,66,66,0,1,0,1,0,drop
59916,445,0,0,66,66,0,1,0,1,0,drop
59914,445,0,0,66,66,0,1,0,1,0,drop
443,51550,0,0,100,100,0,1,0,1,0,deny
59677,445,0,0,70,70,0,1,0,1,0,drop
45682,25604,0,0,62,62,0,1,0,1,0,deny
59763,25604,0,0,66,66,0,1,0,1,0,deny
59486,50584,0,0,62,62,0,1,0,1,0,deny
56386,50584,0,0,66,66,0,1,0,1,0,deny
443,61686,0,0,1484,1484,0,1,0,1,0,deny
58371,23,0,0,60,60,0,1,0,1,0,deny
17957,64097,0,0,66,66,0,1,0,1,0,deny
63988,50584,0,0,66,66,0,1,0,1,0,deny
49167,19750,0,0,66,66,0,1,0,1,0,deny
50806,51505,0,0,66,66,0,1,0,1,0,deny
35864,44847,0,0,78,78,0,1,0,1,0,deny
37028,51505,0,0,62,62,0,1,0,1,0,deny
57937,22114,0,0,146,146,0,1,0,1,0,deny
59673,445,0,0,70,70,0,1,0,1,0,drop
59671,445,0,0,70,70,0,1,0,1,0,drop
64511,445,0,0,70,70,0,1,0,1,0,drop
64509,445,0,0,70,70,0,1,0,1,0,drop
57538,23,0,0,60,60,0,1,0,1,0,deny
64499,445,0,0,70,70,0,1,0,1,0,drop
64504,445,0,0,70,70,0,1,0,1,0,drop
14336,64147,0,0,62,62,0,1,0,1,0,deny
0,0,0,0,124,64,60,2,0,1,1,allow
59669,445,0,0,70,70,0,1,0,1,0,drop
59900,445,0,0,66,66,0,1,0,1,0,drop
59902,445,0,0,66,66,0,1,0,1,0,drop
59899,445,0,0,66,66,0,1,0,1,0,drop
27337,51505,0,0,62,62,0,1,0,1,0,deny
50052,65008,0,0,60,60,0,1,0,1,0,deny
54280,3385,0,0,60,60,0,1,0,1,0,deny
723,3389,0,0,74,74,0,1,0,1,0,deny
1045,36237,0,0,66,66,0,1,0,1,0,deny
5087,22114,0,0,66,66,0,1,0,1,0,deny
64497,445,0,0,70,70,0,1,0,1,0,drop
64490,445,0,0,70,70,0,1,0,1,0,drop
64489,445,0,0,70,70,0,1,0,1,0,drop
64485,445,0,0,70,70,0,1,0,1,0,drop
47910,7464,0,0,60,60,0,1,0,1,0,deny
59662,445,0,0,70,70,0,1,0,1,0,drop
63461,51505,0,0,66,66,0,1,0,1,0,deny
12260,51505,0,0,62,62,0,1,0,1,0,deny
59660,445,0,0,70,70,0,1,0,1,0,drop
59659,445,0,0,70,70,0,1,0,1,0,drop
34400,39004,0,0,74,74,0,1,0,1,0,deny
59658,445,0,0,70,70,0,1,0,1,0,drop
59657,445,0,0,70,70,0,1,0,1,0,drop
52695,26467,0,0,66,66,0,1,0,1,0,deny
59654,445,0,0,70,70,0,1,0,1,0,drop
59651,445,0,0,70,70,0,1,0,1,0,drop
64478,445,0,0,70,70,0,1,0,1,0,drop
64477,445,0,0,70,70,0,1,0,1,0,drop
64474,445,0,0,70,70,0,1,0,1,0,drop
7286,44847,0,0,66,66,0,1,0,1,0,deny
61766,44847,0,0,62,62,0,1,0,1,0,deny
59889,445,0,0,66,66,0,1,0,1,0,drop
59639,445,0,0,70,70,0,1,0,1,0,drop
59638,445,0,0,70,70,0,1,0,1,0,drop
59634,445,0,0,70,70,0,1,0,1,0,drop
11450,57470,0,0,62,62,0,1,0,1,0,deny
26872,44847,0,0,62,62,0,1,0,1,0,deny
59628,445,0,0,70,70,0,1,0,1,0,drop
56766,53,34150,53,204,104,100,2,30,1,1,allow
55022,53,30402,53,772,103,669,2,30,1,1,allow
56004,53,42302,53,172,88,84,2,30,1,1,allow
64068,53,64068,53,1184,83,1101,4,59,2,2,allow
55742,53,41755,53,186,95,91,2,31,1,1,allow
57321,53,34343,53,762,98,664,2,30,1,1,allow
49177,53,53466,53,735,88,647,2,30,1,1,allow
65264,53,2001,53,738,86,652,2,30,1,1,allow
64810,53,33589,53,272,93,179,4,33,2,2,allow
27005,30008,3198,30008,890,126,764,2,31,1,1,allow
49759,53,54195,53,164,84,80,2,31,1,1,allow
50930,443,59751,443,9354,2370,6984,24,16,13,11,allow
63154,443,63154,443,4642,1735,2907,19,30,11,8,allow
58751,443,12034,443,10505,6856,3649,29,16,15,14,allow
55025,80,12764,80,1142,626,516,8,180,5,3,allow
50299,53,31351,53,770,102,668,2,30,1,1,allow
49314,443,47530,443,3185,2263,922,18,25,9,9,allow
55580,53,25974,53,190,97,93,2,30,1,1,allow
51940,26399,4423,26399,66,66,0,1,5,1,0,allow
49742,53,64012,53,731,91,640,2,30,1,1,allow
39718,443,11292,443,10186,3128,7058,26,16,13,13,allow
60445,20555,38160,20555,70,70,0,1,5,1,0,allow
64172,53,18592,53,194,99,95,2,30,1,1,allow
60776,4156,29632,4156,66,66,0,1,5,1,0,allow
52607,443,60417,443,18341,14819,3522,59,1044,31,28,allow
57226,53,4215,53,88,88,0,1,30,1,0,allow
55187,53,20282,53,256,93,163,2,30,1,1,allow
55337,53,28465,53,196,100,96,2,30,1,1,allow
65304,53,37771,53,190,97,93,2,30,1,1,allow
56974,53,21612,53,814,110,704,2,30,1,1,allow
27005,27017,35539,27017,873,126,747,2,31,1,1,allow
49313,443,5265,443,3185,2263,922,18,25,9,9,allow
55238,53,7598,53,168,86,82,2,31,1,1,allow
52478,443,48158,443,9844,3089,6755,21,133,10,11,allow
58754,443,12477,443,7674,4959,2715,24,16,13,11,allow
57992,80,4887,80,10247,3696,6551,32,33,16,16,allow
55776,53,13718,53,182,93,89,3,33,2,1,allow
51966,18716,12930,18716,70,70,0,2,8,2,0,allow
58745,443,47699,443,14654,9694,4960,36,17,19,17,allow
58749,443,22893,443,6246,4267,1979,21,16,11,10,allow
56829,53,58561,53,170,87,83,2,30,1,1,allow
64711,53,23065,53,760,97,663,2,30,1,1,allow
55211,53,19820,53,760,97,663,2,30,1,1,allow
64902,53,48255,53,762,98,664,2,30,1,1,allow
56509,53,41875,53,747,90,657,2,31,1,1,allow
57307,53,57558,53,170,87,83,2,31,1,1,allow
61850,34021,0,0,66,66,0,1,91,1,0,allow
49421,5228,11226,5228,8399,1901,6498,39,1562,16,23,allow
27005,30005,45159,30005,890,126,764,2,31,1,1,allow
33525,53,23050,53,168,78,90,2,31,1,1,allow
56128,53,30035,53,744,89,655,2,31,1,1,allow
55820,53,6966,53,168,86,82,2,31,1,1,allow
56470,53,21021,53,196,100,96,2,31,1,1,allow
64421,53,64542,53,172,88,84,2,31,1,1,allow
56204,53,35079,53,190,97,93,2,31,1,1,allow
64081,443,44288,443,7280,2277,5003,19,136,9,10,allow
50265,34311,31562,34311,480,149,331,2,1200,1,1,allow
50324,53,1643,53,754,94,660,2,31,1,1,allow
57907,53,57907,53,228,97,131,2,31,1,1,allow
56180,53,48216,53,757,98,659,2,31,1,1,allow
49918,53,24031,53,196,100,96,2,31,1,1,allow
56892,53,3600,53,198,101,97,2,31,1,1,allow
55067,53,2725,53,164,84,80,2,31,1,1,allow
57302,53,18711,53,770,102,668,2,31,1,1,allow
55413,53,9671,53,216,110,106,2,31,1,1,allow
64976,53,22301,53,186,95,91,2,31,1,1,allow
55912,53,49501,53,198,101,97,2,31,1,1,allow
56310,53,55159,53,760,97,663,2,31,1,1,allow
55283,53,5653,53,754,94,660,2,31,1,1,allow
64628,53,57301,53,198,101,97,2,31,1,1,allow
55970,53,39090,53,810,108,702,2,31,1,1,allow
49410,53,65177,53,172,88,84,2,31,1,1,allow
56152,53,61194,53,190,97,93,2,31,1,1,allow
55808,53,45901,53,738,86,652,2,31,1,1,allow
64692,53,27620,53,760,97,663,2,31,1,1,allow
55399,53,7515,53,176,90,86,2,31,1,1,allow
56330,53,30393,53,198,101,97,2,31,1,1,allow
56461,53,50926,53,760,96,664,2,31,1,1,allow
57363,53,6725,53,172,88,84,2,31,1,1,allow
49451,53,46529,53,757,98,659,2,31,1,1,allow
51234,443,8944,443,31736,1463,30273,43,32,14,29,allow
50010,53,39739,53,756,95,661,2,31,1,1,allow
57418,53,27035,53,758,96,662,2,31,1,1,allow
55969,53,43128,53,731,91,640,2,31,1,1,allow
65515,53,32592,53,204,104,100,2,31,1,1,allow
50518,53,60220,53,802,104,698,2,31,1,1,allow
40940,443,13530,443,12685,7319,5366,36,398,15,21,allow
30960,45742,3769,45742,330,330,0,6,3609,6,0,allow
44847,51413,1303,51413,475,150,325,2,1200,1,1,allow
30960,45741,31412,45741,330,330,0,6,3609,6,0,allow
59629,445,0,0,70,70,0,1,0,1,0,drop
43063,57470,0,0,62,62,0,1,0,1,0,deny
42366,57470,0,0,66,66,0,1,0,1,0,deny
57555,35440,0,0,66,66,0,1,0,1,0,deny
16013,35253,0,0,66,66,0,1,0,1,0,deny
1025,51221,0,0,62,62,0,1,0,1,0,deny
8592,35993,0,0,66,66,0,1,0,1,0,deny
23415,11392,0,0,66,66,0,1,0,1,0,deny
52252,46314,0,0,62,62,0,1,0,1,0,deny
64469,445,0,0,70,70,0,1,0,1,0,drop
64467,445,0,0,70,70,0,1,0,1,0,drop
59617,445,0,0,70,70,0,1,0,1,0,drop
49298,53,53447,53,230,102,128,2,30,1,1,allow
64366,53,57312,53,234,94,140,2,30,1,1,allow
35339,443,19701,443,6677,1006,5671,19,27,11,8,allow
56698,443,46123,443,8058,2038,6020,20,15,11,9,allow
49773,53,59337,53,225,110,115,2,30,1,1,allow
64559,53,24538,53,182,94,88,2,30,1,1,allow
56004,53,58058,53,178,94,84,2,30,1,1,allow
49953,53,45166,53,214,110,104,2,30,1,1,allow
46773,80,41646,80,2075,1376,699,13,83,7,6,allow
38691,443,60473,443,90369,3417,86952,95,15,30,65,allow
60779,40010,64094,40010,316,136,180,6,5,3,3,allow
60863,443,14093,443,134,60,74,3,5,2,1,allow
63925,18912,12626,18912,70,70,0,1,4,1,0,allow
64391,53,9777,53,209,102,107,2,29,1,1,allow
56204,53,35086,53,195,102,93,2,30,1,1,allow
46774,80,26120,80,2074,1375,699,13,83,7,6,allow
43879,443,28850,443,71822,4809,67013,112,241,54,58,allow
34312,80,11906,80,874,500,374,10,14,6,4,allow
64665,53,19631,53,181,94,87,2,31,1,1,allow
38936,443,16870,443,3217,2090,1127,16,255,9,7,allow
56470,53,41515,53,198,102,96,2,30,1,1,allow
40306,443,40306,443,4520,1613,2907,19,26,11,8,allow
57434,443,22130,443,9237,2447,6790,30,16,14,16,allow
56984,53,20901,53,199,102,97,2,29,1,1,allow
49906,53,24653,53,200,94,106,2,29,1,1,allow
50427,443,32859,443,783009,84254,698755,776,706,250,526,allow
57122,53,4958,53,199,102,97,2,29,1,1,allow
45862,443,6882,443,234,234,0,4,11,4,0,allow
49229,53,40938,53,183,94,89,2,29,1,1,allow
55358,53,38932,53,183,94,89,2,29,1,1,allow
65430,53,43606,53,305,94,211,2,29,1,1,allow
57122,53,16456,53,199,102,97,2,29,1,1,allow
56984,53,7040,53,199,102,97,2,29,1,1,allow
56984,53,53152,53,199,102,97,2,29,1,1,allow
49949,53,18474,53,193,102,91,2,30,1,1,allow
34415,443,34473,443,6397,1590,4807,23,315,12,11,allow
58763,443,45079,443,5108,700,4408,15,15,7,8,allow
63913,24806,2171,24806,630,508,122,9,15,7,2,allow
51794,80,29436,80,5480,3236,2244,19,47,12,7,allow
57275,53,57643,53,199,102,97,2,30,1,1,allow
55752,53,32253,53,177,94,83,2,30,1,1,allow
37565,123,4980,123,184,94,90,2,30,1,1,allow
50581,53,22242,53,177,94,83,2,30,1,1,allow
63033,443,16495,443,6869,3059,3810,30,123,15,15,allow
65273,53,64303,53,226,102,124,2,30,1,1,allow
49181,53,18919,53,184,102,82,2,30,1,1,allow
49167,53,55211,53,258,94,164,2,30,1,1,allow
43163,443,21681,443,10100,3072,7028,25,16,14,11,allow
36368,80,54133,80,78,78,0,1,5,1,0,allow
56766,53,19363,53,210,110,100,2,30,1,1,allow
52914,443,10656,443,70,70,0,1,5,1,0,allow
56894,53,27064,53,178,94,84,2,30,1,1,allow
64949,53,27960,53,472,124,348,4,39,2,2,allow
55489,53,44022,53,185,102,83,2,30,1,1,allow
57590,53,59223,53,260,86,174,2,30,1,1,allow
60462,80,40235,80,1588,553,1035,10,75,6,4,allow
56422,53,41175,53,199,102,97,2,30,1,1,allow
55808,53,32888,53,183,94,89,2,30,1,1,allow
64445,53,20808,53,269,94,175,2,30,1,1,allow
46378,443,41415,443,10675,4478,6197,25,16,13,12,allow
43025,443,51895,443,25223,13115,12108,63,116,33,30,allow
27005,33026,58261,33026,879,126,753,3,32,2,1,allow
55808,53,36895,53,183,94,89,2,30,1,1,allow
34416,443,50099,443,6396,1589,4807,23,315,12,11,allow
14421,443,39143,443,15204,8747,6457,83,167,44,39,allow
56646,80,51204,80,234,234,0,4,12,4,0,allow
64559,53,29849,53,198,110,88,2,30,1,1,allow
64172,53,61363,53,361,99,262,4,54,2,2,allow
56766,53,15187,53,210,110,100,2,30,1,1,allow
49812,53,48839,53,392,101,291,4,39,2,2,allow
56236,53,43042,53,241,94,147,2,30,1,1,allow
55934,53,48489,53,196,102,94,2,30,1,1,allow
43162,443,31273,443,10096,3002,7094,25,16,13,12,allow
55934,53,60885,53,196,102,94,2,30,1,1,allow
49181,53,64897,53,168,86,82,2,30,1,1,allow
49364,53,61056,53,779,86,693,2,30,1,1,allow
51814,80,8693,80,11975,2907,9068,24,38,14,10,allow
56766,53,59139,53,210,110,100,2,30,1,1,allow
56892,53,6597,53,199,102,97,2,30,1,1,allow
64068,53,64068,53,1184,83,1101,4,59,2,2,allow
64579,53,56844,53,178,94,84,2,30,1,1,allow
49837,53,44716,53,734,86,648,2,30,1,1,allow
49734,53,20221,53,216,110,106,2,30,1,1,allow
50966,443,50616,443,17161,1619,15542,18,143,4,14,allow
55391,53,33139,53,210,110,100,2,30,1,1,allow
17750,44597,35749,44597,481,150,331,2,1200,1,1,allow
27005,33084,13746,33084,906,126,780,2,30,1,1,allow
55912,53,11122,53,199,102,97,2,30,1,1,allow
57385,53,7964,53,197,102,95,2,30,1,1,allow
65491,53,31323,53,193,102,91,2,33,1,1,allow
9916,53,9916,53,235,90,145,2,33,1,1,allow
53146,50393,21783,50393,70,70,0,2,8,2,0,allow
50700,80,7007,80,142,142,0,1,5,1,0,allow
65493,443,45559,443,438968,12780,426188,449,16,157,292,allow
62525,7080,62525,7080,2960,432,2528,11,15,6,5,allow
64276,53,63257,53,398,105,293,4,46,2,2,allow
50195,53,23918,53,199,102,97,2,30,1,1,allow
64879,53,48255,53,356,118,238,2,30,1,1,allow
50581,53,15550,53,185,102,83,2,30,1,1,allow
64579,53,27350,53,178,94,84,2,30,1,1,allow
50168,53,56159,53,211,78,133,2,30,1,1,allow
64867,53,35181,53,184,86,98,2,30,1,1,allow
36406,5228,24879,5228,17762,4403,13359,92,616,47,45,allow
43676,443,26633,443,5903,1367,4536,18,16,10,8,allow
9192,443,26579,443,318,192,126,6,22,4,2,allow
56829,53,52849,53,185,102,83,2,30,1,1,allow
55133,53,13417,53,168,86,82,2,30,1,1,allow
37027,53,20580,53,168,78,90,2,30,1,1,allow
1931,53,26121,53,210,78,132,2,30,1,1,allow
56152,53,29649,53,195,102,93,2,30,1,1,allow
56704,53,2195,53,177,94,83,2,30,1,1,allow
53221,53,3242,53,165,78,87,2,30,1,1,allow
64421,53,34149,53,178,94,84,2,30,1,1,allow
49174,53,10014,53,323,107,216,4,47,2,2,allow
49192,8106,32598,8106,2050,1277,773,15,15,8,7,allow
46772,80,10171,80,2068,1371,697,13,83,7,6,allow
63915,23225,23322,23225,564,382,182,9,15,6,3,allow
46770,80,34528,80,2068,1371,697,13,83,7,6,allow
56699,443,19537,443,8006,1986,6020,20,15,11,9,allow
48086,443,38296,443,3138,2011,1127,16,255,9,7,allow
35340,443,44611,443,7470,1088,6382,21,27,12,9,allow
65304,53,22589,53,308,97,211,4,33,2,2,allow
51967,12110,50176,12110,70,70,0,2,7,2,0,allow
52477,443,18110,443,8788,2185,6603,15,134,7,8,allow
46769,80,58026,80,3589,2432,1157,17,86,9,8,allow
53721,443,43069,443,70,70,0,2,7,2,0,allow
48135,443,38274,443,6426,1858,4568,22,16,12,10,allow
42438,443,37580,443,7747,1737,6010,27,316,13,14,allow
63924,26328,47247,26328,70,70,0,1,4,1,0,allow
63923,59177,22656,59177,70,70,0,1,4,1,0,allow
51939,34393,16792,34393,70,70,0,1,5,1,0,allow
51938,11218,41228,11218,70,70,0,1,5,1,0,allow
49577,53,58264,53,389,134,255,2,29,1,1,allow
49734,53,21745,53,216,110,106,2,30,1,1,allow
55238,53,10880,53,168,86,82,2,30,1,1,allow
65304,53,31926,53,195,102,93,2,29,1,1,allow
50347,53,2188,53,756,94,662,2,29,1,1,allow
49675,53,62598,53,199,102,97,2,29,1,1,allow
56496,53,36684,53,164,86,78,2,29,1,1,allow
65494,443,61063,443,92044,4379,87665,102,16,37,65,allow
55776,53,26753,53,271,93,178,4,30,2,2,allow
56004,53,60416,53,178,94,84,2,29,1,1,allow
49355,53,6777,53,168,86,82,2,29,1,1,allow
49825,53,24008,53,814,110,704,2,29,1,1,allow
55890,53,15703,53,193,102,91,2,29,1,1,allow
57122,53,57720,53,199,102,97,2,29,1,1,allow
56717,53,63655,53,178,94,84,2,30,1,1,allow
56416,53,40943,53,969,86,883,2,29,1,1,allow
64955,53,3638,53,210,110,100,2,29,1,1,allow
55238,53,60752,53,168,86,82,2,29,1,1,allow
49734,53,34033,53,216,110,106,2,30,1,1,allow
1929,53,20387,53,260,86,174,2,30,1,1,allow
55489,53,35095,53,177,94,83,2,30,1,1,allow
27005,32038,39933,32038,868,126,742,2,30,1,1,allow
56263,53,57632,53,214,110,104,2,31,1,1,allow
55884,53,23694,53,438,180,258,6,30,3,3,allow
57307,53,5441,53,177,94,83,2,30,1,1,allow
57057,53,64992,53,194,102,92,2,31,1,1,allow
55820,53,20613,53,168,86,82,2,30,1,1,allow
58766,443,24380,443,6031,770,5261,18,15,8,10,allow
50081,443,5325,443,11958,2983,8975,28,48,15,13,allow
49650,443,26849,443,92597,47158,45439,747,1187,422,325,allow
35341,443,55051,443,1473,988,485,12,26,7,5,allow
35336,443,36436,443,6821,1076,5745,21,27,12,9,allow
64810,53,44808,53,272,93,179,4,33,2,2,allow
60446,6882,37809,6882,70,70,0,1,5,1,0,allow
51275,10924,1826,10924,70,70,0,1,5,1,0,allow
14429,443,41458,443,4118,2905,1213,27,87,16,11,allow
36314,443,44182,443,6287,1476,4811,25,16,13,12,allow
64632,443,35078,443,8391,5178,3213,41,256,20,21,allow
51667,25826,43054,25826,9415,9415,0,11,30,11,0,allow
49986,53,46060,53,779,110,669,2,30,1,1,allow
55808,53,41787,53,183,94,89,2,30,1,1,allow
49935,53,57757,53,775,102,673,2,30,1,1,allow
49949,53,15582,53,193,102,91,2,30,1,1,allow
55441,53,20729,53,216,110,106,2,30,1,1,allow
55337,53,58173,53,198,102,96,2,30,1,1,allow
27005,33086,33799,33086,877,126,751,2,30,1,1,allow
50605,80,49790,80,1657,1247,410,8,15,5,3,allow
60447,36396,58005,36396,70,70,0,1,5,1,0,allow
51796,80,13753,80,2188,1282,906,13,47,8,5,allow
1932,53,37462,53,210,78,132,2,30,1,1,allow
59899,3389,59899,3389,3504,1790,1714,17,32,9,8,allow
49610,53,48262,53,241,94,147,2,30,1,1,allow
50195,53,43781,53,199,102,97,2,30,1,1,allow
64016,53,52366,53,184,94,90,2,30,1,1,allow
64985,53,37843,53,194,102,92,2,30,1,1,allow
49759,53,54239,53,166,86,80,2,30,1,1,allow
65018,53,21026,53,168,94,74,2,31,1,1,allow
55912,53,4881,53,199,102,97,2,31,1,1,allow
57363,53,22472,53,178,94,84,2,30,1,1,allow
43164,443,24293,443,10030,3002,7028,24,16,13,11,allow
34417,443,59906,443,6378,1571,4807,23,315,12,11,allow
14420,443,3846,443,5103,3164,1939,32,168,17,15,allow
43161,443,23414,443,10102,3072,7030,25,16,14,11,allow
51795,80,9427,80,3955,2325,1630,18,47,11,7,allow
51793,80,57988,80,3960,2330,1630,18,47,11,7,allow
51792,80,21440,80,3840,2265,1575,16,47,10,6,allow
50070,443,16090,443,9148,1570,7578,31,257,13,18,allow
50699,443,40507,443,9382,3057,6325,35,1220,17,18,allow
53631,443,46993,443,31965,26754,5211,63,22,34,29,allow
50187,53,34456,53,168,78,90,2,30,1,1,allow
39115,443,62542,443,335190,17497,317693,449,42,211,238,allow
65220,53,55029,53,178,94,84,2,30,1,1,allow
55441,53,33231,53,216,110,106,2,30,1,1,allow
49953,53,46343,53,214,110,104,2,30,1,1,allow
56422,53,18940,53,199,102,97,2,30,1,1,allow
64956,53,29274,53,196,102,94,2,30,1,1,allow
64814,53,26949,53,165,86,79,2,31,1,1,allow
65485,53,26521,53,184,94,90,2,31,1,1,allow
65238,53,15919,53,168,86,82,2,31,1,1,allow
65275,53,14086,53,168,86,82,2,31,1,1,allow
55413,53,59906,53,216,110,106,2,31,1,1,allow
41886,53,64973,53,168,78,90,2,31,1,1,allow
55186,443,62291,443,7375,1549,5826,31,353,10,21,allow
65249,53,43445,53,733,94,639,2,30,1,1,allow
56330,53,49598,53,199,102,97,2,30,1,1,allow
27005,33111,34326,33111,895,126,769,2,30,1,1,allow
50340,53,17641,53,189,102,87,2,31,1,1,allow
64450,53,63147,53,196,94,102,2,31,1,1,allow
55051,53,44193,53,167,86,81,2,31,1,1,allow
49532,53,18389,53,443,182,261,6,31,3,3,allow
56979,53,43376,53,180,94,86,2,31,1,1,allow
57307,53,15696,53,177,94,83,2,30,1,1,allow
56979,53,3476,53,180,94,86,2,30,1,1,allow
27005,32025,26233,32025,887,126,761,2,30,1,1,allow
64964,53,59512,53,197,102,95,2,31,1,1,allow
56470,53,54674,53,198,102,96,2,31,1,1,allow
45211,443,19368,443,1629,968,661,15,275,8,7,allow
57142,53,22612,53,165,86,79,2,31,1,1,allow
56152,53,5986,53,195,102,93,2,31,1,1,allow
49849,53,33985,53,173,94,79,2,31,1,1,allow
56575,443,16584,443,14284,5729,8555,31,61,19,12,allow
50167,53,41841,53,260,86,174,2,30,1,1,allow
56770,53,31600,53,779,86,693,2,30,1,1,allow
55962,53,7744,53,193,102,91,2,30,1,1,allow
27005,27111,65327,27111,913,126,787,2,30,1,1,allow
49626,53,39799,53,969,86,883,2,30,1,1,allow
64592,53,28124,53,197,94,103,2,30,1,1,allow
64154,53,43771,53,194,102,92,2,30,1,1,allow
55238,53,27709,53,168,86,82,2,31,1,1,allow
64956,53,26166,53,196,102,94,2,30,1,1,allow
56101,53,38415,53,194,102,92,2,31,1,1,allow
64814,53,35715,53,173,94,79,2,30,1,1,allow
57228,53,47428,53,199,102,97,2,30,1,1,allow
55399,53,9206,53,180,94,86,2,31,1,1,allow
65039,53,20269,53,258,94,164,2,31,1,1,allow
64976,53,40742,53,193,102,91,2,31,1,1,allow
56892,53,32986,53,199,102,97,2,31,1,1,allow
49918,53,25518,53,198,102,96,2,31,1,1,allow
64547,53,28372,53,367,102,265,2,31,1,1,allow
56063,53,29074,53,196,102,94,2,31,1,1,allow
55580,53,4575,53,195,102,93,2,31,1,1,allow
32299,40034,44134,40034,253,190,63,2,31,1,1,allow
47473,443,41796,443,11072,3983,7089,27,186,15,12,allow
51388,443,47694,443,4209,1570,2639,14,136,7,7,allow
55850,443,57703,443,4344,2189,2155,15,126,7,8,allow
43674,80,54012,80,3714,1646,2068,18,186,9,9,allow
55392,53,27900,53,195,102,93,2,31,1,1,allow
64624,53,46919,53,228,94,134,2,30,1,1,allow
49918,53,41805,53,198,102,96,2,30,1,1,allow
49410,53,54828,53,178,94,84,2,30,1,1,allow
56330,53,48273,53,199,102,97,2,30,1,1,allow
49671,53,2651,53,166,86,80,2,31,1,1,allow
51964,1103,52197,1103,70,70,0,2,8,2,0,allow
58756,443,10542,443,5168,700,4468,16,15,7,9,allow
51451,443,12053,443,6957,1775,5182,22,17,12,10,allow
57891,80,37829,80,6518,1210,5308,15,24,8,7,allow
56553,443,45538,443,116577,6817,109760,137,62,54,83,allow
64985,53,34087,53,194,102,92,2,30,1,1,allow
51235,80,15389,80,3588,2362,1226,24,87,13,11,allow
53118,443,63279,443,21933,11660,10273,206,188,114,92,allow
51963,21638,62624,21638,70,70,0,2,8,2,0,allow
50321,53,23352,53,438,180,258,6,30,3,3,allow
65018,53,37688,53,152,78,74,2,30,1,1,allow
56204,53,16211,53,195,102,93,2,30,1,1,allow
55399,53,43504,53,180,94,86,2,30,1,1,allow
59874,445,0,0,66,66,0,1,0,1,0,drop
59871,445,0,0,66,66,0,1,0,1,0,drop
7347,56205,0,0,66,66,0,1,0,1,0,deny
34731,22114,0,0,146,146,0,1,0,1,0,deny
64460,445,0,0,70,70,0,1,0,1,0,drop
61000,50432,0,0,146,146,0,1,0,1,0,deny
56098,55442,0,0,66,66,0,1,0,1,0,deny
56218,43890,0,0,66,66,0,1,0,1,0,deny
26601,22114,0,0,66,66,0,1,0,1,0,deny
64455,445,0,0,70,70,0,1,0,1,0,drop
64454,445,0,0,70,70,0,1,0,1,0,drop
64452,445,0,0,70,70,0,1,0,1,0,drop
59613,445,0,0,70,70,0,1,0,1,0,drop
59865,445,0,0,66,66,0,1,0,1,0,drop
2572,35440,0,0,66,66,0,1,0,1,0,deny
9445,56205,0,0,66,66,0,1,0,1,0,deny
57260,51221,0,0,66,66,0,1,0,1,0,deny
59862,445,0,0,66,66,0,1,0,1,0,drop
59857,445,0,0,66,66,0,1,0,1,0,drop
59855,445,0,0,66,66,0,1,0,1,0,drop
59861,445,0,0,66,66,0,1,0,1,0,drop
59853,445,0,0,66,66,0,1,0,1,0,drop
59851,445,0,0,66,66,0,1,0,1,0,drop
59850,445,0,0,66,66,0,1,0,1,0,drop
59604,445,0,0,70,70,0,1,0,1,0,drop
59602,445,0,0,70,70,0,1,0,1,0,drop
59601,445,0,0,70,70,0,1,0,1,0,drop
59598,445,0,0,70,70,0,1,0,1,0,drop
56638,64147,0,0,62,62,0,1,0,1,0,deny
3549,64147,0,0,62,62,0,1,0,1,0,deny
64444,445,0,0,70,70,0,1,0,1,0,drop
59597,445,0,0,70,70,0,1,0,1,0,drop
14036,48817,0,0,62,62,0,1,0,1,0,deny
43129,15503,0,0,62,62,0,1,0,1,0,deny
64441,445,0,0,70,70,0,1,0,1,0,drop
64439,445,0,0,70,70,0,1,0,1,0,drop
64437,445,0,0,70,70,0,1,0,1,0,drop
65012,32468,0,0,66,66,0,1,0,1,0,deny
54313,64147,0,0,66,66,0,1,0,1,0,deny
53044,36237,0,0,62,62,0,1,0,1,0,deny
44459,37807,0,0,62,62,0,1,0,1,0,deny
20563,21247,0,0,66,66,0,1,0,1,0,deny
1560,51505,0,0,62,62,0,1,0,1,0,deny
52184,22114,0,0,66,66,0,1,0,1,0,deny
15465,64147,0,0,62,62,0,1,0,1,0,deny
11136,15503,0,0,145,145,0,1,0,1,0,deny
59591,445,0,0,70,70,0,1,0,1,0,drop
46837,57470,0,0,62,62,0,1,0,1,0,deny
1024,44847,0,0,62,62,0,1,0,1,0,deny
11907,57470,0,0,66,66,0,1,0,1,0,deny
62131,50584,0,0,62,62,0,1,0,1,0,deny
8820,41864,0,0,143,143,0,1,0,1,0,deny
64436,445,0,0,70,70,0,1,0,1,0,drop
64432,445,0,0,70,70,0,1,0,1,0,drop
64429,445,0,0,70,70,0,1,0,1,0,drop
59846,445,0,0,66,66,0,1,0,1,0,drop
64428,445,0,0,70,70,0,1,0,1,0,drop
59841,445,0,0,66,66,0,1,0,1,0,drop
65259,37965,0,0,66,66,0,1,0,1,0,deny
59840,445,0,0,66,66,0,1,0,1,0,drop
59838,445,0,0,66,66,0,1,0,1,0,drop
59583,445,0,0,70,70,0,1,0,1,0,drop
59580,445,0,0,70,70,0,1,0,1,0,drop
59837,445,0,0,66,66,0,1,0,1,0,drop
48903,25773,0,0,157,157,0,1,0,1,0,reset-both
59576,445,0,0,70,70,0,1,0,1,0,drop
64420,445,0,0,70,70,0,1,0,1,0,drop
59575,445,0,0,70,70,0,1,0,1,0,drop
54280,3398,0,0,60,60,0,1,0,1,0,deny
64415,445,0,0,70,70,0,1,0,1,0,drop
64410,445,0,0,70,70,0,1,0,1,0,drop
61392,50584,0,0,62,62,0,1,0,1,0,deny
16721,22114,0,0,146,146,0,1,0,1,0,deny
25565,38308,0,0,60,60,0,1,0,1,0,deny
65398,7129,0,0,66,66,0,1,0,1,0,deny
10445,46824,0,0,62,62,0,1,0,1,0,deny
38411,17372,0,0,62,62,0,1,0,1,0,deny
59571,445,0,0,70,70,0,1,0,1,0,drop
59826,445,0,0,66,66,0,1,0,1,0,drop
60557,23117,0,0,66,66,0,1,0,1,0,deny
59569,445,0,0,70,70,0,1,0,1,0,drop
33003,28543,0,0,62,62,0,1,0,1,0,deny
55027,37965,0,0,145,145,0,1,0,1,0,deny
50106,31573,0,0,62,62,0,1,0,1,0,deny
60272,26467,0,0,66,66,0,1,0,1,0,deny
59818,445,0,0,66,66,0,1,0,1,0,drop
64404,445,0,0,70,70,0,1,0,1,0,drop
7364,50584,0,0,66,66,0,1,0,1,0,deny
59565,445,0,0,70,70,0,1,0,1,0,drop
26131,56205,0,0,62,62,0,1,0,1,0,deny
59815,445,0,0,66,66,0,1,0,1,0,drop
59413,51505,0,0,66,66,0,1,0,1,0,deny
16905,57866,0,0,66,66,0,1,0,1,0,deny
59809,445,0,0,66,66,0,1,0,1,0,drop
10736,35440,0,0,66,66,0,1,0,1,0,deny
59803,445,0,0,66,66,0,1,0,1,0,drop
54324,7000,54324,7000,4007,1690,2317,15,0,8,7,allow
443,61686,0,0,78,78,0,1,0,1,0,deny
443,61686,0,0,642,642,0,1,0,1,0,deny
443,61686,0,0,90,90,0,1,0,1,0,deny
443,61686,0,0,1484,1484,0,1,0,1,0,deny
65422,26467,0,0,62,62,0,1,0,1,0,deny
10834,50584,0,0,66,66,0,1,0,1,0,deny
59552,445,0,0,70,70,0,1,0,1,0,drop
49636,44847,0,0,62,62,0,1,0,1,0,deny
3597,11392,0,0,66,66,0,1,0,1,0,deny
64390,445,0,0,70,70,0,1,0,1,0,drop
64388,445,0,0,70,70,0,1,0,1,0,drop
64389,445,0,0,70,70,0,1,0,1,0,drop
0,0,0,0,480,244,236,4,0,2,2,allow
59549,445,0,0,70,70,0,1,0,1,0,drop
59791,445,0,0,66,66,0,1,0,1,0,drop
59785,445,0,0,66,66,0,1,0,1,0,drop
59789,445,0,0,66,66,0,1,0,1,0,drop
59790,445,0,0,66,66,0,1,0,1,0,drop
59787,445,0,0,66,66,0,1,0,1,0,drop
59792,445,0,0,66,66,0,1,0,1,0,drop
59788,445,0,0,66,66,0,1,0,1,0,drop
59786,445,0,0,66,66,0,1,0,1,0,drop
54389,28543,0,0,66,66,0,1,0,1,0,deny
58686,18375,0,0,66,66,0,1,0,1,0,deny
65344,46824,0,0,66,66,0,1,0,1,0,deny
31727,57470,0,0,62,62,0,1,0,1,0,deny
38253,23117,0,0,146,146,0,1,0,1,0,deny
59544,445,0,0,70,70,0,1,0,1,0,drop
59543,445,0,0,70,70,0,1,0,1,0,drop
7310,44847,0,0,66,66,0,1,0,1,0,deny
35154,42707,0,0,62,62,0,1,0,1,0,deny
57170,38303,0,0,66,66,0,1,0,1,0,deny
59541,445,0,0,70,70,0,1,0,1,0,drop
32648,55108,0,0,145,145,0,1,0,1,0,deny
64381,445,0,0,70,70,0,1,0,1,0,drop
64379,445,0,0,70,70,0,1,0,1,0,drop
64378,445,0,0,70,70,0,1,0,1,0,drop
64375,445,0,0,70,70,0,1,0,1,0,drop
56308,22114,0,0,146,146,0,1,0,1,0,deny
58745,30188,0,0,66,66,0,1,0,1,0,deny
64237,51505,0,0,62,62,0,1,0,1,0,deny
51934,36180,0,0,66,66,0,1,0,1,0,deny
59770,445,0,0,66,66,0,1,0,1,0,drop
59773,445,0,0,66,66,0,1,0,1,0,drop
59771,445,0,0,66,66,0,1,0,1,0,drop
65012,2767,0,0,62,62,0,1,0,1,0,deny
1404,51180,0,0,145,145,0,1,0,1,0,deny
33524,10387,0,0,159,159,0,1,0,1,0,deny
60771,58414,0,0,66,66,0,1,0,1,0,deny
64368,445,0,0,70,70,0,1,0,1,0,drop
13554,44847,0,0,62,62,0,1,0,1,0,deny
59534,445,0,0,70,70,0,1,0,1,0,drop
64361,445,0,0,70,70,0,1,0,1,0,drop
64358,445,0,0,70,70,0,1,0,1,0,drop
64357,445,0,0,70,70,0,1,0,1,0,drop
59532,445,0,0,70,70,0,1,0,1,0,drop
39098,51505,0,0,62,62,0,1,0,1,0,deny
13413,44847,0,0,66,66,0,1,0,1,0,deny
2323,23117,0,0,146,146,0,1,0,1,0,deny
64091,53,52948,53,172,88,84,2,30,1,1,allow
55006,53,7313,53,711,87,624,2,30,1,1,allow
52787,443,54390,443,1550,834,716,19,141,10,9,allow
56330,53,38670,53,760,97,663,2,30,1,1,allow
33898,80,33898,80,14448,2001,12447,26,16,14,12,allow
37619,443,7866,443,6169,4980,1189,28,16,15,13,allow
62387,80,62387,80,548903,4452,544451,440,20,58,382,allow
49566,80,39778,80,10134,1142,8992,24,46,12,12,allow
52729,80,27175,80,2255,997,1258,16,152,8,8,allow
50562,80,50562,80,1696,996,700,11,22,6,5,allow
42999,3389,42999,3389,3910,1805,2105,20,19,12,8,allow
35543,443,52290,443,7298,2601,4697,21,26,10,11,allow
61315,53,20800,53,8616,4944,3672,22,87,11,11,allow
50578,443,12552,443,13595,7140,6455,39,116,24,15,allow
64964,53,20852,53,194,99,95,2,31,1,1,allow
55857,53,27164,53,192,98,94,2,30,1,1,allow
56940,443,15296,443,4184,2787,1397,19,345,10,9,allow
37617,443,6093,443,1654,931,723,20,16,11,9,allow
58034,80,58034,80,21684,903,20781,30,41,12,18,allow
27005,27023,20750,27023,875,126,749,3,32,2,1,allow
42550,5222,16634,5222,2060,981,1079,21,15,11,10,allow
53145,44634,28253,44634,70,70,0,2,8,2,0,allow
51975,443,63500,443,35746,4732,31014,68,67,33,35,allow
65363,53,16393,53,747,93,654,2,30,1,1,allow
60092,443,60092,443,4700,1793,2907,19,28,11,8,allow
58727,443,14813,443,26922,13251,13671,50,18,26,24,allow
46987,443,48389,443,3847,2650,1197,22,32,13,9,allow
52786,443,4838,443,9032,2673,6359,30,142,16,14,allow
43921,443,8788,443,8324,1658,6666,24,83,14,10,allow
37618,443,28939,443,28034,26485,1549,48,16,29,19,allow
57985,80,36501,80,3703,2068,1635,17,33,10,7,allow
64986,53,36194,53,182,93,89,2,31,1,1,allow
58696,443,11326,443,6889,4719,2170,25,330,14,11,allow
58750,443,9806,443,3776,2372,1404,17,15,9,8,allow
55229,443,47978,443,3602,1519,2083,18,60,10,8,allow
58297,443,46075,443,7338,2419,4919,19,17,12,7,allow
46014,443,8499,443,13661,2246,11415,28,256,14,14,allow
58853,443,20470,443,155516,6298,149218,174,107,49,125,allow
50444,443,31610,443,47752,21819,25933,119,704,59,60,allow
55256,443,41393,443,3524,2973,551,15,16,9,6,allow
49208,53,22620,53,578,286,292,9,15,5,4,allow
53742,63344,47218,63344,1294,797,497,13,15,7,6,allow
54489,80,6564,80,2828,1710,1118,10,255,6,4,allow
51937,38056,49622,38056,66,66,0,1,5,1,0,allow
51965,48708,39312,48708,70,70,0,2,8,2,0,allow
62039,443,46235,443,356,60,296,6,18,2,4,allow
52788,443,21903,443,1550,834,716,19,141,10,9,allow
64956,53,25279,53,192,98,94,2,30,1,1,allow
49272,53,25138,53,168,86,82,3,44,2,1,allow
57993,80,1572,80,3822,2132,1690,19,32,11,8,allow
56775,53,1038,53,733,85,648,2,30,1,1,allow
55271,53,11910,53,754,94,660,2,30,1,1,allow
56979,53,36485,53,176,90,86,2,31,1,1,allow
57371,53,32883,53,212,108,104,2,31,1,1,allow
55392,53,38891,53,190,97,93,2,31,1,1,allow
56611,53,54936,53,170,87,83,2,31,1,1,allow
49209,53,10202,53,198,101,97,2,31,1,1,allow
49769,53,37724,53,780,93,687,2,31,1,1,allow
57228,53,5585,53,198,101,97,2,30,1,1,allow
64029,53,31401,53,176,90,86,2,30,1,1,allow
57115,53,15026,53,756,95,661,2,30,1,1,allow
56620,53,43601,53,762,98,664,2,30,1,1,allow
27005,27027,61298,27027,880,126,754,2,31,1,1,allow
49931,53,19319,53,190,97,93,2,31,1,1,allow
32940,443,60631,443,13056,4233,8823,27,121,12,15,allow
49663,53,12596,53,190,97,93,2,31,1,1,allow
50509,53,14571,53,789,110,679,2,31,1,1,allow
65024,53,56492,53,174,89,85,2,31,1,1,allow
56085,53,59161,53,166,85,81,2,31,1,1,allow
55867,53,4524,53,184,94,90,2,31,1,1,allow
8878,80,27996,80,1220,403,817,15,414,4,11,allow
41953,443,3719,443,4129,2865,1264,17,361,9,8,allow
56063,53,65199,53,192,98,94,2,31,1,1,allow
27005,27019,23362,27019,873,126,747,2,31,1,1,allow
55000,53,30925,53,753,93,660,2,31,1,1,allow
64321,53,31319,53,190,97,93,2,31,1,1,allow
57071,53,61611,53,164,84,80,2,31,1,1,allow
50407,53,51161,53,749,89,660,2,31,1,1,allow
33545,443,31253,443,9737,3353,6384,27,32,13,14,allow
59596,3389,59596,3389,3523,1714,1809,17,34,8,9,allow
49372,53,17589,53,216,110,106,2,31,1,1,allow
56626,53,22670,53,710,89,621,2,31,1,1,allow
57177,53,5547,53,174,89,85,2,31,1,1,allow
55728,53,39278,53,190,97,93,2,31,1,1,allow
49783,53,20382,53,174,89,85,2,31,1,1,allow
56009,53,7541,53,172,88,84,2,31,1,1,allow
56927,53,57010,53,749,94,655,2,31,1,1,allow
54663,443,5282,443,18311,11567,6744,43,363,21,22,allow
23553,37965,0,0,62,62,0,1,0,1,0,deny
59531,445,0,0,70,70,0,1,0,1,0,drop
59530,445,0,0,70,70,0,1,0,1,0,drop
1025,50584,0,0,62,62,0,1,0,1,0,deny
59529,445,0,0,70,70,0,1,0,1,0,drop
1026,64147,0,0,62,62,0,1,0,1,0,deny
59526,445,0,0,70,70,0,1,0,1,0,drop
59523,445,0,0,70,70,0,1,0,1,0,drop
9518,30228,0,0,100,100,0,1,0,1,0,deny
9518,57587,0,0,100,100,0,1,0,1,0,deny
9518,3855,0,0,100,100,0,1,0,1,0,deny
6712,44818,0,0,66,66,0,1,0,1,0,deny
55153,53,36786,53,733,94,639,2,30,1,1,allow
64351,445,0,0,70,70,0,1,0,1,0,drop
64349,445,0,0,70,70,0,1,0,1,0,drop
64346,445,0,0,70,70,0,1,0,1,0,drop
37647,29892,0,0,145,145,0,1,0,1,0,deny
26835,47993,0,0,62,62,0,1,0,1,0,deny
59511,445,0,0,70,70,0,1,0,1,0,drop
59510,445,0,0,70,70,0,1,0,1,0,drop
59507,445,0,0,70,70,0,1,0,1,0,drop
61419,57470,0,0,66,66,0,1,0,1,0,deny
59501,445,0,0,70,70,0,1,0,1,0,drop
59500,445,0,0,70,70,0,1,0,1,0,drop
59761,445,0,0,66,66,0,1,0,1,0,drop
27160,64147,0,0,62,62,0,1,0,1,0,deny
59876,44847,0,0,66,66,0,1,0,1,0,deny
64104,22114,0,0,66,66,0,1,0,1,0,deny
63963,50584,0,0,66,66,0,1,0,1,0,deny
22784,9571,0,0,62,62,0,1,0,1,0,deny
44491,50584,0,0,62,62,0,1,0,1,0,deny
56869,17637,0,0,66,66,0,1,0,1,0,deny
64342,445,0,0,70,70,0,1,0,1,0,drop
64338,445,0,0,70,70,0,1,0,1,0,drop
3181,53567,0,0,66,66,0,1,0,1,0,deny
59489,445,0,0,70,70,0,1,0,1,0,drop
43323,1,0,0,62,62,0,1,0,1,0,deny
50577,53,36248,53,196,102,94,2,30,1,1,allow
49498,53,4790,53,245,102,143,2,30,1,1,allow
49467,53,63815,53,811,94,717,2,30,1,1,allow
55051,53,56758,53,167,86,81,2,30,1,1,allow
37555,16386,35583,16386,432,192,240,8,30,4,4,allow
11295,40032,25935,40032,148,86,62,2,30,1,1,allow
11295,40018,13039,40018,156,94,62,2,30,1,1,allow
52765,443,7289,443,10359,1566,8793,27,150,13,14,allow
65485,53,26681,53,184,94,90,2,29,1,1,allow
64793,53,25945,53,168,86,82,2,29,1,1,allow
55868,53,29665,53,198,110,88,2,29,1,1,allow
64991,53,31407,53,196,94,102,2,29,1,1,allow
50576,53,22318,53,765,102,663,2,29,1,1,allow
55868,53,11909,53,198,110,88,2,29,1,1,allow
65275,53,52488,53,184,102,82,2,29,1,1,allow
49191,51253,24345,51253,504,318,186,8,15,5,3,allow
48346,443,9051,443,2272788,106549,2166239,2492,190,850,1642,allow
55776,53,11984,53,271,93,178,4,32,2,2,allow
50994,443,11381,443,6349,1072,5277,18,21,10,8,allow
41876,443,3381,443,55975,2553,53422,72,105,29,43,allow
32877,443,56293,443,5701,1585,4116,23,1102,13,10,allow
51452,443,19936,443,6936,1761,5175,17,16,11,6,allow
5240,36828,56682,36828,166456,128,166328,270,35,3,267,allow
65220,53,8622,53,178,94,84,2,29,1,1,allow
64602,53,17194,53,751,94,657,2,29,1,1,allow
55809,443,31063,443,62,62,0,1,4,1,0,allow
56349,53,33887,53,168,86,82,2,29,1,1,allow
50340,53,41286,53,181,94,87,2,29,1,1,allow
56349,53,14775,53,184,102,82,2,29,1,1,allow
50561,80,50561,80,1695,995,700,11,21,6,5,allow
49410,53,7557,53,178,94,84,2,30,1,1,allow
64898,53,53869,53,167,86,81,2,29,1,1,allow
55413,53,38303,53,216,110,106,2,29,1,1,allow
65515,53,42704,53,210,110,100,2,29,1,1,allow
64029,53,34743,53,180,94,86,2,30,1,1,allow
55392,53,8146,53,195,102,93,2,30,1,1,allow
55244,53,26585,53,184,102,82,2,30,1,1,allow
50241,53,50241,53,260,106,154,2,32,1,1,allow
45275,443,27366,443,130,70,60,3,5,2,1,allow
51935,38639,36468,38639,70,70,0,1,5,1,0,allow
51535,443,45578,443,202,70,132,3,11,1,2,allow
63136,443,35141,443,6781,1289,5492,17,15,9,8,allow
57709,443,55185,443,10392,2789,7603,25,16,13,12,allow
57363,53,32810,53,178,94,84,2,30,1,1,allow
37555,16385,63752,16385,556,256,300,10,30,5,5,allow
64776,53,62229,53,198,94,104,2,30,1,1,allow
49534,53,49440,53,168,86,82,2,30,1,1,allow
55176,53,23799,53,181,94,87,2,30,1,1,allow
10151,22208,55626,22208,323,150,173,2,1203,1,1,allow
27005,27091,18957,27091,883,126,757,2,31,1,1,allow
64091,53,16270,53,178,94,84,2,30,1,1,allow
57402,9992,42519,9992,47040,13931,33109,428,129,207,221,allow
49209,53,59782,53,199,102,97,2,30,1,1,allow
58058,443,59293,443,560,280,280,9,28,5,4,allow
56695,443,5124,443,8006,1986,6020,20,15,11,9,allow
57071,53,59373,53,166,86,80,2,30,1,1,allow
55045,443,7851,443,4660,3048,1612,31,81,15,16,allow
65361,53,5566,53,764,102,662,2,30,1,1,allow
52168,443,14996,443,73105,13398,59707,220,374,108,112,allow
50495,53,24606,53,182,102,80,2,30,1,1,allow
58752,443,52846,443,5167,700,4467,16,15,7,9,allow
64989,53,13455,53,167,86,81,2,30,1,1,allow
38122,443,65050,443,191454,11241,180213,262,42,128,134,allow
57057,53,25166,53,194,102,92,2,30,1,1,allow
50932,443,17054,443,167483,7402,160081,221,23,93,128,allow
49410,53,12703,53,178,94,84,2,30,1,1,allow
37558,16386,20045,16386,432,192,240,8,30,4,4,allow
44849,443,64447,443,13791,7866,5925,35,46,20,15,allow
56330,53,26400,53,199,102,97,2,30,1,1,allow
64091,53,24113,53,178,94,84,2,30,1,1,allow
64419,53,6330,53,210,102,108,2,30,1,1,allow
37558,16385,3655,16385,432,192,240,8,30,4,4,allow
64628,53,28992,53,199,102,97,2,30,1,1,allow
57142,53,15103,53,165,86,79,2,30,1,1,allow
37556,16386,44427,16386,432,192,240,8,30,4,4,allow
55857,53,49437,53,196,102,94,2,30,1,1,allow
57307,53,14179,53,177,94,83,2,30,1,1,allow
56526,53,41730,53,168,94,74,2,30,1,1,allow
64989,53,9165,53,183,102,81,2,30,1,1,allow
64602,53,26542,53,185,102,83,2,30,1,1,allow
56204,53,48094,53,195,102,93,2,30,1,1,allow
57371,53,64674,53,214,110,104,2,30,1,1,allow
52758,80,33293,80,1746,980,766,15,151,8,7,allow
49510,53,7986,53,754,94,660,2,30,1,1,allow
37556,16384,16862,16384,556,256,300,10,30,5,5,allow
49849,53,18692,53,173,94,79,2,30,1,1,allow
64562,53,22327,53,371,94,277,2,30,1,1,allow
54748,53,4076,53,245,110,135,2,30,1,1,allow
56063,53,52462,53,196,102,94,2,30,1,1,allow
50009,80,24998,80,186,64,122,4,29,2,2,allow
36688,443,22490,443,86101,7312,78789,145,128,63,82,allow
57994,443,19602,443,14465,1797,12668,30,170,14,16,allow
56263,53,42126,53,214,110,104,2,30,1,1,allow
55342,53,5897,53,323,110,213,2,30,1,1,allow
49605,53,37521,53,239,110,129,2,30,1,1,allow
55067,53,28702,53,166,86,80,2,30,1,1,allow
37558,16384,22272,16384,556,256,300,10,30,5,5,allow
37555,16384,64075,16384,432,192,240,8,30,4,4,allow
50495,53,55393,53,166,86,80,2,30,1,1,allow
64029,53,26038,53,180,94,86,2,30,1,1,allow
56696,443,57667,443,8059,2039,6020,20,15,11,9,allow
59784,443,16677,443,6698,1606,5092,23,19,13,10,allow
49155,443,35211,443,8941,1776,7165,22,136,12,10,allow
50931,443,19777,443,4178,2310,1868,39,30,23,16,allow
48343,443,59139,443,1985333,91427,1893906,2159,190,721,1438,allow
58391,443,1299,443,347192,61325,285867,643,191,297,346,allow
58396,443,53120,443,138065,109491,28574,429,186,230,199,allow
48345,443,50795,443,940826,59470,881356,1101,190,412,689,allow
62037,80,19447,80,1670,422,1248,13,17,5,8,allow
37075,80,59950,80,1597,783,814,10,15,5,5,allow
55019,443,34089,443,12411,7888,4523,33,17,19,14,allow
48952,443,47489,443,15944,6988,8956,135,324,72,63,allow
49737,443,51096,443,334252,14917,319335,405,73,179,226,allow
64810,53,55417,53,272,93,179,4,33,2,2,allow
49788,53,26549,53,302,97,205,4,43,2,2,allow
48344,443,64214,443,2588313,95154,2493159,2645,190,811,1834,allow
64810,53,65205,53,272,93,179,4,32,2,2,allow
52587,443,5455,443,6170,918,5252,18,15,10,8,allow
58753,443,55994,443,5167,700,4467,16,14,7,9,allow
49953,53,27349,53,214,110,104,2,29,1,1,allow
56697,443,20511,443,8007,1987,6020,20,15,11,9,allow
56894,53,54448,53,178,94,84,2,29,1,1,allow
51961,40373,19759,40373,70,70,0,2,8,2,0,allow
56152,53,35520,53,195,102,93,2,29,1,1,allow
62038,80,20471,80,668,224,444,10,18,4,6,allow
64162,53,51950,53,255,118,137,2,29,1,1,allow
51933,80,57196,80,717,651,66,7,15,6,1,allow
56710,53,63295,53,193,94,99,2,29,1,1,allow
53629,443,28491,443,123122,115571,7551,161,23,93,68,allow
57363,53,20262,53,178,94,84,2,29,1,1,allow
64898,53,30399,53,167,86,81,2,29,1,1,allow
64296,53,31060,53,215,94,121,2,29,1,1,allow
51924,80,58410,80,32222,3146,29076,43,31,18,25,allow
10002,80,8568,80,3759,741,3018,15,45,8,7,allow
58748,443,31963,443,5167,700,4467,16,15,7,9,allow
52757,80,11666,80,2426,1594,832,17,151,9,8,allow
56694,443,1542,443,8058,2038,6020,20,15,11,9,allow
56263,53,62395,53,214,110,104,2,29,1,1,allow
49949,53,12218,53,193,102,91,2,29,1,1,allow
64480,53,30625,53,276,126,150,2,30,1,1,allow
55848,53,34320,53,168,86,82,2,30,1,1,allow
55848,53,45545,53,184,102,82,2,30,1,1,allow
57313,53,1093,53,811,94,717,2,30,1,1,allow
27005,32039,29138,32039,883,126,757,2,31,1,1,allow
65176,53,36351,53,193,102,91,2,31,1,1,allow
49209,53,48140,53,199,102,97,2,31,1,1,allow
55495,53,27718,53,210,110,100,2,31,1,1,allow
64628,53,1942,53,199,102,97,2,30,1,1,allow
55166,53,22324,53,177,94,83,2,30,1,1,allow
64321,53,62198,53,195,102,93,2,30,1,1,allow
64091,53,62313,53,178,94,84,2,30,1,1,allow
46123,443,37747,443,5161,3826,1335,16,137,9,7,allow
49931,53,55078,53,195,102,93,2,30,1,1,allow
65013,53,26292,53,473,105,368,4,30,2,2,allow
49567,53,30320,53,195,94,101,2,30,1,1,allow
55867,53,6696,53,184,94,90,2,30,1,1,allow
64822,53,9057,53,200,94,106,2,30,1,1,allow
49622,53,6128,53,209,102,107,2,30,1,1,allow
55413,53,32368,53,216,110,106,2,31,1,1,allow
55828,53,29834,53,181,94,87,2,31,1,1,allow
49837,443,55049,443,4685,2421,2264,10,119,5,5,allow
30188,58770,26804,58770,14172,5733,8439,79,1531,37,42,allow
37845,443,37845,443,4441,1534,2907,19,25,11,8,allow
52991,53,52991,53,235,90,145,2,32,1,1,allow
55857,53,19177,53,437,98,339,4,41,2,2,allow
10010,80,10501,80,2166,600,1566,10,45,6,4,allow
52695,443,43213,443,34402,2328,32074,55,153,23,32,allow
59422,53,43330,53,168,78,90,2,30,1,1,allow
49534,53,53329,53,168,86,82,2,30,1,1,allow
65437,53,6994,53,173,94,79,2,30,1,1,allow
55176,53,15853,53,181,94,87,2,30,1,1,allow
55771,53,22517,53,819,102,717,2,30,1,1,allow
65437,53,4286,53,165,86,79,2,30,1,1,allow
64602,53,18957,53,185,102,83,2,30,1,1,allow
60578,443,8619,443,27150,3104,24046,55,157,24,31,allow
51936,17650,3656,17650,70,70,0,1,5,1,0,allow
56526,53,17737,53,168,94,74,2,30,1,1,allow
37556,16385,7205,16385,432,192,240,8,30,4,4,allow
65152,53,2972,53,763,102,661,2,30,1,1,allow
64986,53,9099,53,183,94,89,2,30,1,1,allow
56470,53,63709,53,198,102,96,2,30,1,1,allow
56938,8000,45584,8000,110,110,0,1,30,1,0,allow
56085,53,41627,53,167,86,81,2,30,1,1,allow
58123,80,21790,80,3641,1784,1857,19,375,10,9,allow
50272,53,61330,53,210,110,100,2,30,1,1,allow
36710,443,45580,443,6786,1795,4991,18,16,11,7,allow
51960,58601,12629,58601,70,70,0,2,8,2,0,allow
49181,53,15171,53,491,98,393,4,40,2,2,allow
52769,443,2032,443,8083,1790,6293,27,150,14,13,allow
52764,443,33185,443,14001,2908,11093,35,150,18,17,allow
64421,53,53236,53,398,88,310,4,54,2,2,allow
50577,53,42323,53,819,102,717,2,30,1,1,allow
65253,53,8346,53,766,102,664,2,30,1,1,allow
55771,53,25077,53,196,102,94,2,30,1,1,allow
65515,53,3298,53,210,110,100,2,30,1,1,allow
49379,53,52143,53,260,102,158,2,30,1,1,allow
55166,53,19784,53,177,94,83,2,30,1,1,allow
56594,53,5143,53,173,94,79,2,30,1,1,allow
55857,53,31762,53,196,102,94,2,30,1,1,allow
56185,53,13789,53,167,86,81,2,30,1,1,allow
57371,53,5536,53,214,110,104,2,30,1,1,allow
55742,53,18944,53,193,102,91,2,30,1,1,allow
55244,53,24318,53,184,102,82,2,30,1,1,allow
64029,53,40003,53,180,94,86,2,30,1,1,allow
57228,53,13792,53,199,102,97,2,30,1,1,allow
49663,53,65385,53,195,102,93,2,30,1,1,allow
57177,53,13049,53,179,94,85,2,30,1,1,allow
44385,53,19261,53,212,78,134,2,30,1,1,allow
64781,53,27529,53,209,102,107,2,30,1,1,allow
64169,53,50395,53,209,102,107,2,30,1,1,allow
27005,27999,8243,27999,913,126,787,2,31,1,1,allow
57177,53,17706,53,179,94,85,2,31,1,1,allow
64244,53,63345,53,199,102,97,2,31,1,1,allow
64986,53,17110,53,183,94,89,2,31,1,1,allow
55728,53,24572,53,195,102,93,2,31,1,1,allow
49378,53,42308,53,306,94,212,2,30,1,1,allow
64586,53,9543,53,183,94,89,2,30,1,1,allow
57445,53,50878,53,342,142,200,2,30,1,1,allow
64598,53,46493,53,342,142,200,2,30,1,1,allow
65052,53,39393,53,200,94,106,2,30,1,1,allow
56142,53,42662,53,194,102,92,2,31,1,1,allow
57147,53,3974,53,166,86,80,2,31,1,1,allow
64174,53,10238,53,180,94,86,2,31,1,1,allow
27005,32073,35249,32073,884,126,758,2,31,1,1,allow
64965,53,42321,53,200,94,106,2,31,1,1,allow
64964,53,28757,53,197,102,95,2,31,1,1,allow
56643,53,21130,53,195,102,93,2,31,1,1,allow
55641,53,24406,53,184,94,90,2,31,1,1,allow
57127,53,61936,53,193,102,91,2,31,1,1,allow
64627,53,3343,53,199,102,97,2,31,1,1,allow
55392,53,19876,53,195,102,93,2,31,1,1,allow
27005,32065,5075,32065,877,126,751,2,31,1,1,allow
57126,53,6801,53,183,94,89,2,31,1,1,allow
56381,53,14303,53,196,102,94,2,31,1,1,allow
52992,443,3497,443,97763,8230,89533,131,150,49,82,allow
37965,28596,25273,28596,479,150,329,2,1199,1,1,allow
41790,443,64093,443,2350,1392,958,17,275,9,8,allow
50000,53,12799,53,216,110,106,2,31,1,1,allow
64989,53,29167,53,214,94,120,2,31,1,1,allow
64607,53,58592,53,211,110,101,2,31,1,1,allow
37957,443,45183,443,7280,2250,5030,15,120,7,8,allow
33995,443,61498,443,6419,995,5424,21,361,11,10,allow
60461,443,30128,443,18515,2899,15616,32,148,15,17,allow
49214,53,64649,53,227,102,125,2,30,1,1,allow
56005,53,41493,53,403,142,261,2,30,1,1,allow
64922,53,2264,53,209,102,107,2,30,1,1,allow
64803,53,18696,53,403,142,261,2,31,1,1,allow
56085,53,39673,53,167,86,81,2,31,1,1,allow
27005,27057,9296,27057,917,126,791,2,31,1,1,allow
55596,53,25789,53,194,102,92,2,31,1,1,allow
56063,53,23721,53,196,102,94,2,31,1,1,allow
55867,53,63583,53,184,94,90,2,31,1,1,allow
49209,53,27106,53,199,102,97,2,31,1,1,allow
49346,53,44128,53,164,78,86,2,31,1,1,allow
56145,53,42798,53,458,188,270,6,31,3,3,allow
49420,53,64966,53,183,94,89,2,31,1,1,allow
8886,80,28945,80,1748,716,1032,19,395,6,13,allow
43549,443,50179,443,10316,2303,8013,39,120,20,19,allow
64911,53,26816,53,209,110,99,2,31,1,1,allow
36266,443,8453,443,6043,1568,4475,11,119,4,7,allow
54664,443,18558,443,8263,1279,6984,15,136,7,8,allow
45549,443,52830,443,7951,1449,6502,22,125,12,10,allow
57470,54058,20688,54058,150,150,0,1,1199,1,0,allow
57278,443,35481,443,8960,2949,6011,21,122,10,11,allow
56411,53,33416,53,184,94,90,2,31,1,1,allow
63917,57826,39527,57826,70,70,0,1,5,1,0,allow
53745,18569,18242,18569,70,70,0,1,5,1,0,allow
48634,443,39947,443,448,78,370,6,25,1,5,allow
58747,443,20889,443,5167,700,4467,16,15,7,9,allow
44911,80,13176,80,1052,612,440,10,15,5,5,allow
35176,80,37365,80,1987,1329,658,10,136,6,4,allow
50543,443,11342,443,11275,4454,6821,24,36,13,11,allow
63651,443,19234,443,333668,12291,321377,321,170,72,249,allow
49968,53,62146,53,1412,94,1318,4,33,2,2,allow
51959,42269,57888,42269,70,70,0,2,8,2,0,allow
51921,80,46796,80,35092,3319,31773,48,31,21,27,allow
64987,53,36862,53,410,100,310,4,55,2,2,allow
55126,53,10895,53,193,102,91,2,31,1,1,allow
56381,443,16712,443,7236,2290,4946,18,16,11,7,allow
5232,46495,40739,46495,832,832,0,14,96,14,0,allow
38450,443,8906,443,593,473,120,4,15,2,2,allow
56693,443,47203,443,7862,1873,5989,20,16,11,9,allow
51148,9571,0,0,66,66,0,1,0,1,0,deny
39681,37965,0,0,66,66,0,1,0,1,0,deny
59744,445,0,0,66,66,0,1,0,1,0,drop
59743,445,0,0,66,66,0,1,0,1,0,drop
29577,64147,0,0,62,62,0,1,0,1,0,deny
16387,25619,0,0,60,60,0,1,0,1,0,deny
16387,64660,0,0,60,60,0,1,0,1,0,deny
16387,24782,0,0,60,60,0,1,0,1,0,deny
53500,1,0,0,66,66,0,1,0,1,0,deny
18088,23,0,0,60,60,0,1,0,1,0,deny
63672,22114,0,0,66,66,0,1,0,1,0,deny
52938,64097,0,0,66,66,0,1,0,1,0,deny
64332,445,0,0,70,70,0,1,0,1,0,drop
59485,445,0,0,70,70,0,1,0,1,0,drop
64325,445,0,0,70,70,0,1,0,1,0,drop
64324,445,0,0,70,70,0,1,0,1,0,drop
64323,445,0,0,70,70,0,1,0,1,0,drop
59738,445,0,0,66,66,0,1,0,1,0,drop
45964,5333,0,0,60,60,0,1,0,1,0,deny
52418,46314,0,0,66,66,0,1,0,1,0,deny
59476,445,0,0,70,70,0,1,0,1,0,drop
59474,445,0,0,70,70,0,1,0,1,0,drop
59473,445,0,0,70,70,0,1,0,1,0,drop
59472,445,0,0,70,70,0,1,0,1,0,drop
17760,50584,0,0,146,146,0,1,0,1,0,deny
59725,445,0,0,66,66,0,1,0,1,0,drop
59731,445,0,0,66,66,0,1,0,1,0,drop
59733,445,0,0,66,66,0,1,0,1,0,drop
59734,445,0,0,66,66,0,1,0,1,0,drop
59728,445,0,0,66,66,0,1,0,1,0,drop
59724,445,0,0,66,66,0,1,0,1,0,drop
59722,445,0,0,66,66,0,1,0,1,0,drop
59468,445,0,0,70,70,0,1,0,1,0,drop
61639,37965,0,0,66,66,0,1,0,1,0,deny
55616,56205,0,0,66,66,0,1,0,1,0,deny
443,60496,0,0,320,320,0,1,0,1,0,deny
44411,37965,0,0,62,62,0,1,0,1,0,deny
64314,445,0,0,70,70,0,1,0,1,0,drop
54016,42707,0,0,62,62,0,1,0,1,0,deny
64313,445,0,0,70,70,0,1,0,1,0,drop
64312,445,0,0,70,70,0,1,0,1,0,drop
64309,445,0,0,70,70,0,1,0,1,0,drop
28367,23,0,0,60,60,0,1,0,1,0,deny
26713,64147,0,0,62,62,0,1,0,1,0,deny
28040,64147,0,0,66,66,0,1,0,1,0,deny
65419,26467,0,0,62,62,0,1,0,1,0,deny
45941,23386,0,0,60,60,0,1,0,1,0,deny
45941,23386,0,0,60,60,0,1,0,1,0,deny
16387,8455,0,0,60,60,0,1,0,1,0,deny
16387,49252,0,0,60,60,0,1,0,1,0,deny
16387,35244,0,0,60,60,0,1,0,1,0,deny
59462,445,0,0,70,70,0,1,0,1,0,drop
32770,51505,0,0,62,62,0,1,0,1,0,deny
26642,57470,0,0,62,62,0,1,0,1,0,deny
64307,445,0,0,70,70,0,1,0,1,0,drop
64306,445,0,0,70,70,0,1,0,1,0,drop
64305,445,0,0,70,70,0,1,0,1,0,drop
56442,11392,0,0,66,66,0,1,0,1,0,deny
59718,445,0,0,66,66,0,1,0,1,0,drop
32520,47993,0,0,66,66,0,1,0,1,0,deny
6338,23117,0,0,66,66,0,1,0,1,0,deny
64300,445,0,0,70,70,0,1,0,1,0,drop
60786,51505,0,0,66,66,0,1,0,1,0,deny
2432,11392,0,0,62,62,0,1,0,1,0,deny
60374,57470,0,0,62,62,0,1,0,1,0,deny
59455,445,0,0,70,70,0,1,0,1,0,drop
56367,44847,0,0,62,62,0,1,0,1,0,deny
59714,445,0,0,66,66,0,1,0,1,0,drop
40571,26467,0,0,62,62,0,1,0,1,0,deny
59453,445,0,0,70,70,0,1,0,1,0,drop
65081,26467,0,0,66,66,0,1,0,1,0,deny
59712,445,0,0,66,66,0,1,0,1,0,drop
59710,445,0,0,66,66,0,1,0,1,0,drop
59709,445,0,0,66,66,0,1,0,1,0,drop
3978,35440,0,0,62,62,0,1,0,1,0,deny
16387,34137,0,0,60,60,0,1,0,1,0,deny
16387,61049,0,0,60,60,0,1,0,1,0,deny
16387,23177,0,0,60,60,0,1,0,1,0,deny
59449,445,0,0,70,70,0,1,0,1,0,drop
59447,445,0,0,70,70,0,1,0,1,0,drop
57034,44847,0,0,66,66,0,1,0,1,0,deny
64292,445,0,0,70,70,0,1,0,1,0,drop
33886,39127,0,0,162,162,0,1,0,1,0,deny
51743,64147,0,0,62,62,0,1,0,1,0,deny
55421,57470,0,0,74,74,0,1,0,1,0,deny
64284,445,0,0,70,70,0,1,0,1,0,drop
64282,445,0,0,70,70,0,1,0,1,0,drop
59443,445,0,0,70,70,0,1,0,1,0,drop
13423,56205,0,0,62,62,0,1,0,1,0,deny
13408,44847,0,0,62,62,0,1,0,1,0,deny
59697,445,0,0,66,66,0,1,0,1,0,drop
59441,445,0,0,70,70,0,1,0,1,0,drop
13090,36237,0,0,66,66,0,1,0,1,0,deny
59690,445,0,0,66,66,0,1,0,1,0,drop
64274,445,0,0,70,70,0,1,0,1,0,drop
59437,445,0,0,70,70,0,1,0,1,0,drop
58858,15503,0,0,66,66,0,1,0,1,0,deny
61030,21247,0,0,66,66,0,1,0,1,0,deny
59688,445,0,0,66,66,0,1,0,1,0,drop
10416,64147,0,0,62,62,0,1,0,1,0,deny
45042,48817,0,0,109,109,0,1,0,1,0,deny
30129,37965,0,0,72,72,0,1,0,1,0,deny
0,0,0,0,320,320,0,5,0,5,0,allow
0,0,0,0,2000,1020,980,20,0,10,10,allow
35229,32468,0,0,62,62,0,1,0,1,0,deny
59680,445,0,0,66,66,0,1,0,1,0,drop
55835,62413,0,0,62,62,0,1,0,1,0,deny
59673,445,0,0,66,66,0,1,0,1,0,drop
8403,46824,0,0,62,62,0,1,0,1,0,deny
443,42788,0,0,74,74,0,1,0,1,0,deny
18904,57470,0,0,62,62,0,1,0,1,0,deny
59424,445,0,0,70,70,0,1,0,1,0,drop
51581,22114,0,0,66,66,0,1,0,1,0,deny
58972,57866,0,0,66,66,0,1,0,1,0,deny
59421,445,0,0,70,70,0,1,0,1,0,drop
64263,445,0,0,70,70,0,1,0,1,0,drop
64261,445,0,0,70,70,0,1,0,1,0,drop
64260,445,0,0,70,70,0,1,0,1,0,drop
59662,445,0,0,66,66,0,1,0,1,0,drop
59664,445,0,0,66,66,0,1,0,1,0,drop
59665,445,0,0,66,66,0,1,0,1,0,drop
59658,445,0,0,66,66,0,1,0,1,0,drop
59663,445,0,0,66,66,0,1,0,1,0,drop
59660,445,0,0,66,66,0,1,0,1,0,drop
59661,445,0,0,66,66,0,1,0,1,0,drop
59659,445,0,0,66,66,0,1,0,1,0,drop
16327,55442,0,0,66,66,0,1,0,1,0,deny
42223,67,0,0,60,60,0,1,0,1,0,deny
59694,50584,0,0,62,62,0,1,0,1,0,deny
13963,50584,0,0,62,62,0,1,0,1,0,deny
47013,44512,0,0,62,62,0,1,0,1,0,deny
59416,445,0,0,70,70,0,1,0,1,0,drop
1187,64147,0,0,66,66,0,1,0,1,0,deny
27947,26467,0,0,62,62,0,1,0,1,0,deny
59415,445,0,0,70,70,0,1,0,1,0,drop
49915,35440,0,0,146,146,0,1,0,1,0,deny
50927,44847,0,0,62,62,0,1,0,1,0,deny
59413,445,0,0,70,70,0,1,0,1,0,drop
50424,55777,0,0,62,62,0,1,0,1,0,deny
64249,445,0,0,70,70,0,1,0,1,0,drop
64247,445,0,0,70,70,0,1,0,1,0,drop
64245,445,0,0,70,70,0,1,0,1,0,drop
64242,445,0,0,70,70,0,1,0,1,0,drop
27617,51505,0,0,146,146,0,1,0,1,0,deny
49323,53,45688,53,192,98,94,2,30,1,1,allow
53144,58987,43141,58987,70,70,0,2,8,2,0,allow
58115,3389,58115,3389,4166,2141,2025,18,17,9,9,allow
64627,53,17603,53,198,101,97,2,30,1,1,allow
64244,53,29357,53,198,101,97,2,30,1,1,allow
55938,53,49190,53,780,93,687,2,30,1,1,allow
50012,53,54567,53,208,106,102,2,30,1,1,allow
57189,53,57433,53,174,89,85,2,30,1,1,allow
57187,53,15982,53,782,105,677,2,30,1,1,allow
56991,53,36997,53,748,106,642,2,30,1,1,allow
57204,53,58502,53,182,93,89,2,30,1,1,allow
54467,80,25502,80,17572,1518,16054,30,255,16,14,allow
58725,443,21181,443,26960,13206,13754,53,17,28,25,allow
63934,55027,48051,55027,66,66,0,2,8,2,0,allow
53140,64128,33195,64128,698,320,378,10,17,6,4,allow
54472,80,34355,80,13695,1377,12318,26,255,14,12,allow
61518,22,61518,22,7306,2583,4723,36,25,19,17,allow
56381,53,44431,53,192,98,94,2,31,1,1,allow
56341,3389,56341,3389,3424,1710,1714,16,33,8,8,allow
35980,443,35980,443,4398,1491,2907,19,26,11,8,allow
58723,443,11514,443,24079,11282,12797,44,17,22,22,allow
60443,50284,54263,50284,164,70,94,2,5,1,1,allow
36026,443,14720,443,7050,984,6066,18,39,12,6,allow
54473,80,28386,80,14035,1381,12654,26,255,14,12,allow
56411,53,42159,53,184,94,90,2,31,1,1,allow
55641,53,45216,53,184,94,90,2,31,1,1,allow
55593,53,41754,53,749,89,660,2,30,1,1,allow
55596,53,37319,53,188,96,92,2,31,1,1,allow
33878,443,33484,443,2279,1637,642,15,25,9,6,allow
64534,53,43156,53,212,108,104,2,31,1,1,allow
45259,53,45259,53,176,78,98,2,30,1,1,allow
58744,443,27181,443,2576,1549,1027,15,15,7,8,allow
65176,53,2902,53,186,95,91,2,30,1,1,allow
55670,31056,18384,31056,70,70,0,2,8,2,0,allow
55006,53,44866,53,789,110,679,2,30,1,1,allow
5231,30114,20445,30114,832,832,0,14,96,14,0,allow
58724,443,37298,443,21610,9250,12360,40,17,19,21,allow
8971,80,8971,80,326,186,140,6,29,4,2,allow
53738,25760,39657,25760,2031,1019,1012,11,16,6,5,allow
58719,443,6983,443,18880,7831,11049,37,18,19,18,allow
54470,80,58006,80,16896,1514,15382,30,255,16,14,allow
55514,53,31515,53,747,93,654,2,30,1,1,allow
65294,53,15570,53,710,89,621,2,30,1,1,allow
56489,53,16732,53,208,106,102,2,31,1,1,allow
64911,53,61645,53,202,103,99,2,31,1,1,allow
56643,53,22354,53,190,97,93,2,31,1,1,allow
36542,3142,36542,3142,138,78,60,2,6,1,1,allow
50544,443,14371,443,11083,4570,6513,24,35,13,11,allow
56661,53,9185,53,297,102,195,4,34,2,2,allow
64837,53,3342,53,190,97,93,2,31,1,1,allow
51956,36995,25588,36995,70,70,0,2,8,2,0,allow
6722,80,6722,80,326,186,140,6,29,4,2,allow
45641,443,12763,443,99276,88410,10866,143,333,78,65,allow
37616,443,22145,443,6506,1356,5150,24,16,14,10,allow
34697,443,10528,443,15997,3015,12982,31,18,16,15,allow
51898,443,2125,443,7866,1549,6317,21,321,10,11,allow
34698,443,50104,443,16164,3053,13111,31,18,16,15,allow
51753,7000,51753,7000,3638,2087,1551,17,15,10,7,allow
56171,53,61869,53,756,95,661,2,30,1,1,allow
34600,80,41483,80,3089,775,2314,15,16,9,6,allow
48015,443,45822,443,19394,2961,16433,51,196,24,27,allow
64987,53,19027,53,196,100,96,2,30,1,1,allow
50551,80,50551,80,4780,1925,2855,16,22,8,8,allow
56690,53,19054,53,802,104,698,2,30,1,1,allow
56142,53,12873,53,188,96,92,2,30,1,1,allow
55828,53,3503,53,178,91,87,2,30,1,1,allow
56415,53,58262,53,174,89,85,2,31,1,1,allow
56094,53,60857,53,764,99,665,2,31,1,1,allow
64588,53,37209,53,186,95,91,2,31,1,1,allow
6881,41872,4010,41872,509,150,359,2,1200,1,1,allow
65246,53,33087,53,174,89,85,2,31,1,1,allow
63473,443,25564,443,4490,1234,3256,20,122,9,11,allow
45590,53,0,0,82,82,0,1,31,1,0,allow
65042,53,25956,53,182,93,89,2,31,1,1,allow
56627,53,42658,53,186,95,91,2,31,1,1,allow
57181,53,65198,53,733,93,640,2,31,1,1,allow
65512,53,60205,53,744,95,649,2,31,1,1,allow
30960,45738,57653,45738,396,396,0,7,3615,7,0,allow
56649,443,48324,443,3469,1006,2463,15,121,7,8,allow
57127,53,59492,53,186,95,91,2,31,1,1,allow
64174,53,49823,53,176,90,86,2,31,1,1,allow
65042,53,41893,53,182,93,89,2,31,1,1,allow
55344,53,18078,53,208,106,102,2,31,1,1,allow
63960,53,41492,53,172,88,84,2,31,1,1,allow
64555,53,55433,53,166,85,81,2,31,1,1,allow
53980,443,7192,443,4957,1627,3330,17,120,8,9,allow
56673,53,13818,53,186,95,91,2,31,1,1,allow
62102,443,56889,443,3466,821,2645,11,121,5,6,allow
64619,53,54626,53,174,89,85,2,31,1,1,allow
57470,45561,33811,45561,792,792,0,13,1201,13,0,allow
55130,53,9076,53,216,110,106,2,31,1,1,allow
56785,53,64900,53,186,95,91,2,31,1,1,allow
55126,53,24901,53,186,95,91,2,31,1,1,allow
56889,53,27625,53,206,105,101,2,31,1,1,allow
55533,53,56018,53,182,93,89,2,31,1,1,allow
56387,53,9036,53,182,93,89,2,31,1,1,allow
49216,53,25748,53,178,91,87,2,31,1,1,allow
56387,53,7178,53,182,93,89,2,31,1,1,allow
53979,443,21511,443,3566,871,2695,11,120,5,6,allow
49864,53,25609,53,186,95,91,2,31,1,1,allow
48817,8677,48817,8677,490,149,341,2,1200,1,1,allow
49160,51839,39818,51839,868,150,718,4,1200,2,2,allow
31974,51505,0,0,66,66,0,1,0,1,0,deny
59644,445,0,0,66,66,0,1,0,1,0,drop
59642,445,0,0,66,66,0,1,0,1,0,drop
59641,445,0,0,66,66,0,1,0,1,0,drop
57131,31061,0,0,145,145,0,1,0,1,0,deny
61000,15503,0,0,146,146,0,1,0,1,0,deny
32704,46824,0,0,66,66,0,1,0,1,0,deny
59406,445,0,0,70,70,0,1,0,1,0,drop
57538,30188,0,0,66,66,0,1,0,1,0,deny
443,23133,0,0,97,97,0,1,0,1,0,deny
61000,57587,0,0,146,146,0,1,0,1,0,deny
64240,445,0,0,70,70,0,1,0,1,0,drop
35925,443,8324,443,1092248,9101,1083147,860,195,111,749,allow
65410,53,23769,53,216,94,122,2,30,1,1,allow
7166,64147,0,0,62,62,0,1,0,1,0,deny
59404,445,0,0,70,70,0,1,0,1,0,drop
38306,51221,0,0,62,62,0,1,0,1,0,deny
64237,445,0,0,70,70,0,1,0,1,0,drop
64231,445,0,0,70,70,0,1,0,1,0,drop
64230,445,0,0,70,70,0,1,0,1,0,drop
39063,5900,0,0,60,60,0,1,0,1,0,deny
63343,53,0,0,74,74,0,1,0,1,0,deny
12969,55777,0,0,66,66,0,1,0,1,0,deny
7226,50584,0,0,62,62,0,1,0,1,0,deny
59403,445,0,0,70,70,0,1,0,1,0,drop
59402,445,0,0,70,70,0,1,0,1,0,drop
59401,445,0,0,70,70,0,1,0,1,0,drop
8313,51505,0,0,66,66,0,1,0,1,0,deny
59397,445,0,0,70,70,0,1,0,1,0,drop
59395,445,0,0,70,70,0,1,0,1,0,drop
25090,9192,0,0,145,145,0,1,0,1,0,deny
51346,51221,0,0,74,74,0,1,0,1,0,deny
52925,3389,0,0,60,60,0,1,0,1,0,deny
13485,43708,0,0,554,554,0,1,0,1,0,deny
45941,23386,0,0,60,60,0,1,0,1,0,deny
45941,23386,0,0,60,60,0,1,0,1,0,deny
9448,57866,0,0,62,62,0,1,0,1,0,deny
24145,35440,0,0,62,62,0,1,0,1,0,deny
6999,11119,0,0,143,143,0,1,0,1,0,deny
59383,445,0,0,70,70,0,1,0,1,0,drop
59382,445,0,0,70,70,0,1,0,1,0,drop
27402,37628,0,0,62,62,0,1,0,1,0,deny
59378,445,0,0,70,70,0,1,0,1,0,drop
54305,39004,0,0,62,62,0,1,0,1,0,deny
59373,445,0,0,70,70,0,1,0,1,0,drop
64221,445,0,0,70,70,0,1,0,1,0,drop
64222,445,0,0,70,70,0,1,0,1,0,drop
64217,445,0,0,70,70,0,1,0,1,0,drop
34470,57470,0,0,66,66,0,1,0,1,0,deny
8868,50584,0,0,146,146,0,1,0,1,0,deny
59630,445,0,0,66,66,0,1,0,1,0,drop
37203,443,4528,443,466,392,74,4,0,3,1,allow
14148,1,0,0,66,66,0,1,0,1,0,deny
56092,56205,0,0,146,146,0,1,0,1,0,deny
52003,44512,0,0,66,66,0,1,0,1,0,deny
51426,47563,0,0,100,100,0,1,0,1,0,deny
10797,50584,0,0,62,62,0,1,0,1,0,deny
34932,38608,0,0,62,62,0,1,0,1,0,deny
59361,445,0,0,70,70,0,1,0,1,0,drop
54276,37628,0,0,66,66,0,1,0,1,0,deny
64215,445,0,0,70,70,0,1,0,1,0,drop
64213,445,0,0,70,70,0,1,0,1,0,drop
50261,64147,0,0,66,66,0,1,0,1,0,deny
54593,51505,0,0,66,66,0,1,0,1,0,deny
61798,35440,0,0,66,66,0,1,0,1,0,deny
51426,12447,0,0,100,100,0,1,0,1,0,deny
61000,1,0,0,146,146,0,1,0,1,0,deny
18423,51505,0,0,62,62,0,1,0,1,0,deny
65322,53,28599,53,395,102,293,2,30,1,1,allow
64987,53,43588,53,198,102,96,2,30,1,1,allow
50575,53,21343,53,184,94,90,2,30,1,1,allow
49663,53,58279,53,195,102,93,2,30,1,1,allow
56269,53,36395,53,102,102,0,1,30,1,0,allow
50000,53,33265,53,216,110,106,2,30,1,1,allow
49420,53,61159,53,183,94,89,2,30,1,1,allow
51632,443,13714,443,5021,2884,2137,14,135,7,7,allow
50156,53,6756,53,186,102,84,2,30,1,1,allow
55218,443,17111,443,17915,7421,10494,39,61,21,18,allow
63914,32805,13245,32805,70,70,0,1,4,1,0,allow
50208,80,63761,80,1277,460,817,16,77,5,11,allow
49189,443,23027,443,9734,1613,8121,24,17,12,12,allow
51111,80,8917,80,366,240,126,7,21,5,2,allow
64976,53,53844,53,193,102,91,2,29,1,1,allow
64421,53,32983,53,178,94,84,2,29,1,1,allow
49490,443,14327,443,9109,1943,7166,32,270,16,16,allow
51853,443,32598,443,7415,1550,5865,28,37,15,13,allow
53746,7546,50898,7546,70,70,0,1,4,1,0,allow
53760,45682,34507,45682,70,70,0,2,7,2,0,allow
34325,443,18256,443,2450,1451,999,19,315,10,9,allow
56661,53,3079,53,297,102,195,4,34,2,2,allow
55912,53,45004,53,199,102,97,2,29,1,1,allow
57371,53,14687,53,321,108,213,4,33,2,2,allow
55350,53,27984,53,177,94,83,2,29,1,1,allow
51958,51322,52514,51322,70,70,0,2,7,2,0,allow
53762,9587,1266,9587,70,70,0,2,7,2,0,allow
56594,53,50396,53,165,86,79,2,29,1,1,allow
64507,53,28479,53,382,102,280,2,29,1,1,allow
57096,53,49643,53,443,182,261,6,29,3,3,allow
56611,53,17951,53,177,94,83,2,29,1,1,allow
64898,53,46183,53,209,94,115,2,29,1,1,allow
50440,53,52778,53,458,188,270,6,29,3,3,allow
55350,53,12521,53,185,102,83,2,29,1,1,allow
49312,53,33674,53,306,94,212,2,29,1,1,allow
49561,53,39252,53,754,94,660,2,30,1,1,allow
56611,53,12492,53,177,94,83,2,29,1,1,allow
55649,53,24364,53,216,110,106,2,30,1,1,allow
58741,443,39394,443,5168,700,4468,16,15,7,9,allow
50552,80,50552,80,2887,1776,1111,14,22,8,6,allow
56806,443,47180,443,403093,31796,371297,497,151,185,312,allow
54469,80,59842,80,1466,831,635,10,255,6,4,allow
50341,5222,19733,5222,9254,3356,5898,74,444,30,44,allow
58742,443,35475,443,5166,700,4466,16,15,7,9,allow
57189,53,16894,53,179,94,85,2,30,1,1,allow
55495,53,17025,53,210,110,100,2,30,1,1,allow
49746,53,8872,53,290,102,188,2,30,1,1,allow
49786,53,59022,53,752,110,642,2,30,1,1,allow
63943,53,44134,53,196,94,102,2,30,1,1,allow
50012,53,27557,53,212,110,102,2,30,1,1,allow
55641,53,38684,53,184,94,90,2,30,1,1,allow
55911,53,35640,53,211,110,101,2,30,1,1,allow
56489,53,43327,53,212,110,102,2,30,1,1,allow
56009,53,53982,53,178,94,84,2,30,1,1,allow
27005,33051,48719,33051,887,126,761,2,31,1,1,allow
56381,53,54551,53,196,102,94,2,30,1,1,allow
57204,53,58516,53,183,94,89,2,30,1,1,allow
55533,53,40009,53,183,94,89,2,30,1,1,allow
54461,80,46042,80,2544,900,1644,12,255,7,5,allow
38517,53,38517,53,214,82,132,2,32,1,1,allow
6455,80,6455,80,326,186,140,6,29,4,2,allow
51485,443,20455,443,828,390,438,11,40,4,7,allow
42654,443,18143,443,3650,2162,1488,25,80,13,12,allow
5571,80,5571,80,326,186,140,6,29,4,2,allow
49456,443,8615,443,10956,1757,9199,21,37,10,11,allow
56562,443,49879,443,8821,3228,5593,25,60,15,10,allow
58743,443,4487,443,5167,700,4467,16,15,7,9,allow
49404,53,23314,53,200,94,106,2,30,1,1,allow
52324,443,60831,443,295493,16052,279441,394,68,186,208,allow
50287,443,51254,443,14559,2721,11838,31,16,17,14,allow
50209,53,30899,53,749,94,655,2,30,1,1,allow
65024,53,47698,53,179,94,85,2,30,1,1,allow
44938,443,27497,443,46323,1563,44760,49,30,15,34,allow
63929,53,15311,53,195,94,101,2,30,1,1,allow
57204,53,35848,53,183,94,89,2,30,1,1,allow
50575,53,41966,53,184,94,90,2,30,1,1,allow
57126,53,50266,53,183,94,89,2,30,1,1,allow
55621,53,47829,53,453,186,267,6,30,3,3,allow
49372,53,37424,53,216,110,106,2,30,1,1,allow
49254,53,55219,53,265,110,155,2,30,1,1,allow
49797,53,5232,53,787,110,677,2,30,1,1,allow
56269,53,62645,53,816,102,714,2,30,1,1,allow
56643,53,48653,53,195,102,93,2,30,1,1,allow
56415,53,51829,53,179,94,85,2,30,1,1,allow
49323,53,61963,53,196,102,94,2,30,1,1,allow
57127,53,64638,53,193,102,91,2,30,1,1,allow
47662,80,15716,80,1067,697,370,8,63,5,3,allow
6590,80,6590,80,326,186,140,6,29,4,2,allow
5686,80,5686,80,326,186,140,6,29,4,2,allow
50598,80,63854,80,17837,3830,14007,27,24,12,15,allow
35217,443,21700,443,2388,1628,760,18,294,11,7,allow
56692,443,45896,443,7914,1925,5989,20,15,11,9,allow
64896,53,50820,53,195,94,101,2,30,1,1,allow
55495,53,27673,53,210,110,100,2,30,1,1,allow
36851,53,31171,53,86,86,0,1,30,1,0,allow
55828,53,17599,53,181,94,87,2,30,1,1,allow
64707,53,47683,53,258,102,156,2,30,1,1,allow
64607,53,1706,53,211,110,101,2,30,1,1,allow
56415,53,6950,53,179,94,85,2,30,1,1,allow
50604,80,39550,80,1658,1247,411,8,15,5,3,allow
51955,39871,23023,39871,70,70,0,2,8,2,0,allow
55464,53,43920,53,216,94,122,2,30,1,1,allow
64457,53,27221,53,261,102,159,2,30,1,1,allow
65146,53,65321,53,335,102,233,2,30,1,1,allow
56009,53,46044,53,178,94,84,2,30,1,1,allow
49420,53,47944,53,183,94,89,2,30,1,1,allow
64964,53,38711,53,197,102,95,2,30,1,1,allow
57071,53,6792,53,166,86,80,2,30,1,1,allow
56411,53,39978,53,184,94,90,2,30,1,1,allow
27005,32028,16656,32028,900,126,774,2,31,1,1,allow
50079,443,27272,443,20880,7976,12904,41,47,22,19,allow
55017,443,32512,443,7627,2734,4893,26,16,15,11,allow
55020,443,26568,443,7239,2934,4305,26,16,15,11,allow
50603,443,37566,443,2928,1448,1480,17,20,10,7,allow
56645,80,11255,80,234,234,0,4,12,4,0,allow
53743,23915,44968,23915,70,70,0,1,4,1,0,allow
58746,443,54765,443,5107,700,4407,15,15,7,8,allow
53808,443,50826,443,10785,2147,8638,22,30,10,12,allow
55018,443,29845,443,7232,2925,4307,27,16,16,11,allow
56661,53,53473,53,297,102,195,4,34,2,2,allow
54067,443,60829,443,113020,6140,106880,149,202,66,83,allow
49323,53,40976,53,196,102,94,2,31,1,1,allow
34530,80,15851,80,1056,682,374,10,15,6,4,allow
63916,56318,63492,56318,70,70,0,1,4,1,0,allow
56691,443,29213,443,7862,1873,5989,20,15,11,9,allow
5233,22683,23073,22683,832,832,0,14,95,14,0,allow
56142,53,19071,53,194,102,92,2,29,1,1,allow
63937,43443,33286,43443,246,66,180,4,7,2,2,allow
63938,26204,5698,26204,66,66,0,2,7,2,0,allow
57071,53,20542,53,166,86,80,2,29,1,1,allow
55031,443,21855,443,134,60,74,3,5,2,1,allow
52080,443,29531,443,3052,2014,1038,16,15,9,7,allow
56185,53,12663,53,183,102,81,2,29,1,1,allow
54076,443,7008,443,55394,4535,50859,91,170,47,44,allow
64987,53,27930,53,198,102,96,2,29,1,1,allow
49384,53,28867,53,305,93,212,4,48,2,2,allow
64976,53,29065,53,193,102,91,2,29,1,1,allow
56979,53,50155,53,180,94,86,2,29,1,1,allow
64628,53,58574,53,199,102,97,2,29,1,1,allow
49671,53,15823,53,166,86,80,2,29,1,1,allow
64586,53,51199,53,183,94,89,2,29,1,1,allow
49811,53,52504,53,300,118,182,2,29,1,1,allow
50272,53,52496,53,210,110,100,2,29,1,1,allow
55728,53,18036,53,195,102,93,2,29,1,1,allow
50272,53,35628,53,210,110,100,2,29,1,1,allow
57147,53,63811,53,166,86,80,2,29,1,1,allow
57204,53,13761,53,183,94,89,2,30,1,1,allow
57131,53,26066,53,168,78,90,2,30,1,1,allow
55596,53,31644,53,194,102,92,2,30,1,1,allow
49783,53,25868,53,179,94,85,2,30,1,1,allow
64496,53,57419,53,196,94,102,2,30,1,1,allow
56889,53,27210,53,211,110,101,2,30,1,1,allow
56009,53,38515,53,178,94,84,2,30,1,1,allow
64619,53,25912,53,179,94,85,2,31,1,1,allow
57470,64108,16646,64108,330,330,0,6,1199,6,0,allow
55649,53,62328,53,216,110,106,2,30,1,1,allow
55728,53,52425,53,195,102,93,2,30,1,1,allow
64555,53,59391,53,167,86,81,2,30,1,1,allow
50037,53,65320,53,195,102,93,2,31,1,1,allow
32012,500,63361,500,879,462,417,2,600,1,1,allow
64321,53,56788,53,195,102,93,2,31,1,1,allow
27005,33060,38657,33060,928,126,802,2,31,1,1,allow
51931,19416,18686,19416,70,70,0,1,5,1,0,allow
64321,53,14158,53,296,97,199,4,53,2,2,allow
65240,53,20571,53,453,186,267,6,30,3,3,allow
52323,443,4848,443,454059,23387,430672,602,76,275,327,allow
64986,53,34295,53,183,94,89,2,30,1,1,allow
64837,53,36950,53,195,102,93,2,30,1,1,allow
56085,53,34233,53,167,86,81,2,30,1,1,allow
55155,53,1843,53,183,94,89,2,30,1,1,allow
54194,443,38493,443,195229,13204,182025,270,124,102,168,allow
63933,443,50085,443,6822,3370,3452,21,135,10,11,allow
64872,53,21895,53,166,86,80,2,31,1,1,allow
56142,53,56422,53,194,102,92,2,31,1,1,allow
53759,80,20494,80,997,582,415,11,315,6,5,allow
65489,53,57940,53,531,97,434,4,35,2,2,allow
51932,36498,40161,36498,70,70,0,1,5,1,0,allow
54066,443,63244,443,307208,13249,293959,367,202,153,214,allow
54073,443,61123,443,90387,4941,85446,123,170,54,69,allow
57117,80,29144,80,1049,679,370,8,16,5,3,allow
45019,443,10530,443,33865,6559,27306,67,67,34,33,allow
64273,53,19409,53,256,102,154,2,30,1,1,allow
49931,53,2557,53,195,102,93,2,30,1,1,allow
56104,53,55768,53,210,110,100,2,30,1,1,allow
55830,53,41012,53,184,94,90,2,30,1,1,allow
55237,53,14253,53,193,102,91,2,30,1,1,allow
59692,443,65414,443,6129,3123,3006,12,120,7,5,allow
55159,53,57486,53,168,86,82,2,30,1,1,allow
40709,443,57804,443,256802,11839,244963,329,173,136,193,allow
55039,443,37835,443,19775,1890,17885,40,80,17,23,allow
56611,53,45220,53,177,94,83,2,30,1,1,allow
43176,53,34266,53,168,78,90,2,30,1,1,allow
56166,53,15271,53,193,102,91,2,30,1,1,allow
49730,53,58094,53,767,102,665,2,30,1,1,allow
64534,53,37006,53,214,110,104,2,30,1,1,allow
55237,53,28991,53,193,102,91,2,30,1,1,allow
33884,53,0,0,86,86,0,1,30,1,0,allow
57914,443,40977,443,17285,4005,13280,26,120,11,15,allow
55644,53,20547,53,184,94,90,2,30,1,1,allow
55808,53,26919,53,179,94,85,2,30,1,1,allow
55911,53,54432,53,211,110,101,2,30,1,1,allow
49845,53,42421,53,168,86,82,2,30,1,1,allow
56627,53,14624,53,193,102,91,2,30,1,1,allow
55130,53,35650,53,216,110,106,2,30,1,1,allow
49162,53,33354,53,183,94,89,2,30,1,1,allow
49563,53,27987,53,200,102,98,2,31,1,1,allow
55644,53,33807,53,184,94,90,2,31,1,1,allow
27005,32055,20958,32055,878,126,752,2,31,1,1,allow
56104,53,51847,53,210,110,100,2,31,1,1,allow
56627,53,7670,53,193,102,91,2,31,1,1,allow
64174,53,11186,53,180,94,86,2,31,1,1,allow
65176,53,48862,53,193,102,91,2,31,1,1,allow
64244,53,1570,53,199,102,97,2,31,1,1,allow
64627,53,39841,53,199,102,97,2,31,1,1,allow
59693,443,23790,443,1867,250,1617,8,120,4,4,allow
60433,443,40567,443,7113,3977,3136,23,136,12,11,allow
36712,53,0,0,139,70,69,2,30,1,1,allow
27005,26258,3792,26258,886,126,760,2,31,1,1,allow
55344,53,62039,53,212,110,102,2,30,1,1,allow
27005,33070,6671,33070,883,126,757,2,31,1,1,allow
56643,53,25715,53,195,102,93,2,31,1,1,allow
55596,53,30266,53,194,102,92,2,31,1,1,allow
64911,53,46196,53,209,110,99,2,31,1,1,allow
56166,53,32897,53,193,102,91,2,31,1,1,allow
56411,53,48736,53,184,94,90,2,31,1,1,allow
57127,53,17390,53,193,102,91,2,31,1,1,allow
64837,53,35241,53,195,102,93,2,31,1,1,allow
51147,443,61160,443,7124,2457,4667,23,120,10,13,allow
60565,443,42590,443,6483,3687,2796,18,135,9,9,allow
61286,443,11751,443,8970,5359,3611,22,121,11,11,allow
27005,32066,15067,32066,881,126,755,2,31,1,1,allow
27005,33055,20199,33055,888,126,762,2,31,1,1,allow
56426,53,37263,53,184,94,90,2,31,1,1,allow
57038,53,5859,53,186,102,84,2,31,1,1,allow
56041,53,17868,53,179,94,85,2,31,1,1,allow
49235,53,6024,53,164,86,78,2,31,1,1,allow
56381,53,46735,53,196,102,94,2,31,1,1,allow
56648,443,4719,443,7080,2136,4944,18,121,8,10,allow
50262,443,49732,443,7608,2413,5195,19,120,9,10,allow
58848,443,16146,443,2109,420,1689,11,121,6,5,allow
50265,44843,10747,44843,70,70,0,1,1200,1,0,allow
55877,12187,8942,12187,150,150,0,1,1200,1,0,allow
55641,53,35786,53,184,94,90,2,31,1,1,allow
64428,53,26819,53,299,97,202,4,44,2,2,allow
63929,443,53771,443,14647,2365,12282,22,136,10,12,allow
53741,43800,30138,43800,70,70,0,1,5,1,0,allow
59617,445,0,0,66,66,0,1,0,1,0,drop
59616,445,0,0,66,66,0,1,0,1,0,drop
59357,445,0,0,70,70,0,1,0,1,0,drop
64203,445,0,0,70,70,0,1,0,1,0,drop
49855,36180,0,0,62,62,0,1,0,1,0,deny
64198,445,0,0,70,70,0,1,0,1,0,drop
64194,445,0,0,70,70,0,1,0,1,0,drop
64193,445,0,0,70,70,0,1,0,1,0,drop
59347,445,0,0,70,70,0,1,0,1,0,drop
59346,445,0,0,70,70,0,1,0,1,0,drop
59345,445,0,0,70,70,0,1,0,1,0,drop
59609,445,0,0,66,66,0,1,0,1,0,drop
59342,445,0,0,70,70,0,1,0,1,0,drop
59340,445,0,0,70,70,0,1,0,1,0,drop
50086,57470,0,0,66,66,0,1,0,1,0,deny
60610,58414,0,0,62,62,0,1,0,1,0,deny
26606,40108,0,0,145,145,0,1,0,1,0,deny
59594,445,0,0,66,66,0,1,0,1,0,drop
59593,445,0,0,66,66,0,1,0,1,0,drop
59605,445,0,0,66,66,0,1,0,1,0,drop
59599,445,0,0,66,66,0,1,0,1,0,drop
59601,445,0,0,66,66,0,1,0,1,0,drop
59600,445,0,0,66,66,0,1,0,1,0,drop
59597,445,0,0,66,66,0,1,0,1,0,drop
62819,56205,0,0,62,62,0,1,0,1,0,deny
50245,44847,0,0,66,66,0,1,0,1,0,deny
64190,445,0,0,70,70,0,1,0,1,0,drop
24285,26467,0,0,62,62,0,1,0,1,0,deny
55111,39004,0,0,66,66,0,1,0,1,0,deny
28413,64147,0,0,66,66,0,1,0,1,0,deny
64185,445,0,0,70,70,0,1,0,1,0,drop
64183,445,0,0,70,70,0,1,0,1,0,drop
64181,445,0,0,70,70,0,1,0,1,0,drop
57173,44847,0,0,62,62,0,1,0,1,0,deny
1024,57470,0,0,72,72,0,1,0,1,0,deny
51812,1433,0,0,60,60,0,1,0,1,0,deny
59334,445,0,0,70,70,0,1,0,1,0,drop
24949,47563,0,0,145,145,0,1,0,1,0,deny
3074,64147,0,0,62,62,0,1,0,1,0,deny
24910,64147,0,0,66,66,0,1,0,1,0,deny
22125,23,0,0,60,60,0,1,0,1,0,deny
49514,39127,0,0,162,162,0,1,0,1,0,deny
17378,44847,0,0,66,66,0,1,0,1,0,deny
59327,445,0,0,70,70,0,1,0,1,0,drop
64180,445,0,0,70,70,0,1,0,1,0,drop
64177,445,0,0,70,70,0,1,0,1,0,drop
64173,445,0,0,70,70,0,1,0,1,0,drop
59326,445,0,0,70,70,0,1,0,1,0,drop
59587,445,0,0,66,66,0,1,0,1,0,drop
443,43775,0,0,97,97,0,1,0,1,0,deny
64172,445,0,0,70,70,0,1,0,1,0,drop
63988,50584,0,0,66,66,0,1,0,1,0,deny
60141,62413,0,0,66,66,0,1,0,1,0,deny
2180,63710,0,0,62,62,0,1,0,1,0,deny
59585,445,0,0,66,66,0,1,0,1,0,drop
1057,57470,0,0,62,62,0,1,0,1,0,deny
59583,445,0,0,66,66,0,1,0,1,0,drop
59582,445,0,0,66,66,0,1,0,1,0,drop
59579,445,0,0,66,66,0,1,0,1,0,drop
59321,445,0,0,70,70,0,1,0,1,0,drop
60351,50584,0,0,62,62,0,1,0,1,0,deny
59319,445,0,0,70,70,0,1,0,1,0,drop
21750,39004,0,0,66,66,0,1,0,1,0,deny
59486,50584,0,0,62,62,0,1,0,1,0,deny
12737,35440,0,0,62,62,0,1,0,1,0,deny
14042,22114,0,0,62,62,0,1,0,1,0,deny
14042,22114,0,0,146,146,0,1,0,1,0,deny
3023,40108,0,0,148,148,0,1,0,1,0,deny
3068,36237,0,0,62,62,0,1,0,1,0,deny
64164,445,0,0,70,70,0,1,0,1,0,drop
56035,1310,0,0,66,66,0,1,0,1,0,deny
37028,51505,0,0,62,62,0,1,0,1,0,deny
58791,15503,0,0,66,66,0,1,0,1,0,deny
12644,11392,0,0,62,62,0,1,0,1,0,deny
59315,445,0,0,70,70,0,1,0,1,0,drop
64159,445,0,0,70,70,0,1,0,1,0,drop
64156,445,0,0,70,70,0,1,0,1,0,drop
39287,57470,0,0,62,62,0,1,0,1,0,deny
50806,51505,0,0,66,66,0,1,0,1,0,deny
55854,54369,0,0,74,74,0,1,0,1,0,deny
51996,57470,0,0,66,66,0,1,0,1,0,deny
59313,445,0,0,70,70,0,1,0,1,0,drop
1143,25198,0,0,148,148,0,1,0,1,0,deny
59569,445,0,0,66,66,0,1,0,1,0,drop
13285,29892,0,0,145,145,0,1,0,1,0,deny
42964,5900,0,0,60,60,0,1,0,1,0,deny
59309,445,0,0,70,70,0,1,0,1,0,drop
59561,445,0,0,66,66,0,1,0,1,0,drop
5087,22114,0,0,66,66,0,1,0,1,0,deny
64144,445,0,0,70,70,0,1,0,1,0,drop
25267,2323,0,0,60,60,0,1,0,1,0,deny
65166,62413,0,0,66,66,0,1,0,1,0,deny
59915,42707,0,0,145,145,0,1,0,1,0,deny
59559,445,0,0,66,66,0,1,0,1,0,deny
12260,51505,0,0,62,62,0,1,0,1,0,deny
57468,57470,0,0,66,66,0,1,0,1,0,deny
53766,51505,0,0,62,62,0,1,0,1,0,deny
59552,445,0,0,66,66,0,1,0,1,0,drop
45941,23386,0,0,60,60,0,1,0,1,0,deny
45238,44847,0,0,66,66,0,1,0,1,0,deny
19875,30170,0,0,145,145,0,1,0,1,0,deny
59543,445,0,0,66,66,0,1,0,1,0,drop
59296,445,0,0,70,70,0,1,0,1,0,drop
14967,24855,0,0,62,62,0,1,0,1,0,reset-both
59293,445,0,0,70,70,0,1,0,1,0,drop
51413,57470,0,0,72,72,0,1,0,1,0,deny
57302,62413,0,0,66,66,0,1,0,1,0,deny
58076,21247,0,0,62,62,0,1,0,1,0,deny
64134,445,0,0,70,70,0,1,0,1,0,drop
64133,445,0,0,70,70,0,1,0,1,0,drop
64132,445,0,0,70,70,0,1,0,1,0,drop
35408,56205,0,0,62,62,0,1,0,1,0,deny
59530,445,0,0,66,66,0,1,0,1,0,drop
55644,53,49999,53,184,94,90,2,30,1,1,allow
56104,53,14895,53,204,104,100,2,30,1,1,allow
56751,53,17361,53,752,93,659,2,30,1,1,allow
49563,53,8253,53,200,102,98,2,30,1,1,allow
56879,53,15562,53,744,95,649,2,30,1,1,allow
59904,443,14583,443,694,370,324,12,34,7,5,allow
63900,42641,18797,42641,504,382,122,8,16,6,2,allow
53141,8595,16874,8595,70,70,0,1,5,1,0,allow
51950,17499,15514,17499,70,70,0,2,8,2,0,allow
46861,15000,42443,15000,130,70,60,2,5,1,1,allow
50286,443,3120,443,8773,1538,7235,25,15,14,11,allow
65262,53,47231,53,216,110,106,2,30,1,1,allow
36738,80,36738,80,416,198,218,7,121,4,3,allow
63935,51413,5308,51413,312,132,180,6,7,3,3,allow
50392,8080,50392,8080,8962,4731,4231,26,75,14,12,allow
64862,53,32776,53,206,105,101,2,30,1,1,allow
64872,53,35777,53,164,84,80,2,30,1,1,allow
49251,443,56131,443,15567,1944,13623,40,81,17,23,allow
49247,53,6509,53,478,196,282,6,64,3,3,allow
55016,1113,36871,1113,6723,1881,4842,25,16,15,10,allow
57364,53,57364,53,213,79,134,2,32,1,1,allow
51700,7000,51700,7000,2163,676,1487,14,15,7,7,allow
38848,80,21726,80,288702,9850,278852,312,105,123,189,allow
55808,53,62686,53,174,89,85,2,30,1,1,allow
55184,53,64437,53,182,93,89,2,31,1,1,allow
57629,80,39284,80,1115,534,581,12,16,7,5,allow
49245,53,3951,53,190,97,93,2,31,1,1,allow
56943,80,45580,80,2817,2024,793,12,75,7,5,allow
50406,8080,50406,8080,47078,2874,44204,66,51,32,34,allow
60979,443,13590,443,49981,8331,41650,75,48,36,39,allow
64200,53,60467,53,186,95,91,2,30,1,1,allow
51107,80,61498,80,366,240,126,7,21,5,2,allow
41061,5222,19047,5222,107717,16808,90909,301,618,148,153,allow
59000,443,41990,443,9876,5325,4551,25,131,14,11,allow
49692,53,19952,53,208,106,102,2,30,1,1,allow
56998,443,56998,443,4577,1670,2907,19,26,11,8,allow
49845,53,59006,53,168,86,82,2,30,1,1,allow
56166,53,15904,53,186,95,91,2,30,1,1,allow
56730,53,51057,53,733,86,647,2,30,1,1,allow
65451,53,6208,53,188,96,92,2,31,1,1,allow
56426,53,19941,53,184,94,90,2,31,1,1,allow
60792,443,60792,443,16401,8712,7689,53,297,25,28,allow
50972,3544,28007,3544,258,107,151,2,31,1,1,allow
3819,80,3819,80,9399,632,8767,15,15,7,8,allow
64460,53,62568,53,192,98,94,2,31,1,1,allow
56041,53,27459,53,174,89,85,2,31,1,1,allow
49480,53,49480,53,213,79,134,2,32,1,1,allow
55000,443,17337,443,134,60,74,3,10,2,1,allow
48885,53,48885,53,215,80,135,2,32,1,1,allow
36307,80,3965,80,1368,920,448,12,20,7,5,allow
59001,443,42456,443,9860,5309,4551,25,131,14,11,allow
57071,443,54499,443,20873,8800,12073,68,19,37,31,allow
5588,5588,0,0,3354,1792,1562,46,194,23,23,allow
61503,443,25661,443,182448,3931,178517,161,26,36,125,allow
49162,53,42033,53,182,93,89,2,30,1,1,allow
55159,53,17196,53,168,86,82,2,30,1,1,allow
49825,53,42990,53,168,86,82,2,30,1,1,allow
49621,53,22875,53,182,93,89,2,31,1,1,allow
38567,80,39974,80,1571,877,694,11,181,6,5,allow
15503,14130,48221,14130,480,149,331,2,1200,1,1,allow
56216,5228,61293,5228,2495,1477,1018,17,3600,8,9,allow
55630,53,58025,53,194,99,95,2,31,1,1,allow
58972,443,21151,443,5979,3487,2492,21,168,10,11,allow
50049,443,7528,443,27889,1445,26444,37,121,14,23,allow
40098,443,58425,443,4564,3204,1360,19,348,10,9,allow
64473,53,45182,53,184,94,90,2,31,1,1,allow
50037,53,57358,53,190,97,93,2,30,1,1,allow
57416,53,52623,53,186,95,91,2,30,1,1,allow
65107,53,21629,53,186,95,91,2,31,1,1,allow
64036,53,10774,53,182,93,89,2,31,1,1,allow
64475,53,56794,53,184,94,90,2,31,1,1,allow
51957,53,51957,53,825,99,726,2,31,1,1,allow
27005,30009,16373,30009,889,126,763,2,31,1,1,allow
15755,53,15755,53,241,95,146,2,31,1,1,allow
65144,53,52237,53,204,104,100,2,31,1,1,allow
62275,443,20241,443,18482489,568378,17914111,19386,214,6466,12920,allow
49188,53,21489,53,777,87,690,2,31,1,1,allow
57397,53,25863,53,182,93,89,2,31,1,1,allow
56144,53,58343,53,176,90,86,2,31,1,1,allow
65049,53,59454,53,184,94,90,2,31,1,1,allow
51221,10476,15636,10476,528,528,0,9,1201,9,0,allow
62062,443,17723,443,13499,2333,11166,24,137,10,14,allow
59534,445,0,0,66,66,0,1,0,1,0,drop
59532,445,0,0,66,66,0,1,0,1,0,drop
59527,445,0,0,66,66,0,1,0,1,0,drop
59535,445,0,0,66,66,0,1,0,1,0,drop
59528,445,0,0,66,66,0,1,0,1,0,drop
59531,445,0,0,66,66,0,1,0,1,0,drop
59529,445,0,0,66,66,0,1,0,1,0,drop
17548,36829,0,0,62,62,0,1,0,1,0,deny
9687,57470,0,0,78,78,0,1,0,1,0,deny
1091,37965,0,0,62,62,0,1,0,1,0,deny
59288,445,0,0,70,70,0,1,0,1,0,drop
54866,37965,0,0,62,62,0,1,0,1,0,deny
23415,11392,0,0,66,66,0,1,0,1,0,deny
48857,50584,0,0,66,66,0,1,0,1,0,deny
11256,47967,0,0,143,143,0,1,0,1,0,deny
59287,445,0,0,70,70,0,1,0,1,0,drop
8592,35993,0,0,66,66,0,1,0,1,0,deny
51382,56205,0,0,66,66,0,1,0,1,0,deny
24301,6881,0,0,146,146,0,1,0,1,0,deny
10447,30317,0,0,146,146,0,1,0,1,0,deny
59285,445,0,0,70,70,0,1,0,1,0,drop
10480,26467,0,0,62,62,0,1,0,1,0,deny
26323,50584,0,0,146,146,0,1,0,1,0,deny
10477,44847,0,0,62,62,0,1,0,1,0,deny
55644,53,55094,53,184,94,90,2,30,1,1,allow
34154,443,26354,443,45554,1695,43859,50,30,15,35,allow
1024,44847,0,0,62,62,0,1,0,1,0,deny
13917,18033,0,0,62,62,0,1,0,1,0,deny
55444,23,0,0,60,60,0,1,0,1,0,deny
64131,445,0,0,70,70,0,1,0,1,0,drop
64122,445,0,0,70,70,0,1,0,1,0,drop
64123,445,0,0,70,70,0,1,0,1,0,drop
64121,445,0,0,70,70,0,1,0,1,0,drop
41734,57470,0,0,62,62,0,1,0,1,0,deny
2464,50584,0,0,66,66,0,1,0,1,0,deny
22409,55442,0,0,74,74,0,1,0,1,0,deny
59514,445,0,0,66,66,0,1,0,1,0,drop
59513,445,0,0,66,66,0,1,0,1,0,drop
59512,445,0,0,66,66,0,1,0,1,0,drop
56098,55442,0,0,66,66,0,1,0,1,0,deny
59278,445,0,0,70,70,0,1,0,1,0,drop
14336,64147,0,0,62,62,0,1,0,1,0,deny
26601,22114,0,0,66,66,0,1,0,1,0,deny
56218,43890,0,0,66,66,0,1,0,1,0,deny
59276,445,0,0,70,70,0,1,0,1,0,drop
9445,56205,0,0,66,66,0,1,0,1,0,deny
20724,19750,0,0,78,78,0,1,0,1,0,deny
64112,445,0,0,70,70,0,1,0,1,0,drop
51429,22114,0,0,66,66,0,1,0,1,0,deny
59275,445,0,0,70,70,0,1,0,1,0,drop
56413,53,33044,53,338,110,228,2,30,1,1,allow
56785,53,32079,53,193,102,91,2,30,1,1,allow
57416,53,15222,53,193,102,91,2,30,1,1,allow
64862,53,5762,53,211,110,101,2,30,1,1,allow
39890,443,25429,443,18127,8010,10117,41,116,24,17,allow
49552,80,31507,80,1963,1067,896,11,15,6,5,allow
56690,443,7139,443,7914,1925,5989,20,15,11,9,allow
58740,443,9858,443,5228,700,4528,17,14,7,10,allow
60778,40010,59381,40010,316,136,180,6,6,3,3,allow
57069,443,33403,443,15125,2482,12643,53,38,27,26,allow
49663,53,4720,53,195,102,93,2,29,1,1,allow
55828,53,62076,53,181,94,87,2,29,1,1,allow
55344,53,42459,53,212,110,102,2,29,1,1,allow
64534,53,57803,53,214,110,104,2,30,1,1,allow
56824,443,13725,443,18356,13354,5002,47,34,29,18,allow
49554,443,18292,443,7540,1840,5700,18,15,10,8,allow
56317,53,56317,53,216,82,134,2,32,1,1,allow
39326,53,39326,53,233,90,143,2,32,1,1,allow
27005,32063,51455,32063,889,126,763,3,31,2,1,allow
54677,443,22432,443,10029,4115,5914,31,61,17,14,allow
50010,80,40489,80,5058,4299,759,11,27,6,5,allow
46851,443,41590,443,3998,1986,2012,20,255,10,10,allow
51962,1024,18199,1024,316,136,180,6,5,3,3,allow
36821,443,10604,443,5948,1553,4395,16,15,10,6,allow
65189,53,21618,53,734,94,640,2,29,1,1,allow
49162,53,39735,53,183,94,89,2,29,1,1,allow
58997,443,10081,443,70,70,0,1,4,1,0,allow
64588,53,11970,53,193,102,91,2,29,1,1,allow
42847,443,14614,443,162,102,60,2,4,1,1,allow
65246,53,9355,53,179,94,85,2,29,1,1,allow
46660,443,53403,443,13699,2575,11124,30,135,15,15,allow
27691,53,27691,53,235,90,145,2,32,1,1,allow
56444,53,36861,53,730,102,628,2,29,1,1,allow
63960,53,45995,53,178,94,84,2,30,1,1,allow
55830,53,49103,53,184,94,90,2,29,1,1,allow
56415,53,18388,53,179,94,85,2,29,1,1,allow
55155,53,2864,53,183,94,89,2,29,1,1,allow
50156,53,35377,53,178,94,84,2,29,1,1,allow
55533,53,54545,53,183,94,89,2,29,1,1,allow
64244,53,64721,53,199,102,97,2,29,1,1,allow
55155,53,64785,53,183,94,89,2,29,1,1,allow
55130,53,39778,53,216,110,106,2,29,1,1,allow
65042,53,26467,53,183,94,89,2,29,1,1,allow
55822,53,10353,53,324,126,198,2,30,1,1,allow
64837,53,39780,53,195,102,93,2,30,1,1,allow
56687,443,42301,443,7889,1900,5989,20,15,11,9,allow
49421,443,23073,443,301494,6917,294577,306,48,101,205,allow
53853,53,0,0,139,70,69,2,30,1,1,allow
65262,53,31670,53,216,110,106,2,30,1,1,allow
56426,53,49161,53,184,94,90,2,30,1,1,allow
64818,53,61380,53,260,102,158,2,30,1,1,allow
64473,53,9936,53,184,94,90,2,30,1,1,allow
64862,53,39051,53,211,110,101,2,30,1,1,allow
49563,53,27885,53,200,102,98,2,30,1,1,allow
51923,80,55461,80,60441,6260,54181,79,29,35,44,allow
39910,80,12870,80,1658,1344,314,10,15,5,5,allow
64460,53,29713,53,196,102,94,2,30,1,1,allow
50553,443,23117,443,1632,1023,609,16,133,9,7,allow
51927,63309,60569,63309,70,70,0,1,5,1,0,allow
51920,80,17031,80,5069,4443,626,11,30,6,5,allow
37611,443,45731,443,11038,3875,7163,33,16,18,15,allow
57986,80,14489,80,1898,1524,374,14,15,8,6,allow
64416,53,56387,53,291,110,181,2,30,1,1,allow
2874,53,2874,53,216,82,134,2,31,1,1,allow
37608,443,50721,443,7866,2680,5186,26,16,14,12,allow
56889,53,22522,53,211,110,101,2,30,1,1,allow
56358,53,65243,53,210,110,100,2,33,1,1,allow
50664,443,33919,443,9666,1682,7984,25,16,13,12,allow
49310,53,37425,53,239,102,137,2,30,1,1,allow
51928,52520,11257,52520,70,70,0,1,5,1,0,allow
58058,80,25761,80,318,192,126,6,21,4,2,allow
56689,443,16946,443,7890,1901,5989,20,15,11,9,allow
65246,53,26370,53,179,94,85,2,30,1,1,allow
56688,443,60189,443,7942,1953,5989,20,15,11,9,allow
56673,53,10759,53,193,102,91,2,30,1,1,allow
64534,53,35373,53,214,110,104,2,30,1,1,allow
64795,53,2622,53,338,110,228,2,30,1,1,allow
65451,53,62075,53,194,102,92,2,30,1,1,allow
64897,53,54215,53,312,94,218,2,30,1,1,allow
49245,53,24840,53,195,102,93,2,30,1,1,allow
49419,53,29016,53,252,102,150,2,30,1,1,allow
65512,53,38019,53,265,102,163,2,30,1,1,allow
55533,53,2426,53,183,94,89,2,30,1,1,allow
56673,53,26407,53,193,102,91,2,30,1,1,allow
37965,48477,53954,48477,7097,4720,2377,89,3163,55,34,allow
49692,53,65365,53,212,110,102,2,30,1,1,allow
64666,53,52653,53,226,102,124,2,30,1,1,allow
51929,53371,28667,53371,70,70,0,1,5,1,0,allow
51109,80,7098,80,366,240,126,7,20,5,2,allow
39687,443,29168,443,10412,5123,5289,36,236,19,17,allow
64200,53,27722,53,193,102,91,2,30,1,1,allow
64200,53,25588,53,193,102,91,2,30,1,1,allow
65107,53,27622,53,193,102,91,2,30,1,1,allow
49692,53,33543,53,212,110,102,2,30,1,1,allow
54453,443,34094,443,257837,37453,220384,446,952,175,271,allow
59945,443,18013,443,10477,3435,7042,34,20,18,16,allow
57336,443,14468,443,6956,2856,4100,28,16,16,12,allow
35196,5222,52205,5222,3376,1509,1867,32,83,16,16,allow
59754,80,41353,80,1352,848,504,13,83,8,5,allow
64041,53,42434,53,198,94,104,2,30,1,1,allow
49692,53,30173,53,212,110,102,2,30,1,1,allow
63960,53,27823,53,178,94,84,2,30,1,1,allow
56532,53,37108,53,164,86,78,2,30,1,1,allow
49671,53,34167,53,242,110,132,2,30,1,1,allow
27005,30006,1523,30006,888,126,762,2,31,1,1,allow
6881,6881,14892,6881,502,150,352,2,1200,1,1,allow
37877,80,30834,80,991,483,508,9,181,5,4,allow
27005,33038,15973,33038,892,126,766,2,31,1,1,allow
49327,443,33965,443,54335,2550,51785,74,42,29,45,allow
54075,443,31475,443,76388,4341,72047,107,169,48,59,allow
49551,80,48076,80,1769,873,896,11,15,6,5,allow
54074,443,19199,443,72465,3991,68474,98,169,43,55,allow
49553,443,65490,443,6074,865,5209,16,15,9,7,allow
51952,50967,36786,50967,70,70,0,2,7,2,0,allow
57436,66,13833,66,70,70,0,2,7,2,0,allow
51325,443,47264,443,2019,1219,800,15,17,8,7,allow
51954,12380,62025,12380,70,70,0,2,7,2,0,allow
53739,27290,28914,27290,70,70,0,1,4,1,0,allow
56661,53,7946,53,297,102,195,4,33,2,2,allow
53720,443,39047,443,11338,7078,4260,19,16,12,7,allow
64627,53,53750,53,305,101,204,4,44,2,2,allow
50554,443,37415,443,7343,1707,5636,26,134,14,12,allow
49828,53,44800,53,733,86,647,2,29,1,1,allow
58999,443,40792,443,9569,2606,6963,22,135,11,11,allow
56166,53,54206,53,193,102,91,2,29,1,1,allow
41764,53,7946,53,168,78,90,2,29,1,1,allow
64872,53,24466,53,730,102,628,2,29,1,1,allow
51110,80,59490,80,1524,1028,496,10,20,7,3,allow
57177,53,20677,53,179,94,85,2,29,1,1,allow
63902,22928,21119,22928,504,382,122,8,15,6,2,allow
49372,53,4796,53,527,208,319,6,64,3,3,allow
56627,53,58271,53,193,102,91,2,29,1,1,allow
55867,53,51725,53,184,94,90,2,29,1,1,allow
49216,53,14364,53,181,94,87,2,30,1,1,allow
49162,53,33526,53,183,94,89,2,30,1,1,allow
49940,53,16387,53,257,110,147,2,29,1,1,allow
55126,53,61612,53,193,102,91,2,29,1,1,allow
55184,53,59449,53,183,94,89,2,30,1,1,allow
56889,53,49457,53,211,110,101,2,30,1,1,allow
49372,53,58789,53,216,110,106,2,30,1,1,allow
56104,53,19874,53,210,110,100,2,30,1,1,allow
65262,53,52236,53,216,110,106,2,30,1,1,allow
49864,53,63965,53,193,102,91,2,30,1,1,allow
27005,33059,8397,33059,900,126,774,2,31,1,1,allow
64460,53,42311,53,196,102,94,2,31,1,1,allow
49825,53,56726,53,168,86,82,2,30,1,1,allow
64036,53,20328,53,183,94,89,2,30,1,1,allow
32675,53,58212,53,218,78,140,2,30,1,1,allow
65144,53,10538,53,210,110,100,2,30,1,1,allow
49669,53,30235,53,197,94,103,2,30,1,1,allow
27005,32078,44538,32078,871,126,745,2,31,1,1,allow
56170,443,45296,443,9201,4926,4275,19,120,10,9,allow
51539,443,52838,443,94949,5974,88975,118,148,45,73,allow
55035,443,8425,443,5653,2347,3306,33,361,18,15,allow
49435,53,45474,53,720,94,626,2,30,1,1,allow
42846,443,19024,443,162,102,60,2,5,1,1,allow
49247,53,7662,53,478,196,282,6,63,3,3,allow
36483,80,36483,80,1015966,37923,978043,1167,205,468,699,allow
39689,443,12729,443,7259,3893,3366,34,236,18,16,allow
56673,53,29686,53,193,102,91,2,30,1,1,allow
56041,53,26244,53,179,94,85,2,30,1,1,allow
57416,53,53787,53,193,102,91,2,30,1,1,allow
64417,53,10923,53,231,102,129,2,30,1,1,allow
64555,53,55605,53,167,86,81,2,30,1,1,allow
65262,53,62763,53,216,110,106,2,30,1,1,allow
49216,53,15355,53,181,94,87,2,30,1,1,allow
65176,53,39241,53,193,102,91,2,30,1,1,allow
64862,53,53283,53,211,110,101,2,30,1,1,allow
53262,443,28483,443,4385,2869,1516,32,19,18,14,allow
49770,80,9129,80,254,128,126,5,15,3,2,allow
52297,443,5562,443,3055,1931,1124,16,16,9,7,allow
65246,53,35369,53,179,94,85,2,30,1,1,allow
34153,443,49528,443,7037,1282,5755,21,30,11,10,allow
55126,53,18152,53,193,102,91,2,30,1,1,allow
64911,53,45523,53,209,110,99,2,30,1,1,allow
65523,53,26977,53,228,94,134,2,30,1,1,allow
64200,53,53095,53,193,102,91,2,30,1,1,allow
57052,443,57052,443,4616,1709,2907,19,28,11,8,allow
53261,443,49163,443,12912,4288,8624,43,20,22,21,allow
50405,8080,50405,8080,3985,2010,1975,17,51,10,7,allow
63939,24867,28601,24867,312,132,180,6,6,3,3,allow
51951,65387,56923,65387,70,70,0,2,8,2,0,allow
44158,443,51060,443,232,172,60,3,5,2,1,allow
55130,53,20364,53,216,110,106,2,30,1,1,allow
55344,53,59156,53,212,110,102,2,30,1,1,allow
57038,53,2434,53,186,102,84,2,30,1,1,allow
56387,53,17582,53,183,94,89,2,30,1,1,allow
49235,53,22418,53,172,94,78,2,30,1,1,allow
63960,53,31296,53,178,94,84,2,30,1,1,allow
64514,53,1734,53,209,102,107,2,30,1,1,allow
55630,53,39473,53,197,102,95,2,30,1,1,allow
49864,53,57559,53,193,102,91,2,30,1,1,allow
56041,53,56903,53,179,94,85,2,30,1,1,allow
27005,33035,15064,33035,864,126,738,2,31,1,1,allow
64473,53,39348,53,184,94,90,2,31,1,1,allow
55184,53,63377,53,183,94,89,2,30,1,1,allow
65025,53,23591,53,347,94,253,2,30,1,1,allow
27005,33076,50946,33076,889,126,763,2,31,1,1,allow
53829,53,12567,53,258,86,172,2,31,1,1,allow
27005,50003,14417,50003,887,126,761,2,31,1,1,allow
65451,53,9650,53,194,102,92,2,31,1,1,allow
65107,53,31681,53,193,102,91,2,31,1,1,allow
64319,53,34050,53,193,102,91,2,31,1,1,allow
65251,53,39893,53,179,94,85,2,31,1,1,allow
64619,53,39601,53,179,94,85,2,31,1,1,allow
64872,53,64528,53,166,86,80,2,31,1,1,allow
50037,53,63751,53,195,102,93,2,31,1,1,allow
49501,53,63385,53,193,102,91,2,31,1,1,allow
63035,443,64744,443,1864,250,1614,8,120,4,4,allow
34319,443,65277,443,15358,11148,4210,93,423,51,42,allow
58847,443,11614,443,7014,1630,5384,20,120,10,10,allow
57603,80,12542,80,886,886,0,1,120,1,0,allow
37484,443,55128,443,59233,7514,51719,70,122,27,43,allow
6881,6889,64062,6889,228,118,110,2,1199,1,1,allow
57470,52215,48091,52215,528,528,0,9,1200,9,0,allow
52839,443,27104,443,11808,5409,6399,73,123,33,40,allow
50037,53,12005,53,195,102,93,2,30,1,1,allow
55630,53,11814,53,197,102,95,2,30,1,1,allow
27005,33052,60950,33052,873,126,747,2,31,1,1,allow
50972,3544,56182,3544,409,107,302,4,31,2,2,allow
64070,53,32128,53,243,94,149,2,31,1,1,allow
55184,53,41873,53,183,94,89,2,31,1,1,allow
55456,443,5231,443,7409,2302,5107,19,135,9,10,allow
56686,443,39990,443,7941,1952,5989,20,16,11,9,allow
49216,53,46478,53,316,91,225,4,32,2,2,allow
55669,62781,37625,62781,320,140,180,6,7,3,3,allow
51949,5484,1068,5484,70,70,0,2,8,2,0,allow
53734,22051,14778,22051,70,70,0,1,5,1,0,allow
51052,80,32804,80,5678,1692,3986,13,17,8,5,allow
39333,443,52867,443,7832,1895,5937,24,83,14,10,allow
51957,56737,56106,56737,316,136,180,6,6,3,3,allow
38346,80,22623,80,1818,1504,314,13,16,8,5,allow
42317,443,11761,443,416,210,206,7,27,4,3,allow
51504,443,9734,443,6656,769,5887,14,16,9,5,allow
62514,37807,0,0,66,66,0,1,0,1,0,deny
64104,445,0,0,70,70,0,1,0,1,0,drop
64103,445,0,0,70,70,0,1,0,1,0,drop
64102,445,0,0,70,70,0,1,0,1,0,drop
47201,44847,0,0,66,66,0,1,0,1,0,deny
59274,445,0,0,70,70,0,1,0,1,0,drop
59273,445,0,0,70,70,0,1,0,1,0,drop
10145,21247,0,0,62,62,0,1,0,1,0,deny
59271,445,0,0,70,70,0,1,0,1,0,drop
59267,445,0,0,70,70,0,1,0,1,0,drop
44459,37807,0,0,62,62,0,1,0,1,0,deny
11061,4229,0,0,145,145,0,1,0,1,0,deny
59255,445,0,0,70,70,0,1,0,1,0,drop
59254,445,0,0,70,70,0,1,0,1,0,drop
1560,51505,0,0,62,62,0,1,0,1,0,deny
59251,445,0,0,70,70,0,1,0,1,0,drop
59244,445,0,0,70,70,0,1,0,1,0,drop
59245,445,0,0,70,70,0,1,0,1,0,drop
49522,21247,0,0,66,66,0,1,0,1,0,deny
18224,23,0,0,60,60,0,1,0,1,0,deny
64094,445,0,0,70,70,0,1,0,1,0,drop
64093,445,0,0,70,70,0,1,0,1,0,drop
64092,445,0,0,70,70,0,1,0,1,0,drop
11907,57470,0,0,66,66,0,1,0,1,0,deny
62257,2767,0,0,66,66,0,1,0,1,0,deny
46837,57470,0,0,62,62,0,1,0,1,0,deny
27309,6881,0,0,146,146,0,1,0,1,0,deny
59503,445,0,0,66,66,0,1,0,1,0,drop
37837,37965,0,0,62,62,0,1,0,1,0,deny
55027,48051,0,0,62,62,0,1,0,1,0,deny
52459,33890,0,0,60,60,0,1,0,1,0,deny
52252,46314,0,0,62,62,0,1,0,1,0,deny
56101,57470,0,0,66,66,0,1,0,1,0,deny
62143,23,0,0,60,60,0,1,0,1,0,deny
59233,445,0,0,70,70,0,1,0,1,0,drop
64087,445,0,0,70,70,0,1,0,1,0,drop
64084,445,0,0,70,70,0,1,0,1,0,drop
61392,50584,0,0,62,62,0,1,0,1,0,deny
59487,445,0,0,66,66,0,1,0,1,0,drop
59486,445,0,0,66,66,0,1,0,1,0,drop
59228,445,0,0,70,70,0,1,0,1,0,drop
49113,50584,0,0,66,66,0,1,0,1,0,deny
65398,7129,0,0,66,66,0,1,0,1,0,deny
6404,64147,0,0,145,145,0,1,0,1,0,deny
59220,445,0,0,70,70,0,1,0,1,0,drop
59219,445,0,0,70,70,0,1,0,1,0,drop
59218,445,0,0,70,70,0,1,0,1,0,drop
31745,2323,0,0,60,60,0,1,0,1,0,deny
64073,445,0,0,70,70,0,1,0,1,0,drop
60557,23117,0,0,66,66,0,1,0,1,0,deny
59215,445,0,0,70,70,0,1,0,1,0,drop
59213,445,0,0,70,70,0,1,0,1,0,drop
64070,445,0,0,70,70,0,1,0,1,0,drop
64068,445,0,0,70,70,0,1,0,1,0,drop
64067,445,0,0,70,70,0,1,0,1,0,drop
443,45940,0,0,85,85,0,1,0,1,0,deny
59481,445,0,0,66,66,0,1,0,1,0,drop
50920,60182,0,0,66,66,0,1,0,1,0,deny
59476,445,0,0,66,66,0,1,0,1,0,drop
59475,445,0,0,66,66,0,1,0,1,0,drop
59474,445,0,0,66,66,0,1,0,1,0,drop
59466,445,0,0,66,66,0,1,0,1,0,drop
59470,445,0,0,66,66,0,1,0,1,0,drop
59467,445,0,0,66,66,0,1,0,1,0,drop
59465,445,0,0,66,66,0,1,0,1,0,drop
64824,36829,0,0,66,66,0,1,0,1,0,deny
52914,37965,0,0,66,66,0,1,0,1,0,deny
64059,445,0,0,70,70,0,1,0,1,0,drop
16387,8455,0,0,60,60,0,1,0,1,0,deny
16387,49252,0,0,60,60,0,1,0,1,0,deny
16387,35244,0,0,60,60,0,1,0,1,0,deny
50675,56205,0,0,66,66,0,1,0,1,0,deny
64057,445,0,0,70,70,0,1,0,1,0,drop
64056,445,0,0,70,70,0,1,0,1,0,drop
64053,445,0,0,70,70,0,1,0,1,0,drop
4110,35440,0,0,66,66,0,1,0,1,0,deny
6666,5000,0,0,60,60,0,1,0,1,0,deny
59206,445,0,0,70,70,0,1,0,1,0,drop
59413,51505,0,0,66,66,0,1,0,1,0,deny
63956,38211,0,0,62,62,0,1,0,1,0,deny
41756,56205,0,0,62,62,0,1,0,1,0,deny
59199,445,0,0,70,70,0,1,0,1,0,drop
59197,445,0,0,70,70,0,1,0,1,0,drop
39324,64147,0,0,62,62,0,1,0,1,0,deny
64052,445,0,0,70,70,0,1,0,1,0,drop
64049,445,0,0,70,70,0,1,0,1,0,drop
64045,445,0,0,70,70,0,1,0,1,0,drop
59458,445,0,0,66,66,0,1,0,1,0,drop
57765,2767,0,0,146,146,0,1,0,1,0,deny
64044,445,0,0,70,70,0,1,0,1,0,drop
59456,445,0,0,66,66,0,1,0,1,0,drop
59193,445,0,0,70,70,0,1,0,1,0,drop
59454,445,0,0,66,66,0,1,0,1,0,drop
59452,445,0,0,66,66,0,1,0,1,0,drop
59191,445,0,0,70,70,0,1,0,1,0,drop
16477,37807,0,0,66,66,0,1,0,1,0,deny
59450,445,0,0,66,66,0,1,0,1,0,drop
12031,36237,0,0,66,66,0,1,0,1,0,deny
33003,28543,0,0,62,62,0,1,0,1,0,deny
5132,23,0,0,60,60,0,1,0,1,0,deny
54389,28543,0,0,66,66,0,1,0,1,0,deny
36893,67,0,0,60,60,0,1,0,1,0,deny
10445,46824,0,0,62,62,0,1,0,1,0,deny
53725,64147,0,0,66,66,0,1,0,1,0,deny
59187,445,0,0,70,70,0,1,0,1,0,drop
65344,46824,0,0,66,66,0,1,0,1,0,deny
50,38211,0,0,66,66,0,1,0,1,0,deny
64037,445,0,0,70,70,0,1,0,1,0,drop
64030,445,0,0,70,70,0,1,0,1,0,drop
64029,445,0,0,70,70,0,1,0,1,0,drop
59186,445,0,0,70,70,0,1,0,1,0,drop
1054,57470,0,0,62,62,0,1,0,1,0,deny
57368,7302,0,0,66,66,0,1,0,1,0,deny
57170,38303,0,0,66,66,0,1,0,1,0,deny
59440,445,0,0,66,66,0,1,0,1,0,drop
59181,445,0,0,70,70,0,1,0,1,0,drop
63527,50584,0,0,62,62,0,1,0,1,0,deny
51320,37965,0,0,62,62,0,1,0,1,0,deny
59432,445,0,0,66,66,0,1,0,1,0,drop
64017,445,0,0,70,70,0,1,0,1,0,drop
58745,30188,0,0,66,66,0,1,0,1,0,deny
19841,50584,0,0,62,62,0,1,0,1,0,deny
59429,445,0,0,66,66,0,1,0,1,0,drop
26448,9192,0,0,145,145,0,1,0,1,0,deny
39098,51505,0,0,62,62,0,1,0,1,0,deny
13413,44847,0,0,66,66,0,1,0,1,0,deny
16382,17500,0,0,62,62,0,1,0,1,0,deny
59168,445,0,0,70,70,0,1,0,1,0,drop
59422,445,0,0,66,66,0,1,0,1,0,drop
51503,443,40605,443,4801,702,4099,13,16,8,5,allow
38234,443,15725,443,9807,2542,7265,47,19,24,23,allow
26929,443,8333,443,7487,2728,4759,25,19,13,12,allow
50272,443,27135,443,772,432,340,12,18,7,5,allow
42277,443,42277,443,2200,1253,947,23,76,12,11,allow
49041,443,30685,443,5144,847,4297,16,132,9,7,allow
59778,443,59778,443,4580,1673,2907,19,28,11,8,allow
43311,80,24777,80,811,671,140,6,31,4,2,allow
56572,53,56572,53,253,99,154,2,32,1,1,allow
54319,53,54319,53,253,99,154,2,32,1,1,allow
53732,22704,15296,22704,70,70,0,1,5,1,0,allow
42282,443,42282,443,2052,1187,865,21,76,11,10,allow
42280,443,42280,443,2052,1187,865,21,76,11,10,allow
56722,80,63327,80,41658,23230,18428,114,798,66,48,allow
64912,53,12678,53,182,93,89,2,31,1,1,allow
56468,53,8242,53,176,90,86,2,30,1,1,allow
47819,443,19809,443,6258,956,5302,20,16,11,9,allow
60380,443,29465,443,70,70,0,1,5,1,0,allow
53737,51456,42714,51456,70,70,0,1,5,1,0,allow
47326,443,40388,443,6318,1025,5293,17,33,9,8,allow
34141,53,34141,53,217,87,130,2,30,1,1,allow
64319,53,16100,53,186,95,91,2,30,1,1,allow
49501,53,44593,53,186,95,91,2,31,1,1,allow
62439,443,62439,443,4507,1600,2907,19,26,11,8,allow
39232,53,39232,53,215,80,135,2,32,1,1,allow
11919,53,11919,53,213,79,134,2,32,1,1,allow
54012,443,7741,443,4318,726,3592,14,16,7,7,allow
54182,443,54182,443,4581,1674,2907,19,29,11,8,allow
36548,443,36548,443,4621,1714,2907,19,30,11,8,allow
5180,80,5180,80,33443,797,32646,33,16,9,24,allow
50494,443,62791,443,5331564,43954,5287610,4171,80,672,3499,allow
49837,53,8590,53,176,90,86,2,30,1,1,allow
6881,6881,38378,6881,231,111,120,2,1200,1,1,allow
51221,50861,60298,50861,490,149,341,2,1200,1,1,allow
64357,53,4119,53,182,93,89,2,31,1,1,allow
58467,53,16449,53,235,95,140,2,31,1,1,allow
47744,80,34323,80,1571,877,694,11,180,6,5,allow
49274,53,46367,53,194,99,95,2,31,1,1,allow
49312,53,34351,53,767,102,665,2,31,1,1,allow
32912,53,0,0,82,82,0,1,31,1,0,allow
56395,53,20688,53,170,87,83,2,31,1,1,allow
49385,31652,0,0,66,66,0,1,91,1,0,allow
65524,53,51364,53,182,93,89,2,31,1,1,allow
30960,45740,3924,45740,330,330,0,6,3609,6,0,allow
59414,445,0,0,66,66,0,1,0,1,0,drop
59165,445,0,0,70,70,0,1,0,1,0,drop
28875,51505,0,0,146,146,0,1,0,1,0,deny
43578,15503,0,0,74,74,0,1,0,1,0,deny
57706,64147,0,0,62,62,0,1,0,1,0,deny
64006,445,0,0,70,70,0,1,0,1,0,drop
63459,443,62292,443,7782,1280,6502,22,79,10,12,allow
64005,445,0,0,70,70,0,1,0,1,0,drop
64004,445,0,0,70,70,0,1,0,1,0,drop
59161,445,0,0,70,70,0,1,0,1,0,drop
59402,445,0,0,66,66,0,1,0,1,0,drop
59403,445,0,0,66,66,0,1,0,1,0,drop
59404,445,0,0,66,66,0,1,0,1,0,drop
59401,445,0,0,66,66,0,1,0,1,0,drop
59405,445,0,0,66,66,0,1,0,1,0,drop
59398,445,0,0,66,66,0,1,0,1,0,drop
59399,445,0,0,66,66,0,1,0,1,0,drop
59400,445,0,0,66,66,0,1,0,1,0,drop
30135,37965,0,0,62,62,0,1,0,1,0,deny
59876,44847,0,0,66,66,0,1,0,1,0,deny
64104,22114,0,0,66,66,0,1,0,1,0,deny
59159,445,0,0,70,70,0,1,0,1,0,drop
64449,30188,0,0,66,66,0,1,0,1,0,deny
54825,444,0,0,60,60,0,1,0,1,0,deny
44922,57470,0,0,74,74,0,1,0,1,0,deny
51926,58664,64074,58664,70,70,0,1,5,1,0,allow
51502,443,41545,443,7211,823,6388,16,15,10,6,allow
65322,443,20624,443,8429792,268889,8160903,8985,135,2983,6002,allow
49245,53,23757,53,195,102,93,2,30,1,1,allow
65107,53,53716,53,193,102,91,2,30,1,1,allow
64619,53,61367,53,438,89,349,4,44,2,2,allow
36699,443,33647,443,11086707,166045,10920662,9176,172,1285,7891,allow
62348,443,31303,443,1592,965,627,15,20,7,8,allow
55662,36445,15210,36445,504,318,186,8,17,5,3,allow
49621,53,6731,53,501,188,313,6,33,3,3,allow
53735,58869,24687,58869,70,70,0,1,4,1,0,allow
53704,443,40944,443,5743,1339,4404,18,180,8,10,allow
18743,53,18743,53,235,90,145,2,31,1,1,allow
56919,443,47014,443,54568,32686,21882,69,161,40,29,allow
48608,443,46175,443,6371,848,5523,20,16,11,9,allow
44559,443,29969,443,6903,1185,5718,26,255,12,14,allow
38689,443,13215,443,1264333,25315,1239018,1197,16,355,842,allow
63930,44330,64385,44330,66,66,0,2,7,2,0,allow
53736,37168,63835,37168,70,70,0,1,4,1,0,allow
36166,80,26343,80,1614,1300,314,10,15,5,5,allow
49621,53,59180,53,287,93,194,4,56,2,2,allow
49864,53,49733,53,193,102,91,2,29,1,1,allow
13826,443,17437,443,7356,1014,6342,20,75,10,10,allow
57397,53,11845,53,183,94,89,2,29,1,1,allow
64172,53,13713,53,197,102,95,2,29,1,1,allow
5588,5588,0,0,3354,1792,1562,46,193,23,23,allow
49621,53,9845,53,183,94,89,2,29,1,1,allow
49825,53,31559,53,168,86,82,2,29,1,1,allow
59402,53,59402,53,216,90,126,2,29,1,1,allow
65332,53,1654,53,226,86,140,2,29,1,1,allow
49563,53,41117,53,200,102,98,2,29,1,1,allow
49837,53,4839,53,180,94,86,2,29,1,1,allow
57397,53,24712,53,183,94,89,2,30,1,1,allow
56426,53,8485,53,184,94,90,2,30,1,1,allow
51925,29587,19217,29587,70,70,0,1,5,1,0,allow
56936,80,5916,80,1490,886,604,10,75,6,4,allow
63896,80,57609,80,314,192,122,6,15,4,2,allow
64319,53,2772,53,193,102,91,2,30,1,1,allow
49164,53,54796,53,226,102,124,2,30,1,1,allow
64912,53,47656,53,183,94,89,2,30,1,1,allow
51890,80,53517,80,7097,3553,3544,15,31,8,7,allow
56685,443,20018,443,7855,1866,5989,20,15,11,9,allow
58729,443,41982,443,5167,700,4467,16,15,7,9,allow
15503,6881,43362,6881,2310,2310,0,36,3136,36,0,allow
55229,53,60362,53,720,94,626,2,30,1,1,allow
57397,53,3449,53,183,94,89,2,30,1,1,allow
49337,53,51649,53,258,126,132,2,30,1,1,allow
51675,443,51675,443,4539,1632,2907,19,27,11,8,allow
64365,53,55898,53,196,94,102,2,30,1,1,allow
50635,443,12337,443,8252,1702,6550,26,72,13,13,allow
65049,53,51039,53,184,94,90,2,30,1,1,allow
64460,53,1617,53,196,102,94,2,30,1,1,allow
56497,443,18628,443,1343,763,580,14,26,8,6,allow
56468,53,30389,53,180,94,86,2,30,1,1,allow
50270,443,3425,443,868,514,354,13,18,8,5,allow
55630,53,24833,53,197,102,95,2,30,1,1,allow
56144,53,26768,53,180,94,86,2,30,1,1,allow
51947,16935,29468,16935,70,70,0,2,8,2,0,allow
64592,53,20935,53,177,94,83,2,30,1,1,allow
65007,53,25080,53,180,86,94,2,30,1,1,allow
56935,80,54520,80,1482,878,604,10,75,6,4,allow
65144,53,24637,53,210,110,100,2,30,1,1,allow
17282,7000,17282,7000,2163,676,1487,14,15,7,7,allow
50349,80,24554,80,3909,888,3021,12,15,6,6,allow
64678,53,43744,53,289,102,187,2,30,1,1,allow
38688,443,23677,443,90166,3481,86685,96,16,31,65,allow
56937,80,7429,80,2567,1586,981,13,75,8,5,allow
49180,53,37264,53,314,97,217,4,34,2,2,allow
56644,80,27121,80,234,234,0,4,12,4,0,allow
56498,443,11650,443,1343,763,580,14,26,8,6,allow
49193,80,37184,80,6158,654,5504,15,16,8,7,allow
64036,53,28611,53,360,93,267,4,57,2,2,allow
49876,53,42623,53,211,102,109,2,30,1,1,allow
56468,53,1634,53,180,94,86,2,30,1,1,allow
42316,443,23676,443,6397,2103,4294,17,26,9,8,allow
49654,22,49654,22,7791,3373,4418,54,36,26,28,allow
58040,80,24098,80,9984,5333,4651,21,25,10,11,allow
51925,80,55386,80,51645,3868,47777,67,28,30,37,allow
54468,443,26749,443,2402,1444,958,18,81,10,8,allow
63929,48477,10688,48477,66,66,0,2,7,2,0,allow
58038,80,30379,80,5029,2608,2421,15,25,9,6,allow
44960,443,32145,443,306066,33556,272510,414,196,162,252,allow
56938,80,50995,80,1403,841,562,10,75,6,4,allow
53455,53,0,0,82,82,0,2,40,2,0,allow
53757,1,21144,1,70,70,0,2,8,2,0,allow
53722,6881,24173,6881,552,306,246,9,15,5,4,allow
49192,80,39568,80,2807,587,2220,13,16,7,6,allow
39032,443,17584,443,5819,1571,4248,26,58,14,12,allow
50282,443,64648,443,15775,3795,11980,48,18,32,16,allow
53733,40599,48603,40599,70,70,0,1,4,1,0,allow
49247,53,56867,53,478,196,282,6,63,3,3,allow
57862,443,61289,443,448344,11729,436615,474,157,128,346,allow
36386,443,8343,443,1209,709,500,14,28,8,6,allow
56684,443,53117,443,7907,1918,5989,20,15,11,9,allow
57871,443,42705,443,7716,3991,3725,50,125,25,25,allow
57416,53,53137,53,193,102,91,2,29,1,1,allow
49323,53,47360,53,196,102,94,2,29,1,1,allow
64872,53,61410,53,166,86,80,2,29,1,1,allow
49510,53,6465,53,329,118,211,2,29,1,1,allow
49355,53,58716,53,193,102,91,2,29,1,1,allow
49825,53,18724,53,168,86,82,2,29,1,1,allow
56532,53,65053,53,164,86,78,2,29,1,1,allow
64319,53,63281,53,193,102,91,2,29,1,1,allow
64475,53,62342,53,184,94,90,2,29,1,1,allow
64095,53,51473,53,269,110,159,2,30,1,1,allow
64105,53,29112,53,300,102,198,2,30,1,1,allow
64473,53,45476,53,184,94,90,2,30,1,1,allow
43628,443,48034,443,13974,3774,10200,29,120,12,17,allow
52458,443,42668,443,4550,1777,2773,17,135,8,9,allow
53750,27352,21637,27352,70,70,0,2,8,2,0,allow
53754,25306,12188,25306,70,70,0,2,8,2,0,allow
51924,28016,53313,28016,70,70,0,1,5,1,0,allow
43702,443,33020,443,1201,707,494,12,26,7,5,allow
39677,443,47798,443,7123,1331,5792,22,81,11,11,allow
49191,80,25150,80,2807,587,2220,13,16,7,6,allow
57870,443,40542,443,1373,734,639,17,125,10,7,allow
48347,443,29830,443,8415,883,7532,23,54,8,15,allow
50541,80,22542,80,4296,3281,1015,12,33,7,5,allow
37604,443,53490,443,8493,2314,6179,33,16,18,15,allow
58050,80,17128,80,318,192,126,6,20,4,2,allow
49197,53,3341,53,249,94,155,2,30,1,1,allow
13825,443,28678,443,8844,949,7895,19,75,9,10,allow
58056,80,49652,80,3518,1780,1738,12,20,7,5,allow
50275,443,24781,443,708,362,346,11,18,6,5,allow
55668,80,2182,80,70,70,0,2,8,2,0,allow
43027,80,42429,80,1506,1446,60,2,5,1,1,allow
50633,443,56668,443,6673,1791,4882,22,72,12,10,allow
58728,443,26266,443,5167,700,4467,16,15,7,9,allow
60995,443,4422,443,1351,846,505,12,19,7,5,allow
64592,53,18733,53,177,94,83,2,30,1,1,allow
64026,53,2303,53,244,94,150,2,31,1,1,allow
38125,443,63227,443,497663,22937,474726,585,38,245,340,allow
50021,80,33696,80,10026538,185017,9841521,9515,195,2989,6526,allow
43701,443,61661,443,1201,707,494,12,26,7,5,allow
50279,443,26201,443,1128,654,474,17,18,10,7,allow
44861,443,14296,443,1625,1038,587,14,27,8,6,allow
50634,443,27378,443,8220,1670,6550,26,71,13,13,allow
49355,53,27262,53,193,102,91,2,30,1,1,allow
64475,53,56537,53,184,94,90,2,30,1,1,allow
56771,53,12754,53,261,94,167,2,30,1,1,allow
55432,443,59316,443,256189,15094,241095,316,122,120,196,allow
56675,53,13397,53,254,94,160,2,30,1,1,allow
65251,53,45927,53,183,98,85,3,31,2,1,allow
38001,443,11115,443,1652,817,835,17,186,9,8,allow
56534,443,31456,443,3055,993,2062,10,120,5,5,allow
35165,443,20390,443,7174,4658,2516,18,121,10,8,allow
54425,443,49600,443,1648,813,835,17,186,9,8,allow
57179,53,11960,53,325,94,231,2,30,1,1,allow
64912,53,33217,53,183,94,89,2,31,1,1,allow
49654,53,58880,53,214,110,104,2,31,1,1,allow
63976,443,11736,443,1270998,514773,756225,3073,2384,1413,1660,allow
37999,443,54290,443,1650,815,835,17,186,9,8,allow
56400,80,42500,80,1281,398,883,16,392,4,12,allow
33017,443,62492,443,11008,4624,6384,36,322,19,17,allow
36438,5223,19564,5223,5243,1898,3345,34,3005,18,16,allow
43381,443,3948,443,9551,2173,7378,33,25,17,16,allow
48452,443,56539,443,9553,2175,7378,33,27,17,16,allow
31653,53,31653,53,235,90,145,2,34,1,1,allow
52788,53,56727,53,196,94,102,2,30,1,1,allow
64357,53,36127,53,183,94,89,2,30,1,1,allow
49274,53,14620,53,197,102,95,2,30,1,1,allow
50562,53,50562,53,216,82,134,2,32,1,1,allow
31096,53,31096,53,216,82,134,2,32,1,1,allow
54894,443,28940,443,9829,2313,7516,37,25,19,18,allow
33774,443,40240,443,9551,2173,7378,33,27,17,16,allow
53651,443,17075,443,9485,2173,7312,32,27,17,15,allow
64381,443,33769,443,4838,1059,3779,16,54,8,8,allow
64813,53,4341,53,180,94,86,2,30,1,1,allow
49569,53,17630,53,213,94,119,2,30,1,1,allow
49654,53,53040,53,214,110,104,2,30,1,1,allow
49501,53,46075,53,343,92,251,4,32,2,2,allow
58436,443,57353,443,18290,3012,15278,46,136,24,22,allow
49355,53,60733,53,193,102,91,2,30,1,1,allow
56468,53,3693,53,180,94,86,2,30,1,1,allow
56920,23117,0,0,146,146,0,1,0,1,0,deny
54826,444,0,0,60,60,0,1,0,1,0,deny
59155,445,0,0,70,70,0,1,0,1,0,drop
46516,57470,0,0,62,62,0,1,0,1,0,deny
64824,37965,0,0,62,62,0,1,0,1,0,deny
3181,53567,0,0,66,66,0,1,0,1,0,deny
62493,50584,0,0,146,146,0,1,0,1,0,deny
60425,15503,0,0,145,145,0,1,0,1,0,deny
60786,51505,0,0,66,66,0,1,0,1,0,deny
51148,9571,0,0,66,66,0,1,0,1,0,deny
22784,9571,0,0,62,62,0,1,0,1,0,deny
53500,1,0,0,66,66,0,1,0,1,0,deny
64000,445,0,0,70,70,0,1,0,1,0,drop
64001,445,0,0,70,70,0,1,0,1,0,drop
63997,445,0,0,70,70,0,1,0,1,0,drop
63987,445,0,0,70,70,0,1,0,1,0,drop
43323,1,0,0,62,62,0,1,0,1,0,deny
26889,50265,0,0,62,62,0,1,0,1,0,deny
59191,35440,0,0,66,66,0,1,0,1,0,deny
61451,17500,0,0,62,62,0,1,0,1,0,deny
59148,445,0,0,70,70,0,1,0,1,0,drop
20724,19750,0,0,78,78,0,1,0,1,0,deny
59383,445,0,0,66,66,0,1,0,1,0,drop
59384,445,0,0,66,66,0,1,0,1,0,drop
59386,445,0,0,66,66,0,1,0,1,0,drop
59146,445,0,0,70,70,0,1,0,1,0,drop
39681,37965,0,0,66,66,0,1,0,1,0,deny
23553,37965,0,0,62,62,0,1,0,1,0,deny
38909,57470,0,0,62,62,0,1,0,1,0,deny
53447,22114,0,0,146,146,0,1,0,1,0,deny
59145,445,0,0,70,70,0,1,0,1,0,drop
16319,44847,0,0,62,62,0,1,0,1,0,deny
59144,445,0,0,70,70,0,1,0,1,0,drop
63984,445,0,0,70,70,0,1,0,1,0,drop
59143,445,0,0,70,70,0,1,0,1,0,drop
1818,22114,0,0,62,62,0,1,0,1,0,deny
50624,50584,0,0,66,66,0,1,0,1,0,deny
59139,445,0,0,70,70,0,1,0,1,0,drop
59141,445,0,0,70,70,0,1,0,1,0,drop
63983,445,0,0,70,70,0,1,0,1,0,drop
63981,445,0,0,70,70,0,1,0,1,0,drop
63980,445,0,0,70,70,0,1,0,1,0,drop
6881,26296,0,0,143,143,0,1,0,1,0,deny
40512,57470,0,0,74,74,0,1,0,1,0,deny
59125,445,0,0,70,70,0,1,0,1,0,drop
59124,445,0,0,70,70,0,1,0,1,0,drop
59119,445,0,0,70,70,0,1,0,1,0,drop
51368,1900,0,0,139,139,0,1,0,1,0,deny
13559,57866,0,0,62,62,0,1,0,1,0,deny
59114,445,0,0,70,70,0,1,0,1,0,drop
59115,445,0,0,70,70,0,1,0,1,0,drop
2432,11392,0,0,62,62,0,1,0,1,0,deny
50063,35776,0,0,148,148,0,1,0,1,0,deny
63966,445,0,0,70,70,0,1,0,1,0,drop
63964,445,0,0,70,70,0,1,0,1,0,drop
63963,445,0,0,70,70,0,1,0,1,0,drop
26835,47993,0,0,62,62,0,1,0,1,0,deny
22987,15503,0,0,146,146,0,1,0,1,0,deny
59373,445,0,0,66,66,0,1,0,1,0,drop
32520,47993,0,0,66,66,0,1,0,1,0,deny
54242,443,22470,443,499,425,74,4,0,3,1,allow
54241,443,12202,443,499,425,74,4,0,3,1,allow
64815,37965,0,0,62,62,0,1,0,1,0,deny
59103,445,0,0,70,70,0,1,0,1,0,drop
65081,26467,0,0,66,66,0,1,0,1,0,deny
40571,26467,0,0,62,62,0,1,0,1,0,deny
25237,57470,0,0,62,62,0,1,0,1,0,deny
16693,36237,0,0,66,66,0,1,0,1,0,deny
49168,57470,0,0,66,66,0,1,0,1,0,deny
6666,5984,0,0,60,60,0,1,0,1,0,deny
53024,57866,0,0,146,146,0,1,0,1,0,deny
63958,445,0,0,70,70,0,1,0,1,0,drop
63957,445,0,0,70,70,0,1,0,1,0,drop
57034,44847,0,0,66,66,0,1,0,1,0,deny
59099,445,0,0,70,70,0,1,0,1,0,drop
59357,445,0,0,66,66,0,1,0,1,0,drop
59355,445,0,0,66,66,0,1,0,1,0,drop
13423,56205,0,0,62,62,0,1,0,1,0,deny
12986,64147,0,0,145,145,0,1,0,1,0,deny
59090,445,0,0,70,70,0,1,0,1,0,drop
59089,445,0,0,70,70,0,1,0,1,0,drop
59087,445,0,0,70,70,0,1,0,1,0,drop
59084,445,0,0,70,70,0,1,0,1,0,drop
1043,48817,0,0,136,136,0,1,0,1,0,deny
59082,445,0,0,70,70,0,1,0,1,0,drop
63945,445,0,0,70,70,0,1,0,1,0,drop
63939,445,0,0,70,70,0,1,0,1,0,drop
63942,445,0,0,70,70,0,1,0,1,0,drop
63940,445,0,0,70,70,0,1,0,1,0,drop
51743,64147,0,0,62,62,0,1,0,1,0,deny
59350,445,0,0,66,66,0,1,0,1,0,drop
44491,50584,0,0,62,62,0,1,0,1,0,deny
13090,36237,0,0,66,66,0,1,0,1,0,deny
3667,56205,0,0,62,62,0,1,0,1,0,deny
59335,445,0,0,66,66,0,1,0,1,0,drop
59336,445,0,0,66,66,0,1,0,1,0,drop
59341,445,0,0,66,66,0,1,0,1,0,drop
59343,445,0,0,66,66,0,1,0,1,0,drop
59339,445,0,0,66,66,0,1,0,1,0,drop
59338,445,0,0,66,66,0,1,0,1,0,drop
59345,445,0,0,66,66,0,1,0,1,0,drop
58858,15503,0,0,66,66,0,1,0,1,0,deny
55854,54369,0,0,74,74,0,1,0,1,0,deny
63931,445,0,0,70,70,0,1,0,1,0,drop
58901,443,24407,443,17071,1532,15539,17,27,3,14,allow
59077,445,0,0,70,70,0,1,0,1,0,drop
49958,36829,0,0,66,66,0,1,0,1,0,deny
63929,445,0,0,70,70,0,1,0,1,0,drop
63928,445,0,0,70,70,0,1,0,1,0,drop
63925,445,0,0,70,70,0,1,0,1,0,drop
42640,11119,0,0,148,148,0,1,0,1,0,deny
12951,50584,0,0,66,66,0,1,0,1,0,deny
30129,37965,0,0,72,72,0,1,0,1,0,deny
55966,35440,0,0,62,62,0,1,0,1,0,deny
59069,445,0,0,70,70,0,1,0,1,0,drop
59067,445,0,0,70,70,0,1,0,1,0,drop
36579,30188,0,0,66,66,0,1,0,1,0,deny
58582,50584,0,0,62,62,0,1,0,1,0,deny
63924,445,0,0,70,70,0,1,0,1,0,drop
63921,445,0,0,70,70,0,1,0,1,0,drop
63919,445,0,0,70,70,0,1,0,1,0,drop
51581,22114,0,0,66,66,0,1,0,1,0,deny
59328,445,0,0,66,66,0,1,0,1,0,drop
58972,57866,0,0,66,66,0,1,0,1,0,deny
59062,445,0,0,70,70,0,1,0,1,0,drop
63916,445,0,0,70,70,0,1,0,1,0,drop
59061,445,0,0,70,70,0,1,0,1,0,drop
59326,445,0,0,66,66,0,1,0,1,0,drop
49286,23,0,0,60,60,0,1,0,1,0,deny
32648,55108,0,0,145,145,0,1,0,1,0,deny
59325,445,0,0,66,66,0,1,0,1,0,drop
59324,445,0,0,66,66,0,1,0,1,0,drop
59321,445,0,0,66,66,0,1,0,1,0,drop
32137,44512,0,0,62,62,0,1,0,1,0,deny
59057,445,0,0,70,70,0,1,0,1,0,drop
7881,48817,0,0,133,133,0,1,0,1,0,deny
59055,445,0,0,70,70,0,1,0,1,0,drop
63909,445,0,0,70,70,0,1,0,1,0,drop
63902,445,0,0,70,70,0,1,0,1,0,drop
63898,445,0,0,70,70,0,1,0,1,0,drop
27844,52700,0,0,70,70,0,1,0,1,0,deny
26254,56205,0,0,62,62,0,1,0,1,0,deny
59310,445,0,0,66,66,0,1,0,1,0,drop
59051,445,0,0,70,70,0,1,0,1,0,drop
12969,55777,0,0,66,66,0,1,0,1,0,deny
54986,53,11167,53,212,108,104,2,31,1,1,allow
51917,80,25082,80,43399,5061,38338,55,29,24,31,allow
65417,443,43584,443,2494,1643,851,17,25,9,8,allow
54648,443,56134,443,9215,3253,5962,51,22,25,26,allow
54379,80,23086,80,1466,729,737,12,16,7,5,allow
34471,53,34471,53,253,99,154,2,32,1,1,allow
51508,4545,51508,4545,156,156,0,3,8,3,0,allow
48728,443,2946,443,2437,1321,1116,15,83,9,6,allow
64383,443,47790,443,4017,978,3039,14,53,8,6,allow
34522,80,31284,80,1420,715,705,12,16,7,5,allow
56594,53,29926,53,788,108,680,2,30,1,1,allow
23127,53,23127,53,233,91,142,2,30,1,1,allow
54008,443,44994,443,4249,724,3525,13,15,7,6,allow
54005,443,23305,443,4253,726,3527,13,15,7,6,allow
54782,443,13415,443,9487,2103,7384,32,24,16,16,allow
64382,443,26649,443,4017,978,3039,14,53,8,6,allow
49756,80,38066,80,20926,3231,17695,37,51,17,20,allow
58890,80,50368,80,23867,3316,20551,38,135,20,18,allow
49667,80,52853,80,1165,468,697,8,125,5,3,allow
52714,443,48732,443,26399,2076,24323,37,319,15,22,allow
50237,443,44543,443,2994,1521,1473,15,83,9,6,allow
64813,53,27372,53,176,90,86,2,30,1,1,allow
12776,53,12776,53,239,94,145,2,30,1,1,allow
52715,443,11256,443,26901,2286,24615,46,319,18,28,allow
55254,443,18680,443,13275,3587,9688,38,27,20,18,allow
49117,443,48924,443,9551,2173,7378,33,27,17,16,allow
42642,443,22756,443,10548,2689,7859,38,24,19,19,allow
37346,443,8413,443,7814,2339,5475,26,316,12,14,allow
51945,1587,22122,1587,70,70,0,2,8,2,0,allow
5588,5588,0,0,3354,1792,1562,46,193,23,23,allow
31976,53,31976,53,241,95,146,2,30,1,1,allow
65238,53,13271,53,86,86,0,1,30,1,0,allow
41577,53,15196,53,168,78,90,2,30,1,1,allow
54550,443,54550,443,13490,2525,10965,30,18,17,13,allow
57354,53,55769,53,767,102,665,2,30,1,1,allow
52460,53,0,0,82,82,0,1,30,1,0,allow
33008,53,33008,53,263,104,159,2,30,1,1,allow
54486,443,15577,443,3170,1036,2134,13,135,6,7,allow
51876,443,3089,443,1852,1103,749,16,32,9,7,allow
51931,443,20564,443,2328,1677,651,17,23,9,8,allow
51855,443,29819,443,11894,2661,9233,32,32,18,14,allow
56413,53,30670,53,224,94,130,2,30,1,1,allow
64297,443,21726,443,56432,4371,52061,72,135,29,43,allow
56574,443,27778,443,75732,15030,60702,137,138,56,81,allow
49201,53,5443,53,200,102,98,2,31,1,1,allow
36767,53,36767,53,237,93,144,2,31,1,1,allow
30960,45739,64773,45739,330,330,0,6,3609,6,0,allow
48360,443,45618,443,8400,2088,6312,33,20,18,15,allow
47000,53,0,0,82,82,0,1,31,1,0,allow
42190,53,42190,53,639,86,553,2,31,1,1,allow
37598,443,64510,443,8102,2685,5417,24,17,15,9,allow
65428,53,7407,53,731,85,646,2,31,1,1,allow
22131,53,22131,53,172,76,96,2,31,1,1,allow
49621,53,49621,53,231,90,141,2,31,1,1,allow
62449,443,11939,443,9977,4364,5613,19,121,9,10,allow
46585,443,60959,443,9439,3223,6216,27,137,13,14,allow
54380,60038,0,0,66,66,0,1,90,1,0,allow
30960,45736,51969,45736,396,396,0,7,3616,7,0,allow
51221,57274,16024,57274,528,528,0,9,1201,9,0,allow
50424,55777,0,0,62,62,0,1,0,1,0,deny
8403,46824,0,0,62,62,0,1,0,1,0,deny
3978,35440,0,0,62,62,0,1,0,1,0,deny
32704,46824,0,0,66,66,0,1,0,1,0,deny
51188,64147,0,0,62,62,0,1,0,1,0,deny
56521,32480,0,0,62,62,0,1,0,1,0,deny
59303,445,0,0,66,66,0,1,0,1,0,drop
63888,445,0,0,70,70,0,1,0,1,0,drop
7226,50584,0,0,62,62,0,1,0,1,0,deny
59301,445,0,0,66,66,0,1,0,1,0,drop
8313,51505,0,0,66,66,0,1,0,1,0,deny
38306,51221,0,0,62,62,0,1,0,1,0,deny
64606,53,40619,53,278,118,160,2,30,1,1,allow
54986,53,26600,53,214,110,104,2,30,1,1,allow
37603,443,12094,443,8493,2314,6179,33,15,18,15,allow
59053,53,2855,53,227,86,141,2,30,1,1,allow
65524,53,59878,53,183,94,89,2,30,1,1,allow
43523,53,26419,53,168,78,90,2,30,1,1,allow
35579,443,65088,443,13136,3596,9540,40,26,21,19,allow
58712,80,8787,80,4176,3453,723,14,15,7,7,allow
51946,9407,10036,9407,70,70,0,2,7,2,0,allow
53730,37096,48081,37096,70,70,0,1,4,1,0,allow
63898,13205,50081,13205,70,70,0,1,4,1,0,allow
64036,53,62200,53,183,94,89,2,29,1,1,allow
65049,53,41682,53,184,94,90,2,29,1,1,allow
56221,53,31091,53,177,94,83,2,29,1,1,allow
64334,53,61866,53,311,94,217,2,30,1,1,allow
64093,53,55556,53,213,94,119,2,30,1,1,allow
48689,443,50166,443,9681,2243,7438,35,24,18,17,allow
60270,443,42458,443,9551,2173,7378,33,26,17,16,allow
57376,443,40721,443,7211,823,6388,16,15,10,6,allow
56522,80,49102,80,798,401,397,7,17,5,2,allow
48348,443,49861,443,20838,2211,18627,40,14,20,20,allow
51943,55464,31100,55464,70,70,0,2,8,2,0,allow
49520,80,52279,80,2011,975,1036,13,70,7,6,allow
51922,18413,51851,18413,70,70,0,1,5,1,0,allow
58533,443,53373,443,17356,5096,12260,46,26,24,22,allow
51920,32678,28612,32678,70,70,0,1,5,1,0,allow
60442,49556,41273,49556,624,318,306,10,15,5,5,allow
49540,80,39259,80,374,192,182,7,42,4,3,allow
48349,443,46666,443,42932,2883,40049,63,14,31,32,allow
49516,80,21754,80,1256,746,510,11,70,6,5,allow
21276,53,21276,53,244,98,146,2,33,1,1,allow
49993,80,30030,80,21812,900,20912,27,26,9,18,allow
52642,6881,49230,6881,1106,800,306,10,14,5,5,allow
51966,443,65076,443,9249,4498,4751,39,15,22,17,allow
63904,18268,33783,18268,70,70,0,1,4,1,0,allow
49690,53,14782,53,790,110,680,2,29,1,1,allow
55091,443,55091,443,21122,2591,18531,36,17,18,18,allow
51914,5222,1180,5222,5141,2331,2810,41,144,24,17,allow
63317,53,0,0,181,86,95,2,30,1,1,allow
56395,53,28310,53,177,94,83,2,30,1,1,allow
65049,53,38762,53,184,94,90,2,30,1,1,allow
49245,53,64738,53,195,102,93,2,30,1,1,allow
20641,53,20641,53,240,98,142,2,29,1,1,allow
56221,53,42617,53,177,94,83,2,29,1,1,allow
50345,80,27840,80,736,670,66,6,15,5,1,allow
49178,80,4471,80,2807,587,2220,13,16,7,6,allow
49179,80,7093,80,2807,587,2220,13,16,7,6,allow
2348,3389,2348,3389,4145,1976,2169,22,19,13,9,allow
51915,5222,45227,5222,11827,5467,6360,100,144,54,46,allow
55559,53,14649,53,1026,292,734,8,50,4,4,allow
55464,53,8236,53,214,110,104,2,30,1,1,allow
54986,53,42487,53,214,110,104,2,30,1,1,allow
37597,443,2780,443,10497,3476,7021,34,17,18,16,allow
55695,53,46724,53,209,102,107,2,30,1,1,allow
38720,5222,21758,5222,6262,2015,4247,35,48,17,18,allow
58709,443,26417,443,7924,702,7222,17,16,7,10,allow
55663,19994,59885,19994,70,70,0,2,8,2,0,allow
64554,53,57103,53,498,204,294,6,30,3,3,allow
55479,53,49461,53,232,94,138,2,30,1,1,allow
41246,443,27215,443,234,234,0,4,12,4,0,allow
51834,80,36073,80,366,240,126,7,32,5,2,allow
49188,8108,9022,8108,1788,1016,772,15,15,8,7,allow
60297,53,6955,53,227,86,141,2,30,1,1,allow
51923,11542,51093,11542,70,70,0,1,5,1,0,allow
41750,443,14251,443,4636,792,3844,16,15,8,8,allow
56120,53,36940,53,212,102,110,2,30,1,1,allow
49666,80,7693,80,2356,499,1857,10,125,6,4,allow
55396,443,55396,443,63319,6716,56603,91,19,45,46,allow
40050,53,42804,53,168,78,90,2,30,1,1,allow
48966,53,48747,53,168,78,90,2,30,1,1,allow
49181,80,37044,80,6158,654,5504,15,16,8,7,allow
63135,443,47015,443,7127,1737,5390,18,16,10,8,allow
49274,53,26954,53,560,199,361,6,82,3,3,allow
64357,53,13293,53,183,94,89,2,30,1,1,allow
55495,53,24897,53,305,94,211,2,30,1,1,allow
65236,53,60243,53,247,118,129,2,30,1,1,allow
51941,19333,28791,19333,70,70,0,2,8,2,0,allow
49733,80,1914,80,4198,2450,1748,20,148,15,5,allow
56252,53,46494,53,531,90,441,4,41,2,2,allow
51090,80,46921,80,10434,1041,9393,20,45,11,9,allow
54449,443,54449,443,7974,2926,5048,25,17,15,10,allow
65377,53,55727,53,207,86,121,2,30,1,1,allow
49793,53,56349,53,271,102,169,2,30,1,1,allow
56470,53,27427,53,168,78,90,2,30,1,1,allow
50266,443,13343,443,6344,2063,4281,26,21,12,14,allow
36430,443,7560,443,9423,2105,7318,31,26,16,15,allow
44710,443,12033,443,13320,3575,9745,38,26,19,19,allow
43499,443,52568,443,9685,2330,7355,23,15,12,11,allow
63906,36909,1381,36909,70,70,0,1,4,1,0,allow
51274,24399,41980,24399,70,70,0,1,5,1,0,allow
56337,443,18375,443,9683,2173,7510,35,26,17,18,allow
65194,53,9315,53,265,91,174,4,36,2,2,allow
39854,443,9295,443,7903,3497,4406,38,72,22,16,allow
65491,443,49902,443,452013,13200,438813,465,16,163,302,allow
37790,443,42788,443,448,78,370,6,25,1,5,allow
53306,443,56801,443,11114,3066,8048,41,119,22,19,allow
50347,80,44018,80,1671,862,809,10,15,5,5,allow
58583,443,61583,443,8605,3169,5436,19,17,12,7,allow
46492,80,56877,80,1967,1133,834,12,45,7,5,allow
51953,62964,9503,62964,316,136,180,6,5,3,3,allow
49190,80,2197,80,6158,654,5504,15,15,8,7,allow
49539,80,49460,80,378,192,186,7,42,4,3,allow
51891,80,21420,80,7434,3830,3604,17,30,9,8,allow
55667,19667,52444,19667,70,70,0,2,8,2,0,allow
51942,22272,51406,22272,210,70,140,4,8,2,2,allow
53729,40721,47011,40721,70,70,0,1,4,1,0,allow
41748,443,37689,443,4570,792,3778,15,15,8,7,allow
63899,62015,51023,62015,70,70,0,1,4,1,0,allow
56433,80,35239,80,17188,1559,15629,25,25,10,15,allow
37653,5223,25600,5223,142,142,0,1,5,1,0,allow
51922,80,2848,80,52962,3994,48968,71,27,32,39,allow
49911,53,26669,53,258,110,148,2,30,1,1,allow
50127,443,64951,443,31982,9936,22046,61,16,33,28,allow
65238,53,22542,53,168,86,82,2,29,1,1,allow
49582,443,23714,443,29241,2457,26784,48,171,24,24,allow
64813,53,44563,53,180,94,86,2,30,1,1,allow
56181,53,2631,53,784,94,690,2,29,1,1,allow
50940,443,10678,443,6888,1774,5114,25,210,14,11,allow
53812,443,40871,443,2966,801,2165,13,135,6,7,allow
65144,53,2841,53,210,110,100,2,29,1,1,allow
49762,53,15647,53,195,94,101,2,30,1,1,allow
49703,53,48424,53,198,86,112,2,30,1,1,allow
44847,15315,12919,15315,150,150,0,1,1200,1,0,allow
55158,53,38311,53,212,102,110,2,30,1,1,allow
64357,53,57507,53,271,85,186,4,30,2,2,allow
49574,53,12004,53,337,110,227,2,30,1,1,allow
55756,53,23922,53,311,94,217,2,30,1,1,allow
27515,53,18456,53,224,78,146,2,30,1,1,allow
63379,443,51286,443,2649,330,2319,12,134,5,7,allow
53254,443,47275,443,9949,4623,5326,45,150,23,22,allow
41815,5228,54746,5228,7701,2155,5546,30,611,17,13,allow
51906,443,34093,443,5685,1179,4506,18,29,10,8,allow
60150,443,32146,443,7741,2692,5049,24,16,13,11,allow
48014,80,51000,80,4006,3572,434,14,15,7,7,allow
55666,36653,26608,36653,70,70,0,2,8,2,0,allow
41047,443,9579,443,6423,744,5679,16,16,9,7,allow
51451,80,37614,80,214,140,74,4,15,3,1,allow
49665,80,5154,80,2237,508,1729,10,125,6,4,allow
65463,53,27388,53,210,102,108,2,30,1,1,allow
59627,53,32997,53,290,102,188,2,30,1,1,allow
49935,53,2977,53,370,94,276,2,30,1,1,allow
55464,53,12452,53,214,110,104,2,30,1,1,allow
35556,53,63282,53,168,78,90,2,30,1,1,allow
60936,443,12668,443,1864,250,1614,8,120,4,4,allow
49925,443,37960,443,19134,7361,11773,40,148,19,21,allow
56263,53,57350,53,385,134,251,2,31,1,1,allow
63466,443,61707,443,5828,1439,4389,16,75,9,7,allow
57625,443,18316,443,4751,909,3842,15,16,9,6,allow
41751,443,36135,443,4570,792,3778,15,15,8,7,allow
65492,443,42698,443,92573,4519,88054,105,16,39,66,allow
64374,53,45440,53,239,102,137,2,30,1,1,allow
64912,53,24794,53,183,94,89,2,30,1,1,allow
64384,53,2219,53,333,94,239,2,30,1,1,allow
56680,53,8517,53,211,102,109,2,30,1,1,allow
51194,443,35674,443,1561,768,793,17,185,9,8,allow
38112,443,61056,443,1053962,45604,1008358,1190,69,456,734,allow
50048,443,29440,443,6887,2473,4414,20,15,11,9,allow
64813,53,11826,53,335,90,245,4,35,2,2,allow
51921,37744,34923,37744,70,70,0,1,5,1,0,allow
56492,443,36078,443,3715,1659,2056,35,188,18,17,allow
64298,53,48284,53,311,118,193,2,30,1,1,allow
44577,443,43261,443,30773,9123,21650,90,104,48,42,allow
56395,53,7674,53,177,94,83,2,30,1,1,allow
55204,53,12205,53,263,94,169,2,30,1,1,allow
55654,443,49899,443,186406,10415,175991,218,123,79,139,allow
56451,53,25472,53,322,102,220,2,30,1,1,allow
64588,53,18701,53,211,102,109,2,30,1,1,allow
25108,53,24919,53,222,78,144,2,30,1,1,allow
65146,53,35272,53,763,102,661,2,31,1,1,allow
49936,53,28353,53,211,102,109,2,31,1,1,allow
16230,53,64249,53,223,78,145,2,30,1,1,allow
49501,53,50847,53,193,102,91,2,31,1,1,allow
64791,443,34950,443,4725,1727,2998,11,121,6,5,allow
61887,443,28383,443,81136,7785,73351,109,131,40,69,allow
6882,4443,56989,4443,600,600,0,5,1200,5,0,allow
19473,35726,44271,35726,481,150,331,2,1200,1,1,allow
44037,443,25209,443,5839,3664,2175,13,120,8,5,allow
56035,53,29824,53,337,94,243,2,30,1,1,allow
55242,53,7339,53,373,126,247,2,30,1,1,allow
55333,123,5768,123,184,94,90,2,30,1,1,allow
55634,53,46753,53,308,102,206,2,30,1,1,allow
54986,53,61995,53,214,110,104,2,30,1,1,allow
64789,443,4787,443,1786,172,1614,7,121,3,4,allow
50724,443,63657,443,3171,1369,1802,9,120,5,4,allow
30188,63853,28721,63853,502,150,352,2,1200,1,1,allow
55034,443,13403,443,7969,4870,3099,36,360,20,16,allow
51948,34853,60337,34853,316,136,180,6,6,3,3,allow
63925,18912,65425,18912,66,66,0,2,8,2,0,allow
51918,80,52022,80,426,240,186,8,29,5,3,allow
49180,80,59682,80,6158,654,5504,15,16,8,7,allow
57165,53,7622,53,498,204,294,6,30,3,3,allow
56125,53,56568,53,311,118,193,2,30,1,1,allow
65524,53,37598,53,183,94,89,2,30,1,1,allow
56684,53,21413,53,301,94,207,2,31,1,1,allow
64281,53,45768,53,214,110,104,2,31,1,1,allow
50266,443,41683,443,49981,15486,34495,269,138,136,133,allow
50271,443,3937,443,10103,2342,7761,39,121,22,17,allow
53723,51501,24523,51501,70,70,0,1,5,1,0,allow
53501,443,53501,443,960,539,421,9,36,5,4,allow
51900,80,40398,80,366,240,126,7,29,5,2,allow
50276,443,53649,443,9984,2917,7067,49,102,28,21,allow
50270,443,45158,443,9998,2237,7761,38,121,21,17,allow
50285,443,58128,443,7210,2382,4828,33,100,19,14,allow
63924,26328,57332,26328,66,66,0,2,8,2,0,allow
50337,80,47050,80,1083,653,430,8,16,5,3,allow
51913,80,58997,80,366,240,126,7,29,5,2,allow
51841,443,41534,443,1686,984,702,15,32,8,7,allow
56853,443,46609,443,7092,1795,5297,25,32,14,11,allow
49675,53,62009,53,78,78,0,1,30,1,0,allow
65252,53,49878,53,249,102,147,2,30,1,1,allow
51346,51221,0,0,74,74,0,1,0,1,0,deny
59038,445,0,0,70,70,0,1,0,1,0,drop
48676,53393,0,0,60,60,0,1,0,1,0,deny
22409,55442,0,0,74,74,0,1,0,1,0,deny
53746,36237,0,0,66,66,0,1,0,1,0,deny
59293,445,0,0,66,66,0,1,0,1,0,drop
59035,445,0,0,70,70,0,1,0,1,0,drop
60204,2767,0,0,62,62,0,1,0,1,0,deny
9448,57866,0,0,62,62,0,1,0,1,0,deny
59290,445,0,0,66,66,0,1,0,1,0,drop
55320,22114,0,0,146,146,0,1,0,1,0,deny
45682,47993,0,0,62,62,0,1,0,1,0,deny
36400,51505,0,0,62,62,0,1,0,1,0,deny
18011,44847,0,0,62,62,0,1,0,1,0,deny
21759,51505,0,0,66,66,0,1,0,1,0,deny
25653,26296,0,0,148,148,0,1,0,1,0,deny
56157,50584,0,0,62,62,0,1,0,1,0,deny
59030,445,0,0,70,70,0,1,0,1,0,drop
58981,50584,0,0,146,146,0,1,0,1,0,deny
59029,445,0,0,70,70,0,1,0,1,0,drop
63878,445,0,0,70,70,0,1,0,1,0,drop
63877,445,0,0,70,70,0,1,0,1,0,drop
63876,445,0,0,70,70,0,1,0,1,0,drop
35229,32468,0,0,62,62,0,1,0,1,0,deny
59271,445,0,0,66,66,0,1,0,1,0,drop
59275,445,0,0,66,66,0,1,0,1,0,drop
59277,445,0,0,66,66,0,1,0,1,0,drop
59276,445,0,0,66,66,0,1,0,1,0,drop
59272,445,0,0,66,66,0,1,0,1,0,drop
59270,445,0,0,66,66,0,1,0,1,0,drop
59274,445,0,0,66,66,0,1,0,1,0,drop
59269,445,0,0,66,66,0,1,0,1,0,drop
59027,445,0,0,70,70,0,1,0,1,0,drop
62731,21247,0,0,66,66,0,1,0,1,0,deny
20724,19750,0,0,78,78,0,1,0,1,0,deny
55386,32480,0,0,62,62,0,1,0,1,0,deny
5859,11392,0,0,66,66,0,1,0,1,0,deny
27402,37628,0,0,62,62,0,1,0,1,0,deny
54276,37628,0,0,66,66,0,1,0,1,0,deny
59020,445,0,0,70,70,0,1,0,1,0,drop
63872,445,0,0,70,70,0,1,0,1,0,drop
63868,445,0,0,70,70,0,1,0,1,0,drop
63871,445,0,0,70,70,0,1,0,1,0,drop
63860,445,0,0,70,70,0,1,0,1,0,drop
59018,445,0,0,70,70,0,1,0,1,0,drop
59257,445,0,0,66,66,0,1,0,1,0,drop
59254,445,0,0,66,66,0,1,0,1,0,drop
59255,445,0,0,66,66,0,1,0,1,0,drop
34932,38608,0,0,62,62,0,1,0,1,0,deny
59017,445,0,0,70,70,0,1,0,1,0,drop
59016,445,0,0,70,70,0,1,0,1,0,drop
59015,445,0,0,70,70,0,1,0,1,0,drop
59013,445,0,0,70,70,0,1,0,1,0,drop
59009,445,0,0,70,70,0,1,0,1,0,drop
48527,7302,0,0,146,146,0,1,0,1,0,deny
50245,44847,0,0,66,66,0,1,0,1,0,deny
41249,50584,0,0,66,66,0,1,0,1,0,deny
63857,445,0,0,70,70,0,1,0,1,0,drop
63851,445,0,0,70,70,0,1,0,1,0,drop
63852,445,0,0,70,70,0,1,0,1,0,drop
63849,445,0,0,70,70,0,1,0,1,0,drop
56833,23117,0,0,62,62,0,1,0,1,0,deny
1024,57470,0,0,72,72,0,1,0,1,0,deny
55111,39004,0,0,66,66,0,1,0,1,0,deny
58997,445,0,0,70,70,0,1,0,1,0,drop
58996,445,0,0,70,70,0,1,0,1,0,drop
54240,443,62221,443,499,425,74,4,0,3,1,allow
54239,443,8377,443,499,425,74,4,0,3,1,allow
54238,443,21116,443,499,425,74,4,0,3,1,allow
54236,443,22668,443,499,425,74,4,0,3,1,allow
54237,443,5337,443,499,425,74,4,0,3,1,allow
58993,445,0,0,70,70,0,1,0,1,0,drop
28413,64147,0,0,66,66,0,1,0,1,0,deny
54305,39004,0,0,62,62,0,1,0,1,0,deny
54305,39004,0,0,145,145,0,1,0,1,0,deny
57173,44847,0,0,62,62,0,1,0,1,0,deny
19617,39004,0,0,62,62,0,1,0,1,0,deny
58986,445,0,0,70,70,0,1,0,1,0,drop
58987,445,0,0,70,70,0,1,0,1,0,drop
62912,26467,0,0,62,62,0,1,0,1,0,deny
11541,40108,0,0,148,148,0,1,0,1,0,deny
54779,50584,0,0,66,66,0,1,0,1,0,deny
27947,26467,0,0,66,66,0,1,0,1,0,deny
60514,39004,0,0,66,66,0,1,0,1,0,deny
63839,445,0,0,70,70,0,1,0,1,0,drop
63838,445,0,0,70,70,0,1,0,1,0,drop
63836,445,0,0,70,70,0,1,0,1,0,drop
43100,22114,0,0,146,146,0,1,0,1,0,deny
59245,445,0,0,66,66,0,1,0,1,0,drop
58975,445,0,0,70,70,0,1,0,1,0,drop
45964,55559,0,0,60,60,0,1,0,1,0,deny
29734,23,0,0,60,60,0,1,0,1,0,deny
57233,50934,0,0,66,66,0,1,0,1,0,deny
48323,35253,0,0,146,146,0,1,0,1,0,deny
51015,64147,0,0,62,62,0,1,0,1,0,deny
14923,51505,0,0,62,62,0,1,0,1,0,deny
3068,36237,0,0,62,62,0,1,0,1,0,deny
21750,39004,0,0,66,66,0,1,0,1,0,deny
62388,39004,0,0,145,145,0,1,0,1,0,deny
39920,22114,0,0,62,62,0,1,0,1,0,deny
36665,23,0,0,60,60,0,1,0,1,0,deny
24145,35440,0,0,62,62,0,1,0,1,0,deny
63831,445,0,0,70,70,0,1,0,1,0,drop
63830,445,0,0,70,70,0,1,0,1,0,drop
58971,445,0,0,70,70,0,1,0,1,0,drop
56035,1310,0,0,66,66,0,1,0,1,0,deny
59647,47993,0,0,62,62,0,1,0,1,0,deny
55854,54369,0,0,74,74,0,1,0,1,0,deny
58961,445,0,0,70,70,0,1,0,1,0,drop
58960,445,0,0,70,70,0,1,0,1,0,drop
58959,445,0,0,70,70,0,1,0,1,0,drop
59230,445,0,0,66,66,0,1,0,1,0,drop
59228,445,0,0,66,66,0,1,0,1,0,drop
58958,445,0,0,70,70,0,1,0,1,0,drop
10797,50584,0,0,62,62,0,1,0,1,0,deny
58955,445,0,0,70,70,0,1,0,1,0,drop
35864,44847,0,0,78,78,0,1,0,1,0,deny
62109,44847,0,0,62,62,0,1,0,1,0,deny
51096,63710,0,0,62,62,0,1,0,1,0,deny
0,0,0,0,156,156,0,2,0,2,0,allow
0,0,0,0,244,244,0,2,0,2,0,allow
63817,445,0,0,70,70,0,1,0,1,0,drop
59796,23,0,0,60,60,0,1,0,1,0,deny
63815,445,0,0,70,70,0,1,0,1,0,drop
63812,445,0,0,70,70,0,1,0,1,0,drop
63811,445,0,0,70,70,0,1,0,1,0,drop
16387,8455,0,0,60,60,0,1,0,1,0,deny
16387,49252,0,0,60,60,0,1,0,1,0,deny
16387,35244,0,0,60,60,0,1,0,1,0,deny
59222,445,0,0,66,66,0,1,0,1,0,drop
59211,445,0,0,66,66,0,1,0,1,0,drop
59214,445,0,0,66,66,0,1,0,1,0,drop
59215,445,0,0,66,66,0,1,0,1,0,drop
59213,445,0,0,66,66,0,1,0,1,0,drop
59210,445,0,0,66,66,0,1,0,1,0,drop
59216,445,0,0,66,66,0,1,0,1,0,drop
59208,445,0,0,66,66,0,1,0,1,0,drop
58949,445,0,0,70,70,0,1,0,1,0,drop
54134,64147,0,0,66,66,0,1,0,1,0,deny
63804,445,0,0,70,70,0,1,0,1,0,drop
65166,62413,0,0,66,66,0,1,0,1,0,deny
63801,445,0,0,70,70,0,1,0,1,0,drop
63797,445,0,0,70,70,0,1,0,1,0,drop
63799,445,0,0,70,70,0,1,0,1,0,drop
58941,445,0,0,70,70,0,1,0,1,0,drop
58938,445,0,0,70,70,0,1,0,1,0,drop
13484,37965,0,0,62,62,0,1,0,1,0,deny
49855,36180,0,0,62,62,0,1,0,1,0,deny
60022,10387,0,0,159,159,0,1,0,1,0,deny
45238,44847,0,0,66,66,0,1,0,1,0,deny
28580,64147,0,0,62,62,0,1,0,1,0,deny
11450,57470,0,0,66,66,0,1,0,1,0,deny
41755,48817,0,0,145,145,0,1,0,1,0,deny
50486,56205,0,0,62,62,0,1,0,1,0,deny
7275,9524,0,0,66,66,0,1,0,1,0,deny
15180,26467,0,0,62,62,0,1,0,1,0,deny
60610,58414,0,0,62,62,0,1,0,1,0,deny
58934,445,0,0,70,70,0,1,0,1,0,drop
61766,44847,0,0,66,66,0,1,0,1,0,deny
7286,44847,0,0,66,66,0,1,0,1,0,deny
63795,445,0,0,70,70,0,1,0,1,0,drop
63792,445,0,0,70,70,0,1,0,1,0,drop
63790,445,0,0,70,70,0,1,0,1,0,drop
58933,445,0,0,70,70,0,1,0,1,0,drop
59200,445,0,0,66,66,0,1,0,1,0,drop
63788,445,0,0,70,70,0,1,0,1,0,drop
50095,50584,0,0,62,62,0,1,0,1,0,deny
55600,22,0,0,60,60,0,1,0,1,0,deny
59198,445,0,0,66,66,0,1,0,1,0,drop
10480,26467,0,0,62,62,0,1,0,1,0,deny
57302,62413,0,0,66,66,0,1,0,1,0,deny
26872,44847,0,0,62,62,0,1,0,1,0,deny
59195,445,0,0,66,66,0,1,0,1,0,drop
59194,445,0,0,66,66,0,1,0,1,0,drop
55706,443,29687,443,5259,1203,4056,19,41,10,9,allow
49360,443,11814,443,5782,1008,4774,17,16,8,9,allow
49223,80,54325,80,1793,1030,763,11,15,6,5,allow
58051,443,3762,443,8930,1529,7401,21,19,9,12,allow
56559,53,15416,53,731,85,646,2,30,1,1,allow
50282,443,7706,443,24856,2858,21998,57,100,30,27,allow
51882,443,57503,443,366,180,186,7,30,4,3,allow
51849,80,48623,80,366,240,126,7,31,5,2,allow
51881,443,23769,443,4418,1116,3302,17,30,10,7,allow
51869,443,60062,443,4435,1290,3145,17,31,9,8,allow
27480,443,15079,443,11716,1007,10709,42,383,11,31,allow
51848,80,47789,80,12009,5364,6645,23,31,12,11,allow
51842,443,3576,443,1503,984,519,13,31,8,5,allow
43101,443,55812,443,20846,11163,9683,55,318,30,25,allow
16647,53,16647,53,233,91,142,2,30,1,1,allow
64281,53,18314,53,212,108,104,2,30,1,1,allow
51880,443,34522,443,4358,1056,3302,16,30,9,7,allow
51846,80,21384,80,366,240,126,7,31,5,2,allow
50268,443,33459,443,35251,25181,10070,121,123,63,58,allow
50272,443,15445,443,8456,2502,5954,32,120,19,13,allow
7331,53,7331,53,213,79,134,2,32,1,1,allow
60776,4156,9252,4156,70,70,0,2,8,2,0,allow
53726,26083,31165,26083,70,70,0,1,5,1,0,allow
58049,80,61142,80,378,192,186,7,19,4,3,allow
2588,53,2588,53,197,76,121,2,30,1,1,allow
44368,53,44368,53,233,91,142,2,30,1,1,allow
52265,53,0,0,233,89,144,2,30,1,1,allow
65353,53,60832,53,170,87,83,2,30,1,1,allow
51847,80,28250,80,366,240,126,7,31,5,2,allow
51874,443,24684,443,1852,1103,749,16,31,9,7,allow
51840,443,42990,443,246,120,126,5,32,3,2,allow
53500,443,53500,443,960,539,421,9,35,5,4,allow
55046,53,59080,53,300,102,198,4,40,2,2,allow
51879,443,43940,443,4418,1116,3302,17,30,10,7,allow
50283,443,2548,443,49752,4187,45565,87,100,45,42,allow
51348,7000,51348,7000,2163,676,1487,14,15,7,7,allow
50326,80,17692,80,7979,802,7177,17,47,8,9,allow
30859,53,30859,53,213,79,134,2,32,1,1,allow
57328,53,13021,53,1427,101,1326,4,48,2,2,allow
55886,443,32004,443,161,101,60,2,5,1,1,allow
51866,443,8681,443,2449,1794,655,17,31,10,7,allow
51221,33295,49216,33295,528,528,0,9,1200,9,0,allow
51877,443,15246,443,1852,1103,749,16,31,9,7,allow
49541,443,61178,443,8464,2891,5573,20,30,10,10,allow
51861,80,40570,80,366,240,126,7,31,5,2,allow
51875,443,48033,443,1852,1103,749,16,31,9,7,allow
53724,64923,63918,64923,70,70,0,1,5,1,0,allow
51845,80,46640,80,502,310,192,9,31,6,3,allow
51940,26399,39116,26399,70,70,0,2,8,2,0,allow
60184,443,60184,443,4574,1667,2907,19,26,11,8,allow
60445,20555,43690,20555,70,70,0,2,8,2,0,allow
63854,53,30633,53,578,286,292,9,15,5,4,allow
60437,30889,62883,30889,1729,1125,604,14,16,8,6,allow
52713,443,22767,443,26235,2216,24019,39,318,17,22,allow
55004,80,20099,80,2394,630,1764,9,16,6,3,allow
44684,443,12133,443,4728,3417,1311,23,35,12,11,allow
50327,80,7970,80,366,180,186,7,47,4,3,allow
57013,80,43644,80,5696,703,4993,14,75,8,6,allow
49322,443,12551,443,166663,77974,88689,368,2310,123,245,allow
46746,443,46746,443,4427,1520,2907,19,30,11,8,allow
55694,53,54062,53,166,85,81,2,31,1,1,allow
62861,443,20935,443,4777,2262,2515,10,122,5,5,allow
50265,26650,50101,26650,480,149,331,2,1201,1,1,allow
50535,80,30581,80,62768,25796,36972,75,34,33,42,allow
54195,443,39081,443,1786,172,1614,7,120,3,4,allow
50538,80,28093,80,4314,3518,796,15,32,8,7,allow
49740,53,20655,53,793,101,692,2,31,1,1,allow
137,137,54849,137,96,96,0,2,31,2,0,allow
65507,53,3795,53,166,85,81,2,31,1,1,allow
55203,443,52613,443,12947,4309,8638,29,152,15,14,allow
62860,443,23047,443,4954,2554,2400,11,122,6,5,allow
12929,41864,0,0,145,145,0,1,0,1,0,deny
58929,445,0,0,70,70,0,1,0,1,0,drop
59192,445,0,0,66,66,0,1,0,1,0,drop
53656,11119,0,0,148,148,0,1,0,1,0,deny
58928,445,0,0,70,70,0,1,0,1,0,drop
25589,23,0,0,60,60,0,1,0,1,0,deny
1025,51221,0,0,62,62,0,1,0,1,0,deny
51382,56205,0,0,66,66,0,1,0,1,0,deny
51413,57470,0,0,72,72,0,1,0,1,0,deny
60720,23718,0,0,62,62,0,1,0,1,0,deny
63780,445,0,0,70,70,0,1,0,1,0,drop
54866,37965,0,0,62,62,0,1,0,1,0,deny
51862,80,9823,80,6106,5420,686,13,30,7,6,allow
49953,80,9395,80,11209,819,10390,19,15,9,10,allow
60436,56687,61011,56687,564,318,246,9,16,5,4,allow
51960,443,7003,443,8830,1950,6880,27,25,14,13,allow
49959,80,5453,80,9763,749,9014,17,15,8,9,allow
47200,443,56772,443,11003,3821,7182,35,257,14,21,allow
50523,53,31491,53,199,102,97,2,30,1,1,allow
55715,443,4116,443,1648,114,1534,5,120,2,3,allow
51871,443,4793,443,554,310,244,10,30,6,4,allow
51837,80,11115,80,242,120,122,5,31,3,2,allow
52039,80,22816,80,4185,3462,723,14,15,7,7,allow
49769,80,36678,80,254,128,126,5,15,3,2,allow
58047,80,5646,80,7453,2953,4500,19,21,10,9,allow
56138,53,30181,53,284,94,190,2,29,1,1,allow
65353,53,4050,53,177,94,83,2,29,1,1,allow
56311,53,2296,53,311,94,217,2,30,1,1,allow
50047,80,4097,80,1455,349,1106,10,15,5,5,allow
51836,443,36494,443,4927,986,3941,21,31,12,9,allow
51908,80,63314,80,4542,2962,1580,13,28,8,5,allow
51815,80,14356,80,3910,2158,1752,15,32,10,5,allow
51830,80,53910,80,486,300,186,9,31,6,3,allow
57914,443,43452,443,4322,2383,1939,29,124,17,12,allow
50290,443,49413,443,26064,2233,23831,44,97,23,21,allow
51826,443,55412,443,682,370,312,12,32,7,5,allow
49455,443,62985,443,12386,1821,10565,23,33,11,12,allow
53502,443,53502,443,960,539,421,9,35,5,4,allow
53259,443,54002,443,6250,1774,4476,27,17,14,13,allow
50284,443,42928,443,13168,2875,10293,48,99,27,21,allow
63923,59177,7249,59177,66,66,0,2,7,2,0,allow
51915,443,2041,443,362,180,182,7,28,4,3,allow
53748,51413,38549,51413,70,70,0,2,7,2,0,allow
63895,43729,7105,43729,70,70,0,1,4,1,0,allow
56203,53,18895,53,283,102,181,2,29,1,1,allow
56395,53,26847,53,177,94,83,2,29,1,1,allow
49274,53,51381,53,197,102,95,2,29,1,1,allow
56907,53,38903,53,293,102,191,2,29,1,1,allow
50332,80,8939,80,5517,2843,2674,19,47,10,9,allow
50056,27018,50062,27018,546,390,156,6,30,4,2,allow
18125,53,18125,53,235,90,145,2,33,1,1,allow
51917,26077,25405,26077,70,70,0,1,5,1,0,allow
49358,443,2362,443,9482,4710,4772,19,16,11,8,allow
55446,443,18400,443,165191,6141,159050,184,30,67,117,allow
50085,80,41165,80,5514,2362,3152,37,469,19,18,allow
37983,443,26799,443,15668921,169545,15499376,12539,161,1284,11255,allow
49243,53,19778,53,212,102,110,2,30,1,1,allow
29616,53,29616,53,241,98,143,2,30,1,1,allow
56569,53,35579,53,199,102,97,2,30,1,1,allow
56513,53,43170,53,184,86,98,2,30,1,1,allow
57453,443,43967,443,2233,1347,886,23,135,13,10,allow
39455,80,39455,80,14349,1038,13311,26,20,13,13,allow
60438,17148,35885,17148,70,70,0,1,5,1,0,allow
51918,41488,58958,41488,70,70,0,1,5,1,0,allow
51889,80,18568,80,15867,8841,7026,29,29,16,13,allow
51962,443,60648,443,8600,1735,6865,27,25,14,13,allow
65115,53,32763,53,167,86,81,2,30,1,1,allow
59653,80,58858,80,1139,609,530,10,34,6,4,allow
33924,80,28051,80,1139,609,530,10,61,6,4,allow
46298,443,58260,443,52438,4244,48194,77,23,37,40,allow
46288,443,54873,443,28173,21385,6788,100,41,51,49,allow
56681,443,56377,443,8654,2150,6504,20,15,11,9,allow
49957,80,62910,80,6389,690,5699,16,15,8,8,allow
49961,80,19985,80,8315,820,7495,18,15,9,9,allow
46731,443,46731,443,4603,1696,2907,19,30,11,8,allow
51919,10298,57387,10298,70,70,0,1,5,1,0,allow
60336,5222,43827,5222,32653,15160,17493,307,506,160,147,allow
49955,80,63565,80,9810,819,8991,19,15,9,10,allow
59617,443,31345,443,5682,1565,4117,23,66,13,10,allow
49207,443,63518,443,19566,12185,7381,89,176,42,47,allow
64028,53,51007,53,293,134,159,2,30,1,1,allow
63133,80,57043,80,18055,904,17151,22,15,7,15,allow
64651,53,19265,53,196,94,102,2,30,1,1,allow
49201,53,3474,53,200,102,98,2,30,1,1,allow
64028,53,50736,53,263,134,129,2,30,1,1,allow
50523,53,17417,53,199,102,97,2,30,1,1,allow
64281,53,42063,53,214,110,104,2,30,1,1,allow
56526,53,57484,53,210,102,108,2,30,1,1,allow
63092,443,8576,443,4771341,155341,4616000,5024,147,1667,3357,allow
45063,80,24999,80,1892,1014,878,10,21,6,4,allow
51733,5228,35376,5228,6967,1929,5038,25,128,14,11,allow
63132,80,36171,80,19934,920,19014,23,15,7,16,allow
46285,443,47233,443,40877,5947,34930,81,56,39,42,allow
50325,80,35970,80,2535,783,1752,13,48,7,6,allow
50302,80,5947,80,5100,1620,3480,17,114,10,7,allow
50329,80,27783,80,1550,728,822,13,47,7,6,allow
49960,80,58313,80,9718,819,8899,19,15,9,10,allow
49954,80,59970,80,10841,821,10020,19,15,9,10,allow
48838,8080,7294,8080,533,327,206,8,33,5,3,allow
51017,80,29159,80,2654,796,1858,12,18,7,5,allow
65237,53,3519,53,225,94,131,2,30,1,1,allow
49201,53,35149,53,200,102,98,2,30,1,1,allow
63893,443,26379,443,3071,804,2267,15,135,7,8,allow
49763,443,47715,443,12767,8343,4424,31,122,17,14,allow
49890,443,49782,443,2513598,90400,2423198,2658,280,896,1762,allow
49280,80,50074,80,200808,6612,194196,217,3669,83,134,allow
51831,80,34274,80,486,300,186,9,31,6,3,allow
21133,41620,37961,41620,150,150,0,1,1199,1,0,allow
35221,443,12640,443,146299,21774,124525,246,141,98,148,allow
51907,80,10230,80,9189,3144,6045,19,28,11,8,allow
49224,80,15279,80,2999,2271,728,11,15,6,5,allow
51914,80,46843,80,366,240,126,7,28,5,2,allow
51835,443,47905,443,546,300,246,10,31,6,4,allow
51825,443,16261,443,4943,936,4007,21,32,11,10,allow
51898,80,53700,80,366,240,126,7,28,5,2,allow
63134,80,1605,80,18032,904,17128,22,15,7,15,allow
51928,80,8868,80,1357,963,394,10,26,7,3,allow
50264,443,26394,443,25435,5293,20142,104,138,54,50,allow
50269,80,46714,80,1606,823,783,12,121,7,5,allow
60447,36396,16095,36396,70,70,0,2,8,2,0,allow
50281,443,10698,443,25811,4278,21533,73,100,38,35,allow
53138,15048,65155,15048,70,70,0,1,4,1,0,allow
50287,443,3897,443,8247,2761,5486,36,99,19,17,allow
51872,443,26165,443,442,250,192,8,30,5,3,allow
50257,443,7570,443,249660,21361,228299,416,141,191,225,allow
60439,47783,39683,47783,70,70,0,1,5,1,0,allow
56860,49991,48987,49991,70,70,0,1,5,1,0,allow
63892,8080,57373,8080,1269,548,721,10,15,6,4,allow
53725,57418,10921,57418,70,70,0,1,4,1,0,allow
60853,443,17952,443,126,60,66,3,4,2,1,allow
50263,443,33451,443,35817,18303,17514,160,138,85,75,allow
6977,53,6977,53,235,90,145,2,32,1,1,allow
55046,53,5301,53,300,102,198,4,40,2,2,allow
51275,10924,61359,10924,70,70,0,2,8,2,0,allow
58186,443,61282,443,5086,3296,1790,36,56,18,18,allow
55046,53,27327,53,300,102,198,4,39,2,2,allow
55046,53,20538,53,300,102,198,4,40,2,2,allow
55444,443,59927,443,1455177,56285,1398892,1600,31,632,968,allow
55198,80,49692,80,41822,2038,39784,56,15,27,29,allow
51982,80,47547,80,14487990,289826,14198164,13259,54,3839,9420,allow
50323,80,57798,80,2074,793,1281,11,48,6,5,allow
49958,80,11985,80,11173,821,10352,19,15,9,10,allow
41576,443,6870,443,5954,1607,4347,27,215,14,13,allow
49956,80,11904,80,10819,819,10000,19,15,9,10,allow
49651,53,30768,53,312,94,218,2,29,1,1,allow
55100,53,52662,53,438,94,344,2,29,1,1,allow
64320,53,39088,53,197,94,103,2,29,1,1,allow
65353,53,24740,53,177,94,83,2,30,1,1,allow
55549,53,55549,53,228,90,138,2,30,1,1,allow
58982,443,29770,443,6400453,202937,6197516,6806,226,2259,4547,allow
43827,443,38851,443,677212,30094,647118,785,136,282,503,allow
59920,443,55787,443,3063,1068,1995,12,134,6,6,allow
6881,58293,28909,58293,228,118,110,2,1200,1,1,allow
37851,443,26132,443,14283,12630,1653,29,126,17,12,allow
56682,443,61779,443,8654,2150,6504,20,15,11,9,allow
60908,443,62015,443,10043,4993,5050,45,15,27,18,allow
49800,53,49800,53,235,90,145,2,33,1,1,allow
9755,53,9755,53,244,98,146,2,33,1,1,allow
55449,443,46191,443,480989,16896,464093,507,22,178,329,allow
58013,80,34784,80,3877,2069,1808,15,26,9,6,allow
54889,443,57896,443,5541,3309,2232,19,61,11,8,allow
43863,80,21010,80,2025,805,1220,12,46,7,5,allow
64471,53,53728,53,264,110,154,2,30,1,1,allow
64998,53,50318,53,214,94,120,2,30,1,1,allow
64281,53,44626,53,214,110,104,2,30,1,1,allow
49591,53,31886,53,198,94,104,2,30,1,1,allow
39995,443,64142,443,6812,2910,3902,31,282,8,23,allow
58886,443,31172,443,3404,2124,1280,18,135,10,8,allow
49547,443,10107,443,6180,1249,4931,14,20,8,6,allow
49549,443,60727,443,5903,1270,4633,14,17,8,6,allow
56007,53,28468,53,197,102,95,2,33,1,1,allow
51939,34393,42807,34393,70,70,0,2,8,2,0,allow
60441,64337,24616,64337,70,70,0,1,5,1,0,allow
51916,24596,60319,24596,70,70,0,1,5,1,0,allow
58575,443,10441,443,6453,1742,4711,20,17,10,10,allow
50333,80,53972,80,442,250,192,8,47,5,3,allow
49359,443,29384,443,6261,1362,4899,22,15,12,10,allow
57355,53,57355,53,242,98,144,2,30,1,1,allow
46002,53,40286,53,168,78,90,2,30,1,1,allow
56569,53,62895,53,199,102,97,2,30,1,1,allow
60769,443,35964,443,3758,1691,2067,12,135,6,6,allow
51944,12470,26336,12470,316,136,180,6,6,3,3,allow
51938,11218,50761,11218,70,70,0,2,8,2,0,allow
60446,6882,2486,6882,70,70,0,2,8,2,0,allow
55445,443,10778,443,1373295,46189,1327106,1448,31,527,921,allow
50334,80,53374,80,442,250,192,8,47,5,3,allow
57454,443,10249,443,4881,1817,3064,30,135,16,14,allow
60971,443,28807,443,396507,14667,381840,458,21,171,287,allow
60142,443,18976,443,2998,1997,1001,16,16,8,8,allow
8836,53,8836,53,203,82,121,2,30,1,1,allow
65115,53,14088,53,167,86,81,2,30,1,1,allow
49401,53,41126,53,258,102,156,2,30,1,1,allow
59930,443,17395,443,58431,5847,52584,55,120,10,45,allow
57470,41013,23995,41013,2128,875,1253,26,1980,13,13,allow
50022,80,11593,80,10023148,180272,9842876,9438,193,2907,6531,allow
49201,53,51989,53,200,102,98,2,30,1,1,allow
57470,1052,29632,1052,132,132,0,3,1199,3,0,allow
57368,53,40892,53,167,86,81,2,30,1,1,allow
64073,53,23568,53,199,102,97,2,30,1,1,allow
55694,53,60951,53,167,86,81,2,30,1,1,allow
64951,53,46883,53,224,86,138,2,30,1,1,allow
54891,443,48520,443,10035,2160,7875,35,120,18,17,allow
52838,443,36112,443,14518,10453,4065,43,120,21,22,allow
50779,443,64325,443,3247,1630,1617,8,120,4,4,allow
47337,443,13338,443,14281,2906,11375,15,122,4,11,allow
44402,443,62685,443,196732,11940,184792,257,139,103,154,allow
53755,45416,43327,45416,320,140,180,6,6,3,3,allow
56642,80,4720,80,234,234,0,4,12,4,0,allow
50665,443,30090,443,22544,1481,21063,31,16,9,22,allow
58326,80,34084,80,804,449,355,9,256,5,4,allow
47238,443,16760,443,16131,4542,11589,45,139,21,24,allow
64073,53,37819,53,520,211,309,6,39,3,3,allow
60777,40010,8810,40010,316,136,180,6,6,3,3,allow
49187,2710,53094,2710,70,70,0,1,5,1,0,allow
27348,80,31901,80,1550,850,700,10,18,5,5,allow
9193,443,3894,443,5043,432,4611,12,16,6,6,allow
123,123,52430,123,184,94,90,2,30,1,1,allow
64669,53,24998,53,198,94,104,2,30,1,1,allow
55694,53,12759,53,167,86,81,2,30,1,1,allow
1091,37965,0,0,62,62,0,1,0,1,0,deny
63775,445,0,0,70,70,0,1,0,1,0,drop
63770,445,0,0,70,70,0,1,0,1,0,drop
58923,445,0,0,70,70,0,1,0,1,0,drop
28124,37965,0,0,145,145,0,1,0,1,0,deny
59180,445,0,0,66,66,0,1,0,1,0,drop
54280,3398,0,0,60,60,0,1,0,1,0,deny
54280,3398,0,0,60,60,0,1,0,1,0,deny
62088,56205,0,0,62,62,0,1,0,1,0,deny
2464,50584,0,0,66,66,0,1,0,1,0,deny
22409,55442,0,0,74,74,0,1,0,1,0,deny
443,60496,0,0,320,320,0,1,0,1,0,deny
44922,57470,0,0,74,74,0,1,0,1,0,deny
51429,22114,0,0,66,66,0,1,0,1,0,deny
45308,22114,0,0,146,146,0,1,0,1,0,deny
59173,445,0,0,66,66,0,1,0,1,0,drop
63760,445,0,0,70,70,0,1,0,1,0,drop
7249,30349,0,0,143,143,0,1,0,1,0,deny
51313,33669,0,0,100,100,0,1,0,1,0,deny
51313,40573,0,0,100,100,0,1,0,1,0,deny
47201,44847,0,0,66,66,0,1,0,1,0,deny
57260,51221,0,0,66,66,0,1,0,1,0,deny
58910,445,0,0,70,70,0,1,0,1,0,drop
45908,33330,0,0,60,60,0,1,0,1,0,deny
59171,445,0,0,66,66,0,1,0,1,0,drop
14036,48817,0,0,66,66,0,1,0,1,0,deny
58907,445,0,0,70,70,0,1,0,1,0,drop
53044,36237,0,0,66,66,0,1,0,1,0,deny
59162,445,0,0,66,66,0,1,0,1,0,drop
52836,36829,0,0,62,62,0,1,0,1,0,deny
60855,35440,0,0,66,66,0,1,0,1,0,deny
16522,26467,0,0,62,62,0,1,0,1,0,deny
59155,445,0,0,66,66,0,1,0,1,0,drop
3549,64147,0,0,62,62,0,1,0,1,0,deny
15465,64147,0,0,66,66,0,1,0,1,0,deny
24212,21247,0,0,146,146,0,1,0,1,0,deny
58345,24748,0,0,148,148,0,1,0,1,0,deny
62257,2767,0,0,66,66,0,1,0,1,0,deny
58902,445,0,0,70,70,0,1,0,1,0,drop
5683,50584,0,0,66,66,0,1,0,1,0,deny
56883,22114,0,0,62,62,0,1,0,1,0,deny
58901,445,0,0,70,70,0,1,0,1,0,drop
49001,48983,0,0,161,161,0,1,0,1,0,deny
13287,16933,0,0,62,62,0,1,0,1,0,deny
58899,445,0,0,70,70,0,1,0,1,0,drop
42361,23,0,0,60,60,0,1,0,1,0,deny
63751,445,0,0,70,70,0,1,0,1,0,drop
63750,445,0,0,70,70,0,1,0,1,0,drop
63748,445,0,0,70,70,0,1,0,1,0,drop
59148,445,0,0,66,66,0,1,0,1,0,drop
59147,445,0,0,66,66,0,1,0,1,0,drop
59146,445,0,0,66,66,0,1,0,1,0,drop
59142,445,0,0,66,66,0,1,0,1,0,drop
59140,445,0,0,66,66,0,1,0,1,0,drop
59145,445,0,0,66,66,0,1,0,1,0,drop
59143,445,0,0,66,66,0,1,0,1,0,drop
59141,445,0,0,66,66,0,1,0,1,0,drop
52018,57866,0,0,62,62,0,1,0,1,0,deny
10145,21247,0,0,62,62,0,1,0,1,0,deny
58892,445,0,0,70,70,0,1,0,1,0,drop
32051,37965,0,0,62,62,0,1,0,1,0,deny
58890,445,0,0,70,70,0,1,0,1,0,drop
63742,445,0,0,70,70,0,1,0,1,0,drop
63740,445,0,0,70,70,0,1,0,1,0,drop
63732,445,0,0,70,70,0,1,0,1,0,drop
63730,445,0,0,70,70,0,1,0,1,0,drop
54234,443,2984,443,499,425,74,4,0,3,1,allow
54233,443,10183,443,499,425,74,4,0,3,1,allow
57499,80,57499,80,343853,13570,330283,445,3,223,222,allow
58889,445,0,0,70,70,0,1,0,1,0,drop
59128,445,0,0,66,66,0,1,0,1,0,drop
59127,445,0,0,66,66,0,1,0,1,0,drop
59125,445,0,0,66,66,0,1,0,1,0,drop
58888,445,0,0,70,70,0,1,0,1,0,drop
58887,445,0,0,70,70,0,1,0,1,0,drop
39730,17372,0,0,66,66,0,1,0,1,0,deny
58884,445,0,0,70,70,0,1,0,1,0,drop
58881,445,0,0,70,70,0,1,0,1,0,drop
10218,2323,0,0,60,60,0,1,0,1,0,deny
47910,7454,0,0,60,60,0,1,0,1,0,deny
63728,445,0,0,70,70,0,1,0,1,0,drop
50106,31573,0,0,66,66,0,1,0,1,0,deny
63723,445,0,0,70,70,0,1,0,1,0,drop
63719,445,0,0,70,70,0,1,0,1,0,drop
63717,445,0,0,70,70,0,1,0,1,0,drop
58869,445,0,0,70,70,0,1,0,1,0,drop
58862,445,0,0,70,70,0,1,0,1,0,drop
50920,60182,0,0,66,66,0,1,0,1,0,deny
58858,445,0,0,70,70,0,1,0,1,0,drop
58859,445,0,0,70,70,0,1,0,1,0,drop
62765,16933,0,0,66,66,0,1,0,1,0,deny
64824,36829,0,0,66,66,0,1,0,1,0,deny
4110,35440,0,0,66,66,0,1,0,1,0,deny
24731,51505,0,0,62,62,0,1,0,1,0,deny
48840,50584,0,0,62,62,0,1,0,1,0,deny
49113,50584,0,0,66,66,0,1,0,1,0,deny
7968,2767,0,0,62,62,0,1,0,1,0,deny
52740,51505,0,0,66,66,0,1,0,1,0,deny
63710,445,0,0,70,70,0,1,0,1,0,drop
50330,53,50330,53,237,93,144,2,0,1,1,allow
49355,53,16925,53,186,95,91,2,0,1,1,allow
63708,445,0,0,70,70,0,1,0,1,0,drop
63709,445,0,0,70,70,0,1,0,1,0,drop
58847,445,0,0,70,70,0,1,0,1,0,drop
59116,445,0,0,66,66,0,1,0,1,0,drop
13285,29892,0,0,145,145,0,1,0,1,0,deny
53218,56205,0,0,62,62,0,1,0,1,0,deny
16477,37807,0,0,66,66,0,1,0,1,0,deny
58842,445,0,0,70,70,0,1,0,1,0,drop
52650,44847,0,0,66,66,0,1,0,1,0,deny
63703,445,0,0,70,70,0,1,0,1,0,drop
63702,445,0,0,70,70,0,1,0,1,0,drop
58686,18375,0,0,66,66,0,1,0,1,0,deny
58834,445,0,0,70,70,0,1,0,1,0,drop
58833,445,0,0,70,70,0,1,0,1,0,drop
58832,445,0,0,70,70,0,1,0,1,0,drop
26758,50584,0,0,62,62,0,1,0,1,0,deny
58830,445,0,0,70,70,0,1,0,1,0,drop
58826,445,0,0,70,70,0,1,0,1,0,drop
50,38211,0,0,66,66,0,1,0,1,0,deny
63956,38211,0,0,62,62,0,1,0,1,0,deny
59099,445,0,0,66,66,0,1,0,1,0,drop
59101,445,0,0,66,66,0,1,0,1,0,drop
31727,57470,0,0,62,62,0,1,0,1,0,deny
64237,51505,0,0,66,66,0,1,0,1,0,deny
63691,445,0,0,70,70,0,1,0,1,0,drop
63686,445,0,0,70,70,0,1,0,1,0,drop
63685,445,0,0,70,70,0,1,0,1,0,drop
63684,445,0,0,70,70,0,1,0,1,0,drop
61278,56205,0,0,62,62,0,1,0,1,0,deny
59094,445,0,0,66,66,0,1,0,1,0,drop
58821,445,0,0,70,70,0,1,0,1,0,drop
65012,2767,0,0,66,66,0,1,0,1,0,deny
19875,30170,0,0,145,145,0,1,0,1,0,deny
59078,445,0,0,66,66,0,1,0,1,0,drop
59083,445,0,0,66,66,0,1,0,1,0,drop
59082,445,0,0,66,66,0,1,0,1,0,drop
59088,445,0,0,66,66,0,1,0,1,0,drop
59086,445,0,0,66,66,0,1,0,1,0,drop
59079,445,0,0,66,66,0,1,0,1,0,drop
59077,445,0,0,66,66,0,1,0,1,0,drop
13445,44847,0,0,66,66,0,1,0,1,0,deny
63676,445,0,0,70,70,0,1,0,1,0,drop
1024,44847,0,0,62,62,0,1,0,1,0,deny
63673,445,0,0,70,70,0,1,0,1,0,drop
63672,445,0,0,70,70,0,1,0,1,0,drop
63669,445,0,0,70,70,0,1,0,1,0,drop
58813,445,0,0,70,70,0,1,0,1,0,drop
58812,445,0,0,70,70,0,1,0,1,0,drop
59898,443,21573,443,5429,2835,2594,19,140,9,10,allow
54599,443,16547,443,6410,2001,4409,27,28,16,11,allow
26782,443,49572,443,7407,2650,4757,24,20,12,12,allow
63921,23758,6337,23758,312,132,180,6,7,3,3,allow
57585,443,55906,443,9273,2712,6561,50,615,25,25,allow
14341,80,14341,80,3360,2260,1100,19,61,11,8,allow
57227,443,51779,443,9322,2994,6328,26,22,16,10,allow
51868,443,55642,443,4375,1230,3145,16,30,8,8,allow
56858,32330,59933,32330,66,66,0,1,5,1,0,allow
37920,53,0,0,82,82,0,1,30,1,0,allow
52786,443,34018,443,8160,2216,5944,22,38,14,8,allow
23216,53,23216,53,235,90,145,2,33,1,1,allow
5239,6064,8462,6064,217199,128,217071,316,37,3,313,allow
32820,443,45406,443,11455,5836,5619,40,317,20,20,allow
49459,443,9422,443,39932,34025,5907,52,21,34,18,allow
32955,80,30230,80,14961,937,14024,25,16,11,14,allow
52788,443,17904,443,21915,3929,17986,40,31,23,17,allow
47422,80,55452,80,1614,1300,314,10,18,5,5,allow
50575,443,8721,443,149414,8612,140802,208,25,107,101,allow
58744,443,37896,443,42954,12409,30545,154,319,67,87,allow
50980,443,34954,443,7959,3288,4671,19,97,11,8,allow
51937,38056,36648,38056,70,70,0,2,8,2,0,allow
54610,443,65041,443,9948,2463,7485,41,27,22,19,allow
14692,443,14692,443,95958,6670,89288,139,80,68,71,allow
54792,443,48996,443,9515,2231,7284,25,22,14,11,allow
60381,80,60381,80,448865,6437,442428,380,151,67,313,allow
5588,5588,0,0,3498,1872,1626,48,201,24,24,allow
51913,52188,58050,52188,66,66,0,1,5,1,0,allow
50537,80,34758,80,4186,3559,627,15,31,8,7,allow
64073,53,57961,53,304,101,203,4,38,2,2,allow
15503,62336,46736,62336,127653507,122661116,4992391,161030,2162,82907,78123,allow
57226,443,27047,443,7924,2027,5897,23,22,14,9,allow
55252,443,43197,443,16179,1763,14416,38,46,17,21,allow
49680,443,50049,443,63100,10145,52955,87,147,37,50,allow
49929,443,35482,443,2484,330,2154,12,136,5,7,allow
44971,443,53632,443,6861,2809,4052,33,407,11,22,allow
59018,443,37679,443,1786,172,1614,7,120,3,4,allow
65194,53,10314,53,178,91,87,2,31,1,1,allow
57964,44847,0,0,62,62,0,1,0,1,0,deny
42108,23,0,0,60,60,0,1,0,1,0,deny
58338,3353,0,0,60,60,0,1,0,1,0,deny
35154,42707,0,0,62,62,0,1,0,1,0,deny
22300,51505,0,0,62,62,0,1,0,1,0,deny
58806,445,0,0,70,70,0,1,0,1,0,drop
58805,445,0,0,70,70,0,1,0,1,0,drop
63668,445,0,0,70,70,0,1,0,1,0,drop
63662,445,0,0,70,70,0,1,0,1,0,drop
63665,445,0,0,70,70,0,1,0,1,0,drop
33627,36237,0,0,62,62,0,1,0,1,0,deny
49001,48983,0,0,161,161,0,1,0,1,0,deny
47102,123,23383,123,184,94,90,2,30,1,1,allow
55824,80,14752,80,1281,398,883,16,393,4,12,allow
50871,443,47245,443,9241,2001,7240,24,28,14,10,allow
53017,80,55649,80,1658,1344,314,10,15,5,5,allow
53715,62348,45392,62348,672,306,366,11,14,5,6,allow
57003,443,38569,443,8592,3700,4892,39,108,21,18,allow
49545,443,43829,443,6606,936,5670,17,23,9,8,allow
50481,443,48883,443,7653,1188,6465,21,15,12,9,allow
57892,80,46739,80,6519,1210,5309,15,17,8,7,allow
57077,443,42602,443,7159,1851,5308,22,31,13,9,allow
55664,45682,37882,45682,320,140,180,6,6,3,3,allow
49186,443,54954,443,508520,13734,494786,527,18,192,335,allow
61661,53,61661,53,235,90,145,2,33,1,1,allow
44052,80,38453,80,282,60,222,5,12,2,3,allow
45537,80,48297,80,1638,1324,314,10,15,5,5,allow
51926,80,62359,80,36720,3404,33316,51,25,22,29,allow
65222,53,8527,53,212,102,110,2,30,1,1,allow
49542,80,57907,80,1012,531,481,8,25,5,3,allow
60945,443,30602,443,7771,2691,5080,34,28,19,15,allow
55107,443,57254,443,12000,3846,8154,29,28,17,12,allow
55659,37787,37419,37787,70,70,0,1,5,1,0,allow
14417,443,14417,443,15556,2973,12583,41,80,22,19,allow
50539,80,55226,80,5912,3532,2380,15,31,8,7,allow
56504,53,9210,53,195,94,101,2,30,1,1,allow
49160,3800,35343,3800,854,150,704,4,1200,2,2,allow
64940,53,23084,53,250,94,156,2,30,1,1,allow
53320,443,39301,443,30796,3050,27746,60,30,32,28,allow
64673,53,43122,53,213,94,119,2,30,1,1,allow
54035,443,43754,443,7724,2555,5169,26,47,15,11,allow
55694,53,17874,53,274,85,189,4,35,2,2,allow
60978,443,39156,443,1004246,35992,968254,1127,90,451,676,allow
56339,443,15948,443,8991,1756,7235,28,26,15,13,allow
63237,443,45268,443,1369,670,699,17,141,9,8,allow
41632,443,12669,443,7670,2131,5539,30,27,15,15,allow
50730,443,12545,443,3514,1609,1905,30,51,16,14,allow
36776,443,7923,443,2866,1674,1192,14,15,8,6,allow
37567,443,42814,443,214,140,74,4,15,3,1,allow
49972,80,64274,80,95065,52092,42973,148,259,77,71,allow
49589,443,40471,443,327575,8400,319175,334,316,113,221,allow
43382,443,40551,443,9624,2231,7393,24,22,14,10,allow
65507,53,47508,53,167,86,81,2,30,1,1,allow
41636,123,47665,123,184,94,90,2,30,1,1,allow
17750,50321,45531,50321,491,150,341,2,1200,1,1,allow
50276,5223,4771,5223,552,280,272,9,16,5,4,allow
64410,53,32197,53,286,98,188,4,40,2,2,allow
45196,443,61474,443,6357,1546,4811,26,17,14,12,allow
65445,53,12722,53,254,102,152,2,30,1,1,allow
37568,443,50535,443,214,140,74,4,15,3,1,allow
40254,443,35283,443,7646,1024,6622,19,15,11,8,allow
55661,49671,27582,49671,70,70,0,1,5,1,0,allow
64073,53,53984,53,304,101,203,4,37,2,2,allow
43479,443,6073,443,6990,2019,4971,29,20,16,13,allow
52247,53,24197,53,216,86,130,2,30,1,1,allow
65507,53,3700,53,167,86,81,2,30,1,1,allow
63973,53,57018,53,346,98,248,4,31,2,2,allow
38115,443,13490,443,281978,16098,265880,405,67,204,201,allow
52146,443,52659,443,774806,25835,748971,772,52,253,519,allow
51935,38639,4270,38639,70,70,0,2,8,2,0,allow
51936,17650,3009,17650,70,70,0,2,8,2,0,allow
9172,443,4913,443,89362,3092,86270,100,21,37,63,allow
39265,443,4436,443,46879,2864,44015,74,179,34,40,allow
14137,443,14137,443,155070,7155,147915,186,81,74,112,allow
50482,443,60480,443,7653,1188,6465,21,15,12,9,allow
52793,443,12880,443,130,70,60,2,14,1,1,allow
60812,80,61213,80,1658,1344,314,10,14,5,5,allow
35217,443,22630,443,4113,2625,1488,25,79,13,12,allow
40217,443,1676,443,14944,7430,7514,32,25,19,13,allow
55813,443,20333,443,15097,2888,12209,40,28,20,20,allow
49742,443,14299,443,16041,1805,14236,30,20,14,16,allow
44890,443,50264,443,232,172,60,3,4,2,1,allow
63922,32305,41561,32305,312,132,180,6,6,3,3,allow
60773,20010,46646,20010,70,70,0,1,5,1,0,allow
63236,443,2158,443,4945,2798,2147,27,141,14,13,allow
9108,443,64667,443,5510,901,4609,15,26,8,7,allow
53652,443,55573,443,11041,3217,7824,26,24,15,11,allow
52425,443,26865,443,6527,1142,5385,23,32,13,10,allow
32967,443,43142,443,5327,963,4364,19,15,11,8,allow
64704,53,49716,53,213,102,111,2,29,1,1,allow
57368,53,45045,53,167,86,81,2,29,1,1,allow
57600,443,30518,443,2614,1689,925,18,21,10,8,allow
52435,53,3973,53,216,78,138,2,29,1,1,allow
50871,53,48869,53,86,86,0,1,30,1,0,allow
65295,53,10641,53,212,102,110,2,29,1,1,allow
46704,80,21758,80,1193,451,742,10,15,6,4,allow
59792,80,7891,80,1453540,37280,1416260,1552,96,507,1045,allow
42868,443,8590,443,10049,2289,7760,35,27,19,16,allow
56338,443,8628,443,11148,3099,8049,26,24,15,11,allow
49448,443,41135,443,186882,17018,169864,206,29,84,122,allow
65168,53,15649,53,230,110,120,2,30,1,1,allow
56265,53,56216,53,213,94,119,2,30,1,1,allow
60138,443,19544,443,2993,1992,1001,16,15,8,8,allow
37569,443,62678,443,214,140,74,4,15,3,1,allow
53113,443,2940,443,11030,4292,6738,32,61,17,15,allow
49967,53,55984,53,303,100,203,4,40,2,2,allow
28479,53,28479,53,235,90,145,2,33,1,1,allow
26385,53,26385,53,235,90,145,2,33,1,1,allow
53660,443,43128,443,350,210,140,6,24,4,2,allow
56370,443,11997,443,26040,2148,23892,44,22,21,23,allow
43654,443,39718,443,8761,2571,6190,24,17,14,10,allow
39118,443,64547,443,206769,6309,200460,215,27,77,138,allow
51892,443,20369,443,5671,1556,4115,23,274,13,10,allow
39447,443,60525,443,7878,1909,5969,31,28,16,15,allow
37566,443,56010,443,214,140,74,4,15,3,1,allow
63962,53,22978,53,274,93,181,4,64,2,2,allow
15016,443,15016,443,21083,3108,17975,45,80,24,21,allow
56698,443,19362,443,106055,8460,97595,168,26,79,89,allow
60265,443,40784,443,11048,3161,7887,26,24,15,11,allow
48690,443,27547,443,19402,10414,8988,35,22,21,14,allow
49546,443,3244,443,5519,945,4574,15,23,8,7,allow
65491,53,6276,53,889,404,485,10,30,5,5,allow
65044,443,31714,443,4446,2496,1950,9,120,5,4,allow
65045,443,13703,443,4305,2217,2088,11,120,5,6,allow
64876,53,13922,53,718,94,624,2,31,1,1,allow
65046,53,1859,53,211,94,117,2,31,1,1,allow
40404,443,18265,443,280,140,140,5,130,3,2,allow
57392,443,58743,443,12347,6378,5969,39,208,20,19,allow
49332,443,12336,443,4425,1910,2515,36,3656,12,24,allow
63914,32805,62469,32805,66,66,0,2,8,2,0,allow
51418,443,34735,443,7653,1188,6465,21,17,12,9,allow
58230,443,58230,443,4465,1558,2907,19,27,11,8,allow
5588,5588,0,0,3354,1792,1562,46,194,23,23,allow
55618,53,36676,53,199,94,105,2,30,1,1,allow
46919,443,8853,443,7094,1672,5422,21,361,10,11,allow
57470,6881,10823,6881,132,132,0,3,1200,3,0,allow
60241,443,3002,443,92975,3289,89686,107,316,40,67,allow
53745,18569,48041,18569,70,70,0,2,8,2,0,allow
43608,53,16507,53,199,94,105,2,30,1,1,allow
50549,53,21467,53,199,94,105,2,30,1,1,allow
50479,443,65060,443,25979,7217,18762,36,16,19,17,allow
45896,443,44655,443,211720,46699,165021,332,109,152,180,allow
63951,53,53032,53,345,106,239,4,38,2,2,allow
53743,23915,28798,23915,70,70,0,2,8,2,0,allow
62232,80,62232,80,2158,1419,739,11,150,6,5,allow
57994,443,31591,443,10027,2130,7897,27,27,16,11,allow
59072,445,0,0,66,66,0,1,0,1,0,drop
63660,445,0,0,70,70,0,1,0,1,0,drop
59068,445,0,0,66,66,0,1,0,1,0,drop
27160,64147,0,0,66,66,0,1,0,1,0,deny
58801,445,0,0,70,70,0,1,0,1,0,drop
44922,57470,0,0,74,74,0,1,0,1,0,deny
59066,445,0,0,66,66,0,1,0,1,0,drop
59064,445,0,0,66,66,0,1,0,1,0,drop
61419,57470,0,0,66,66,0,1,0,1,0,deny
4760,44847,0,0,62,62,0,1,0,1,0,deny
26229,21247,0,0,62,62,0,1,0,1,0,deny
56869,17637,0,0,66,66,0,1,0,1,0,deny
59063,445,0,0,66,66,0,1,0,1,0,drop
58799,445,0,0,70,70,0,1,0,1,0,drop
28009,36237,0,0,62,62,0,1,0,1,0,deny
53906,37965,0,0,62,62,0,1,0,1,0,deny
64449,30188,0,0,66,66,0,1,0,1,0,deny
63652,445,0,0,70,70,0,1,0,1,0,drop
63651,445,0,0,70,70,0,1,0,1,0,drop
63643,445,0,0,70,70,0,1,0,1,0,drop
58795,445,0,0,70,70,0,1,0,1,0,drop
59191,35440,0,0,66,66,0,1,0,1,0,deny
59051,445,0,0,66,66,0,1,0,1,0,drop
12550,37807,0,0,146,146,0,1,0,1,0,deny
59044,445,0,0,66,66,0,1,0,1,0,drop
63633,445,0,0,70,70,0,1,0,1,0,drop
50624,50584,0,0,66,66,0,1,0,1,0,deny
35619,12883,0,0,159,159,0,1,0,1,0,deny
58782,445,0,0,70,70,0,1,0,1,0,drop
1530,62413,0,0,62,62,0,1,0,1,0,deny
54016,42707,0,0,66,66,0,1,0,1,0,deny
59042,445,0,0,66,66,0,1,0,1,0,drop
58779,445,0,0,70,70,0,1,0,1,0,drop
1036,64147,0,0,145,145,0,1,0,1,0,deny
59035,445,0,0,66,66,0,1,0,1,0,drop
5462,21247,0,0,62,62,0,1,0,1,0,deny
11362,64147,0,0,145,145,0,1,0,1,0,deny
59027,445,0,0,66,66,0,1,0,1,0,drop
30365,45991,0,0,60,60,0,1,0,1,0,deny
14844,37965,0,0,62,62,0,1,0,1,0,deny
48388,44847,0,0,62,62,0,1,0,1,0,deny
58774,445,0,0,70,70,0,1,0,1,0,drop
58773,445,0,0,70,70,0,1,0,1,0,drop
1484,22114,0,0,146,146,0,1,0,1,0,deny
58771,445,0,0,70,70,0,1,0,1,0,drop
58338,3369,0,0,60,60,0,1,0,1,0,deny
48676,53399,0,0,60,60,0,1,0,1,0,deny
6338,23117,0,0,66,66,0,1,0,1,0,deny
56367,44847,0,0,66,66,0,1,0,1,0,deny
53835,62413,0,0,62,62,0,1,0,1,0,deny
26642,57470,0,0,62,62,0,1,0,1,0,deny
63622,445,0,0,70,70,0,1,0,1,0,drop
63621,445,0,0,70,70,0,1,0,1,0,drop
63620,445,0,0,70,70,0,1,0,1,0,drop
59018,445,0,0,66,66,0,1,0,1,0,drop
59019,445,0,0,66,66,0,1,0,1,0,drop
59016,445,0,0,66,66,0,1,0,1,0,drop
59013,445,0,0,66,66,0,1,0,1,0,drop
59014,445,0,0,66,66,0,1,0,1,0,drop
59017,445,0,0,66,66,0,1,0,1,0,drop
59011,445,0,0,66,66,0,1,0,1,0,drop
59015,445,0,0,66,66,0,1,0,1,0,drop
25237,57470,0,0,62,62,0,1,0,1,0,deny
16319,44847,0,0,62,62,0,1,0,1,0,deny
59626,22114,0,0,62,62,0,1,0,1,0,deny
49168,57470,0,0,66,66,0,1,0,1,0,deny
58764,445,0,0,70,70,0,1,0,1,0,drop
54298,48983,0,0,159,159,0,1,0,1,0,deny
1026,64147,0,0,62,62,0,1,0,1,0,deny
16693,36237,0,0,66,66,0,1,0,1,0,deny
28999,37807,0,0,146,146,0,1,0,1,0,deny
58762,445,0,0,70,70,0,1,0,1,0,drop
58761,445,0,0,70,70,0,1,0,1,0,drop
63617,445,0,0,70,70,0,1,0,1,0,drop
63618,445,0,0,70,70,0,1,0,1,0,drop
63610,445,0,0,70,70,0,1,0,1,0,drop
63602,445,0,0,70,70,0,1,0,1,0,drop
58760,445,0,0,70,70,0,1,0,1,0,drop
58759,445,0,0,70,70,0,1,0,1,0,drop
58757,445,0,0,70,70,0,1,0,1,0,drop
58754,445,0,0,70,70,0,1,0,1,0,drop
13408,44847,0,0,66,66,0,1,0,1,0,deny
27147,22114,0,0,146,146,0,1,0,1,0,deny
58999,445,0,0,66,66,0,1,0,1,0,drop
58998,445,0,0,66,66,0,1,0,1,0,drop
58996,445,0,0,66,66,0,1,0,1,0,drop
3047,50584,0,0,62,62,0,1,0,1,0,deny
36096,51505,0,0,146,146,0,1,0,1,0,deny
61477,57470,0,0,66,66,0,1,0,1,0,deny
3667,56205,0,0,62,62,0,1,0,1,0,deny
58741,445,0,0,70,70,0,1,0,1,0,drop
58740,445,0,0,70,70,0,1,0,1,0,drop
58736,445,0,0,70,70,0,1,0,1,0,drop
63600,445,0,0,70,70,0,1,0,1,0,drop
53362,23,0,0,60,60,0,1,0,1,0,deny
58730,445,0,0,70,70,0,1,0,1,0,drop
58731,445,0,0,70,70,0,1,0,1,0,drop
63599,445,0,0,70,70,0,1,0,1,0,drop
63595,445,0,0,70,70,0,1,0,1,0,drop
63594,445,0,0,70,70,0,1,0,1,0,drop
28385,26467,0,0,66,66,0,1,0,1,0,deny
11951,45026,0,0,60,60,0,1,0,1,0,deny
0,0,0,0,320,320,0,5,0,5,0,allow
51592,51505,0,0,62,62,0,1,0,1,0,deny
20743,23,0,0,60,60,0,1,0,1,0,deny
58719,445,0,0,70,70,0,1,0,1,0,drop
55835,62413,0,0,66,66,0,1,0,1,0,deny
65085,22114,0,0,62,62,0,1,0,1,0,deny
63581,445,0,0,70,70,0,1,0,1,0,drop
63582,445,0,0,70,70,0,1,0,1,0,drop
63580,445,0,0,70,70,0,1,0,1,0,drop
1818,22114,0,0,62,62,0,1,0,1,0,deny
1818,22114,0,0,146,146,0,1,0,1,0,deny
58986,445,0,0,66,66,0,1,0,1,0,drop
18904,57470,0,0,62,62,0,1,0,1,0,deny
56202,15503,0,0,146,146,0,1,0,1,0,deny
58715,445,0,0,70,70,0,1,0,1,0,drop
54219,443,4628,443,499,425,74,4,0,3,1,allow
54227,443,59982,443,499,425,74,4,0,3,1,allow
54221,443,30528,443,499,425,74,4,0,3,1,allow
54229,443,56153,443,499,425,74,4,0,3,1,allow
54225,443,6300,443,499,425,74,4,0,3,1,allow
54226,443,4295,443,499,425,74,4,0,3,1,allow
54224,443,19866,443,499,425,74,4,0,3,1,allow
54228,443,39518,443,499,425,74,4,0,3,1,allow
54223,443,38222,443,499,425,74,4,0,3,1,allow
54218,443,2874,443,499,425,74,4,0,3,1,allow
54222,443,54407,443,499,425,74,4,0,3,1,allow
54220,443,37468,443,499,425,74,4,0,3,1,allow
13963,50584,0,0,66,66,0,1,0,1,0,deny
58706,445,0,0,70,70,0,1,0,1,0,drop
58703,445,0,0,70,70,0,1,0,1,0,drop
63573,445,0,0,70,70,0,1,0,1,0,drop
63574,445,0,0,70,70,0,1,0,1,0,drop
59694,50584,0,0,66,66,0,1,0,1,0,deny
58701,445,0,0,70,70,0,1,0,1,0,drop
58699,445,0,0,70,70,0,1,0,1,0,drop
47013,44512,0,0,62,62,0,1,0,1,0,deny
58971,445,0,0,66,66,0,1,0,1,0,drop
58968,445,0,0,66,66,0,1,0,1,0,drop
1187,64147,0,0,66,66,0,1,0,1,0,deny
51387,443,47138,443,9584,1871,7713,28,106,14,14,allow
41462,443,21403,443,10331,2157,8174,37,137,18,19,allow
40367,80,26121,80,2119,808,1311,12,16,7,5,allow
56336,53,36932,53,198,93,105,2,30,1,1,allow
60894,443,14726,443,3507,900,2607,13,135,6,7,allow
49331,443,20933,443,4889,763,4126,18,30,8,10,allow
57949,443,49783,443,19190,13041,6149,64,389,33,31,allow
59896,443,22952,443,1537,934,603,14,32,7,7,allow
38115,80,9146,80,6442,1404,5038,23,30,12,11,allow
58077,36653,14563,36653,204,64,140,4,10,2,2,allow
50018,3389,50018,3389,3413,1458,1955,16,18,8,8,allow
54717,443,54717,443,4608,1701,2907,19,27,11,8,allow
51916,80,61338,80,182,60,122,4,26,2,2,allow
56546,443,13186,443,19236,2292,16944,45,55,23,22,allow
9474,53,9474,53,237,91,146,2,33,1,1,allow
47677,80,49789,80,1304,850,454,11,31,6,5,allow
55553,53,10197,53,711,87,624,2,30,1,1,allow
60118,53,0,0,216,84,132,2,30,1,1,allow
50604,443,50604,443,4401,1494,2907,19,28,11,8,allow
50128,80,27649,80,20575,11455,9120,92,966,47,45,allow
59895,443,59498,443,1537,934,603,14,32,7,7,allow
49859,443,46970,443,18811,1868,16943,22,142,7,15,allow
59894,443,37643,443,1537,934,603,14,33,7,7,allow
47595,33441,0,0,106,106,0,1,60,1,0,allow
10850,53,10850,53,237,91,146,2,34,1,1,allow
56560,443,46506,443,84111,3300,80811,104,54,41,63,allow
53719,49306,15851,49306,70,70,0,1,5,1,0,allow
60443,50284,16097,50284,258,70,188,4,8,2,2,allow
56857,43237,51679,43237,66,66,0,1,5,1,0,allow
55052,443,42502,443,4425,876,3549,15,29,8,7,allow
38612,443,17131,443,20651533,655694,19995839,24885,362,8746,16139,allow
38608,443,19892,443,17473899,604274,16869625,22165,408,7731,14434,allow
38610,443,57889,443,19092095,654744,18437351,24079,407,8531,15548,allow
51864,38544,39396,38544,1345,679,666,9,30,5,4,allow
59897,443,7806,443,1743,934,809,15,32,7,8,allow
50020,3389,50020,3389,3347,1458,1889,15,18,8,7,allow
56611,80,8801,80,1114,534,580,12,16,7,5,allow
59899,443,64399,443,1401,864,537,12,30,6,6,allow
60410,443,3323,443,3683,1899,1784,20,20,10,10,allow
45119,443,35597,443,2227,1018,1209,17,16,8,9,allow
58039,80,32642,80,318,192,126,6,21,4,2,allow
50697,80,53956,80,2525,1403,1122,22,272,12,10,allow
51910,60443,42638,60443,66,66,0,1,5,1,0,allow
18964,443,18964,443,5157,2180,2977,21,16,12,9,allow
57339,53,43284,53,184,80,104,2,30,1,1,allow
48371,53,57320,53,198,93,105,2,30,1,1,allow
62875,53,0,0,205,80,125,2,30,1,1,allow
53007,443,38198,443,25010,3519,21491,42,135,17,25,allow
6881,12999,32088,12999,622,356,266,4,1201,2,2,allow
41799,443,41969,443,10518,3356,7162,24,121,11,13,allow
51594,53,61639,53,172,80,92,2,31,1,1,allow
46285,443,49897,443,36209,28887,7322,65,364,34,31,allow
6889,47807,0,0,143,143,0,1,0,1,0,deny
32342,62413,0,0,62,62,0,1,0,1,0,deny
63563,445,0,0,70,70,0,1,0,1,0,drop
31974,51505,0,0,66,66,0,1,0,1,0,deny
58692,445,0,0,70,70,0,1,0,1,0,drop
63558,445,0,0,70,70,0,1,0,1,0,drop
63557,445,0,0,70,70,0,1,0,1,0,drop
63554,445,0,0,70,70,0,1,0,1,0,drop
58963,445,0,0,66,66,0,1,0,1,0,drop
57131,31061,0,0,145,145,0,1,0,1,0,deny
26799,6881,0,0,62,62,0,1,0,1,0,deny
25234,1,0,0,62,62,0,1,0,1,0,reset-both
30389,53,30389,53,235,90,145,2,33,1,1,allow
58959,445,0,0,66,66,0,1,0,1,0,drop
58956,445,0,0,66,66,0,1,0,1,0,drop
58958,445,0,0,66,66,0,1,0,1,0,drop
58955,445,0,0,66,66,0,1,0,1,0,drop
58952,445,0,0,66,66,0,1,0,1,0,drop
58949,445,0,0,66,66,0,1,0,1,0,drop
58948,445,0,0,66,66,0,1,0,1,0,drop
5223,13602,0,0,66,66,0,1,0,1,0,deny
58685,445,0,0,70,70,0,1,0,1,0,drop
63547,445,0,0,70,70,0,1,0,1,0,drop
58683,445,0,0,70,70,0,1,0,1,0,drop
63545,445,0,0,70,70,0,1,0,1,0,drop
63544,445,0,0,70,70,0,1,0,1,0,drop
63542,445,0,0,70,70,0,1,0,1,0,drop
7166,64147,0,0,66,66,0,1,0,1,0,deny
58678,445,0,0,70,70,0,1,0,1,0,drop
58677,445,0,0,70,70,0,1,0,1,0,drop
10416,64147,0,0,62,62,0,1,0,1,0,deny
50663,443,7277,443,7136,1421,5715,18,15,8,10,allow
56543,443,33644,443,8659,1687,6972,30,55,16,14,allow
49253,53,0,0,218,78,140,2,30,1,1,allow
60771,80,37890,80,254,128,126,5,15,3,2,allow
50670,443,29531,443,11940,3585,8355,43,16,24,19,allow
50477,443,6875,443,25979,7217,18762,36,15,19,17,allow
53716,6881,32283,6881,70,70,0,1,4,1,0,allow
50210,80,7597,80,1277,460,817,16,71,5,11,allow
49558,53,61665,53,423,104,319,4,39,2,2,allow
65507,53,22060,53,167,86,81,2,29,1,1,allow
64096,53,55413,53,197,94,103,2,29,1,1,allow
57470,18560,34437,18560,150,150,0,1,1199,1,0,allow
65265,3389,65265,3389,4213,2429,1784,18,31,9,9,allow
49484,443,58905,443,407843,11895,395948,436,271,157,279,allow
50708,80,15427,80,3114,1695,1419,15,196,11,4,allow
57070,443,3388,443,18227,6731,11496,63,18,34,29,allow
50713,80,55082,80,708,384,324,12,195,7,5,allow
8802,80,39611,80,4999,1313,3686,36,667,8,28,allow
57993,443,27022,443,8647,1990,6657,23,26,14,9,allow
54997,443,59177,443,10817,4402,6415,31,23,17,14,allow
64768,53,30558,53,394,102,292,2,29,1,1,allow
58025,80,19163,80,708,384,324,12,23,7,5,allow
53746,7546,3408,7546,70,70,0,2,7,2,0,allow
57431,80,59179,80,11357,5000,6357,22,30,11,11,allow
64656,53,17241,53,387,102,285,2,29,1,1,allow
57012,53,13483,53,230,86,144,2,29,1,1,allow
55131,53,55323,53,244,94,150,2,30,1,1,allow
39666,443,38106,443,7522,2433,5089,16,120,8,8,allow
50662,443,10724,443,6518,1200,5318,17,16,8,9,allow
51932,36498,31404,36498,70,70,0,2,8,2,0,allow
64410,53,3799,53,196,102,94,2,35,1,1,allow
55062,80,41792,80,486,240,246,9,28,5,4,allow
58044,80,31147,80,2742,1116,1626,11,20,6,5,allow
58042,80,52870,80,318,192,126,6,20,4,2,allow
54352,443,38196,443,12594,5098,7496,32,34,17,15,allow
51418,53,32808,53,168,78,90,2,30,1,1,allow
64215,53,28280,53,196,94,102,2,30,1,1,allow
43197,80,55210,80,3605,1700,1905,16,186,9,7,allow
57239,5228,64844,5228,16135,7514,8621,173,9115,72,101,allow
49593,53,25320,53,253,102,151,2,30,1,1,allow
50710,80,11292,80,708,384,324,12,195,7,5,allow
50712,80,10227,80,708,384,324,12,195,7,5,allow
60287,80,11423,80,130,70,60,2,15,1,1,allow
51931,19416,65025,19416,70,70,0,2,8,2,0,allow
65115,53,63102,53,301,95,206,4,36,2,2,allow
65090,53,43740,53,209,102,107,2,30,1,1,allow
50400,53,28411,53,177,94,83,2,30,1,1,allow
50400,53,9416,53,177,94,83,2,30,1,1,allow
46567,443,46567,443,4398,1491,2907,19,29,11,8,allow
64025,53,10807,53,199,94,105,2,30,1,1,allow
34092,53,13668,53,168,78,90,2,30,1,1,allow
41739,53,41739,53,235,90,145,2,32,1,1,allow
57850,3389,57850,3389,3347,1458,1889,15,18,8,7,allow
43817,53,43817,53,203,82,121,2,30,1,1,allow
62724,443,24098,443,11195,2218,8977,36,80,18,18,allow
55933,53,17036,53,212,102,110,2,30,1,1,allow
55653,443,8699,443,7267,2312,4955,16,120,7,9,allow
53522,8765,27669,8765,199,75,124,4,59,2,2,allow
55271,53,16538,53,268,102,166,2,30,1,1,allow
43195,80,21562,80,3477,1572,1905,16,186,9,7,allow
57169,53,0,0,208,86,122,2,30,1,1,allow
48931,53,2346,53,168,78,90,2,30,1,1,allow
64425,53,47922,53,216,94,122,2,30,1,1,allow
64579,443,6221,443,24686,1935,22751,36,20,17,19,allow
53083,80,12541,80,5259,1904,3355,30,15,23,7,allow
46999,53,31962,53,168,78,90,2,30,1,1,allow
55699,443,1921,443,4170,1901,2269,14,120,7,7,allow
56214,53,47113,53,200,102,98,2,33,1,1,allow
55075,53,41245,53,181,94,87,2,33,1,1,allow
42890,80,22504,80,2030,586,1444,10,30,6,4,allow
57689,443,27070,443,10855,1786,9069,32,180,15,17,allow
50050,53,17602,53,253,87,166,4,52,2,2,allow
64050,53,59472,53,389,94,295,2,30,1,1,allow
64765,53,34365,53,195,94,101,2,30,1,1,allow
56214,53,47362,53,200,102,98,2,30,1,1,allow
57225,53,35274,53,177,94,83,2,30,1,1,allow
50265,59362,35253,59362,4228,2471,1757,55,2758,31,24,allow
49352,53,48466,53,214,94,120,2,30,1,1,allow
65453,53,27266,53,251,94,157,2,31,1,1,allow
44455,443,5697,443,6972,1375,5597,20,31,10,10,allow
57045,53,2181,53,177,94,83,2,30,1,1,allow
37208,443,37628,443,9621,7389,2232,33,256,14,19,allow
52220,22,52220,22,8248,3445,4803,57,38,26,31,allow
41320,443,41281,443,1743946,54876,1689070,1870,360,678,1192,allow
56812,443,43977,443,11568,9158,2410,42,80,23,19,allow
53425,443,1934,443,7208,2237,4971,26,32,16,10,allow
53020,443,6371,443,3183,2180,1003,16,15,8,8,allow
51893,80,59031,80,14289,7263,7026,27,27,14,13,allow
49355,443,38735,443,4960,896,4064,14,16,8,6,allow
63131,34880,2031,34880,316,190,126,5,15,3,2,allow
50478,443,59774,443,25979,7217,18762,36,15,19,17,allow
51420,443,42852,443,7653,1188,6465,21,16,12,9,allow
40956,443,7227,443,10836,1733,9103,34,180,15,19,allow
39926,443,4012,443,40820,4400,36420,81,81,42,39,allow
51421,443,61384,443,9345,3051,6294,22,15,13,9,allow
50664,443,64015,443,7767,1421,6346,20,15,8,12,allow
63916,56318,49851,56318,66,66,0,2,7,2,0,allow
49295,53,11197,53,280,96,184,4,36,2,2,allow
63917,57826,24551,57826,66,66,0,2,7,2,0,allow
33938,443,14561,443,6919,2112,4807,19,15,10,9,allow
50714,80,62410,80,708,384,324,12,195,7,5,allow
37562,443,51859,443,13836,6371,7465,34,23,20,14,allow
58043,80,57225,80,378,192,186,7,20,4,3,allow
50210,1688,10212,1688,70,70,0,1,5,1,0,allow
53650,53,49968,53,199,94,105,2,29,1,1,allow
42749,443,12087,443,6172,1310,4862,28,468,10,18,allow
49753,80,62550,80,32910,18450,14460,143,1647,75,68,allow
55384,53,19331,53,94,94,0,1,30,1,0,allow
49683,53,44598,53,262,94,168,2,29,1,1,allow
64283,53,39891,53,337,110,227,2,29,1,1,allow
48292,80,5673,80,14038,3554,10484,45,1142,16,29,allow
52817,443,5709,443,2658,1126,1532,25,120,12,13,allow
64052,443,61598,443,4395,1673,2722,14,119,7,7,allow
49308,53,5550,53,195,94,101,2,29,1,1,allow
65097,53,14229,53,718,94,624,2,30,1,1,allow
59116,443,24457,443,48923,5417,43506,61,122,25,36,allow
53087,443,59846,443,408922,10621,398301,421,121,145,276,allow
6881,6889,14083,6889,228,118,110,2,1199,1,1,allow
51910,80,31121,80,4994,3658,1336,11,26,6,5,allow
64420,53,48861,53,294,95,199,4,42,2,2,allow
55049,443,41973,443,5587,3950,1637,26,55,15,11,allow
50709,80,20258,80,708,384,324,12,195,7,5,allow
49686,53,9507,53,343,94,249,2,30,1,1,allow
49805,53,26905,53,296,102,194,2,30,1,1,allow
57349,53,0,0,222,86,136,2,30,1,1,allow
49305,53,42044,53,177,94,83,2,30,1,1,allow
64743,53,57022,53,210,102,108,2,30,1,1,allow
43196,80,6981,80,3494,1589,1905,16,186,9,7,allow
6881,6881,57384,6881,238,118,120,2,1200,1,1,allow
47661,80,24519,80,2865,2000,865,12,15,7,5,allow
43440,80,5073,80,2093,825,1268,12,45,7,5,allow
54485,80,18876,80,130,70,60,2,15,1,1,allow
55061,80,17010,80,486,240,246,9,28,5,4,allow
53260,443,64697,443,6136,1916,4220,28,15,16,12,allow
57075,53,9642,53,199,94,105,2,30,1,1,allow
55077,53,49404,53,394,94,300,2,30,1,1,allow
55075,53,35995,53,181,94,87,2,30,1,1,allow
49914,53,9646,53,718,94,624,2,30,1,1,allow
44454,443,1457,443,7092,1495,5597,22,31,12,10,allow
50602,80,38980,80,1658,1247,411,8,15,5,3,allow
51682,80,11682,80,59786,3488,56298,119,55,45,74,allow
51852,80,36581,80,182,60,122,4,29,2,2,allow
51909,33509,56937,33509,70,70,0,1,5,1,0,allow
51911,14543,20500,14543,70,70,0,1,5,1,0,allow
50711,80,56692,80,708,384,324,12,195,7,5,allow
50661,443,13443,443,298067,6719,291348,307,17,98,209,allow
51450,80,49507,80,214,140,74,4,15,3,1,allow
50050,53,12626,53,253,87,166,4,51,2,2,allow
49901,53,32175,53,231,102,129,2,30,1,1,allow
64517,53,41461,53,211,102,109,2,30,1,1,allow
57225,53,63764,53,177,94,83,2,30,1,1,allow
49281,53,63913,53,251,102,149,2,30,1,1,allow
55144,443,5039,443,3522,869,2653,13,121,6,7,allow
51221,1338,12971,1338,132,132,0,3,1200,3,0,allow
49347,443,51852,443,611644,29314,582330,793,132,333,460,allow
61358,3389,61358,3389,3488,1774,1714,17,33,9,8,allow
37042,53,37042,53,237,98,139,2,30,1,1,allow
54093,5228,31167,5228,7608,1824,5784,34,171,19,15,allow
60343,443,27332,443,36547,3840,32707,88,241,43,45,allow
56641,80,60111,80,234,234,0,4,12,4,0,allow
55474,80,42098,80,25970,2371,23599,52,17,26,26,allow
63597,443,64564,443,19821,11622,8199,77,135,39,38,allow
63588,443,6782,443,11301,2292,9009,37,165,20,17,allow
63592,443,55191,443,6485,1871,4614,27,140,14,13,allow
64664,53,45386,53,250,86,164,4,33,2,2,allow
36413,443,33262,443,2064683,47545,2017138,1994,33,657,1337,allow
63583,443,3577,443,7339,2638,4701,33,167,18,15,allow
63584,443,2301,443,7146,2010,5136,34,167,18,16,allow
49001,55108,0,0,160,160,0,1,0,1,0,deny
58338,3375,0,0,60,60,0,1,0,1,0,deny
21419,23,0,0,60,60,0,1,0,1,0,deny
57538,30188,0,0,66,66,0,1,0,1,0,deny
63539,445,0,0,70,70,0,1,0,1,0,drop
63537,445,0,0,70,70,0,1,0,1,0,drop
63533,445,0,0,70,70,0,1,0,1,0,drop
58944,445,0,0,66,66,0,1,0,1,0,drop
24062,51505,0,0,146,146,0,1,0,1,0,deny
63532,445,0,0,70,70,0,1,0,1,0,drop
58939,445,0,0,66,66,0,1,0,1,0,drop
33543,44847,0,0,62,62,0,1,0,1,0,deny
53746,36237,0,0,66,66,0,1,0,1,0,deny
58671,445,0,0,70,70,0,1,0,1,0,drop
21759,51505,0,0,66,66,0,1,0,1,0,deny
9017,6881,0,0,62,62,0,1,0,1,0,deny
58936,445,0,0,66,66,0,1,0,1,0,drop
58935,445,0,0,66,66,0,1,0,1,0,drop
49001,48983,0,0,161,161,0,1,0,1,0,deny
58076,21247,0,0,66,66,0,1,0,1,0,deny
58933,445,0,0,66,66,0,1,0,1,0,drop
43578,15503,0,0,74,74,0,1,0,1,0,deny
52003,44512,0,0,66,66,0,1,0,1,0,deny
34470,57470,0,0,66,66,0,1,0,1,0,deny
62731,21247,0,0,66,66,0,1,0,1,0,deny
36400,51505,0,0,62,62,0,1,0,1,0,deny
58667,445,0,0,70,70,0,1,0,1,0,drop
61798,35440,0,0,66,66,0,1,0,1,0,deny
63529,445,0,0,70,70,0,1,0,1,0,drop
63513,445,0,0,70,70,0,1,0,1,0,deny
18423,51505,0,0,66,66,0,1,0,1,0,deny
5859,11392,0,0,66,66,0,1,0,1,0,deny
58923,445,0,0,66,66,0,1,0,1,0,drop
5894,44847,0,0,62,62,0,1,0,1,0,deny
54300,22114,0,0,62,62,0,1,0,1,0,deny
54458,64147,0,0,62,62,0,1,0,1,0,deny
40512,57470,0,0,74,74,0,1,0,1,0,deny
55874,64147,0,0,66,66,0,1,0,1,0,deny
39230,23,0,0,60,60,0,1,0,1,0,deny
39742,62413,0,0,62,62,0,1,0,1,0,deny
51262,35440,0,0,62,62,0,1,0,1,0,deny
62388,39004,0,0,62,62,0,1,0,1,0,deny
58654,445,0,0,70,70,0,1,0,1,0,drop
50086,57470,0,0,66,66,0,1,0,1,0,deny
41249,50584,0,0,66,66,0,1,0,1,0,deny
58915,445,0,0,66,66,0,1,0,1,0,drop
63504,445,0,0,70,70,0,1,0,1,0,drop
50283,49169,0,0,62,62,0,1,0,1,0,deny
41815,50265,0,0,146,146,0,1,0,1,0,deny
58651,445,0,0,70,70,0,1,0,1,0,drop
58913,445,0,0,66,66,0,1,0,1,0,drop
58085,57470,0,0,62,62,0,1,0,1,0,deny
45941,23386,0,0,60,60,0,1,0,1,0,deny
58904,445,0,0,66,66,0,1,0,1,0,drop
54779,50584,0,0,66,66,0,1,0,1,0,deny
58646,445,0,0,70,70,0,1,0,1,0,drop
58895,445,0,0,66,66,0,1,0,1,0,drop
58645,445,0,0,70,70,0,1,0,1,0,drop
60514,39004,0,0,66,66,0,1,0,1,0,deny
19617,39004,0,0,62,62,0,1,0,1,0,deny
58643,445,0,0,70,70,0,1,0,1,0,drop
443,60496,0,0,320,320,0,1,0,1,0,deny
62912,26467,0,0,62,62,0,1,0,1,0,deny
65317,51221,0,0,78,78,0,1,0,1,0,deny
2180,63710,0,0,66,66,0,1,0,1,0,deny
63494,445,0,0,70,70,0,1,0,1,0,drop
63493,445,0,0,70,70,0,1,0,1,0,drop
63492,445,0,0,70,70,0,1,0,1,0,drop
27038,63836,0,0,145,145,0,1,0,1,0,deny
58884,445,0,0,66,66,0,1,0,1,0,drop
58889,445,0,0,66,66,0,1,0,1,0,drop
58885,445,0,0,66,66,0,1,0,1,0,drop
58890,445,0,0,66,66,0,1,0,1,0,drop
58883,445,0,0,66,66,0,1,0,1,0,drop
58887,445,0,0,66,66,0,1,0,1,0,drop
58886,445,0,0,66,66,0,1,0,1,0,drop
58882,445,0,0,66,66,0,1,0,1,0,drop
62051,11392,0,0,62,62,0,1,0,1,0,deny
60351,50584,0,0,66,66,0,1,0,1,0,deny
58636,445,0,0,70,70,0,1,0,1,0,drop
43700,30188,0,0,62,62,0,1,0,1,0,deny
1057,57470,0,0,62,62,0,1,0,1,0,deny
58634,445,0,0,70,70,0,1,0,1,0,drop
58791,15503,0,0,66,66,0,1,0,1,0,deny
12644,11392,0,0,66,66,0,1,0,1,0,deny
58633,445,0,0,70,70,0,1,0,1,0,drop
58632,445,0,0,70,70,0,1,0,1,0,drop
58631,445,0,0,70,70,0,1,0,1,0,drop
51996,57470,0,0,66,66,0,1,0,1,0,deny
5222,7493,0,0,66,66,0,1,0,1,0,deny
58628,445,0,0,70,70,0,1,0,1,0,drop
58626,445,0,0,70,70,0,1,0,1,0,drop
63488,445,0,0,70,70,0,1,0,1,0,drop
63482,445,0,0,70,70,0,1,0,1,0,drop
63480,445,0,0,70,70,0,1,0,1,0,drop
63476,445,0,0,70,70,0,1,0,1,0,drop
443,48120,0,0,97,97,0,1,0,1,0,deny
35864,44847,0,0,78,78,0,1,0,1,0,deny
50674,35440,0,0,62,62,0,1,0,1,0,deny
58868,445,0,0,66,66,0,1,0,1,0,drop
58869,445,0,0,66,66,0,1,0,1,0,drop
58867,445,0,0,66,66,0,1,0,1,0,drop
80,7597,0,0,66,66,0,1,0,1,0,deny
27337,51505,0,0,66,66,0,1,0,1,0,deny
50135,50584,0,0,146,146,0,1,0,1,0,deny
58613,445,0,0,70,70,0,1,0,1,0,drop
58612,445,0,0,70,70,0,1,0,1,0,drop
58610,445,0,0,70,70,0,1,0,1,0,drop
58602,445,0,0,70,70,0,1,0,1,0,drop
58603,445,0,0,70,70,0,1,0,1,0,drop
63472,445,0,0,70,70,0,1,0,1,0,drop
63469,445,0,0,70,70,0,1,0,1,0,drop
63467,445,0,0,70,70,0,1,0,1,0,drop
63463,445,0,0,70,70,0,1,0,1,0,drop
54976,2273,0,0,60,60,0,1,0,1,0,deny
51374,30317,0,0,62,62,0,1,0,1,0,deny
53766,51505,0,0,66,66,0,1,0,1,0,deny
58591,445,0,0,70,70,0,1,0,1,0,drop
63455,445,0,0,70,70,0,1,0,1,0,drop
63453,445,0,0,70,70,0,1,0,1,0,drop
63448,445,0,0,70,70,0,1,0,1,0,drop
61766,44847,0,0,66,66,0,1,0,1,0,deny
11450,57470,0,0,66,66,0,1,0,1,0,deny
7286,44847,0,0,66,66,0,1,0,1,0,deny
9394,51505,0,0,62,62,0,1,0,1,0,deny
58858,445,0,0,66,66,0,1,0,1,0,drop
56876,30188,0,0,62,62,0,1,0,1,0,deny
58587,445,0,0,70,70,0,1,0,1,0,drop
26872,44847,0,0,62,62,0,1,0,1,0,deny
28429,23,0,0,60,60,0,1,0,1,0,deny
54984,80,56260,80,2487,680,1807,9,17,6,3,allow
53747,21698,30276,21698,320,140,180,6,7,3,3,allow
63572,443,58406,443,125798,40014,85784,276,171,125,151,allow
63059,443,42784,443,5772,3849,1923,27,270,14,13,allow
48022,5228,46270,5228,10096,2251,7845,41,3747,16,25,allow
50908,443,7886,443,124,64,60,2,15,1,1,allow
54977,80,22361,80,4259,1114,3145,12,18,8,4,allow
51430,443,37453,443,7318,1585,5733,24,50,14,10,allow
55754,53,32469,53,170,87,83,2,31,1,1,allow
21975,3389,21975,3389,3910,1805,2105,20,19,12,8,allow
53141,8595,63363,8595,70,70,0,2,8,2,0,allow
59902,443,47216,443,6196,746,5450,17,28,8,9,allow
49341,443,40823,443,484,210,274,8,135,4,4,allow
51429,443,6993,443,8804,1597,7207,25,50,14,11,allow
55304,53,64050,53,711,87,624,2,30,1,1,allow
49348,80,58488,80,2695,601,2094,14,17,7,7,allow
60339,7010,60339,7010,3322,2027,1295,16,16,9,7,allow
51905,65253,44295,65253,66,66,0,1,5,1,0,allow
54716,443,54716,443,4728,1821,2907,19,29,11,8,allow
54985,80,44594,80,2452,680,1772,9,17,6,3,allow
40599,443,4488,443,7338,2419,4919,19,23,12,7,allow
50469,80,50469,80,350722,14506,336216,459,26,231,228,allow
49350,80,17216,80,2485,529,1956,12,17,6,6,allow
58325,53,35330,53,251,79,172,2,30,1,1,allow
56358,53,16023,53,104,104,0,1,30,1,0,allow
63594,443,17345,443,7673,2645,5028,31,137,17,14,allow
50907,443,12062,443,124,64,60,2,15,1,1,allow
56856,47715,25916,47715,66,66,0,1,5,1,0,allow
49632,7000,49632,7000,1236,676,560,13,15,7,6,allow
9098,443,52183,443,6177,969,5208,17,26,9,8,allow
58888,443,13119,443,274616,12640,261976,352,28,167,185,allow
57045,53,27906,53,170,87,83,2,30,1,1,allow
30960,45737,31575,45737,330,330,0,6,3609,6,0,allow
43918,5228,35546,5228,2276,1356,920,15,3601,7,8,allow
58124,80,58124,80,125299,3364,121935,129,19,44,85,allow
63591,443,24703,443,11746,3874,7872,44,141,22,22,allow
35085,443,56294,443,1617,1062,555,13,45,8,5,allow
49012,443,59626,443,44584,2838,41746,66,31,31,35,allow
52054,80,49202,80,1682,642,1040,13,54,4,9,allow
52708,443,22649,443,10748,1634,9114,22,316,10,12,allow
55822,80,1122,80,1052,612,440,10,16,5,5,allow
56206,53,48081,53,711,87,624,2,30,1,1,allow
61581,443,25669,443,5103,2363,2740,11,120,6,5,allow
65444,3389,65444,3389,4305,2521,1784,19,34,10,9,allow
62343,443,28448,443,13709,1675,12034,25,31,11,14,allow
38576,443,42458,443,10853,8227,2626,30,360,15,15,allow
48817,47719,48817,47719,1837,852,985,8,1200,4,4,allow
32609,64097,0,0,62,62,0,1,0,1,0,deny
58578,445,0,0,70,70,0,1,0,1,0,drop
58577,445,0,0,70,70,0,1,0,1,0,drop
58576,445,0,0,70,70,0,1,0,1,0,drop
35408,56205,0,0,66,66,0,1,0,1,0,deny
58574,445,0,0,70,70,0,1,0,1,0,drop
39098,51505,0,0,146,146,0,1,0,1,0,deny
58570,445,0,0,70,70,0,1,0,1,0,drop
48857,50584,0,0,66,66,0,1,0,1,0,deny
63446,445,0,0,70,70,0,1,0,1,0,drop
63443,445,0,0,70,70,0,1,0,1,0,drop
58869,57470,0,0,145,145,0,1,0,1,0,deny
53321,443,65410,443,416,210,206,7,28,4,3,allow
35775,443,51834,443,6665,3913,2752,33,98,19,14,allow
63599,443,32617,443,10050,1802,8248,30,39,16,14,allow
58976,43890,0,0,62,62,0,1,0,1,0,deny
58843,445,0,0,66,66,0,1,0,1,0,drop
58839,445,0,0,66,66,0,1,0,1,0,drop
10477,44847,0,0,66,66,0,1,0,1,0,deny
13917,18033,0,0,62,62,0,1,0,1,0,deny
58565,445,0,0,70,70,0,1,0,1,0,drop
63433,445,0,0,70,70,0,1,0,1,0,drop
2691,64147,0,0,62,62,0,1,0,1,0,deny
63427,445,0,0,70,70,0,1,0,1,0,drop
63425,445,0,0,70,70,0,1,0,1,0,drop
63424,445,0,0,70,70,0,1,0,1,0,drop
54552,64147,0,0,62,62,0,1,0,1,0,deny
39920,22114,0,0,62,62,0,1,0,1,0,deny
58835,445,0,0,66,66,0,1,0,1,0,drop
10243,36237,0,0,62,62,0,1,0,1,0,deny
58555,445,0,0,70,70,0,1,0,1,0,drop
53656,31573,0,0,62,62,0,1,0,1,0,deny
48420,31755,0,0,146,146,0,1,0,1,0,deny
58827,445,0,0,66,66,0,1,0,1,0,drop
58825,445,0,0,66,66,0,1,0,1,0,drop
58818,445,0,0,66,66,0,1,0,1,0,drop
58830,445,0,0,66,66,0,1,0,1,0,drop
58826,445,0,0,66,66,0,1,0,1,0,drop
58819,445,0,0,66,66,0,1,0,1,0,drop
58829,445,0,0,66,66,0,1,0,1,0,drop
58553,445,0,0,70,70,0,1,0,1,0,drop
62514,37807,0,0,66,66,0,1,0,1,0,deny
1025,51221,0,0,62,62,0,1,0,1,0,deny
57260,51221,0,0,66,66,0,1,0,1,0,deny
63419,445,0,0,70,70,0,1,0,1,0,drop
63417,445,0,0,70,70,0,1,0,1,0,drop
63416,445,0,0,70,70,0,1,0,1,0,drop
63413,445,0,0,70,70,0,1,0,1,0,drop
43350,58414,0,0,62,62,0,1,0,1,0,deny
58549,445,0,0,70,70,0,1,0,1,0,drop
41734,57470,0,0,62,62,0,1,0,1,0,deny
58547,445,0,0,70,70,0,1,0,1,0,drop
14036,48817,0,0,66,66,0,1,0,1,0,deny
15465,64147,0,0,66,66,0,1,0,1,0,deny
6881,6881,0,0,146,146,0,1,0,1,0,deny
53044,36237,0,0,66,66,0,1,0,1,0,deny
3549,64147,0,0,62,62,0,1,0,1,0,deny
62131,50584,0,0,66,66,0,1,0,1,0,deny
48420,26672,0,0,146,146,0,1,0,1,0,deny
58543,445,0,0,70,70,0,1,0,1,0,drop
63411,445,0,0,70,70,0,1,0,1,0,drop
63409,445,0,0,70,70,0,1,0,1,0,drop
63405,445,0,0,70,70,0,1,0,1,0,drop
63598,443,20938,443,164604,5676,158928,188,39,70,118,allow
59898,443,27640,443,1265,684,581,13,30,6,7,allow
60121,443,30083,443,6351,1857,4494,20,16,11,9,allow
49343,443,10308,443,1556,769,787,17,134,9,8,allow
55675,53,34777,53,287,91,196,4,60,2,2,allow
37965,29299,52257,29299,858,858,0,14,1199,14,0,allow
58883,443,6061,443,5476,3102,2374,42,132,23,19,allow
53258,443,34531,443,5916,1774,4142,25,15,14,11,allow
49885,7000,49885,7000,3132,815,2317,14,15,7,7,allow
50470,80,50470,80,2144,900,1244,11,26,7,4,allow
57556,443,56704,443,162,102,60,2,5,1,1,allow
49346,443,21624,443,4312,2524,1788,34,132,19,15,allow
61802,443,61802,443,4521,1614,2907,19,26,11,8,allow
64274,53,5372,53,197,102,95,2,32,1,1,allow
51928,52520,20049,52520,258,70,188,4,8,2,2,allow
38446,443,2799,443,46008,3750,42258,77,48,39,38,allow
49305,53,59053,53,177,94,83,2,29,1,1,allow
65126,443,41319,443,958,384,574,14,34,7,7,allow
60911,53,23878,53,335,78,257,2,29,1,1,allow
57045,53,5353,53,177,94,83,2,29,1,1,allow
65250,53,12810,53,900,110,790,2,30,1,1,allow
49817,53,29101,53,401,91,310,4,29,2,2,allow
63596,443,27876,443,8104,2201,5903,28,135,15,13,allow
58870,443,14754,443,7415,2363,5052,17,120,9,8,allow
56301,53,2529,53,177,94,83,2,30,1,1,allow
50245,443,54814,443,6866,1958,4908,21,20,13,8,allow
60444,47094,7095,47094,320,140,180,6,7,3,3,allow
38427,443,30130,443,12591,2902,9689,40,55,19,21,allow
49383,53,44225,53,94,94,0,1,30,1,0,allow
34489,443,45344,443,8363,1573,6790,24,49,14,10,allow
60791,443,31785,443,15013,10159,4854,34,46,19,15,allow
63887,80,15748,80,314,192,122,6,15,4,2,allow
60126,443,24609,443,3015,2086,929,16,15,9,7,allow
60775,40010,2313,40010,316,136,180,6,6,3,3,allow
46764,443,46764,443,4401,1494,2907,19,29,11,8,allow
30201,53,30201,53,235,90,145,2,33,1,1,allow
42615,443,10393,443,117381,60398,56983,518,4126,256,262,allow
51929,53371,7224,53371,70,70,0,2,8,2,0,allow
9099,443,46908,443,6677,1097,5580,21,25,11,10,allow
56358,53,42887,53,210,110,100,2,33,1,1,allow
59464,443,49741,443,7333,1933,5400,27,16,15,12,allow
56913,53,62016,53,247,94,153,2,30,1,1,allow
49438,443,56148,443,180,60,120,4,15,2,2,allow
58037,80,32783,80,2339,1122,1217,11,20,6,5,allow
57045,53,16294,53,177,94,83,2,30,1,1,allow
34424,53,34424,53,235,90,145,2,33,1,1,allow
38445,443,60732,443,23571,4700,18871,60,48,30,30,allow
64814,53,63374,53,212,102,110,2,30,1,1,allow
44009,443,15754,443,1392,731,661,14,80,8,6,allow
57243,53,28936,53,168,78,90,2,30,1,1,allow
38425,443,45581,443,103112,8212,94900,165,55,80,85,allow
9152,443,16352,443,15550,1508,14042,28,19,13,15,allow
42727,53,0,0,82,82,0,2,40,2,0,allow
60476,80,59400,80,613,539,74,7,15,6,1,allow
47504,443,4278,443,6496,3631,2865,71,606,39,32,allow
50873,443,51953,443,350,210,140,6,26,4,2,allow
56283,53,17978,53,315,102,213,2,30,1,1,allow
64809,53,47769,53,312,78,234,2,30,1,1,allow
50662,443,44987,443,3306,1714,1592,17,16,9,8,allow
51927,63309,55046,63309,70,70,0,2,8,2,0,allow
52539,80,47321,80,1152,712,440,10,15,5,5,allow
50061,80,3362,80,405,285,120,5,15,3,2,allow
54350,443,24025,443,10318,2117,8201,38,371,19,19,allow
49839,53,21176,53,315,102,213,2,30,1,1,allow
56222,53,43289,53,168,78,90,2,30,1,1,allow
65409,53,62247,53,200,94,106,2,30,1,1,allow
51595,443,19980,443,632,158,474,2,30,1,1,allow
58362,53,30634,53,167,78,89,2,30,1,1,allow
40994,443,58076,443,1396,735,661,14,80,8,6,allow
49348,443,47501,443,2879984,113967,2766017,3396,129,1423,1973,allow
51417,443,60924,443,25865,7151,18714,36,15,19,17,allow
56706,80,18045,80,214,140,74,4,25,3,1,allow
14436,443,7159,443,2601,1455,1146,18,15,8,10,allow
51906,17491,7245,17491,70,70,0,1,5,1,0,allow
46812,80,23325,80,1137,679,458,10,15,6,4,allow
51892,80,28935,80,15867,8841,7026,29,26,16,13,allow
53739,27290,11218,27290,70,70,0,2,7,2,0,allow
53741,43800,53441,43800,70,70,0,2,7,2,0,allow
34487,443,45811,443,8363,1573,6790,24,49,14,10,allow
53256,443,33815,443,6185,1994,4191,27,16,16,11,allow
38448,443,13312,443,18512,3109,15403,45,48,22,23,allow
43094,443,34606,443,6443,1973,4470,19,16,11,8,allow
48340,443,49643,443,18198,13269,4929,47,324,20,27,allow
58052,80,61267,80,1550,853,697,9,15,5,4,allow
56478,53,6625,53,177,94,83,2,29,1,1,allow
56007,53,24693,53,197,102,95,2,35,1,1,allow
56478,53,29572,53,177,94,83,2,29,1,1,allow
34488,443,33891,443,8363,1573,6790,24,49,14,10,allow
55754,53,35474,53,177,94,83,2,30,1,1,allow
53678,443,40421,443,6697,1606,5091,23,24,13,10,allow
64082,53,61850,53,329,102,227,2,30,1,1,allow
53708,23280,6417,23280,1903,968,935,16,16,9,7,allow
49266,53,8623,53,86,86,0,1,30,1,0,allow
57546,443,50936,443,34428,22220,12208,84,122,41,43,allow
63595,443,51163,443,8062,2186,5876,29,136,15,14,allow
53706,59208,42614,59208,164,70,94,2,8,1,1,allow
60792,443,58920,443,5037,1343,3694,18,45,11,7,allow
51538,443,28169,443,6384,1899,4485,16,75,9,7,allow
51894,80,51074,80,7434,3830,3604,17,26,9,8,allow
60367,443,5802,443,12979,6398,6581,39,115,22,17,allow
55754,53,39478,53,177,94,83,2,30,1,1,allow
60166,443,54772,443,7639,2673,4966,36,255,17,19,allow
38447,443,18020,443,9824,2902,6922,38,48,19,19,allow
56833,28571,3493,28571,5436,3022,2414,17,32,11,6,allow
58364,53,50367,53,167,78,89,2,30,1,1,allow
58363,53,45299,53,167,78,89,2,30,1,1,allow
56852,443,47368,443,8215,2882,5333,32,90,16,16,allow
53707,44209,9971,44209,1513,989,524,17,16,10,7,allow
42204,443,21062,443,6197,942,5255,19,361,10,9,allow
60864,5223,16379,5223,194,134,60,2,5,1,1,allow
38685,443,17432,443,749731,23099,726632,823,16,326,497,allow
39851,443,44930,443,9355,3422,5933,56,16,28,28,allow
64731,53,43372,53,241,110,131,2,30,1,1,allow
64723,53,15149,53,229,110,119,2,30,1,1,allow
52720,443,21173,443,11732,4753,6979,41,397,17,24,allow
42203,443,25522,443,6345,1024,5321,21,361,11,10,allow
42202,443,2028,443,6610,1106,5504,23,361,12,11,allow
53460,443,49234,443,6118,5698,420,12,124,6,6,allow
55704,53,8827,53,177,94,83,2,31,1,1,allow
60123,443,13855,443,6485,1957,4528,22,16,11,11,allow
50566,443,28525,443,7367,1149,6218,18,27,9,9,allow
49477,53,44035,53,168,78,90,2,30,1,1,allow
65350,53,62383,53,168,86,82,2,30,1,1,allow
65350,53,48988,53,168,86,82,2,30,1,1,allow
38684,443,33741,443,90449,3289,87160,93,16,28,65,allow
56388,53,23027,53,186,95,91,3,34,2,1,allow
45726,443,40256,443,130,70,60,3,6,2,1,allow
50284,443,28484,443,208,60,148,4,12,2,2,allow
38687,443,37401,443,13923,1728,12195,24,16,10,14,allow
37264,443,41734,443,130,70,60,3,5,2,1,allow
63888,6881,45286,6881,70,70,0,1,5,1,0,allow
50565,443,52646,443,1313,876,437,11,27,6,5,allow
50562,443,27211,443,1313,876,437,11,27,6,5,allow
55761,53,38695,53,168,78,90,2,30,1,1,allow
58665,53,16877,53,260,86,174,2,30,1,1,allow
55704,53,43154,53,177,94,83,2,30,1,1,allow
64179,53,19210,53,212,102,110,2,30,1,1,allow
65350,53,48602,53,168,86,82,2,31,1,1,allow
58813,445,0,0,66,66,0,1,0,1,0,drop
58542,445,0,0,70,70,0,1,0,1,0,drop
56883,22114,0,0,62,62,0,1,0,1,0,deny
63404,445,0,0,70,70,0,1,0,1,0,drop
58809,445,0,0,66,66,0,1,0,1,0,deny
63342,53,0,0,72,72,0,1,0,1,0,deny
58808,445,0,0,66,66,0,1,0,1,0,drop
58807,445,0,0,66,66,0,1,0,1,0,drop
37837,37965,0,0,62,62,0,1,0,1,0,deny
58805,445,0,0,66,66,0,1,0,1,0,drop
1038,37965,0,0,62,62,0,1,0,1,0,deny
26085,10387,0,0,148,148,0,1,0,1,0,deny
41840,50584,0,0,66,66,0,1,0,1,0,deny
56101,57470,0,0,66,66,0,1,0,1,0,deny
58537,445,0,0,70,70,0,1,0,1,0,drop
4438,23,0,0,60,60,0,1,0,1,0,deny
63399,445,0,0,70,70,0,1,0,1,0,drop
5688,44847,0,0,62,62,0,1,0,1,0,deny
63390,445,0,0,70,70,0,1,0,1,0,drop
63391,445,0,0,70,70,0,1,0,1,0,drop
52711,37965,0,0,62,62,0,1,0,1,0,deny
52925,3389,0,0,60,60,0,1,0,1,0,deny
58793,445,0,0,66,66,0,1,0,1,0,drop
51646,37965,0,0,62,62,0,1,0,1,0,deny
39730,17372,0,0,66,66,0,1,0,1,0,deny
58524,445,0,0,70,70,0,1,0,1,0,drop
58786,445,0,0,66,66,0,1,0,1,0,drop
63376,445,0,0,70,70,0,1,0,1,0,drop
50106,31573,0,0,66,66,0,1,0,1,0,deny
58521,445,0,0,70,70,0,1,0,1,0,drop
25453,35776,0,0,145,145,0,1,0,1,0,deny
58784,445,0,0,66,66,0,1,0,1,0,drop
50675,56205,0,0,66,66,0,1,0,1,0,deny
56494,15503,0,0,146,146,0,1,0,1,0,deny
52914,37965,0,0,66,66,0,1,0,1,0,deny
24731,51505,0,0,62,62,0,1,0,1,0,deny
58516,445,0,0,70,70,0,1,0,1,0,drop
52537,37965,0,0,62,62,0,1,0,1,0,deny
9506,2323,0,0,60,60,0,1,0,1,0,deny
58515,445,0,0,70,70,0,1,0,1,0,drop
58775,445,0,0,66,66,0,1,0,1,0,drop
41756,56205,0,0,62,62,0,1,0,1,0,deny
58773,445,0,0,66,66,0,1,0,1,0,drop
58513,445,0,0,70,70,0,1,0,1,0,drop
64438,23,0,0,60,60,0,1,0,1,0,deny
39324,64147,0,0,62,62,0,1,0,1,0,deny
63027,35440,0,0,62,62,0,1,0,1,0,deny
63367,445,0,0,70,70,0,1,0,1,0,drop
63365,445,0,0,70,70,0,1,0,1,0,drop
63364,445,0,0,70,70,0,1,0,1,0,drop
58506,445,0,0,70,70,0,1,0,1,0,drop
58758,445,0,0,66,66,0,1,0,1,0,drop
58760,445,0,0,66,66,0,1,0,1,0,drop
58755,445,0,0,66,66,0,1,0,1,0,drop
58761,445,0,0,66,66,0,1,0,1,0,drop
58756,445,0,0,66,66,0,1,0,1,0,drop
58759,445,0,0,66,66,0,1,0,1,0,drop
58754,445,0,0,66,66,0,1,0,1,0,drop
58753,445,0,0,66,66,0,1,0,1,0,drop
43724,35440,0,0,146,146,0,1,0,1,0,deny
443,60496,0,0,320,320,0,1,0,1,0,deny
59147,51505,0,0,62,62,0,1,0,1,0,deny
58504,445,0,0,70,70,0,1,0,1,0,drop
12031,36237,0,0,66,66,0,1,0,1,0,deny
52650,44847,0,0,66,66,0,1,0,1,0,deny
16377,21247,0,0,62,62,0,1,0,1,0,deny
58686,18375,0,0,66,66,0,1,0,1,0,deny
40005,36237,0,0,62,62,0,1,0,1,0,deny
58503,445,0,0,70,70,0,1,0,1,0,drop
58502,445,0,0,70,70,0,1,0,1,0,drop
58501,445,0,0,70,70,0,1,0,1,0,drop
58497,445,0,0,70,70,0,1,0,1,0,drop
58499,445,0,0,70,70,0,1,0,1,0,drop
59095,57470,0,0,66,66,0,1,0,1,0,deny
43129,15503,0,0,62,62,0,1,0,1,0,deny
61008,5555,0,0,60,60,0,1,0,1,0,deny
61147,22114,0,0,62,62,0,1,0,1,0,deny
56186,57470,0,0,62,62,0,1,0,1,0,deny
23900,64147,0,0,62,62,0,1,0,1,0,deny
1054,57470,0,0,62,62,0,1,0,1,0,deny
63360,445,0,0,70,70,0,1,0,1,0,drop
63358,445,0,0,70,70,0,1,0,1,0,drop
63352,445,0,0,70,70,0,1,0,1,0,drop
63348,445,0,0,70,70,0,1,0,1,0,drop
57368,7302,0,0,66,66,0,1,0,1,0,deny
51300,64147,0,0,62,62,0,1,0,1,0,deny
61744,11392,0,0,66,66,0,1,0,1,0,deny
58483,445,0,0,70,70,0,1,0,1,0,drop
58741,445,0,0,66,66,0,1,0,1,0,drop
58739,445,0,0,66,66,0,1,0,1,0,drop
58738,445,0,0,66,66,0,1,0,1,0,drop
58482,445,0,0,70,70,0,1,0,1,0,drop
58476,445,0,0,70,70,0,1,0,1,0,drop
64237,51505,0,0,66,66,0,1,0,1,0,deny
58472,445,0,0,70,70,0,1,0,1,0,drop
58473,445,0,0,70,70,0,1,0,1,0,drop
51320,37965,0,0,62,62,0,1,0,1,0,deny
63527,50584,0,0,66,66,0,1,0,1,0,deny
51185,37965,0,0,62,62,0,1,0,1,0,deny
65012,2767,0,0,66,66,0,1,0,1,0,deny
14023,37965,0,0,62,62,0,1,0,1,0,deny
59985,57470,0,0,62,62,0,1,0,1,0,deny
63344,445,0,0,70,70,0,1,0,1,0,drop
64586,50584,0,0,62,62,0,1,0,1,0,deny
63343,445,0,0,70,70,0,1,0,1,0,drop
63339,445,0,0,70,70,0,1,0,1,0,drop
63334,445,0,0,70,70,0,1,0,1,0,drop
35261,15503,0,0,74,74,0,1,0,1,0,deny
13445,44847,0,0,66,66,0,1,0,1,0,deny
24281,23,0,0,60,60,0,1,0,1,0,deny
1024,44847,0,0,62,62,0,1,0,1,0,deny
10669,49756,0,0,60,60,0,1,0,1,0,deny
58461,445,0,0,70,70,0,1,0,1,0,drop
10669,49756,0,0,60,60,0,1,0,1,0,deny
10669,49756,0,0,60,60,0,1,0,1,0,deny
10669,49756,0,0,60,60,0,1,0,1,0,deny
10669,49756,0,0,60,60,0,1,0,1,0,deny
8889,9806,0,0,60,60,0,1,0,1,0,deny
57020,36237,0,0,62,62,0,1,0,1,0,deny
55009,1114,14128,1114,6562,1873,4689,25,16,15,10,allow
53737,51456,15956,51456,70,70,0,2,8,2,0,allow
443,6793,0,0,169,169,0,2,90,2,0,allow
55704,53,24414,53,170,87,83,2,30,1,1,allow
50561,80,19741,80,318,192,126,6,26,4,2,allow
50573,80,11289,80,318,192,126,6,26,4,2,allow
51231,443,6800,443,63550,10766,52784,98,131,43,55,allow
29011,7000,29011,7000,3756,2125,1631,18,17,10,8,allow
64274,53,57250,53,104,104,0,2,35,2,0,allow
50571,80,62731,80,318,192,126,6,26,4,2,allow
54034,443,22227,443,43491,8521,34970,69,50,34,35,allow
41390,443,29292,443,7240,2035,5205,25,316,12,13,allow
65350,53,19451,53,75,75,0,1,30,1,0,allow
8531,53,8531,53,213,87,126,2,30,1,1,allow
50559,80,62420,80,318,192,126,6,26,4,2,allow
29746,53,29746,53,235,90,145,2,32,1,1,allow
55517,443,55517,443,274414,45529,228885,359,170,186,173,allow
56810,53,59842,53,751,95,656,2,30,1,1,allow
37134,53,0,0,82,82,0,1,30,1,0,allow
52049,443,18143,443,7710,2476,5234,18,135,8,10,allow
6825,53,6825,53,217,87,130,2,30,1,1,allow
50254,53,7590,53,749,94,655,2,30,1,1,allow
64379,53,64379,53,235,90,145,2,33,1,1,allow
53732,22704,63994,22704,70,70,0,2,8,2,0,allow
57634,5228,55639,5228,165,105,60,2,5,1,1,allow
4083,443,26942,443,2227,1018,1209,17,16,8,9,allow
38674,80,36626,80,1114,534,580,12,16,7,5,allow
56721,53,12920,53,711,87,624,2,30,1,1,allow
47733,443,46776,443,556154,55291,500863,1146,559,440,706,allow
64603,34021,0,0,66,66,0,1,90,1,0,allow
55721,53,57546,53,170,87,83,2,31,1,1,allow
45499,443,58024,443,17031,8260,8771,39,128,19,20,allow
50572,80,10361,80,318,192,126,6,26,4,2,allow
60338,7000,60338,7000,3486,1983,1503,15,16,8,7,allow
60380,443,8139,443,70,70,0,2,8,2,0,allow
50570,80,64078,80,318,192,126,6,26,4,2,allow
40474,1488,40474,1488,156,156,0,3,8,3,0,allow
50568,80,17182,80,318,192,126,6,26,4,2,allow
50569,80,5164,80,318,192,126,6,26,4,2,allow
53137,35111,32550,35111,70,70,0,1,5,1,0,allow
50560,80,54497,80,318,192,126,6,26,4,2,allow
60930,443,60930,443,16379,2214,14165,39,18,20,19,allow
54455,443,54455,443,324001,46592,277409,409,177,203,206,allow
35061,80,46318,80,15651782,355118,15296664,15172,45,5065,10107,allow
57051,53,59033,53,711,87,624,2,30,1,1,allow
40204,40028,12239,40028,143,81,62,2,30,1,1,allow
38834,53,64506,53,168,78,90,2,30,1,1,allow
55094,53,26727,53,754,94,660,2,31,1,1,allow
56559,53,54246,53,711,87,624,2,31,1,1,allow
62293,53,18482,53,232,88,144,2,31,1,1,allow
47119,5228,18356,5228,3630,2427,1203,21,3601,11,10,allow
61938,443,24031,443,3663,1097,2566,13,136,6,7,allow
47564,5900,0,0,60,60,0,1,0,1,0,deny
10933,23,0,0,60,60,0,1,0,1,0,deny
39617,50584,0,0,62,62,0,1,0,1,0,deny
42044,60043,0,0,62,62,0,1,0,1,0,deny
16382,17500,0,0,62,62,0,1,0,1,0,deny
63325,445,0,0,70,70,0,1,0,1,0,drop
63324,445,0,0,70,70,0,1,0,1,0,drop
63322,445,0,0,70,70,0,1,0,1,0,drop
21502,44847,0,0,66,66,0,1,0,1,0,deny
58457,445,0,0,70,70,0,1,0,1,0,drop
58728,445,0,0,66,66,0,1,0,1,0,drop
47944,50584,0,0,146,146,0,1,0,1,0,deny
7226,50584,0,0,146,146,0,1,0,1,0,deny
27160,64147,0,0,66,66,0,1,0,1,0,deny
58447,445,0,0,70,70,0,1,0,1,0,drop
58446,445,0,0,70,70,0,1,0,1,0,drop
58444,445,0,0,70,70,0,1,0,1,0,drop
58443,445,0,0,70,70,0,1,0,1,0,drop
58439,445,0,0,70,70,0,1,0,1,0,drop
30135,37965,0,0,66,66,0,1,0,1,0,deny
31727,57470,0,0,62,62,0,1,0,1,0,deny
61419,57470,0,0,66,66,0,1,0,1,0,deny
59948,22114,0,0,146,146,0,1,0,1,0,deny
61451,17500,0,0,66,66,0,1,0,1,0,deny
26889,50265,0,0,66,66,0,1,0,1,0,deny
57706,64147,0,0,66,66,0,1,0,1,0,deny
61033,39004,0,0,66,66,0,1,0,1,0,deny
63318,445,0,0,70,70,0,1,0,1,0,drop
63316,445,0,0,70,70,0,1,0,1,0,drop
28009,36237,0,0,62,62,0,1,0,1,0,deny
61522,64147,0,0,62,62,0,1,0,1,0,deny
38637,22,0,0,60,60,0,1,0,1,0,deny
64824,37965,0,0,62,62,0,1,0,1,0,deny
37260,21247,0,0,66,66,0,1,0,1,0,deny
58713,445,0,0,66,66,0,1,0,1,0,drop
58710,445,0,0,66,66,0,1,0,1,0,drop
49128,18593,0,0,157,157,0,1,0,1,0,deny
58434,445,0,0,70,70,0,1,0,1,0,drop
61323,23117,0,0,146,146,0,1,0,1,0,deny
48706,23393,0,0,60,60,0,1,0,1,0,deny
63305,445,0,0,70,70,0,1,0,1,0,drop
63301,445,0,0,70,70,0,1,0,1,0,drop
49159,53,5839,53,195,86,109,2,30,1,1,allow
34642,53,34642,53,220,90,130,2,30,1,1,allow
56905,53,61024,53,239,110,129,2,30,1,1,allow
50600,80,53751,80,1658,1247,411,8,15,5,3,allow
49354,443,37956,443,22643,7456,15187,32,15,17,15,allow
56301,53,31707,53,177,94,83,2,29,1,1,allow
65171,53,52756,53,194,94,100,2,29,1,1,allow
42642,443,27903,443,6826,1804,5022,21,137,11,10,allow
50567,443,48889,443,7367,1149,6218,18,26,9,9,allow
50591,80,63944,80,318,192,126,6,25,4,2,allow
50563,443,65476,443,1313,876,437,11,26,6,5,allow
41033,443,54265,443,4974,2311,2663,29,79,15,14,allow
9137,80,35596,80,908,842,66,7,18,6,1,allow
52730,7000,52730,7000,2163,676,1487,14,15,7,7,allow
50564,443,57456,443,1313,876,437,11,26,6,5,allow
53744,10030,43880,10030,320,140,180,6,5,3,3,allow
42295,443,63348,443,9164,2473,6691,22,17,13,9,allow
53252,443,50911,443,6899,2368,4531,27,27,14,13,allow
53088,443,43774,443,161938,137946,23992,412,384,227,185,allow
57433,443,58515,443,11243,4236,7007,47,15,22,25,allow
53733,40599,57099,40599,70,70,0,2,7,2,0,allow
35292,8100,45355,8100,78,78,0,1,4,1,0,allow
50700,80,35384,80,142,142,0,1,4,1,0,allow
59470,53,45081,53,184,86,98,2,29,1,1,allow
49250,53,39996,53,225,110,115,2,29,1,1,allow
55704,53,10411,53,177,94,83,2,31,1,1,allow
40204,40002,65519,40002,148,86,62,2,30,1,1,allow
56356,53,26889,53,277,118,159,2,30,1,1,allow
57470,39113,45501,39113,14689,8867,5822,93,3051,67,26,allow
49715,53,39049,53,807,94,713,2,30,1,1,allow
50556,80,38454,80,378,192,186,7,26,4,3,allow
56854,17067,27330,17067,70,70,0,1,5,1,0,allow
47821,443,31829,443,71624,60795,10829,194,131,110,84,allow
42578,443,53109,443,3857,2757,1100,27,22,14,13,allow
58029,80,1723,80,374,192,182,7,21,4,3,allow
55457,53,12461,53,177,94,83,2,30,1,1,allow
65104,53,46686,53,311,94,217,2,30,1,1,allow
56726,53,58672,53,223,102,121,2,30,1,1,allow
55457,53,25879,53,177,94,83,2,30,1,1,allow
50557,80,9717,80,318,192,126,6,26,4,2,allow
64364,53,34718,53,323,110,213,2,30,1,1,allow
57270,53,35020,53,211,102,109,2,30,1,1,allow
51925,29587,42996,29587,70,70,0,2,8,2,0,allow
49487,53,45596,53,267,102,165,2,30,1,1,allow
50577,80,17204,80,2350,896,1454,13,25,7,6,allow
65489,443,61860,443,92240,4799,87441,107,16,43,64,allow
54985,53,45907,53,177,94,83,2,30,1,1,allow
55280,53,18692,53,258,110,148,2,30,1,1,allow
65490,443,45608,443,405489,12010,393479,416,16,146,270,allow
51195,123,46436,123,184,94,90,2,30,1,1,allow
52426,443,50838,443,782,428,354,12,28,7,5,allow
50575,80,13060,80,318,192,126,6,25,4,2,allow
50555,80,24136,80,318,192,126,6,26,4,2,allow
53648,31637,13598,31637,744,618,126,10,28,8,2,allow
43093,443,25301,443,7028,2558,4470,19,16,11,8,allow
62335,443,30924,443,73341,3336,70005,85,48,27,58,allow
41371,53,41371,53,220,90,130,2,30,1,1,allow
56613,53,57106,53,307,134,173,2,30,1,1,allow
54985,53,30088,53,177,94,83,2,30,1,1,allow
57195,53,47926,53,195,102,93,2,33,1,1,allow
41639,8080,18114,8080,78,78,0,2,8,2,0,allow
34782,443,56417,443,15321,1796,13525,26,326,11,15,allow
64838,53,23821,53,338,110,228,2,30,1,1,allow
57201,53,57201,53,220,90,130,2,30,1,1,allow
60186,53,47856,53,199,94,105,2,30,1,1,allow
50552,53,38940,53,164,78,86,2,30,1,1,allow
49195,53,13959,53,239,110,129,2,30,1,1,allow
55721,53,26269,53,177,94,83,2,30,1,1,allow
49606,53,17957,53,258,110,148,2,30,1,1,allow
57340,53,43547,53,370,94,276,2,30,1,1,allow
30188,39920,5702,39920,501,150,351,2,1200,1,1,allow
49272,53,30273,53,168,86,82,2,31,1,1,allow
53232,443,40771,443,69742,34581,35161,105,63,52,53,allow
57556,443,34647,443,7087,2587,4500,21,30,12,9,allow
33825,443,12586,443,15400,12233,3167,75,995,38,37,allow
47140,443,13289,443,7669,3355,4314,33,38,19,14,allow
50545,443,13694,443,10127,1872,8255,26,27,13,13,allow
55247,443,30780,443,9656,3460,6196,22,46,12,10,allow
50550,80,15717,80,374,192,182,7,26,4,3,allow
58512,5222,4015,5222,2834,1238,1596,26,34,13,13,allow
43837,443,18055,443,5733,1543,4190,24,28,13,11,allow
50551,80,44425,80,374,192,182,7,26,4,3,allow
49863,8100,10467,8100,78,78,0,1,4,1,0,allow
51924,28016,24796,28016,70,70,0,2,8,2,0,allow
53735,58869,2598,58869,70,70,0,2,7,2,0,allow
56724,443,8554,443,14956,2081,12875,30,20,16,14,allow
44062,443,39025,443,4614,853,3761,16,127,9,7,allow
53734,22051,59968,22051,70,70,0,2,7,2,0,allow
50261,443,64119,443,10320,3495,6825,45,136,25,20,allow
53736,37168,47120,37168,70,70,0,2,7,2,0,allow
51903,35904,40844,35904,70,70,0,1,5,1,0,allow
57436,53,11754,53,728,102,626,2,29,1,1,allow
64807,53,32139,53,246,118,128,2,29,1,1,allow
37936,443,26226,443,5463,1378,4085,16,145,10,6,allow
55754,53,48167,53,177,94,83,2,29,1,1,allow
58666,53,17306,53,167,78,89,2,29,1,1,allow
58026,80,26240,80,454,262,192,8,21,5,3,allow
59181,53,28620,53,260,86,174,2,29,1,1,allow
49962,53,32122,53,402,118,284,2,30,1,1,allow
52858,443,52858,443,313243,267937,45306,456,5925,210,246,allow
53986,443,26855,443,6734,2264,4470,19,16,11,8,allow
56682,53,9242,53,196,86,110,2,30,1,1,allow
58860,53,53609,53,209,102,107,2,29,1,1,allow
64510,53,63517,53,280,118,162,2,29,1,1,allow
60053,53,50009,53,199,94,105,2,30,1,1,allow
44921,53,22635,53,168,78,90,2,30,1,1,allow
56786,443,47874,443,36203,1763,34440,46,119,17,29,allow
52050,443,62804,443,9896,3586,6310,27,134,13,14,allow
56185,443,34268,443,5415,1730,3685,20,120,9,11,allow
3304,80,1558,80,2340,1419,921,10,15,5,5,allow
51926,58664,36241,58664,70,70,0,2,8,2,0,allow
49345,443,62638,443,26156,6762,19394,37,16,16,21,allow
50194,443,13497,443,50338,5239,45099,54,165,19,35,allow
56682,53,37640,53,168,86,82,2,30,1,1,allow
37840,53,37840,53,216,90,126,2,30,1,1,allow
38515,443,54100,443,12624,5203,7421,48,274,24,24,allow
40204,40027,54251,40027,245,182,63,2,30,1,1,allow
55721,53,41720,53,177,94,83,2,30,1,1,allow
57309,53,41723,53,316,110,206,2,30,1,1,allow
49715,53,16817,53,184,94,90,2,30,1,1,allow
6333,53,6333,53,216,90,126,2,30,1,1,allow
55475,443,50971,443,8714,1456,7258,25,32,13,12,allow
39154,80,25294,80,1504,926,578,15,36,9,6,allow
50540,80,53400,80,2175,1539,636,13,27,8,5,allow
50582,443,54824,443,7453,1467,5986,19,25,10,9,allow
50553,80,13843,80,378,192,186,7,26,4,3,allow
50554,80,7103,80,378,192,186,7,26,4,3,allow
50558,80,10581,80,318,192,126,6,26,4,2,allow
51904,51883,50262,51883,70,70,0,1,5,1,0,allow
65003,53,32396,53,94,94,0,1,30,1,0,allow
57195,53,17608,53,195,102,93,2,30,1,1,allow
53105,53,53105,53,216,90,126,2,30,1,1,allow
65509,53,55791,53,321,102,219,2,30,1,1,allow
47625,53,55385,53,168,78,90,2,30,1,1,allow
36194,443,29201,443,5674,1556,4118,23,271,13,10,allow
50574,80,28738,80,318,192,126,6,25,4,2,allow
64430,53,25685,53,245,118,127,2,30,1,1,allow
6929,53,6929,53,197,90,107,2,30,1,1,allow
64913,53,34114,53,211,102,109,2,30,1,1,allow
60873,443,46332,443,4265,1678,2587,21,142,10,11,allow
15503,63684,7728,63684,481,150,331,2,1200,1,1,allow
60355,443,30669,443,5341,2434,2907,19,135,9,10,allow
34912,443,42889,443,36366,2297,34069,51,139,21,30,allow
6882,9220,16555,9220,654,150,504,3,1200,1,2,allow
44847,30066,30079,30066,150,150,0,1,1200,1,0,allow
45423,80,20264,80,2259,1830,429,11,150,6,5,allow
61886,443,1075,443,8829,3335,5494,16,126,9,7,allow
55286,53,26564,53,268,87,181,4,35,2,2,allow
63899,62015,4677,62015,66,66,0,2,8,2,0,allow
56914,53,35890,53,100,100,0,2,35,2,0,allow
51457,443,49898,443,642,582,60,2,15,1,1,allow
53713,26085,40044,26085,70,70,0,1,5,1,0,allow
51976,443,51253,443,14912,9611,5301,36,57,21,15,allow
36756,443,3567,443,6112,1553,4559,18,16,10,8,allow
1100,27540,53473,27540,132,70,62,2,30,1,1,allow
37434,443,37114,443,11113,2993,8120,26,143,14,12,allow
52043,443,36100,443,7847,1904,5943,21,361,10,11,allow
53729,40721,59100,40721,70,70,0,2,8,2,0,allow
55740,8060,53740,8060,70,70,0,1,5,1,0,allow
55286,53,17426,53,268,87,181,4,35,2,2,allow
50052,53,23158,53,789,102,687,2,30,1,1,allow
64805,53,48699,53,278,102,176,2,31,1,1,allow
63297,445,0,0,70,70,0,1,0,1,0,drop
63296,445,0,0,70,70,0,1,0,1,0,drop
43578,15503,0,0,74,74,0,1,0,1,0,deny
58426,445,0,0,70,70,0,1,0,1,0,drop
58708,445,0,0,66,66,0,1,0,1,0,drop
23197,44847,0,0,146,146,0,1,0,1,0,deny
58425,445,0,0,70,70,0,1,0,1,0,drop
58700,445,0,0,66,66,0,1,0,1,0,drop
58692,445,0,0,66,66,0,1,0,1,0,drop
58698,445,0,0,66,66,0,1,0,1,0,drop
58690,445,0,0,66,66,0,1,0,1,0,drop
58702,445,0,0,66,66,0,1,0,1,0,drop
58691,445,0,0,66,66,0,1,0,1,0,drop
58701,445,0,0,66,66,0,1,0,1,0,drop
60361,57470,0,0,62,62,0,1,0,1,0,deny
1530,62413,0,0,62,62,0,1,0,1,0,deny
35154,42707,0,0,62,62,0,1,0,1,0,deny
62348,30349,0,0,148,148,0,1,0,1,0,deny
63291,445,0,0,70,70,0,1,0,1,0,drop
54016,42707,0,0,66,66,0,1,0,1,0,deny
58420,445,0,0,70,70,0,1,0,1,0,drop
63289,445,0,0,70,70,0,1,0,1,0,drop
63288,445,0,0,70,70,0,1,0,1,0,drop
63286,445,0,0,70,70,0,1,0,1,0,drop
58418,445,0,0,70,70,0,1,0,1,0,drop
443,60496,0,0,320,320,0,1,0,1,0,deny
27528,35440,0,0,62,62,0,1,0,1,0,deny
40512,57470,0,0,74,74,0,1,0,1,0,deny
61135,50265,0,0,62,62,0,1,0,1,0,deny
61150,11392,0,0,62,62,0,1,0,1,0,deny
51401,6881,0,0,62,62,0,1,0,1,0,deny
58414,445,0,0,70,70,0,1,0,1,0,drop
13559,57866,0,0,66,66,0,1,0,1,0,deny
58413,445,0,0,70,70,0,1,0,1,0,drop
63284,445,0,0,70,70,0,1,0,1,0,drop
63280,445,0,0,70,70,0,1,0,1,0,drop
63278,445,0,0,70,70,0,1,0,1,0,drop
21034,50265,0,0,66,66,0,1,0,1,0,deny
58685,445,0,0,66,66,0,1,0,1,0,drop
48388,44847,0,0,62,62,0,1,0,1,0,deny
51535,44847,0,0,62,62,0,1,0,1,0,deny
63276,445,0,0,70,70,0,1,0,1,0,drop
58682,445,0,0,66,66,0,1,0,1,0,drop
6338,23117,0,0,66,66,0,1,0,1,0,deny
64815,37965,0,0,66,66,0,1,0,1,0,deny
56367,44847,0,0,66,66,0,1,0,1,0,deny
58678,445,0,0,66,66,0,1,0,1,0,drop
58680,445,0,0,66,66,0,1,0,1,0,drop
53835,62413,0,0,62,62,0,1,0,1,0,deny
57964,44847,0,0,62,62,0,1,0,1,0,deny
58676,445,0,0,66,66,0,1,0,1,0,drop
58408,445,0,0,70,70,0,1,0,1,0,drop
26642,57470,0,0,62,62,0,1,0,1,0,deny
48676,53389,0,0,60,60,0,1,0,1,0,deny
58338,3369,0,0,60,60,0,1,0,1,0,deny
24874,55108,0,0,145,145,0,1,0,1,0,deny
56794,46824,0,0,66,66,0,1,0,1,0,deny
63272,445,0,0,70,70,0,1,0,1,0,drop
63266,445,0,0,70,70,0,1,0,1,0,drop
63265,445,0,0,70,70,0,1,0,1,0,drop
46516,57470,0,0,62,62,0,1,0,1,0,deny
58665,445,0,0,66,66,0,1,0,1,0,drop
58395,445,0,0,70,70,0,1,0,1,0,drop
13408,44847,0,0,66,66,0,1,0,1,0,deny
3047,50584,0,0,62,62,0,1,0,1,0,deny
45908,33330,0,0,60,60,0,1,0,1,0,deny
58392,445,0,0,70,70,0,1,0,1,0,drop
58658,445,0,0,66,66,0,1,0,1,0,drop
63248,445,0,0,70,70,0,1,0,1,0,drop
4935,3389,0,0,66,66,0,1,0,1,0,deny
56869,17637,0,0,66,66,0,1,0,1,0,deny
58655,445,0,0,66,66,0,1,0,1,0,drop
6889,7363,0,0,143,143,0,1,0,1,0,deny
58387,445,0,0,70,70,0,1,0,1,0,drop
443,60496,0,0,320,320,0,1,0,1,0,deny
49958,36829,0,0,66,66,0,1,0,1,0,deny
58386,445,0,0,70,70,0,1,0,1,0,drop
13285,29892,0,0,145,145,0,1,0,1,0,deny
0,0,0,0,480,244,236,4,0,2,2,allow
58384,445,0,0,70,70,0,1,0,1,0,drop
55966,35440,0,0,66,66,0,1,0,1,0,deny
58648,445,0,0,66,66,0,1,0,1,0,drop
12951,50584,0,0,66,66,0,1,0,1,0,deny
62089,8604,0,0,62,62,0,1,0,1,0,deny
58642,445,0,0,66,66,0,1,0,1,0,drop
47063,15503,0,0,146,146,0,1,0,1,0,deny
55835,62413,0,0,66,66,0,1,0,1,0,deny
8103,65473,0,0,157,157,0,1,0,1,0,deny
16330,50584,0,0,62,62,0,1,0,1,0,deny
58582,50584,0,0,66,66,0,1,0,1,0,deny
13160,7905,0,0,62,62,0,1,0,1,0,deny
25620,50432,0,0,146,146,0,1,0,1,0,deny
51581,17546,0,0,62,62,0,1,0,1,0,deny
36579,30188,0,0,66,66,0,1,0,1,0,deny
58377,445,0,0,70,70,0,1,0,1,0,drop
63239,445,0,0,70,70,0,1,0,1,0,drop
63237,445,0,0,70,70,0,1,0,1,0,drop
63236,445,0,0,70,70,0,1,0,1,0,drop
58375,445,0,0,70,70,0,1,0,1,0,drop
58629,445,0,0,66,66,0,1,0,1,0,drop
58633,445,0,0,66,66,0,1,0,1,0,drop
58628,445,0,0,66,66,0,1,0,1,0,drop
58632,445,0,0,66,66,0,1,0,1,0,drop
58631,445,0,0,66,66,0,1,0,1,0,drop
58630,445,0,0,66,66,0,1,0,1,0,drop
58627,445,0,0,66,66,0,1,0,1,0,drop
58625,445,0,0,66,66,0,1,0,1,0,drop
44821,64147,0,0,62,62,0,1,0,1,0,deny
6881,6881,0,0,146,146,0,1,0,1,0,deny
58374,445,0,0,70,70,0,1,0,1,0,drop
13963,50584,0,0,66,66,0,1,0,1,0,deny
58373,445,0,0,70,70,0,1,0,1,0,drop
58372,445,0,0,70,70,0,1,0,1,0,drop
59694,50584,0,0,66,66,0,1,0,1,0,deny
58367,445,0,0,70,70,0,1,0,1,0,drop
58366,445,0,0,70,70,0,1,0,1,0,drop
1026,64147,0,0,62,62,0,1,0,1,0,deny
19875,30170,0,0,145,145,0,1,0,1,0,deny
1187,64147,0,0,66,66,0,1,0,1,0,deny
27947,26467,0,0,66,66,0,1,0,1,0,deny
443,60496,0,0,187,187,0,1,0,1,0,deny
27844,52700,0,0,74,74,0,1,0,1,0,deny
60374,57470,0,0,62,62,0,1,0,1,0,deny
26254,56205,0,0,66,66,0,1,0,1,0,deny
60374,57470,0,0,145,145,0,1,0,1,0,deny
63234,445,0,0,70,70,0,1,0,1,0,drop
63228,445,0,0,70,70,0,1,0,1,0,drop
63226,445,0,0,70,70,0,1,0,1,0,drop
63220,445,0,0,70,70,0,1,0,1,0,drop
58353,445,0,0,70,70,0,1,0,1,0,drop
58352,445,0,0,70,70,0,1,0,1,0,drop
58349,445,0,0,70,70,0,1,0,1,0,drop
63589,44847,0,0,62,62,0,1,0,1,0,deny
12242,51221,0,0,62,62,0,1,0,1,0,deny
51114,443,50404,443,10301,4593,5708,21,121,10,11,allow
65114,53,6427,53,253,87,166,4,31,2,2,allow
56568,53,15733,53,711,87,624,2,30,1,1,allow
42279,443,42279,443,3414,1979,1435,22,69,11,11,allow
42278,443,42278,443,1916,1121,795,19,69,10,9,allow
56280,53,50135,53,1335,87,1248,4,59,2,2,allow
39672,443,58171,443,6540,5046,1494,19,115,12,7,allow
55286,53,19401,53,268,87,181,4,35,2,2,allow
49295,53,50273,53,280,96,184,4,34,2,2,allow
56007,53,3946,53,99,99,0,1,30,1,0,allow
56896,53,19605,53,256,87,169,2,30,1,1,allow
57470,62348,3608,62348,149,149,0,1,1200,1,0,allow
37035,443,37035,443,4510,1603,2907,19,28,11,8,allow
59530,53,58720,53,578,286,292,9,15,5,4,allow
54086,443,46250,443,4982,2205,2777,46,61,24,22,allow
58908,443,56510,443,6278402,111931,6166471,5306,1119,732,4574,allow
64303,53,50389,53,253,87,166,4,31,2,2,allow
51870,443,29475,443,4375,1230,3145,16,26,8,8,allow
18063,53,18063,53,219,87,132,2,30,1,1,allow
9084,53,9084,53,224,88,136,2,30,1,1,allow
56214,53,17373,53,200,102,98,2,30,1,1,allow
55075,53,29760,53,178,91,87,2,30,1,1,allow
37965,33738,46824,33738,1548,265,1283,4,1200,2,2,allow
55457,443,46084,443,8447,2129,6318,26,250,15,11,allow
9189,443,50417,443,4941,429,4512,12,15,6,6,allow
9188,443,11737,443,5955,728,5227,17,15,8,9,allow
38366,15000,19494,15000,130,70,60,2,6,1,1,allow
55060,80,45377,80,1289,724,565,11,26,6,5,allow
50283,443,36964,443,290,142,148,5,11,3,2,allow
45847,443,35477,443,1134,490,644,18,42,8,10,allow
5588,5588,0,0,3354,1792,1562,46,193,23,23,allow
51800,443,3294,443,36048,2364,33684,54,28,23,31,allow
38163,53,38163,53,216,89,127,2,30,1,1,allow
50460,53,9714,53,751,95,656,2,30,1,1,allow
58605,443,40025,443,3301,1240,2061,14,135,7,7,allow
55168,53,23617,53,816,97,719,2,31,1,1,allow
24985,443,23171,443,2227,1018,1209,17,15,8,9,allow
9190,443,45715,443,4943,429,4514,12,15,6,6,allow
56631,80,27363,80,61771,2713,59058,80,45,35,45,allow
48982,15000,10476,15000,130,70,60,2,5,1,1,allow
51899,47537,11729,47537,66,66,0,1,5,1,0,allow
64664,53,51475,53,168,86,82,2,34,1,1,allow
49569,53,48621,53,91,91,0,2,37,2,0,allow
60957,443,60957,443,70839,5466,65373,98,19,47,51,allow
40786,53,0,0,82,82,0,1,30,1,0,allow
65026,53,20362,53,188,96,92,2,30,1,1,allow
54653,53,54653,53,231,90,141,2,30,1,1,allow
49788,53,44900,53,196,100,96,2,30,1,1,allow
53727,53,60009,53,172,72,100,2,30,1,1,allow
35154,60038,0,0,66,66,0,1,91,1,0,allow
61939,443,12700,443,3698,1049,2649,13,135,6,7,allow
39473,443,53063,443,9590,3811,5779,20,122,10,10,allow
56835,53,37097,53,170,87,83,2,31,1,1,allow
27988,40002,58461,40002,144,82,62,2,31,1,1,allow
8881,443,2247,443,27459,19126,8333,67,402,30,37,allow
27988,40034,46189,40034,141,79,62,2,31,1,1,allow
27988,40023,43847,40023,143,81,62,2,31,1,1,allow
58342,445,0,0,70,70,0,1,0,1,0,drop
58343,445,0,0,70,70,0,1,0,1,0,drop
58612,445,0,0,66,66,0,1,0,1,0,drop
58611,445,0,0,66,66,0,1,0,1,0,drop
58610,445,0,0,66,66,0,1,0,1,0,drop
31974,51505,0,0,66,66,0,1,0,1,0,deny
53971,50265,0,0,62,62,0,1,0,1,0,deny
55733,51505,0,0,66,66,0,1,0,1,0,deny
10416,64147,0,0,62,62,0,1,0,1,0,deny
7166,64147,0,0,66,66,0,1,0,1,0,deny
5222,21212,0,0,66,66,0,1,0,1,0,deny
47365,10387,0,0,159,159,0,1,0,1,0,deny
443,60496,0,0,187,187,0,1,0,1,0,deny
2170,43227,0,0,62,62,0,1,0,1,0,deny
63217,445,0,0,70,70,0,1,0,1,0,drop
51918,27015,0,0,67,67,0,1,0,1,0,deny
63214,445,0,0,70,70,0,1,0,1,0,drop
63210,445,0,0,70,70,0,1,0,1,0,drop
56509,53,49839,53,1165,94,1071,2,30,1,1,allow
23338,53,23338,53,242,98,144,2,30,1,1,allow
64813,53,46374,53,177,94,83,2,30,1,1,allow
55872,123,4281,123,184,94,90,2,30,1,1,allow
56590,53,44528,53,305,94,211,2,30,1,1,allow
50653,80,33144,80,124643,7017,117626,163,21,75,88,allow
57062,80,49519,80,864,507,357,8,38,5,3,allow
56640,80,54626,80,234,234,0,4,11,4,0,allow
50412,80,11804,80,22200,11865,10335,38,86,24,14,allow
60473,443,60473,443,18018,4407,13611,36,100,19,17,allow
65479,53,45836,53,728,102,626,2,29,1,1,allow
65095,53,43220,53,718,94,624,2,30,1,1,allow
46763,443,11187,443,11876848,256539,11620309,11266,74,3584,7682,allow
33893,80,46490,80,1376,788,588,10,23,6,4,allow
51853,80,50403,80,4903,4061,842,11,26,6,5,allow
55022,80,15142,80,1080714,29230,1051484,1137,174,436,701,allow
63906,36909,30978,36909,66,66,0,2,7,2,0,allow
50576,80,30685,80,4189,1691,2498,16,24,9,7,allow
42281,443,42281,443,1530,817,713,17,68,9,8,allow
58021,80,10301,80,318,192,126,6,20,4,2,allow
51090,80,51090,80,19837,2061,17776,30,21,14,16,allow
56694,53,2840,53,427,88,339,4,55,2,2,allow
55249,443,62038,443,3056958,73055,2983903,3016,43,1023,1993,allow
53730,37096,47492,37096,70,70,0,2,7,2,0,allow
64559,53,32115,53,193,102,91,2,29,1,1,allow
55313,53,17189,53,198,94,104,2,29,1,1,allow
57086,53,59882,53,228,102,126,2,29,1,1,allow
55780,53,61304,53,322,134,188,2,29,1,1,allow
65327,53,49765,53,822,102,720,2,29,1,1,allow
50565,53,50708,53,707,94,613,2,30,1,1,allow
64413,53,4808,53,209,102,107,2,30,1,1,allow
65026,53,1071,53,194,102,92,2,30,1,1,allow
57330,53,57913,53,177,94,83,2,30,1,1,allow
51921,37744,59756,37744,70,70,0,2,8,2,0,allow
49538,53,59762,53,754,94,660,2,30,1,1,allow
49937,53,46761,53,718,94,624,2,30,1,1,allow
64361,53,3934,53,194,94,100,2,30,1,1,allow
48553,443,14731,443,49428,2702,46726,70,136,30,40,allow
50265,49083,4910,49083,132,132,0,3,1200,3,0,allow
64868,53,56069,53,216,102,114,2,30,1,1,allow
51920,32678,45180,32678,70,70,0,2,8,2,0,allow
56138,53,23162,53,177,94,83,2,30,1,1,allow
42853,443,44169,443,130,70,60,3,5,2,1,allow
63885,6969,58102,6969,70,70,0,1,5,1,0,allow
57377,53,26653,53,2235,93,2142,4,30,2,2,allow
58824,53,47620,53,358,96,262,4,50,2,2,allow
37297,443,46820,443,232,172,60,3,5,2,1,allow
56579,443,24024,443,23150,13858,9292,52,49,32,20,allow
50754,443,43460,443,10133,2663,7470,35,255,18,17,allow
56206,53,31271,53,211,102,109,2,30,1,1,allow
40001,53,40001,53,218,90,128,2,30,1,1,allow
35556,443,19765,443,2988,1649,1339,17,255,9,8,allow
55059,80,26318,80,306,180,126,6,26,4,2,allow
64647,53,15086,53,718,94,624,2,30,1,1,allow
50199,443,58943,443,8641,2459,6182,22,16,12,10,allow
58024,80,1081,80,318,192,126,6,20,4,2,allow
49461,53,60884,53,314,102,212,2,30,1,1,allow
20495,53,20495,53,217,90,127,2,30,1,1,allow
55007,443,50452,443,9726,4743,4983,41,15,24,17,allow
39057,53,39057,53,222,90,132,2,30,1,1,allow
55442,53,42681,53,177,94,83,2,30,1,1,allow
37614,53,37614,53,209,98,111,2,30,1,1,allow
55300,53,49492,53,308,94,214,2,30,1,1,allow
57377,53,64833,53,1165,94,1071,2,30,1,1,allow
49558,53,18984,53,177,94,83,2,30,1,1,allow
47213,443,42653,443,8166,2498,5668,16,120,8,8,allow
49857,443,44578,443,18811,1868,16943,22,139,7,15,allow
49558,53,29414,53,177,94,83,2,30,1,1,allow
55057,80,24701,80,306,180,126,6,26,4,2,allow
49448,80,49448,80,3193,2163,1030,17,79,10,7,allow
41738,53,43971,53,168,78,90,2,30,1,1,allow
49930,53,6830,53,361,94,267,2,30,1,1,allow
51274,24399,41569,24399,70,70,0,2,8,2,0,allow
51686,80,25444,80,45058,2444,42614,90,52,33,57,allow
49554,443,54292,443,10104,2646,7458,28,186,14,14,allow
63924,53,40615,53,214,102,112,2,30,1,1,allow
50265,45682,34420,45682,330,330,0,6,1200,6,0,allow
49509,443,14742,443,17660,7465,10195,44,201,23,21,allow
51459,443,47605,443,379,259,120,4,16,2,2,allow
44011,443,64228,443,1056,569,487,10,78,6,4,allow
47879,443,13971,443,37598,2397,35201,53,239,22,31,allow
49489,443,58403,443,3170,977,2193,13,135,6,7,allow
56580,443,8692,443,20897,11903,8994,52,49,30,22,allow
51500,443,60787,443,451,259,192,5,23,2,3,allow
59618,443,47989,443,5682,1562,4120,23,61,13,10,allow
55657,53,56154,53,101,101,0,2,34,2,0,allow
63898,13205,16525,13205,66,66,0,2,7,2,0,allow
53714,6882,41499,6882,70,70,0,1,4,1,0,allow
63904,18268,47003,18268,66,66,0,2,7,2,0,allow
42934,443,24809,443,232,172,60,3,5,2,1,allow
55075,53,54293,53,181,94,87,2,33,1,1,allow
55246,443,12271,443,6144,1810,4334,18,45,11,7,allow
56415,443,20835,443,6032,1722,4310,22,117,13,9,allow
49788,53,45773,53,198,102,96,2,33,1,1,allow
58016,80,61881,80,378,192,186,7,21,4,3,allow
53710,27935,34512,27935,70,70,0,1,4,1,0,allow
51802,443,43953,443,4976,1826,3150,19,151,9,10,allow
65317,53,60723,53,195,102,93,2,29,1,1,allow
64559,53,14656,53,816,102,714,2,29,1,1,allow
54833,443,46650,443,3894,969,2925,20,153,9,11,allow
42860,80,52081,80,1346,842,504,13,123,8,5,allow
56363,2710,2278,2710,1222,747,475,10,25,5,5,allow
55721,53,12194,53,177,94,83,2,29,1,1,allow
7954,53,7954,53,226,90,136,2,29,1,1,allow
61980,53,64563,53,374,104,270,4,50,2,2,allow
64969,53,18068,53,329,118,211,2,30,1,1,allow
64408,53,53381,53,199,94,105,2,29,1,1,allow
50207,53,4187,53,195,102,93,2,29,1,1,allow
65113,53,56187,53,232,102,130,2,29,1,1,allow
64813,53,49645,53,177,94,83,2,30,1,1,allow
26180,53,26180,53,245,98,147,2,30,1,1,allow
41093,53,34774,53,78,78,0,1,30,1,0,allow
48565,53,48565,53,197,90,107,2,30,1,1,allow
57330,53,61035,53,177,94,83,2,30,1,1,allow
10844,53,10844,53,222,90,132,2,30,1,1,allow
49272,53,51922,53,266,94,172,2,30,1,1,allow
49841,53,36944,53,227,110,117,2,30,1,1,allow
36476,5228,61709,5228,21282,7311,13971,96,1216,47,49,allow
55774,443,58031,443,6092,3093,2999,16,120,8,8,allow
43092,443,2375,443,7011,2541,4470,19,15,11,8,allow
49569,53,65331,53,181,94,87,2,32,1,1,allow
35623,443,1828,443,9685,2504,7181,26,153,11,15,allow
35441,5222,17710,5222,10854,4776,6078,80,119,41,39,allow
64670,53,9827,53,183,86,97,2,30,1,1,allow
49741,53,44929,53,177,94,83,2,30,1,1,allow
64449,53,62626,53,249,94,155,2,30,1,1,allow
38941,443,59649,443,13623,2693,10930,22,123,10,12,allow
50489,443,43121,443,8389,1077,7312,24,140,12,12,allow
44719,80,51210,80,1998,1422,576,10,15,6,4,allow
62843,53,62843,53,235,90,145,2,32,1,1,allow
56214,53,46867,53,200,102,98,2,33,1,1,allow
51503,443,56151,443,887,635,252,7,23,3,4,allow
54828,443,7869,443,150,150,0,1,5,1,0,allow
56515,995,45992,995,2901,1472,1429,27,17,12,15,allow
57506,443,36392,443,2696,1695,1001,24,105,13,11,allow
55045,53,21912,53,261,102,159,2,30,1,1,allow
50265,35344,29716,35344,1386,1386,0,22,2342,22,0,allow
51922,18413,55909,18413,70,70,0,2,8,2,0,allow
51923,11542,38262,11542,70,70,0,2,8,2,0,allow
55286,53,22881,53,268,87,181,4,35,2,2,allow
55056,80,26189,80,306,180,126,6,26,4,2,allow
55055,80,30882,80,306,180,126,6,26,4,2,allow
50579,80,48781,80,265114,13651,251463,346,76,161,185,allow
5588,5588,0,0,3498,1872,1626,48,197,24,24,allow
49741,53,17465,53,177,94,83,2,30,1,1,allow
50223,53,39269,53,165,86,79,2,30,1,1,allow
51388,443,52372,443,20351,3359,16992,52,103,27,25,allow
50223,53,61828,53,173,94,79,2,30,1,1,allow
55442,53,12898,53,177,94,83,2,30,1,1,allow
49998,53,44432,53,94,94,0,1,30,1,0,allow
10151,31964,38746,31964,481,150,331,2,1200,1,1,allow
37965,6881,16163,6881,452,248,204,4,1199,2,2,allow
58239,80,32964,80,2444,2444,0,3,191,3,0,allow
51974,443,51489,443,11486,5080,6406,24,121,12,12,allow
47509,443,17369,443,7769,2586,5183,18,121,9,9,allow
50265,11035,48783,11035,132,132,0,3,1200,3,0,allow
37965,16881,45844,16881,448,246,202,4,1199,2,2,allow
37965,6881,34922,6881,448,246,202,4,1199,2,2,allow
51221,6881,38542,6881,469,150,319,2,1200,1,1,allow
64055,53,9885,53,265,91,174,4,37,2,2,allow
50656,443,61533,443,3815,1772,2043,18,16,10,8,allow
56138,53,22955,53,177,94,83,2,30,1,1,allow
56518,53,3673,53,177,94,83,2,31,1,1,allow
53705,30600,18470,30600,492,306,186,8,15,5,3,allow
55256,53,58019,53,79,79,0,2,35,2,0,allow
49989,443,4666,443,300,168,132,4,6,2,2,allow
44354,80,44354,80,250076,10158,239918,315,24,146,169,allow
56307,53,64603,53,168,78,90,2,30,1,1,allow
55156,53,44381,53,194,102,92,2,30,1,1,allow
60293,53,33499,53,312,78,234,2,30,1,1,allow
59932,443,1750,443,333535,35190,298345,555,285,257,298,allow
53725,57418,1375,57418,70,70,0,2,8,2,0,allow
56611,80,46294,80,4296,2076,2220,31,128,15,16,allow
56298,53,17699,53,173,94,79,2,30,1,1,allow
51189,53,6847,53,312,78,234,2,30,1,1,allow
55156,53,26617,53,194,102,92,2,31,1,1,allow
62929,443,8515,443,46033,7524,38509,103,141,49,54,allow
63206,445,0,0,70,70,0,1,0,1,0,drop
58331,445,0,0,70,70,0,1,0,1,0,drop
48420,48637,0,0,146,146,0,1,0,1,0,deny
48420,35974,0,0,146,146,0,1,0,1,0,deny
28378,56205,0,0,62,62,0,1,0,1,0,deny
27869,51221,0,0,66,66,0,1,0,1,0,deny
50116,22,0,0,60,60,0,1,0,1,0,deny
45941,23388,0,0,60,60,0,1,0,1,0,deny
9687,57470,0,0,78,78,0,1,0,1,0,deny
11066,50584,0,0,62,62,0,1,0,1,0,deny
60204,2767,0,0,66,66,0,1,0,1,0,deny
58327,445,0,0,70,70,0,1,0,1,0,drop
32845,9797,0,0,60,60,0,1,0,1,0,deny
63197,445,0,0,70,70,0,1,0,1,0,drop
63194,445,0,0,70,70,0,1,0,1,0,drop
63192,445,0,0,70,70,0,1,0,1,0,drop
50292,22114,0,0,62,62,0,1,0,1,0,deny
57799,10387,0,0,145,145,0,1,0,1,0,deny
6546,37965,0,0,62,62,0,1,0,1,0,deny
58076,21247,0,0,66,66,0,1,0,1,0,deny
57538,30188,0,0,66,66,0,1,0,1,0,deny
58599,445,0,0,66,66,0,1,0,1,0,drop
18011,44847,0,0,66,66,0,1,0,1,0,deny
6889,8055,0,0,143,143,0,1,0,1,0,deny
56521,32480,0,0,62,62,0,1,0,1,0,deny
58318,445,0,0,70,70,0,1,0,1,0,drop
58317,445,0,0,70,70,0,1,0,1,0,drop
58316,445,0,0,70,70,0,1,0,1,0,drop
23537,35253,0,0,62,62,0,1,0,1,0,deny
48420,54532,0,0,146,146,0,1,0,1,0,deny
58314,445,0,0,70,70,0,1,0,1,0,drop
56157,50584,0,0,66,66,0,1,0,1,0,deny
58311,445,0,0,70,70,0,1,0,1,0,drop
65179,44847,0,0,62,62,0,1,0,1,0,deny
443,1785,0,0,97,97,0,1,0,1,0,deny
52003,44512,0,0,66,66,0,1,0,1,0,deny
47013,44512,0,0,62,62,0,1,0,1,0,deny
50052,65008,0,0,60,60,0,1,0,1,0,deny
45682,47993,0,0,62,62,0,1,0,1,0,deny
63190,445,0,0,70,70,0,1,0,1,0,drop
34772,15503,0,0,146,146,0,1,0,1,0,deny
27089,30627,0,0,146,146,0,1,0,1,0,deny
43578,15503,0,0,74,74,0,1,0,1,0,deny
55386,32480,0,0,66,66,0,1,0,1,0,deny
34470,57470,0,0,66,66,0,1,0,1,0,deny
18904,57470,0,0,62,62,0,1,0,1,0,deny
61798,35440,0,0,66,66,0,1,0,1,0,deny
58305,445,0,0,70,70,0,1,0,1,0,drop
53208,18375,0,0,62,62,0,1,0,1,0,deny
58583,445,0,0,66,66,0,1,0,1,0,drop
58582,445,0,0,66,66,0,1,0,1,0,drop
18423,51505,0,0,66,66,0,1,0,1,0,deny
64115,2767,0,0,62,62,0,1,0,1,0,deny
41916,53,0,0,60,60,0,1,0,1,0,deny
60962,64147,0,0,66,66,0,1,0,1,0,deny
39981,57470,0,0,62,62,0,1,0,1,0,deny
40512,57470,0,0,74,74,0,1,0,1,0,deny
8999,55783,0,0,146,146,0,1,0,1,0,deny
63179,445,0,0,70,70,0,1,0,1,0,drop
58297,445,0,0,70,70,0,1,0,1,0,drop
1262,23,0,0,60,60,0,1,0,1,0,deny
58295,445,0,0,70,70,0,1,0,1,0,drop
63174,445,0,0,70,70,0,1,0,1,0,drop
63170,445,0,0,70,70,0,1,0,1,0,drop
63172,445,0,0,70,70,0,1,0,1,0,drop
17008,35440,0,0,146,146,0,1,0,1,0,deny
58580,445,0,0,66,66,0,1,0,1,0,drop
50086,57470,0,0,66,66,0,1,0,1,0,deny
59227,11392,0,0,62,62,0,1,0,1,0,deny
58022,5601,0,0,60,60,0,1,0,1,0,deny
48079,43227,0,0,62,62,0,1,0,1,0,deny
58570,445,0,0,66,66,0,1,0,1,0,drop
58574,445,0,0,66,66,0,1,0,1,0,drop
58572,445,0,0,66,66,0,1,0,1,0,drop
58567,445,0,0,66,66,0,1,0,1,0,drop
58569,445,0,0,66,66,0,1,0,1,0,drop
58568,445,0,0,66,66,0,1,0,1,0,drop
58564,445,0,0,66,66,0,1,0,1,0,drop
58290,445,0,0,70,70,0,1,0,1,0,drop
40216,50265,0,0,62,62,0,1,0,1,0,deny
58289,445,0,0,70,70,0,1,0,1,0,drop
63165,445,0,0,70,70,0,1,0,1,0,drop
63161,445,0,0,70,70,0,1,0,1,0,drop
63160,445,0,0,70,70,0,1,0,1,0,drop
63157,445,0,0,70,70,0,1,0,1,0,drop
19068,37965,0,0,62,62,0,1,0,1,0,deny
57698,64147,0,0,62,62,0,1,0,1,0,deny
39531,19473,0,0,62,62,0,1,0,1,0,deny
58285,445,0,0,70,70,0,1,0,1,0,drop
49426,57470,0,0,62,62,0,1,0,1,0,deny
45908,33330,0,0,60,60,0,1,0,1,0,deny
57131,31061,0,0,145,145,0,1,0,1,0,deny
58284,445,0,0,70,70,0,1,0,1,0,drop
10860,55108,0,0,148,148,0,1,0,1,0,deny
63153,445,0,0,70,70,0,1,0,1,0,drop
63151,445,0,0,70,70,0,1,0,1,0,drop
63149,445,0,0,70,70,0,1,0,1,0,drop
33432,5900,0,0,60,60,0,1,0,1,0,deny
58556,445,0,0,66,66,0,1,0,1,0,drop
63148,445,0,0,70,70,0,1,0,1,0,drop
58553,445,0,0,66,66,0,1,0,1,0,drop
58279,445,0,0,70,70,0,1,0,1,0,drop
53465,57470,0,0,62,62,0,1,0,1,0,deny
58552,445,0,0,66,66,0,1,0,1,0,drop
58550,445,0,0,66,66,0,1,0,1,0,drop
5223,21557,0,0,91,91,0,1,0,1,0,deny
58549,445,0,0,66,66,0,1,0,1,0,drop
57233,50934,0,0,66,66,0,1,0,1,0,deny
14923,51505,0,0,66,66,0,1,0,1,0,deny
37927,50265,0,0,66,66,0,1,0,1,0,deny
2180,63710,0,0,66,66,0,1,0,1,0,deny
60351,50584,0,0,66,66,0,1,0,1,0,deny
63147,445,0,0,70,70,0,1,0,1,0,drop
50298,37965,0,0,62,62,0,1,0,1,0,deny
51015,64147,0,0,62,62,0,1,0,1,0,deny
63137,445,0,0,70,70,0,1,0,1,0,drop
63133,445,0,0,70,70,0,1,0,1,0,drop
58791,15503,0,0,66,66,0,1,0,1,0,deny
59647,47993,0,0,66,66,0,1,0,1,0,deny
10521,15503,0,0,146,146,0,1,0,1,0,deny
62109,44847,0,0,66,66,0,1,0,1,0,deny
51996,57470,0,0,66,66,0,1,0,1,0,deny
1057,57470,0,0,62,62,0,1,0,1,0,deny
58266,445,0,0,70,70,0,1,0,1,0,drop
58537,445,0,0,66,66,0,1,0,1,0,drop
15581,46713,0,0,66,66,0,1,0,1,0,deny
58263,445,0,0,70,70,0,1,0,1,0,drop
63196,445,0,0,62,62,0,1,0,1,0,deny
61137,40740,0,0,145,145,0,1,0,1,0,deny
46409,35440,0,0,62,62,0,1,0,1,0,deny
58530,445,0,0,66,66,0,1,0,1,0,drop
63122,445,0,0,70,70,0,1,0,1,0,drop
51505,17372,0,0,62,62,0,1,0,1,0,deny
443,39851,0,0,112,112,0,1,0,1,0,deny
58259,445,0,0,70,70,0,1,0,1,0,drop
54134,64147,0,0,66,66,0,1,0,1,0,deny
58257,445,0,0,70,70,0,1,0,1,0,drop
58528,445,0,0,66,66,0,1,0,1,0,drop
51096,63710,0,0,66,66,0,1,0,1,0,deny
22390,19473,0,0,62,62,0,1,0,1,0,deny
58255,445,0,0,70,70,0,1,0,1,0,drop
53766,51505,0,0,66,66,0,1,0,1,0,deny
13484,37965,0,0,66,66,0,1,0,1,0,deny
58519,445,0,0,66,66,0,1,0,1,0,drop
11337,15503,0,0,62,62,0,1,0,1,0,deny
58510,445,0,0,66,66,0,1,0,1,0,drop
50486,56205,0,0,66,66,0,1,0,1,0,deny
29159,39004,0,0,62,62,0,1,0,1,0,deny
53608,39004,0,0,66,66,0,1,0,1,0,deny
58248,445,0,0,70,70,0,1,0,1,0,drop
41207,5900,0,0,60,60,0,1,0,1,0,deny
48840,50584,0,0,62,62,0,1,0,1,0,deny
58246,445,0,0,70,70,0,1,0,1,0,drop
50095,50584,0,0,66,66,0,1,0,1,0,deny
49981,44847,0,0,62,62,0,1,0,1,0,deny
63113,445,0,0,70,70,0,1,0,1,0,drop
63109,445,0,0,70,70,0,1,0,1,0,drop
63108,445,0,0,70,70,0,1,0,1,0,drop
25222,37965,0,0,62,62,0,1,0,1,0,deny
35408,56205,0,0,66,66,0,1,0,1,0,deny
58500,445,0,0,66,66,0,1,0,1,0,drop
58504,445,0,0,66,66,0,1,0,1,0,drop
58505,445,0,0,66,66,0,1,0,1,0,drop
27988,40029,26130,40029,140,78,62,2,30,1,1,allow
57987,3478,22536,3478,312,140,172,4,30,2,2,allow
53724,64923,33470,64923,70,70,0,2,8,2,0,allow
52425,80,64946,80,1630,918,712,12,16,7,5,allow
49483,53,49626,53,172,88,84,2,30,1,1,allow
49907,53,29279,53,308,92,216,2,30,1,1,allow
57997,80,61005,80,318,192,126,6,21,4,2,allow
63908,33945,27378,33945,312,132,180,6,7,3,3,allow
56637,53,42734,53,711,87,624,2,30,1,1,allow
55340,53,32896,53,184,94,90,2,31,1,1,allow
64251,53,51222,53,170,87,83,2,31,1,1,allow
60337,7000,60337,7000,2163,676,1487,14,16,7,7,allow
63905,19899,5860,19899,312,132,180,6,7,3,3,allow
15503,58675,42815,58675,2227,1224,1003,20,1200,11,9,allow
55924,53,5985,53,711,87,624,2,31,1,1,allow
27988,40027,35628,40027,140,78,62,2,30,1,1,allow
57987,3478,8652,3478,312,140,172,4,30,2,2,allow
48625,443,29976,443,7605,2028,5577,23,159,11,12,allow
49701,53,52830,53,488,110,378,4,32,2,2,allow
63877,51413,26586,51413,564,382,182,9,18,6,3,allow
11962,53,11962,53,194,87,107,2,30,1,1,allow
56518,53,9053,53,170,87,83,2,30,1,1,allow
53498,3389,53498,3389,3549,1594,1955,18,18,10,8,allow
59046,443,4447,443,8279,2876,5403,22,155,9,13,allow
46640,9002,46640,9002,124,60,64,2,5,1,1,allow
51349,80,65226,80,1056,682,374,10,15,6,4,allow
62346,80,27241,80,2328,580,1748,12,16,6,6,allow
49629,53,32885,53,742,88,654,2,30,1,1,allow
55156,53,61392,53,188,96,92,2,30,1,1,allow
56775,53,28683,53,170,87,83,2,30,1,1,allow
49472,53,22827,53,751,95,656,2,31,1,1,allow
45099,443,21949,443,94099,5885,88214,140,104,69,71,allow
53726,26083,18088,26083,70,70,0,2,8,2,0,allow
49453,53,4294,53,763,101,662,2,31,1,1,allow
37247,443,37247,443,4401,1494,2907,19,25,11,8,allow
56567,53,47104,53,701,88,613,2,30,1,1,allow
32854,443,34612,443,9695,4412,5283,22,172,13,9,allow
31750,53,31750,53,200,90,110,2,30,1,1,allow
50615,443,36645,443,1577,949,628,16,71,9,7,allow
53728,19442,57763,19442,320,140,180,6,7,3,3,allow
58782,53,58782,53,310,94,216,2,30,1,1,allow
57998,80,49916,80,318,192,126,6,21,4,2,allow
58007,80,40862,80,318,192,126,6,21,4,2,allow
64958,53,27605,53,216,94,122,2,30,1,1,allow
56509,53,27088,53,1164,93,1071,2,30,1,1,allow
62912,53,42026,53,214,76,138,2,30,1,1,allow
49691,53,43996,53,378,127,251,2,30,1,1,allow
27988,40022,50196,40022,146,84,62,2,30,1,1,allow
27988,40031,63445,40031,140,78,62,2,30,1,1,allow
57411,53,38630,53,711,87,624,2,31,1,1,allow
37565,443,47595,443,8553,3392,5161,25,202,13,12,allow
57470,6881,26091,6881,330,330,0,6,1201,6,0,allow
65436,53,35308,53,332,98,234,3,58,2,1,allow
55471,53,40426,53,760,97,663,2,31,1,1,allow
57195,53,29138,53,190,97,93,2,31,1,1,allow
8884,443,38785,443,5307,3288,2019,25,397,8,17,allow
54159,443,24398,443,4723,2593,2130,16,137,8,8,allow
49771,53,11315,53,728,96,632,2,31,1,1,allow
61746,443,1496,443,251,69,182,3,120,1,2,allow
37965,61872,44512,61872,1548,265,1283,4,1201,2,2,allow
55649,5228,61882,5228,5378,2359,3019,35,3786,16,19,allow
58502,445,0,0,66,66,0,1,0,1,0,drop
58503,445,0,0,66,66,0,1,0,1,0,drop
58498,445,0,0,66,66,0,1,0,1,0,drop
58501,445,0,0,66,66,0,1,0,1,0,drop
64841,6881,0,0,62,62,0,1,0,1,0,deny
58497,445,0,0,66,66,0,1,0,1,0,drop
58245,445,0,0,70,70,0,1,0,1,0,drop
58244,445,0,0,70,70,0,1,0,1,0,drop
58243,445,0,0,70,70,0,1,0,1,0,drop
58238,445,0,0,70,70,0,1,0,1,0,drop
58239,445,0,0,70,70,0,1,0,1,0,drop
21588,52700,0,0,145,145,0,1,0,1,0,deny
64546,57470,0,0,66,66,0,1,0,1,0,deny
48857,50584,0,0,66,66,0,1,0,1,0,deny
28435,23,0,0,60,60,0,1,0,1,0,deny
42731,23,0,0,60,60,0,1,0,1,0,deny
19885,64147,0,0,62,62,0,1,0,1,0,deny
35494,22114,0,0,62,62,0,1,0,1,0,deny
60720,23718,0,0,66,66,0,1,0,1,0,deny
58225,445,0,0,70,70,0,1,0,1,0,drop
58223,445,0,0,70,70,0,1,0,1,0,drop
58221,445,0,0,70,70,0,1,0,1,0,drop
10477,44847,0,0,66,66,0,1,0,1,0,deny
33896,57470,0,0,74,74,0,1,0,1,0,deny
64870,53,1765,53,200,102,98,2,33,1,1,allow
49712,53,62216,53,178,94,84,2,30,1,1,allow
60438,17148,53794,17148,70,70,0,2,8,2,0,allow
59904,53,31184,53,312,78,234,2,29,1,1,allow
58215,445,0,0,70,70,0,1,0,1,0,drop
58214,445,0,0,70,70,0,1,0,1,0,drop
13917,18033,0,0,62,62,0,1,0,1,0,deny
63104,445,0,0,70,70,0,1,0,1,0,drop
63100,445,0,0,70,70,0,1,0,1,0,drop
63095,445,0,0,70,70,0,1,0,1,0,drop
63091,445,0,0,70,70,0,1,0,1,0,drop
58483,445,0,0,66,66,0,1,0,1,0,drop
58485,445,0,0,66,66,0,1,0,1,0,drop
58484,445,0,0,66,66,0,1,0,1,0,drop
15180,26467,0,0,62,62,0,1,0,1,0,deny
62088,56205,0,0,66,66,0,1,0,1,0,deny
43700,30188,0,0,62,62,0,1,0,1,0,deny
52714,64147,0,0,62,62,0,1,0,1,0,deny
63088,445,0,0,70,70,0,1,0,1,0,drop
59236,17,0,0,60,60,0,1,0,1,0,deny
58203,445,0,0,70,70,0,1,0,1,0,drop
63086,445,0,0,70,70,0,1,0,1,0,drop
63084,445,0,0,70,70,0,1,0,1,0,drop
63082,445,0,0,70,70,0,1,0,1,0,drop
5223,21557,0,0,60,60,0,1,0,1,0,deny
62514,37807,0,0,66,66,0,1,0,1,0,deny
50674,35440,0,0,62,62,0,1,0,1,0,deny
60136,56205,0,0,62,62,0,1,0,1,0,deny
58199,445,0,0,70,70,0,1,0,1,0,drop
60855,35440,0,0,66,66,0,1,0,1,0,deny
16522,26467,0,0,66,66,0,1,0,1,0,deny
63071,445,0,0,70,70,0,1,0,1,0,drop
63069,445,0,0,70,70,0,1,0,1,0,drop
63064,445,0,0,70,70,0,1,0,1,0,drop
54742,37965,0,0,66,66,0,1,0,1,0,deny
58189,445,0,0,70,70,0,1,0,1,0,drop
58190,445,0,0,70,70,0,1,0,1,0,drop
58188,445,0,0,70,70,0,1,0,1,0,drop
58185,445,0,0,70,70,0,1,0,1,0,drop
58472,445,0,0,66,66,0,1,0,1,0,drop
9997,53,9997,53,235,90,145,2,32,1,1,allow
45052,80,23641,80,1539,553,986,10,14,6,4,allow
64303,53,30875,53,298,87,211,4,34,2,2,allow
51914,20777,59494,20777,256,136,120,5,8,3,2,allow
49988,443,12921,443,214,82,132,4,5,2,2,allow
63895,43729,42252,43729,66,66,0,2,7,2,0,allow
53723,51501,50854,51501,70,70,0,2,7,2,0,allow
53318,56648,63034,56648,672,432,240,10,142,6,4,allow
26751,443,19482,443,11513,2842,8671,31,18,15,16,allow
58044,443,46397,443,24527,2438,22089,43,329,19,24,allow
65114,53,53193,53,177,94,83,2,29,1,1,allow
65333,53,15875,53,197,94,103,2,29,1,1,allow
65026,53,61151,53,194,102,92,2,29,1,1,allow
65194,53,43835,53,181,94,87,2,29,1,1,allow
56509,53,12733,53,1165,94,1071,2,29,1,1,allow
56775,53,64956,53,177,94,83,2,29,1,1,allow
56518,53,42205,53,177,94,83,2,29,1,1,allow
24202,53,24202,53,220,90,130,2,29,1,1,allow
56835,53,60962,53,177,94,83,2,29,1,1,allow
65114,53,14258,53,177,94,83,2,29,1,1,allow
58563,53,4425,53,312,78,234,2,29,1,1,allow
27005,1308,46544,1308,855,126,729,2,30,1,1,allow
56835,53,48670,53,177,94,83,2,30,1,1,allow
60439,47783,16622,47783,70,70,0,2,8,2,0,allow
27005,1105,38006,1105,855,126,729,2,30,1,1,allow
56518,53,9121,53,177,94,83,2,30,1,1,allow
55340,53,17205,53,184,94,90,2,30,1,1,allow
27988,40017,42811,40017,148,86,62,2,30,1,1,allow
9179,443,30869,443,5731,495,5236,14,15,7,7,allow
51918,41488,54208,41488,70,70,0,2,8,2,0,allow
51898,50677,8224,50677,70,70,0,1,5,1,0,allow
58309,53,16090,53,255,86,169,2,30,1,1,allow
50596,443,51132,443,9573,1963,7610,25,72,12,13,allow
64766,53,54775,53,195,102,93,2,30,1,1,allow
58006,80,48045,80,318,192,126,6,21,4,2,allow
27005,1306,39345,1306,858,126,732,2,30,1,1,allow
38011,443,43234,443,6900,4387,2513,37,98,19,18,allow
63962,53,52393,53,483,189,294,6,85,3,3,allow
59180,53,28928,53,260,86,174,2,30,1,1,allow
59986,53,15041,53,186,86,100,2,30,1,1,allow
57987,3478,44464,3478,312,140,172,4,30,2,2,allow
59341,53,56377,53,187,78,109,2,30,1,1,allow
64877,53,52528,53,94,94,0,1,30,1,0,allow
44007,123,12438,123,184,94,90,2,30,1,1,allow
56775,53,53871,53,177,94,83,2,30,1,1,allow
49483,53,48622,53,178,94,84,2,30,1,1,allow
27005,1104,16545,1104,870,126,744,2,30,1,1,allow
27005,1106,55769,1106,903,126,777,2,30,1,1,allow
27005,1103,38860,1103,822,126,696,2,30,1,1,allow
64251,53,6102,53,177,94,83,2,30,1,1,allow
62766,443,11804,443,3370,1226,2144,13,135,6,7,allow
46556,443,5923,443,9316,1720,7596,25,16,13,12,allow
50643,443,60929,443,1512,844,668,16,64,9,7,allow
59680,80,46564,80,5762500,128192,5634308,5613,134,1854,3759,allow
59199,53,18550,53,228,94,134,2,30,1,1,allow
27988,40013,46561,40013,148,86,62,2,30,1,1,allow
27988,40027,31364,40027,148,86,62,2,30,1,1,allow
27988,40001,35761,40001,148,86,62,2,30,1,1,allow
42479,80,8740,80,696,413,283,7,15,5,2,allow
63903,56016,63323,56016,312,132,180,6,6,3,3,allow
51916,24596,6622,24596,70,70,0,2,8,2,0,allow
56860,49991,37577,49991,70,70,0,2,8,2,0,allow
60441,64337,31545,64337,70,70,0,2,8,2,0,allow
53138,15048,61968,15048,70,70,0,2,7,2,0,allow
56596,53,10703,53,194,102,92,2,31,1,1,allow
57990,80,35454,80,42086,9535,32551,48,21,19,29,allow
50652,80,2519,80,97934,5018,92916,124,20,55,69,allow
50914,443,57800,443,22211,8661,13550,173,854,77,96,allow
62985,8920,45375,8920,823,577,246,9,15,5,4,allow
49184,443,9767,443,493152,13222,479930,509,19,184,325,allow
56651,80,31520,80,11855,7269,4586,28,115,15,13,allow
64524,53,20476,53,274,94,180,4,33,2,2,allow
64086,53,31835,53,241,94,147,2,29,1,1,allow
59516,443,21075,443,9943,1882,8061,32,33,15,17,allow
50281,5223,28986,5223,208,60,148,4,11,2,2,allow
65264,53,8238,53,256,88,168,4,35,2,2,allow
55631,53,42735,53,422,96,326,4,42,2,2,allow
36368,80,60128,80,78,78,0,1,5,1,0,allow
40006,80,2393,80,7086,1841,5245,15,92,8,7,allow
48092,443,48092,443,4398,1491,2907,19,27,11,8,allow
53240,443,24615,443,46348,20067,26281,75,60,37,38,allow
56298,53,16841,53,173,94,79,2,29,1,1,allow
55340,53,11264,53,184,94,90,2,30,1,1,allow
57319,53,57319,53,198,90,108,2,29,1,1,allow
39252,53,39252,53,197,90,107,2,29,1,1,allow
39583,53,11422,53,86,86,0,1,30,1,0,allow
64303,53,57962,53,177,94,83,2,29,1,1,allow
55547,53,1923,53,339,94,245,2,30,1,1,allow
56950,53,38998,53,183,86,97,2,29,1,1,allow
64251,53,24532,53,177,94,83,2,30,1,1,allow
56775,53,45440,53,177,94,83,2,30,1,1,allow
27005,1202,59034,1202,865,126,739,2,30,1,1,allow
56896,53,21578,53,177,94,83,2,30,1,1,allow
50263,53,58515,53,771,102,669,2,30,1,1,allow
56509,53,37473,53,1165,94,1071,2,30,1,1,allow
27005,1102,43095,1102,867,126,741,2,30,1,1,allow
48831,443,51436,443,10129,5016,5113,18,120,9,9,allow
60873,53,0,0,86,86,0,1,30,1,0,allow
56583,53,58946,53,177,94,83,2,31,1,1,allow
49701,53,39669,53,197,102,95,2,31,1,1,allow
6881,60026,38643,60026,509,150,359,2,1199,1,1,allow
27988,40005,9616,40005,148,86,62,2,30,1,1,allow
27988,40003,22369,40003,148,86,62,2,30,1,1,allow
37965,44056,39211,44056,158,158,0,1,1199,1,0,allow
53760,443,58528,443,13059,3730,9329,73,3729,32,41,allow
56563,53,56693,53,177,94,83,2,30,1,1,allow
58850,443,9120,443,18715,10778,7937,39,96,16,23,allow
39978,443,47110,443,8030,7064,966,22,30,13,9,allow
60913,80,45601,80,613,539,74,7,15,6,1,allow
42862,443,59113,443,10233,2198,8035,25,81,14,11,allow
38118,443,33958,443,574857,27894,546963,745,57,346,399,allow
57098,53,51101,53,229,94,135,2,30,1,1,allow
50255,53,26984,53,199,102,97,2,30,1,1,allow
50748,443,45400,443,12166,8765,3401,52,561,25,27,allow
51983,443,27301,443,23955,4211,19744,42,46,21,21,allow
9180,443,3139,443,5731,495,5236,14,15,7,7,allow
45458,443,14560,443,7144,4917,2227,36,561,18,18,allow
64251,53,65162,53,177,94,83,2,30,1,1,allow
56038,53,33876,53,177,94,83,2,30,1,1,allow
27988,40005,15276,40005,148,86,62,2,30,1,1,allow
27988,40002,6353,40002,140,78,62,2,30,1,1,allow
50379,53,12803,53,197,102,95,2,30,1,1,allow
62723,443,17496,443,126815,114702,12113,243,86,139,104,allow
50655,80,4984,80,91198,3990,87208,113,19,49,64,allow
51917,26077,8998,26077,70,70,0,2,8,2,0,allow
51919,10298,22024,10298,70,70,0,2,8,2,0,allow
49342,443,27856,443,6944,2404,4540,21,15,10,11,allow
9178,443,33091,443,5731,495,5236,14,15,7,7,allow
58009,80,11441,80,495,192,303,6,21,4,2,allow
56896,53,58642,53,177,94,83,2,30,1,1,allow
27005,1108,29177,1108,873,126,747,2,30,1,1,allow
27005,1305,52487,1305,855,126,729,2,30,1,1,allow
57987,3478,50170,3478,312,140,172,4,30,2,2,allow
64725,53,58713,53,757,102,655,2,30,1,1,allow
50493,443,55037,443,8164,1206,6958,24,139,12,12,allow
49160,38098,52628,38098,676,367,309,6,1200,3,3,allow
27988,40006,7041,40006,148,86,62,2,30,1,1,allow
55084,53,9496,53,177,94,83,2,31,1,1,allow
26081,53,34120,53,75510,75228,282,904,90,902,2,allow
26081,53,4535,53,243667,236247,7420,2897,90,2851,46,allow
19473,12430,61068,12430,491,150,341,2,1200,1,1,allow
48412,443,30459,443,47703,2616,45087,62,120,24,38,allow
62284,443,22217,443,3419,1275,2144,13,135,6,7,allow
37965,51413,62222,51413,158,158,0,1,1200,1,0,allow
21133,39263,6580,39263,323,150,173,2,1200,1,1,allow
57094,443,45074,443,8180,2643,5537,19,121,9,10,allow
64767,443,64767,443,4507,1600,2907,19,31,11,8,allow
50603,443,4652,443,3443,2189,1254,23,72,13,10,allow
60774,40010,46436,40010,316,136,180,6,7,3,3,allow
56639,80,24086,80,234,234,0,4,12,4,0,allow
49270,443,33027,443,10367,2273,8094,43,730,22,21,allow
53702,51413,55761,51413,70,70,0,1,5,1,0,allow
49640,443,18216,443,8607,3608,4999,25,256,14,11,allow
39359,443,36397,443,46113,6913,39200,86,34,41,45,allow
37715,53,37715,53,235,90,145,2,32,1,1,allow
53449,443,9843,443,12474,4810,7664,39,66,19,20,allow
54707,443,60614,443,5826,1199,4627,21,42,11,10,allow
51927,80,21213,80,1945,1002,943,11,20,7,4,allow
49310,53,42489,53,816,102,714,2,30,1,1,allow
50447,53,27142,53,765,102,663,2,30,1,1,allow
49230,53,1845,53,168,86,82,2,31,1,1,allow
55340,53,63068,53,184,94,90,2,31,1,1,allow
58183,445,0,0,70,70,0,1,0,1,0,drop
52018,57866,0,0,66,66,0,1,0,1,0,deny
56101,57470,0,0,66,66,0,1,0,1,0,deny
63060,445,0,0,70,70,0,1,0,1,0,drop
63059,445,0,0,70,70,0,1,0,1,0,drop
41734,57470,0,0,62,62,0,1,0,1,0,deny
58176,445,0,0,70,70,0,1,0,1,0,drop
46859,50584,0,0,62,62,0,1,0,1,0,deny
11821,64147,0,0,146,146,0,1,0,1,0,deny
58457,445,0,0,66,66,0,1,0,1,0,drop
58455,445,0,0,66,66,0,1,0,1,0,drop
6721,37965,0,0,66,66,0,1,0,1,0,deny
63097,44847,0,0,62,62,0,1,0,1,0,deny
1880,57470,0,0,146,146,0,1,0,1,0,deny
6828,64322,0,0,60,60,0,1,0,1,0,deny
53260,36237,0,0,146,146,0,1,0,1,0,deny
58169,445,0,0,70,70,0,1,0,1,0,drop
58168,445,0,0,70,70,0,1,0,1,0,drop
47910,7461,0,0,60,60,0,1,0,1,0,deny
5223,21557,0,0,60,60,0,1,0,1,0,deny
5223,21557,0,0,91,91,0,1,0,1,0,deny
13287,16933,0,0,62,62,0,1,0,1,0,deny
63052,445,0,0,70,70,0,1,0,1,0,drop
26889,50265,0,0,66,66,0,1,0,1,0,deny
7968,2767,0,0,66,66,0,1,0,1,0,deny
63046,445,0,0,70,70,0,1,0,1,0,drop
63043,445,0,0,70,70,0,1,0,1,0,drop
63042,445,0,0,70,70,0,1,0,1,0,drop
61595,50939,0,0,145,145,0,1,0,1,0,deny
58450,445,0,0,66,66,0,1,0,1,0,drop
58163,445,0,0,70,70,0,1,0,1,0,drop
58161,445,0,0,70,70,0,1,0,1,0,drop
62937,30975,0,0,185,185,0,1,0,1,0,deny
58446,445,0,0,66,66,0,1,0,1,0,drop
58442,445,0,0,66,66,0,1,0,1,0,drop
58445,445,0,0,66,66,0,1,0,1,0,drop
58436,445,0,0,66,66,0,1,0,1,0,drop
58439,445,0,0,66,66,0,1,0,1,0,drop
58435,445,0,0,66,66,0,1,0,1,0,drop
58440,445,0,0,66,66,0,1,0,1,0,drop
10243,36237,0,0,62,62,0,1,0,1,0,deny
1054,57470,0,0,62,62,0,1,0,1,0,deny
45941,23386,0,0,60,60,0,1,0,1,0,deny
63036,445,0,0,70,70,0,1,0,1,0,drop
63033,445,0,0,70,70,0,1,0,1,0,drop
63032,445,0,0,70,70,0,1,0,1,0,drop
63029,445,0,0,70,70,0,1,0,1,0,drop
58157,445,0,0,70,70,0,1,0,1,0,drop
50675,56205,0,0,66,66,0,1,0,1,0,deny
62765,16933,0,0,66,66,0,1,0,1,0,deny
52914,37965,0,0,66,66,0,1,0,1,0,deny
37837,37965,0,0,62,62,0,1,0,1,0,deny
993,16279,0,0,129,129,0,1,0,1,0,deny
58155,445,0,0,70,70,0,1,0,1,0,drop
58973,57470,0,0,62,62,0,1,0,1,0,deny
52740,51505,0,0,66,66,0,1,0,1,0,deny
41756,56205,0,0,62,62,0,1,0,1,0,deny
9494,23,0,0,60,60,0,1,0,1,0,deny
63765,51221,0,0,62,62,0,1,0,1,0,deny
63027,445,0,0,70,70,0,1,0,1,0,drop
63022,445,0,0,70,70,0,1,0,1,0,drop
63026,445,0,0,70,70,0,1,0,1,0,drop
58430,445,0,0,66,66,0,1,0,1,0,drop
58151,445,0,0,70,70,0,1,0,1,0,drop
63020,445,0,0,70,70,0,1,0,1,0,drop
58426,445,0,0,66,66,0,1,0,1,0,drop
58424,445,0,0,66,66,0,1,0,1,0,drop
58422,445,0,0,66,66,0,1,0,1,0,drop
53218,56205,0,0,66,66,0,1,0,1,0,deny
35722,30188,0,0,62,62,0,1,0,1,0,deny
58420,445,0,0,66,66,0,1,0,1,0,drop
32051,37965,0,0,62,62,0,1,0,1,0,deny
63015,445,0,0,70,70,0,1,0,1,0,drop
26758,50584,0,0,66,66,0,1,0,1,0,deny
12031,36237,0,0,66,66,0,1,0,1,0,deny
63008,445,0,0,70,70,0,1,0,1,0,drop
63007,445,0,0,70,70,0,1,0,1,0,drop
65529,35440,0,0,62,62,0,1,0,1,0,deny
58138,445,0,0,70,70,0,1,0,1,0,drop
52836,36829,0,0,66,66,0,1,0,1,0,deny
58409,445,0,0,66,66,0,1,0,1,0,drop
58135,445,0,0,70,70,0,1,0,1,0,drop
57368,7302,0,0,66,66,0,1,0,1,0,deny
59563,30188,0,0,66,66,0,1,0,1,0,deny
61278,56205,0,0,66,66,0,1,0,1,0,deny
63527,50584,0,0,66,66,0,1,0,1,0,deny
58402,445,0,0,66,66,0,1,0,1,0,drop
62992,445,0,0,70,70,0,1,0,1,0,drop
58131,445,0,0,70,70,0,1,0,1,0,drop
58129,445,0,0,70,70,0,1,0,1,0,drop
45941,23388,0,0,60,60,0,1,0,1,0,deny
40005,36237,0,0,62,62,0,1,0,1,0,deny
26448,9192,0,0,145,145,0,1,0,1,0,deny
58127,445,0,0,70,70,0,1,0,1,0,drop
58399,445,0,0,66,66,0,1,0,1,0,drop
51320,37965,0,0,62,62,0,1,0,1,0,deny
14997,57470,0,0,72,72,0,1,0,1,0,deny
58392,445,0,0,66,66,0,1,0,1,0,drop
48660,21622,0,0,143,143,0,1,0,1,0,deny
58387,445,0,0,66,66,0,1,0,1,0,drop
50264,443,29730,443,430,60,370,7,24,2,5,allow
43310,80,46970,80,811,671,140,6,32,4,2,allow
14102,80,14102,80,722,300,422,11,158,5,6,allow
45846,443,37447,443,4819,829,3990,15,40,8,7,allow
57987,80,45212,80,2803,1625,1178,16,21,9,7,allow
57031,53,13224,53,711,87,624,2,30,1,1,allow
34784,53,61391,53,168,78,90,2,30,1,1,allow
55655,63670,50631,63670,70,70,0,1,5,1,0,allow
61489,443,63810,443,4624,1191,3433,23,75,14,9,allow
51964,443,28760,443,54794,16744,38050,82,71,42,40,allow
64396,53,52154,53,349,91,258,2,30,1,1,allow
61091,443,61091,443,18924,5378,13546,33,18,19,14,allow
65486,53,11134,53,760,97,663,2,30,1,1,allow
55905,53,39225,53,754,94,660,2,30,1,1,allow
56583,53,53516,53,170,87,83,2,31,1,1,allow
55508,53,1825,53,814,110,704,2,30,1,1,allow
59892,443,22013,443,1813,1004,809,16,28,8,8,allow
49712,53,29972,53,172,88,84,2,30,1,1,allow
65361,53,33877,53,760,97,663,2,30,1,1,allow
59890,443,5968,443,1401,864,537,12,28,6,6,allow
50390,53,29650,53,772,103,669,2,30,1,1,allow
55466,53,2778,53,170,87,83,2,30,1,1,allow
59887,443,6975,443,1576,973,603,14,28,7,7,allow
59891,443,7306,443,1813,1004,809,16,28,8,8,allow
50601,443,53899,443,5035,3194,1841,23,72,12,11,allow
59881,443,61673,443,302,120,182,6,31,3,3,allow
57400,443,4312,443,10169,1957,8212,26,136,11,15,allow
40309,443,48693,443,51588,40242,11346,107,418,53,54,allow
51913,52188,11778,52188,70,70,0,2,8,2,0,allow
62344,80,50382,80,1892,583,1309,12,16,6,6,allow
57843,443,8894,443,130,70,60,2,15,1,1,allow
50277,443,65171,443,268,120,148,5,11,3,2,allow
49254,53,31955,53,814,110,704,2,30,1,1,allow
49690,53,24171,53,216,110,106,2,30,1,1,allow
47994,443,47994,443,4485,1578,2907,19,28,11,8,allow
60659,443,57729,443,8175,3047,5128,26,165,12,14,allow
56596,53,38999,53,188,96,92,2,31,1,1,allow
60899,7275,19563,7275,2875,449,2426,12,16,7,5,allow
49302,443,39111,443,454,262,192,8,27,5,3,allow
59888,443,28259,443,1401,864,537,12,28,6,6,allow
59884,443,34275,443,1401,864,537,12,28,6,6,allow
56858,32330,62382,32330,70,70,0,2,8,2,0,allow
45964,59999,45964,59999,60,60,0,1,5,1,0,allow
59889,443,31832,443,1576,973,603,14,28,7,7,allow
55658,45261,61900,45261,70,70,0,1,5,1,0,allow
59885,443,10109,443,1401,864,537,12,28,6,6,allow
60884,443,60884,443,4918,1626,3292,17,17,10,7,allow
41247,80,40368,80,78,78,0,1,5,1,0,allow
50493,443,36062,443,2147464,35144,2112320,1951,72,540,1411,allow
61273,443,61273,443,8480,2451,6029,21,17,12,9,allow
49901,53,7736,53,272,122,150,2,30,1,1,allow
64857,53,57218,53,332,104,228,2,30,1,1,allow
56038,53,40412,53,170,87,83,2,30,1,1,allow
49234,53,23533,53,206,97,109,2,30,1,1,allow
49989,53,26196,53,346,111,235,2,30,1,1,allow
49690,53,35001,53,216,110,106,2,30,1,1,allow
65111,443,62828,443,3255,1259,1996,13,135,7,6,allow
57366,53,36112,53,711,87,624,2,31,1,1,allow
54956,53,35292,53,711,87,624,2,31,1,1,allow
47595,33440,0,0,106,106,0,1,61,1,0,allow
57348,443,25316,443,13048,4976,8072,40,140,18,22,allow
52850,443,50911,443,4982,3414,1568,19,362,9,10,allow
57218,53,55252,53,789,110,679,2,31,1,1,allow
49414,53,16481,53,770,102,668,2,31,1,1,allow
49929,53,13431,53,260,124,136,2,31,1,1,allow
56464,53,12940,53,170,87,83,2,31,1,1,allow
49862,53,62626,53,744,89,655,2,31,1,1,allow
50178,53,23159,53,758,96,662,2,31,1,1,allow
56420,443,5096,443,9876,5607,4269,66,122,35,31,allow
42555,443,40081,443,14262,5874,8388,31,138,15,16,allow
49191,53,32868,53,186,95,91,2,31,1,1,allow
52838,443,32099,443,207289,9233,198056,234,136,83,151,allow
22300,51505,0,0,66,66,0,1,0,1,0,deny
58922,57470,0,0,66,66,0,1,0,1,0,deny
58120,445,0,0,70,70,0,1,0,1,0,drop
4760,44847,0,0,62,62,0,1,0,1,0,deny
33627,36237,0,0,66,66,0,1,0,1,0,deny
58118,445,0,0,70,70,0,1,0,1,0,drop
60754,53,60754,53,198,90,108,2,30,1,1,allow
49300,5228,46650,5228,12589,6479,6110,172,4146,86,86,allow
52853,443,45061,443,130,70,60,2,15,1,1,allow
60943,443,53022,443,4960,896,4064,14,18,8,6,allow
49690,53,62022,53,322,110,212,4,30,2,2,allow
49690,53,31414,53,216,110,106,2,30,1,1,allow
9160,443,28992,443,5727,491,5236,14,15,7,7,allow
43934,443,29568,443,2548,1257,1291,15,416,8,7,allow
55240,443,28397,443,6902,1936,4966,22,45,11,11,allow
52802,53,8957,53,350,210,140,6,14,4,2,allow
53139,50285,41730,50285,320,140,180,6,6,3,3,allow
53721,8999,32848,8999,320,140,180,6,6,3,3,allow
38261,443,49964,443,134,60,74,3,4,2,1,allow
9136,80,1532,80,908,842,66,7,15,6,1,allow
49178,53,11567,53,822,102,720,2,29,1,1,allow
50379,53,49959,53,197,102,95,2,29,1,1,allow
57610,443,60687,443,4327,674,3653,14,25,8,6,allow
49339,80,8376,80,1467,361,1106,10,15,5,5,allow
49839,443,39363,443,17843,13076,4767,27,134,17,10,allow
54819,443,51134,443,8093,1263,6830,25,39,13,12,allow
55241,443,32846,443,8080,2630,5450,24,45,12,12,allow
54708,443,18474,443,5702,1143,4559,21,41,12,9,allow
60513,443,43919,443,9047,2015,7032,25,39,13,12,allow
54709,443,26640,443,5493,933,4560,18,41,9,9,allow
53695,21965,20178,21965,2044,1143,901,19,16,9,10,allow
52801,443,38731,443,8308,3201,5107,36,1401,19,17,allow
53704,15000,63052,15000,70,70,0,1,4,1,0,allow
57210,8525,57210,8525,138,78,60,2,5,1,1,allow
9161,443,17981,443,5658,501,5157,14,15,7,7,allow
1558,80,1558,80,6377,703,5674,13,15,6,7,allow
50650,80,8138,80,129929,6216,123713,164,21,74,90,allow
54033,443,63656,443,190,70,120,4,15,2,2,allow
49187,2710,40478,2710,70,70,0,2,7,2,0,allow
34951,443,13510,443,3308,2109,1199,30,751,16,14,allow
51961,443,43999,443,6913,1658,5255,22,17,12,10,allow
57986,443,51773,443,124014,6270,117744,175,27,69,106,allow
48740,443,37273,443,7868,2194,5674,26,36,13,13,allow
42881,443,29777,443,134,60,74,3,4,2,1,allow
51820,80,11900,80,366,240,126,7,25,5,2,allow
53703,16426,38652,16426,70,70,0,1,4,1,0,allow
60706,443,17990,443,4974,836,4138,16,40,8,8,allow
50605,443,56643,443,1766,975,791,15,71,9,6,allow
49852,53,8412,53,94,94,0,1,29,1,0,allow
64766,53,31618,53,195,102,93,2,29,1,1,allow
56835,53,56114,53,177,94,83,2,29,1,1,allow
38264,443,28661,443,134,60,74,3,4,2,1,allow
65264,53,15709,53,178,94,84,2,29,1,1,allow
55084,53,64405,53,177,94,83,2,29,1,1,allow
49230,53,46684,53,168,86,82,2,30,1,1,allow
50255,53,25168,53,199,102,97,2,29,1,1,allow
53306,53,0,0,86,86,0,1,29,1,0,allow
55656,31165,38946,31165,70,70,0,1,5,1,0,allow
40701,5223,47765,5223,5723,1105,4618,27,473,10,17,allow
44583,443,45015,443,6834,3797,3037,48,97,23,25,allow
38114,443,10061,443,863998,37140,826858,1072,61,479,593,allow
57431,53,35038,53,392,134,258,2,30,1,1,allow
55466,53,45668,53,177,94,83,2,30,1,1,allow
59654,53,16319,53,199,94,105,2,30,1,1,allow
65200,53,5141,53,214,110,104,2,30,1,1,allow
64524,53,42733,53,184,94,90,2,31,1,1,allow
9156,443,14551,443,5734,498,5236,14,15,7,7,allow
65496,53,41450,53,280,96,184,4,34,2,2,allow
49874,443,49241,443,15358,8278,7080,47,19,24,23,allow
57195,53,19593,53,195,102,93,2,33,1,1,allow
53718,1053,4101,1053,320,140,180,6,8,3,3,allow
51896,43357,20029,43357,70,70,0,1,5,1,0,allow
35570,443,53736,443,3297,2327,970,22,37,11,11,allow
55239,443,1727,443,9352,2524,6828,27,46,14,13,allow
64908,53,50064,53,812,110,702,2,30,1,1,allow
57332,53,48938,53,168,86,82,2,30,1,1,allow
64888,53,19204,53,718,94,624,2,30,1,1,allow
55659,37787,47813,37787,70,70,0,2,8,2,0,allow
64274,53,64916,53,110,110,0,1,30,1,0,allow
56583,53,7154,53,177,94,83,2,30,1,1,allow
49742,53,51185,53,216,110,106,2,30,1,1,allow
6881,63963,28408,63963,207,118,89,2,1200,1,1,allow
63988,53,36168,53,195,102,93,2,30,1,1,allow
30188,17677,54608,17677,11116,4642,6474,64,1457,30,34,allow
65200,53,50135,53,214,110,104,2,30,1,1,allow
50713,53,50713,53,198,90,108,2,30,1,1,allow
49593,5228,25502,5228,9720,2717,7003,67,1019,34,33,allow
64576,443,6624,443,8503,1969,6534,24,32,13,11,allow
43835,443,28215,443,11422,2361,9061,26,505,10,16,allow
51893,63924,1367,63924,70,70,0,1,5,1,0,allow
9167,443,11467,443,4072,434,3638,12,15,6,6,allow
56954,80,1117,80,1469,970,499,9,65,6,3,allow
49386,443,47173,443,6250,1765,4485,22,15,12,10,allow
38119,53,41188,53,199,94,105,2,30,1,1,allow
49742,53,16673,53,216,110,106,2,30,1,1,allow
49257,53,6745,53,199,102,97,2,30,1,1,allow
56596,53,31650,53,194,102,92,2,30,1,1,allow
57201,53,54960,53,173,94,79,2,30,1,1,allow
7946,23,7946,23,130,66,64,2,5,1,1,allow
64274,53,21757,53,299,104,195,4,35,2,2,allow
39350,3389,39350,3389,3910,1805,2105,20,18,12,8,allow
53699,36887,39756,36887,492,306,186,8,15,5,3,allow
53254,443,33543,443,4498,916,3582,18,17,9,9,allow
9162,443,30671,443,5658,501,5157,14,15,7,7,allow
9155,443,45491,443,5734,498,5236,14,15,7,7,allow
49698,53,53512,53,184,102,82,2,30,1,1,allow
49742,53,36313,53,216,110,106,2,30,1,1,allow
60740,443,50087,443,12605,5558,7047,42,101,18,24,allow
57554,443,18344,443,7323,2654,4669,23,30,13,10,allow
48739,443,34033,443,7107,1636,5471,24,38,11,13,allow
52892,443,14885,443,130,70,60,2,14,1,1,allow
57885,80,59656,80,32460,9354,23106,67,71,40,27,allow
48736,443,16569,443,371295,17988,353307,571,40,233,338,allow
56493,443,6298,443,10532,6786,3746,55,81,28,27,allow
53727,8999,52156,8999,320,140,180,6,5,3,3,allow
49310,53,61139,53,186,95,91,3,33,2,1,allow
51818,80,64733,80,366,240,126,7,25,5,2,allow
50642,443,51887,443,10981,2295,8686,32,63,16,16,allow
42880,443,28151,443,134,60,74,3,4,2,1,allow
51894,26116,8093,26116,70,70,0,1,5,1,0,allow
37886,443,62818,443,134,60,74,3,5,2,1,allow
49561,80,28691,80,57215,680,56535,47,135,7,40,allow
9163,443,23024,443,5658,501,5157,14,15,7,7,allow
49429,443,22034,443,990201,31101,959100,1061,192,383,678,allow
49438,443,47897,443,135574,9426,126148,201,183,102,99,allow
56707,443,1984,443,5928,1558,4370,22,20,13,9,allow
49178,53,26968,53,199,102,97,2,29,1,1,allow
56563,53,35411,53,177,94,83,2,29,1,1,allow
9157,443,57140,443,5734,498,5236,14,15,7,7,allow
49698,53,38054,53,184,102,82,2,30,1,1,allow
51897,57057,43684,57057,70,70,0,1,5,1,0,allow
50255,53,55681,53,199,102,97,2,29,1,1,allow
49257,53,51437,53,199,102,97,2,30,1,1,allow
49712,53,30095,53,178,94,84,2,29,1,1,allow
49423,443,63927,443,4287346,130607,4156739,4409,282,1473,2936,allow
33418,443,42698,443,4764,1876,2888,22,81,10,12,allow
39661,7275,31233,7275,8822,1485,7337,26,15,13,13,allow
56038,53,20578,53,177,94,83,2,29,1,1,allow
55466,53,37366,53,177,94,83,2,30,1,1,allow
49712,53,3465,53,178,94,84,2,30,1,1,allow
57201,53,44480,53,165,86,79,2,30,1,1,allow
56038,53,24286,53,177,94,83,2,30,1,1,allow
49701,53,24977,53,197,102,95,2,30,1,1,allow
51120,53,11316,53,168,78,90,2,30,1,1,allow
49713,53,44635,53,177,94,83,2,30,1,1,allow
23283,53,47679,53,344,78,266,2,30,1,1,allow
33638,443,11926,443,1784,1010,774,16,185,9,7,allow
57470,56250,44821,56250,330,330,0,6,1199,6,0,allow
37965,54777,17164,54777,158,158,0,1,1200,1,0,allow
59879,443,12932,443,302,120,182,6,32,3,3,allow
51895,17172,22553,17172,70,70,0,1,5,1,0,allow
55657,37273,52099,37273,70,70,0,1,5,1,0,allow
39796,443,39796,443,4744,1837,2907,19,27,11,8,allow
49508,53,13388,53,199,102,97,2,30,1,1,allow
56953,80,31471,80,37311,3340,33971,52,65,26,26,allow
38269,443,44100,443,130,70,60,2,15,1,1,allow
54537,80,39580,80,4096,3455,641,13,15,8,5,allow
65040,53,27133,53,256,88,168,4,32,2,2,allow
55661,49671,9206,49671,70,70,0,2,8,2,0,allow
60773,20010,34411,20010,70,70,0,2,8,2,0,allow
51674,80,17494,80,533166,22786,510380,905,50,321,584,allow
53700,45682,9190,45682,492,306,186,8,15,5,3,allow
9158,443,59645,443,5727,491,5236,14,15,7,7,allow
49713,53,37729,53,177,94,83,2,30,1,1,allow
49359,53,8497,53,216,110,106,2,30,1,1,allow
65020,443,45828,443,5507,3397,2110,13,120,7,6,allow
50583,80,64336,80,630930,27504,603426,812,74,381,431,allow
9159,443,37775,443,5727,491,5236,14,15,7,7,allow
49535,53,29045,53,771,102,669,2,30,1,1,allow
42996,53,58544,53,168,78,90,2,30,1,1,allow
57332,53,59062,53,184,102,82,2,30,1,1,allow
57389,53,29962,53,193,102,91,2,30,1,1,allow
60546,443,51628,443,52666,33941,18725,95,139,49,46,allow
63567,443,49835,443,2467,1198,1269,22,186,11,11,allow
57470,51745,40205,51745,3214,1260,1954,33,1371,17,16,allow
64410,53,61695,53,196,102,94,2,30,1,1,allow
21054,53,21054,53,216,98,118,2,30,1,1,allow
50022,53,19595,53,182,94,88,2,30,1,1,allow
63988,53,51956,53,195,102,93,2,30,1,1,allow
55503,53,56462,53,216,110,106,2,30,1,1,allow
57333,53,18124,53,342,110,232,2,30,1,1,allow
56469,53,63453,53,177,94,83,2,31,1,1,allow
56939,53,41325,53,216,110,106,2,31,1,1,allow
59090,443,47184,443,1469,702,767,20,120,10,10,allow
52339,443,45302,443,4362,1266,3096,26,129,11,15,allow
62692,443,51155,443,14518,2409,12109,23,135,10,13,allow
58056,443,56911,443,866223,30135,836088,916,138,300,616,allow
55921,443,24781,443,4348,1536,2812,14,121,6,8,allow
37965,1025,42195,1025,158,158,0,1,1200,1,0,allow
37965,6881,15418,6881,1534,248,1286,4,1200,2,2,allow
65493,443,24258,443,7975,423,7552,15,120,6,9,allow
6881,7999,34044,7999,238,118,120,2,1199,1,1,allow
57389,53,9146,53,193,102,91,2,31,1,1,allow
33748,443,24979,443,70,70,0,2,5,2,0,allow
59607,53,65103,53,209,102,107,2,30,1,1,allow
49954,53,49870,53,216,110,106,2,30,1,1,allow
55513,53,1888,53,184,94,90,2,30,1,1,allow
50375,53,64896,53,211,110,101,2,30,1,1,allow
49359,53,18321,53,216,110,106,2,30,1,1,allow
56520,53,53336,53,177,94,83,2,31,1,1,allow
63566,443,27176,443,2537,1268,1269,23,186,12,11,allow
37965,32405,17637,32405,766,248,518,4,1200,2,2,allow
28021,443,4074,443,5578,1390,4188,19,16,9,10,allow
49508,53,17731,53,199,102,97,2,30,1,1,allow
55503,53,44075,53,216,110,106,2,30,1,1,allow
49701,53,55177,53,197,102,95,2,30,1,1,allow
56388,53,20771,53,816,102,714,2,30,1,1,allow
56484,53,42861,53,214,110,104,2,31,1,1,allow
57917,6789,34924,6789,8164,1336,6828,34,18,18,16,allow
55370,443,38504,443,3055,953,2102,23,50,10,13,allow
50473,80,50473,80,78355,11395,66960,122,27,62,60,allow
26847,443,30937,443,10585,3919,6666,33,80,16,17,allow
5588,5588,0,0,3498,1872,1626,48,199,24,24,allow
55740,53,13751,53,228,110,118,2,30,1,1,allow
56413,51221,0,0,62,62,0,1,0,1,0,deny
58117,445,0,0,70,70,0,1,0,1,0,drop
62983,445,0,0,70,70,0,1,0,1,0,drop
62982,445,0,0,70,70,0,1,0,1,0,drop
62980,445,0,0,70,70,0,1,0,1,0,drop
58115,445,0,0,70,70,0,1,0,1,0,drop
58480,57470,0,0,66,66,0,1,0,1,0,deny
58375,445,0,0,66,66,0,1,0,1,0,drop
58113,445,0,0,70,70,0,1,0,1,0,drop
58377,445,0,0,66,66,0,1,0,1,0,drop
58376,445,0,0,66,66,0,1,0,1,0,drop
58112,445,0,0,70,70,0,1,0,1,0,drop
58374,445,0,0,66,66,0,1,0,1,0,drop
58373,445,0,0,66,66,0,1,0,1,0,drop
58372,445,0,0,66,66,0,1,0,1,0,drop
58371,445,0,0,66,66,0,1,0,1,0,drop
58369,445,0,0,66,66,0,1,0,1,0,drop
4419,23,0,0,60,60,0,1,0,1,0,deny
26229,21247,0,0,66,66,0,1,0,1,0,deny
39324,64147,0,0,62,62,0,1,0,1,0,deny
57706,64147,0,0,66,66,0,1,0,1,0,deny
58097,445,0,0,70,70,0,1,0,1,0,drop
58096,445,0,0,70,70,0,1,0,1,0,drop
58091,445,0,0,70,70,0,1,0,1,0,drop
28809,50584,0,0,62,62,0,1,0,1,0,deny
58086,445,0,0,70,70,0,1,0,1,0,drop
58087,445,0,0,70,70,0,1,0,1,0,drop
12465,11392,0,0,62,62,0,1,0,1,0,deny
53906,37965,0,0,62,62,0,1,0,1,0,deny
62977,445,0,0,70,70,0,1,0,1,0,drop
62976,445,0,0,70,70,0,1,0,1,0,drop
62972,445,0,0,70,70,0,1,0,1,0,drop
62965,445,0,0,70,70,0,1,0,1,0,drop
9494,23,0,0,60,60,0,1,0,1,0,deny
58356,445,0,0,66,66,0,1,0,1,0,drop
58355,445,0,0,66,66,0,1,0,1,0,drop
58354,445,0,0,66,66,0,1,0,1,0,drop
61451,17500,0,0,66,66,0,1,0,1,0,deny
16382,17500,0,0,62,62,0,1,0,1,0,deny
44554,5900,0,0,60,60,0,1,0,1,0,deny
16377,21247,0,0,62,62,0,1,0,1,0,deny
51414,22,0,0,60,60,0,1,0,1,0,deny
58075,445,0,0,70,70,0,1,0,1,0,drop
62960,445,0,0,70,70,0,1,0,1,0,drop
52655,15503,0,0,146,146,0,1,0,1,0,deny
62956,445,0,0,70,70,0,1,0,1,0,drop
62954,445,0,0,70,70,0,1,0,1,0,drop
62953,445,0,0,70,70,0,1,0,1,0,drop
17344,62413,0,0,62,62,0,1,0,1,0,deny
46286,21247,0,0,62,62,0,1,0,1,0,deny
14925,57470,0,0,145,145,0,1,0,1,0,deny
58071,445,0,0,70,70,0,1,0,1,0,drop
5462,21247,0,0,66,66,0,1,0,1,0,deny
56381,51505,0,0,62,62,0,1,0,1,0,deny
25651,48817,0,0,140,140,0,1,0,1,0,deny
40369,57470,0,0,62,62,0,1,0,1,0,deny
1044,23,0,0,60,60,0,1,0,1,0,deny
58062,445,0,0,70,70,0,1,0,1,0,drop
58061,445,0,0,70,70,0,1,0,1,0,drop
58059,445,0,0,70,70,0,1,0,1,0,drop
13559,57866,0,0,66,66,0,1,0,1,0,deny
64586,50584,0,0,62,62,0,1,0,1,0,deny
39516,23,0,0,60,60,0,1,0,1,0,deny
58058,445,0,0,70,70,0,1,0,1,0,drop
62941,445,0,0,70,70,0,1,0,1,0,drop
62938,445,0,0,70,70,0,1,0,1,0,drop
62936,445,0,0,70,70,0,1,0,1,0,drop
58054,445,0,0,70,70,0,1,0,1,0,drop
21034,50265,0,0,66,66,0,1,0,1,0,deny
58344,445,0,0,66,66,0,1,0,1,0,drop
51535,44847,0,0,62,62,0,1,0,1,0,deny
8999,57470,0,0,146,146,0,1,0,1,0,deny
64824,37965,0,0,62,62,0,1,0,1,0,deny
64815,37965,0,0,66,66,0,1,0,1,0,deny
58048,445,0,0,70,70,0,1,0,1,0,drop
39617,50584,0,0,62,62,0,1,0,1,0,deny
62935,445,0,0,70,70,0,1,0,1,0,drop
62933,445,0,0,70,70,0,1,0,1,0,drop
59626,22114,0,0,66,66,0,1,0,1,0,deny
48488,50584,0,0,62,62,0,1,0,1,0,deny
16654,50265,0,0,62,62,0,1,0,1,0,deny
58327,445,0,0,66,66,0,1,0,1,0,drop
58326,445,0,0,66,66,0,1,0,1,0,drop
58041,445,0,0,70,70,0,1,0,1,0,drop
14844,37965,0,0,62,62,0,1,0,1,0,deny
58040,445,0,0,70,70,0,1,0,1,0,drop
62396,51050,0,0,146,146,0,1,0,1,0,deny
35833,23,0,0,60,60,0,1,0,1,0,deny
12074,10197,0,0,72,72,0,1,0,1,0,deny
28899,37965,0,0,62,62,0,1,0,1,0,deny
62923,445,0,0,70,70,0,1,0,1,0,drop
58034,445,0,0,70,70,0,1,0,1,0,drop
62916,445,0,0,70,70,0,1,0,1,0,drop
62914,445,0,0,70,70,0,1,0,1,0,drop
62913,445,0,0,70,70,0,1,0,1,0,drop
58033,445,0,0,70,70,0,1,0,1,0,drop
58321,445,0,0,66,66,0,1,0,1,0,drop
47134,37965,0,0,62,62,0,1,0,1,0,deny
15933,64147,0,0,62,62,0,1,0,1,0,deny
9494,23,0,0,60,60,0,1,0,1,0,deny
11574,51505,0,0,62,62,0,1,0,1,0,deny
58313,445,0,0,66,66,0,1,0,1,0,drop
58315,445,0,0,66,66,0,1,0,1,0,drop
58318,445,0,0,66,66,0,1,0,1,0,drop
58314,445,0,0,66,66,0,1,0,1,0,drop
58311,445,0,0,66,66,0,1,0,1,0,drop
58309,445,0,0,66,66,0,1,0,1,0,drop
58308,445,0,0,66,66,0,1,0,1,0,drop
48219,55442,0,0,62,62,0,1,0,1,0,deny
58029,445,0,0,70,70,0,1,0,1,0,drop
62907,445,0,0,70,70,0,1,0,1,0,drop
62905,445,0,0,70,70,0,1,0,1,0,drop
62903,445,0,0,70,70,0,1,0,1,0,drop
62902,445,0,0,70,70,0,1,0,1,0,drop
33359,443,23934,443,9818,2036,7782,28,31,12,16,allow
9494,23,0,0,60,60,0,1,0,1,0,deny
52432,50265,0,0,66,66,0,1,0,1,0,deny
58028,445,0,0,70,70,0,1,0,1,0,drop
49958,36829,0,0,66,66,0,1,0,1,0,deny
45833,13494,0,0,60,60,0,1,0,1,0,deny
19204,48817,0,0,148,148,0,1,0,1,0,deny
0,0,0,0,320,320,0,5,0,5,0,allow
50767,57470,0,0,62,62,0,1,0,1,0,deny
12951,50584,0,0,66,66,0,1,0,1,0,deny
51592,51505,0,0,66,66,0,1,0,1,0,deny
55966,35440,0,0,66,66,0,1,0,1,0,deny
16330,50584,0,0,62,62,0,1,0,1,0,deny
52614,44847,0,0,62,62,0,1,0,1,0,deny
57849,50584,0,0,66,66,0,1,0,1,0,deny
65085,22114,0,0,66,66,0,1,0,1,0,deny
58023,445,0,0,70,70,0,1,0,1,0,drop
62900,445,0,0,70,70,0,1,0,1,0,drop
62896,445,0,0,70,70,0,1,0,1,0,drop
62895,445,0,0,70,70,0,1,0,1,0,drop
18876,44847,0,0,66,66,0,1,0,1,0,deny
58582,50584,0,0,66,66,0,1,0,1,0,deny
58301,445,0,0,66,66,0,1,0,1,0,drop
36579,30188,0,0,66,66,0,1,0,1,0,deny
62892,445,0,0,70,70,0,1,0,1,0,drop
58298,445,0,0,66,66,0,1,0,1,0,drop
58296,445,0,0,66,66,0,1,0,1,0,drop
58294,445,0,0,66,66,0,1,0,1,0,drop
9018,23,0,0,60,60,0,1,0,1,0,deny
61408,30188,0,0,62,62,0,1,0,1,0,deny
58292,445,0,0,66,66,0,1,0,1,0,drop
1035,64147,0,0,145,145,0,1,0,1,0,deny
34301,21247,0,0,146,146,0,1,0,1,0,deny
55553,37965,0,0,66,66,0,1,0,1,0,deny
58010,445,0,0,70,70,0,1,0,1,0,drop
62887,445,0,0,70,70,0,1,0,1,0,drop
62883,445,0,0,70,70,0,1,0,1,0,drop
62880,445,0,0,70,70,0,1,0,1,0,drop
46516,57470,0,0,62,62,0,1,0,1,0,deny
27844,52700,0,0,74,74,0,1,0,1,0,deny
26254,56205,0,0,66,66,0,1,0,1,0,deny
58007,445,0,0,70,70,0,1,0,1,0,drop
58282,445,0,0,66,66,0,1,0,1,0,drop
41674,5900,0,0,60,60,0,1,0,1,0,deny
57747,15000,28219,15000,130,70,60,2,6,1,1,allow
57134,53,50387,53,1425,97,1328,4,53,2,2,allow
57438,53,17355,53,782,105,677,2,30,1,1,allow
64902,53,51695,53,414,106,308,2,30,1,1,allow
50669,80,58976,80,1485,806,679,13,15,7,6,allow
55803,53,50944,53,760,97,663,2,30,1,1,allow
57315,53,60318,53,748,95,653,2,30,1,1,allow
56661,443,26302,443,18375,7252,11123,47,40,24,23,allow
53589,3389,53589,3389,3407,1518,1889,16,16,9,7,allow
53719,49306,59032,49306,70,70,0,2,8,2,0,allow
57188,53,2618,53,744,89,655,2,30,1,1,allow
49359,53,18838,53,216,110,106,2,30,1,1,allow
50475,80,50475,80,26023,3118,22905,38,24,18,20,allow
63882,49163,63966,49163,66,66,0,1,5,1,0,allow
33387,80,58397,80,9105,1930,7175,18,16,9,9,allow
64971,53,64971,53,218,85,133,2,30,1,1,allow
49257,53,2534,53,198,101,97,2,30,1,1,allow
5612,53,5612,53,227,89,138,2,30,1,1,allow
56433,53,27409,53,170,87,83,2,31,1,1,allow
50418,53,2799,53,760,96,664,2,31,1,1,allow
65387,53,24725,53,272,122,150,2,30,1,1,allow
50253,53,9014,53,756,95,661,2,30,1,1,allow
55377,53,19699,53,1428,103,1325,4,32,2,2,allow
55083,53,35659,53,216,110,106,2,30,1,1,allow
55582,53,45316,53,170,87,83,2,30,1,1,allow
64332,53,24629,53,374,96,278,4,55,2,2,allow
55513,53,5223,53,184,94,90,2,30,1,1,allow
61499,443,53254,443,15584,2626,12958,34,37,18,16,allow
65055,53,55759,53,1426,98,1328,4,55,2,2,allow
57011,53,6103,53,770,101,669,2,30,1,1,allow
51910,60443,64340,60443,70,70,0,2,8,2,0,allow
38060,443,63699,443,27679,15839,11840,75,103,39,36,allow
50476,80,50476,80,28872,5086,23786,50,24,24,26,allow
49337,53,4969,53,303,97,206,4,56,2,2,allow
57284,53,3184,53,212,108,104,2,31,1,1,allow
65419,53,10153,53,198,101,97,2,31,1,1,allow
49619,53,50189,53,789,110,679,2,30,1,1,allow
61059,80,61059,80,16824,810,16014,22,15,8,14,allow
56601,443,39654,443,8978,3243,5735,22,45,13,9,allow
57215,53,55858,53,810,108,702,2,30,1,1,allow
56390,53,2004,53,701,88,613,2,30,1,1,allow
50478,80,50478,80,28032,3868,24164,47,24,23,24,allow
56857,43237,16433,43237,70,70,0,2,8,2,0,allow
64530,53,49179,53,782,105,677,2,30,1,1,allow
49757,80,22692,80,1396,864,532,9,15,5,4,allow
64993,53,50463,53,748,95,653,2,30,1,1,allow
50005,53,45437,53,295,101,194,4,30,2,2,allow
55102,53,40717,53,190,97,93,2,30,1,1,allow
63988,53,39055,53,190,97,93,2,30,1,1,allow
61651,123,29529,123,184,94,90,2,30,1,1,allow
57389,53,59363,53,186,95,91,2,30,1,1,allow
55110,53,57772,53,770,102,668,2,30,1,1,allow
56568,53,49055,53,206,105,101,2,30,1,1,allow
49845,53,18683,53,168,86,82,2,31,1,1,allow
49777,53,49271,53,168,78,90,2,31,1,1,allow
64055,53,63061,53,178,91,87,2,31,1,1,allow
44915,443,17055,443,23886,6994,16892,26,129,12,14,allow
64880,53,46886,53,164,84,80,2,30,1,1,allow
56275,53,15148,53,164,84,80,2,31,1,1,allow
56861,53,42758,53,756,95,661,2,31,1,1,allow
49961,53,46234,53,216,110,106,2,31,1,1,allow
56939,53,50675,53,216,110,106,2,31,1,1,allow
56156,53,34308,53,711,87,624,2,31,1,1,allow
64565,53,49218,53,802,104,698,2,31,1,1,allow
61810,443,52096,443,3109,812,2297,13,136,6,7,allow
55629,53,44695,53,168,86,82,2,31,1,1,allow
56356,53,2062,53,758,96,662,2,31,1,1,allow
55633,53,26791,53,793,101,692,2,31,1,1,allow
56621,53,7810,53,760,96,664,2,31,1,1,allow
55549,53,31074,53,202,103,99,2,31,1,1,allow
56429,53,7462,53,762,98,664,2,31,1,1,allow
65115,53,30947,53,170,87,83,2,31,1,1,allow
55181,53,51083,53,815,95,720,2,31,1,1,allow
56070,53,55660,53,186,95,91,2,31,1,1,allow
56969,53,8130,53,754,94,660,2,31,1,1,allow
55357,53,12869,53,754,94,660,2,31,1,1,allow
49152,53,51402,53,206,105,101,2,31,1,1,allow
64524,53,34078,53,184,94,90,2,31,1,1,allow
64675,53,55719,53,749,94,655,2,31,1,1,allow
55010,53,38368,53,190,97,93,2,31,1,1,allow
56668,53,31919,53,198,101,97,2,31,1,1,allow
49275,53,59894,53,190,97,93,2,31,1,1,allow
37965,16253,55858,16253,5892,3784,2108,81,3115,47,34,allow
60319,53,31437,53,316,80,236,2,31,1,1,allow
50265,26512,31440,26512,480,149,331,2,1200,1,1,allow
64870,53,47029,53,200,102,98,2,31,1,1,allow
64697,53,42927,53,198,101,97,2,31,1,1,allow
57896,46783,0,0,100,100,0,1,0,1,0,deny
53234,48817,0,0,148,148,0,1,0,1,0,deny
57896,49903,0,0,100,100,0,1,0,1,0,deny
32342,62413,0,0,66,66,0,1,0,1,0,deny
45941,23386,0,0,60,60,0,1,0,1,0,deny
45941,23386,0,0,60,60,0,1,0,1,0,deny
20012,8443,0,0,60,60,0,1,0,1,0,deny
58002,445,0,0,70,70,0,1,0,1,0,drop
53971,55442,0,0,62,62,0,1,0,1,0,deny
58001,445,0,0,70,70,0,1,0,1,0,drop
58274,445,0,0,66,66,0,1,0,1,0,drop
62864,445,0,0,70,70,0,1,0,1,0,drop
60204,2767,0,0,66,66,0,1,0,1,0,deny
57999,445,0,0,70,70,0,1,0,1,0,drop
58272,445,0,0,66,66,0,1,0,1,0,drop
32137,44512,0,0,62,62,0,1,0,1,0,deny
58263,445,0,0,66,66,0,1,0,1,0,drop
8999,15503,0,0,146,146,0,1,0,1,0,deny
42216,53,45740,53,199,94,105,2,30,1,1,allow
51909,33509,44942,33509,70,70,0,2,8,2,0,allow
56484,53,39719,53,214,110,104,2,30,1,1,allow
51940,53,28110,53,199,94,105,2,30,1,1,allow
61078,123,41282,123,184,94,90,2,30,1,1,allow
55382,53,35558,53,199,102,97,2,30,1,1,allow
56577,53,47746,53,198,110,88,2,30,1,1,allow
51585,443,25112,443,2840,330,2510,12,135,5,7,allow
59872,443,27152,443,6239,800,5439,18,32,8,10,allow
55809,443,47324,443,62,62,0,1,4,1,0,allow
49436,443,51591,443,784271,38715,745556,1017,183,465,552,allow
65200,53,41473,53,214,110,104,2,29,1,1,allow
49954,53,53212,53,216,110,106,2,29,1,1,allow
65386,53,46279,53,168,86,82,2,29,1,1,allow
53716,6881,40646,6881,70,70,0,2,7,2,0,allow
57553,443,21487,443,7075,2575,4500,21,30,12,9,allow
54080,443,18578,443,6673,1531,5142,22,341,10,12,allow
55115,53,50368,53,313,110,203,4,35,2,2,allow
58434,443,57588,443,170342,10231,160111,264,136,130,134,allow
38632,443,3130,443,9606,1228,8378,20,115,9,11,allow
49437,443,14429,443,586175,29694,556481,753,182,349,404,allow
56374,53,20604,53,177,94,83,2,29,1,1,allow
65059,53,56951,53,197,94,103,2,29,1,1,allow
55102,53,13108,53,195,102,93,2,29,1,1,allow
65496,53,16227,53,194,102,92,2,29,1,1,allow
55466,53,26661,53,177,94,83,2,29,1,1,allow
53588,3389,53588,3389,3489,1534,1955,17,16,9,8,allow
65386,53,22726,53,184,102,82,2,29,1,1,allow
59727,3389,59727,3389,8409,1841,6568,27,20,11,16,allow
56374,53,12810,53,177,94,83,2,29,1,1,allow
49315,53,15991,53,94,94,0,1,30,1,0,allow
64880,53,31529,53,166,86,80,2,30,1,1,allow
53458,443,20818,443,7584,7094,490,14,123,7,7,allow
56464,53,12026,53,177,94,83,2,30,1,1,allow
55608,53,12316,53,195,102,93,2,30,1,1,allow
47523,443,49117,443,429929,11379,418550,456,21,174,282,allow
51890,31122,11914,31122,70,70,0,1,5,1,0,allow
49434,443,8627,443,197635,12994,184641,287,183,143,144,allow
56728,443,61064,443,5367,725,4642,15,15,8,7,allow
63879,80,50871,80,314,192,122,6,15,4,2,allow
59763,443,10249,443,24828,8387,16441,80,111,44,36,allow
23157,53,23157,53,228,90,138,2,30,1,1,allow
64790,53,64538,53,779,86,693,2,30,1,1,allow
55292,53,15138,53,274,94,180,2,30,1,1,allow
65419,53,45268,53,199,102,97,2,30,1,1,allow
56433,53,26629,53,177,94,83,2,30,1,1,allow
56626,443,37778,443,45304,28614,16690,82,41,45,37,allow
51891,23238,29444,23238,70,70,0,1,5,1,0,allow
55115,53,46461,53,313,110,203,4,35,2,2,allow
56800,443,33972,443,7518,2862,4656,18,75,10,8,allow
55502,53,25311,53,193,102,91,2,30,1,1,allow
40600,53,40600,53,228,90,138,2,30,1,1,allow
42384,443,3442,443,101952,6925,95027,143,333,72,71,allow
54079,443,34399,443,6931,1974,4957,24,342,11,13,allow
60104,80,20513,80,18480,7940,10540,48,71,27,21,allow
49856,53,57011,53,168,78,90,2,30,1,1,allow
55516,123,34894,123,184,94,90,2,30,1,1,allow
23984,53,23984,53,216,98,118,2,30,1,1,allow
50005,53,14000,53,199,102,97,2,30,1,1,allow
56701,53,54684,53,211,110,101,2,30,1,1,allow
56433,53,3210,53,177,94,83,2,30,1,1,allow
48164,53,51985,53,199,94,105,2,30,1,1,allow
49936,53,12720,53,754,94,660,2,30,1,1,allow
65040,53,33364,53,178,94,84,2,30,1,1,allow
49226,53,53578,53,765,102,663,2,30,1,1,allow
51522,443,43510,443,190,70,120,4,15,2,2,allow
55504,53,20782,53,199,94,105,2,30,1,1,allow
64983,53,5979,53,181,94,87,2,30,1,1,allow
55614,53,42097,53,309,110,199,2,30,1,1,allow
65067,53,28760,53,86,86,0,1,30,1,0,allow
54224,53,18536,53,199,94,105,2,30,1,1,allow
55453,53,1077,53,730,102,628,2,30,1,1,allow
65139,53,54576,53,443,182,261,6,30,3,3,allow
56861,33412,8103,33412,70,70,0,1,5,1,0,allow
58035,80,7543,80,4168,2906,1262,11,15,6,5,allow
28020,443,11039,443,5576,1388,4188,19,15,9,10,allow
58980,123,62249,123,184,94,90,2,30,1,1,allow
55083,53,1182,53,216,110,106,2,30,1,1,allow
55582,53,5858,53,177,94,83,2,30,1,1,allow
49472,53,31228,53,772,102,670,2,30,1,1,allow
65056,53,13429,53,168,94,74,2,30,1,1,allow
65056,53,16740,53,168,94,74,2,30,1,1,allow
57284,53,19677,53,214,110,104,2,30,1,1,allow
51648,443,53191,443,30116,4336,25780,44,123,18,26,allow
17750,39318,52655,39318,481,150,331,2,1200,1,1,allow
48368,443,5888,443,9157,3805,5352,39,100,18,21,allow
10003,443,7102,443,7617,4161,3456,34,332,15,19,allow
42273,443,42273,443,4398,1491,2907,19,26,11,8,allow
51911,14543,57115,14543,70,70,0,2,8,2,0,allow
63962,53,21344,53,185,93,92,3,58,2,1,allow
35499,443,34865,443,2270,1303,967,20,102,11,9,allow
60440,53830,1700,53830,320,140,180,6,6,3,3,allow
55981,80,6270,80,130,70,60,2,15,1,1,allow
49174,53,31879,53,199,102,97,2,33,1,1,allow
38084,443,21809,443,2697,1520,1177,21,182,10,11,allow
60951,53,52563,53,164,78,86,2,29,1,1,allow
51892,46647,6843,46647,70,70,0,1,5,1,0,allow
33445,53,19899,53,168,78,90,2,29,1,1,allow
60287,53,28366,53,168,78,90,2,29,1,1,allow
58843,80,20341,80,1439485,27511,1411974,1308,108,369,939,allow
56520,53,9113,53,177,94,83,2,29,1,1,allow
40749,5222,28403,5222,3474,915,2559,34,685,10,24,allow
56577,53,39696,53,182,94,88,2,30,1,1,allow
50022,53,4784,53,198,110,88,2,29,1,1,allow
55503,53,6618,53,216,110,106,2,29,1,1,allow
46369,443,62410,443,12157,3583,8574,81,480,34,47,allow
50962,53,0,0,229,85,144,2,29,1,1,allow
50375,53,45862,53,211,110,101,2,30,1,1,allow
55513,53,13816,53,184,94,90,2,30,1,1,allow
56464,53,56163,53,177,94,83,2,30,1,1,allow
55382,53,48828,53,199,102,97,2,30,1,1,allow
64983,53,54706,53,181,94,87,2,30,1,1,allow
56610,443,5877,443,100002,5891,94111,138,44,60,78,allow
56583,53,33992,53,177,94,83,2,29,1,1,allow
50510,53,6283,53,734,94,640,2,30,1,1,allow
55582,53,57520,53,177,94,83,2,30,1,1,allow
65486,53,53853,53,193,102,91,2,30,1,1,allow
55102,53,6205,53,195,102,93,2,30,1,1,allow
50005,53,15477,53,199,102,97,2,30,1,1,allow
56469,53,24320,53,177,94,83,2,30,1,1,allow
57284,53,51341,53,214,110,104,2,30,1,1,allow
56701,53,21171,53,211,110,101,2,30,1,1,allow
50005,53,1672,53,199,102,97,2,30,1,1,allow
56523,53,49008,53,184,102,82,2,30,1,1,allow
49659,53,53164,53,730,102,628,2,30,1,1,allow
56568,53,16992,53,211,110,101,2,30,1,1,allow
58282,53,59362,53,215,102,113,2,30,1,1,allow
49713,53,20450,53,821,102,719,2,30,1,1,allow
50584,53,19282,53,738,86,652,2,30,1,1,allow
55778,53,54108,53,181,94,87,2,30,1,1,allow
56984,53,44033,53,209,102,107,2,30,1,1,allow
43604,53,41746,53,168,78,90,2,30,1,1,allow
39461,53,45858,53,168,78,90,2,30,1,1,allow
56275,53,46209,53,166,86,80,2,30,1,1,allow
55010,53,9213,53,195,102,93,2,31,1,1,allow
49161,53,58186,53,168,86,82,2,30,1,1,allow
43298,53,31678,53,199,94,105,2,30,1,1,allow
56803,53,10846,53,195,102,93,2,30,1,1,allow
56993,53,49057,53,168,86,82,2,30,1,1,allow
65348,53,57406,53,214,102,112,2,31,1,1,allow
56137,53,23667,53,199,102,97,2,31,1,1,allow
57180,53,28550,53,305,86,219,2,31,1,1,allow
37335,443,52361,443,4734755,152171,4582584,5334,405,2083,3251,allow
65147,53,63811,53,194,102,92,2,31,1,1,allow
57444,443,62310,443,7975,1742,6233,24,81,14,10,allow
51889,44348,37588,44348,70,70,0,1,5,1,0,allow
56523,53,57340,53,168,86,82,2,30,1,1,allow
56023,53,18673,53,195,102,93,2,30,1,1,allow
43563,53,1876,53,164,78,86,2,30,1,1,allow
56596,53,43071,53,194,102,92,2,30,1,1,allow
52926,443,36627,443,5458,1390,4068,17,15,9,8,allow
63130,55860,38620,55860,1426,964,462,7,15,4,3,allow
50210,1688,19159,1688,70,70,0,2,8,2,0,allow
51443,443,36286,443,70,70,0,1,5,1,0,allow
55083,53,24986,53,325,110,215,4,44,2,2,allow
52925,443,23150,443,5582,1388,4194,19,15,9,10,allow
56484,53,12661,53,214,110,104,2,30,1,1,allow
65486,53,8619,53,193,102,91,2,30,1,1,allow
56939,53,27310,53,216,110,106,2,30,1,1,allow
50368,53,63672,53,763,102,661,2,30,1,1,allow
38008,443,10885,443,11784,6760,5024,50,247,30,20,allow
51311,22,51311,22,5624,2099,3525,30,23,17,13,allow
60434,11339,17493,11339,70,70,0,1,5,1,0,allow
56464,53,58795,53,177,94,83,2,30,1,1,allow
56568,53,45144,53,211,110,101,2,30,1,1,allow
55083,53,56476,53,216,110,106,2,30,1,1,allow
49161,53,58630,53,184,102,82,2,30,1,1,allow
50040,53,5250,53,193,102,91,2,30,1,1,allow
49713,53,3397,53,198,102,96,2,30,1,1,allow
55413,53,7034,53,779,86,693,2,30,1,1,allow
55199,53,62068,53,152,78,74,2,30,1,1,allow
55032,443,19722,443,8965,3021,5944,39,360,22,17,allow
6881,34635,39166,34635,228,118,110,2,1200,1,1,allow
53530,53,6923,53,164,78,86,2,30,1,1,allow
48604,53,57366,53,164,78,86,2,30,1,1,allow
49125,53,10970,53,168,78,90,2,30,1,1,allow
45607,53,29195,53,168,78,90,2,30,1,1,allow
56433,53,56287,53,177,94,83,2,30,1,1,allow
55102,53,47869,53,195,102,93,2,30,1,1,allow
56070,53,23575,53,193,102,91,2,30,1,1,allow
65499,53,27912,53,182,102,80,2,30,1,1,allow
50237,53,53638,53,183,94,89,2,31,1,1,allow
56758,53,35324,53,173,94,79,2,31,1,1,allow
51847,53,49805,53,164,78,86,2,31,1,1,allow
49411,53,17691,53,195,102,93,2,31,1,1,allow
57284,53,21102,53,214,110,104,2,31,1,1,allow
49152,53,17272,53,307,105,202,4,31,2,2,allow
56137,53,37448,53,199,102,97,2,30,1,1,allow
65180,53,26372,53,165,86,79,2,30,1,1,allow
50622,53,57483,53,185,102,83,2,30,1,1,allow
55549,53,9583,53,209,110,99,2,30,1,1,allow
65115,53,30107,53,253,87,166,4,31,2,2,allow
37387,443,27821,443,64440,16508,47932,101,142,44,57,allow
49845,53,35831,53,168,86,82,2,30,1,1,allow
49152,53,49230,53,211,110,101,2,31,1,1,allow
64885,53,51711,53,212,102,110,2,31,1,1,allow
56512,53,52518,53,889,404,485,10,31,5,5,allow
57043,53,20251,53,166,86,80,2,31,1,1,allow
64885,53,54457,53,182,102,80,2,31,1,1,allow
56015,53,12325,53,195,102,93,2,31,1,1,allow
41575,443,49577,443,24256,1841,22415,41,131,18,23,allow
50622,53,8191,53,177,94,83,2,31,1,1,allow
56982,53,27888,53,177,94,83,2,31,1,1,allow
56803,53,20372,53,195,102,93,2,31,1,1,allow
37576,53,58836,53,168,78,90,2,30,1,1,allow
55000,53,36007,53,193,102,91,2,31,1,1,allow
64586,53,19634,53,252,94,158,2,31,1,1,allow
65350,53,14923,53,212,102,110,2,31,1,1,allow
56939,53,59190,53,216,110,106,2,31,1,1,allow
49275,53,35482,53,195,102,93,2,31,1,1,allow
55851,53,26107,53,167,86,81,2,31,1,1,allow
65218,53,5567,53,194,102,92,2,31,1,1,allow
55133,53,17544,53,443,182,261,6,31,3,3,allow
57389,53,16174,53,193,102,91,2,31,1,1,allow
64276,53,55136,53,197,102,95,2,31,1,1,allow
49961,53,61953,53,322,110,212,4,31,2,2,allow
33705,443,51177,443,4610,918,3692,15,135,7,8,allow
57470,60080,37928,60080,12668,8506,4162,117,3745,74,43,allow
60864,5223,21557,5223,6278,2408,3870,27,3600,15,12,allow
42718,443,45721,443,7341,2111,5230,18,135,8,10,allow
9058,443,18160,443,5655,934,4721,16,130,8,8,allow
65419,53,4348,53,295,101,194,4,31,2,2,allow
53720,50795,49301,50795,320,140,180,6,7,3,3,allow
33610,443,59796,443,9490,1158,8332,24,257,13,11,allow
55673,53,34311,53,179,94,85,2,31,1,1,allow
64751,53,23466,53,458,188,270,6,31,3,3,allow
51915,35068,4331,35068,316,136,180,6,6,3,3,allow
53698,8120,60768,8120,70,70,0,1,5,1,0,allow
39937,443,39937,443,4756,1849,2907,19,27,11,8,allow
56544,443,41897,443,39717,3740,35977,76,53,39,37,allow
49272,53,48276,53,168,86,82,2,33,1,1,allow
55233,443,14491,443,10226,3230,6996,28,47,16,12,allow
50442,37807,0,0,62,62,0,1,0,1,0,deny
58259,445,0,0,66,66,0,1,0,1,0,drop
57990,445,0,0,70,70,0,1,0,1,0,drop
60239,23,0,0,60,60,0,1,0,1,0,deny
42968,56205,0,0,62,62,0,1,0,1,0,deny
57988,445,0,0,70,70,0,1,0,1,0,drop
5450,23,0,0,60,60,0,1,0,1,0,deny
57987,445,0,0,70,70,0,1,0,1,0,drop
18011,44847,0,0,66,66,0,1,0,1,0,deny
57986,445,0,0,70,70,0,1,0,1,0,drop
57985,445,0,0,70,70,0,1,0,1,0,drop
56636,43890,0,0,66,66,0,1,0,1,0,deny
56157,50584,0,0,66,66,0,1,0,1,0,deny
57982,445,0,0,70,70,0,1,0,1,0,drop
57981,445,0,0,70,70,0,1,0,1,0,drop
62857,445,0,0,70,70,0,1,0,1,0,drop
62854,445,0,0,70,70,0,1,0,1,0,drop
62852,445,0,0,70,70,0,1,0,1,0,drop
58247,445,0,0,66,66,0,1,0,1,0,drop
22922,35440,0,0,62,62,0,1,0,1,0,deny
58246,445,0,0,66,66,0,1,0,1,0,drop
58249,445,0,0,66,66,0,1,0,1,0,drop
58248,445,0,0,66,66,0,1,0,1,0,drop
58244,445,0,0,66,66,0,1,0,1,0,drop
58242,445,0,0,66,66,0,1,0,1,0,drop
58245,445,0,0,66,66,0,1,0,1,0,drop
58241,445,0,0,66,66,0,1,0,1,0,drop
9017,6881,0,0,66,66,0,1,0,1,0,deny
48676,53395,0,0,60,60,0,1,0,1,0,deny
33543,44847,0,0,66,66,0,1,0,1,0,deny
10438,23,0,0,60,60,0,1,0,1,0,deny
27272,64147,0,0,62,62,0,1,0,1,0,deny
57967,445,0,0,70,70,0,1,0,1,0,drop
57966,445,0,0,70,70,0,1,0,1,0,drop
57964,445,0,0,70,70,0,1,0,1,0,drop
10669,49756,0,0,60,60,0,1,0,1,0,deny
10669,49756,0,0,60,60,0,1,0,1,0,deny
10669,49756,0,0,60,60,0,1,0,1,0,deny
10669,49756,0,0,60,60,0,1,0,1,0,deny
10669,49756,0,0,60,60,0,1,0,1,0,deny
57957,445,0,0,70,70,0,1,0,1,0,drop
57956,445,0,0,70,70,0,1,0,1,0,drop
50529,44847,0,0,66,66,0,1,0,1,0,deny
58501,44847,0,0,62,62,0,1,0,1,0,deny
52626,44847,0,0,62,62,0,1,0,1,0,deny
39742,62413,0,0,66,66,0,1,0,1,0,deny
38781,51505,0,0,62,62,0,1,0,1,0,deny
62844,445,0,0,70,70,0,1,0,1,0,drop
62846,445,0,0,70,70,0,1,0,1,0,drop
62840,445,0,0,70,70,0,1,0,1,0,drop
62835,445,0,0,70,70,0,1,0,1,0,drop
58229,445,0,0,66,66,0,1,0,1,0,drop
58228,445,0,0,66,66,0,1,0,1,0,drop
58227,445,0,0,66,66,0,1,0,1,0,drop
5894,44847,0,0,66,66,0,1,0,1,0,deny
55874,64147,0,0,66,66,0,1,0,1,0,deny
57945,445,0,0,70,70,0,1,0,1,0,drop
54300,22114,0,0,66,66,0,1,0,1,0,deny
54458,64147,0,0,62,62,0,1,0,1,0,deny
56521,32480,0,0,62,62,0,1,0,1,0,deny
55386,32480,0,0,66,66,0,1,0,1,0,deny
51262,35440,0,0,66,66,0,1,0,1,0,deny
61000,15503,0,0,146,146,0,1,0,1,0,deny
62832,445,0,0,70,70,0,1,0,1,0,drop
62392,15503,0,0,146,146,0,1,0,1,0,deny
50283,49169,0,0,66,66,0,1,0,1,0,deny
62831,445,0,0,70,70,0,1,0,1,0,drop
62825,445,0,0,70,70,0,1,0,1,0,drop
62821,445,0,0,70,70,0,1,0,1,0,drop
45964,2225,0,0,60,60,0,1,0,1,0,deny
57940,445,0,0,70,70,0,1,0,1,0,drop
62388,39004,0,0,62,62,0,1,0,1,0,deny
58085,57470,0,0,66,66,0,1,0,1,0,deny
57930,445,0,0,70,70,0,1,0,1,0,drop
57931,445,0,0,70,70,0,1,0,1,0,drop
57929,445,0,0,70,70,0,1,0,1,0,drop
57927,445,0,0,70,70,0,1,0,1,0,drop
57925,445,0,0,70,70,0,1,0,1,0,drop
46774,51050,0,0,146,146,0,1,0,1,0,deny
62810,445,0,0,70,70,0,1,0,1,0,drop
62812,445,0,0,70,70,0,1,0,1,0,drop
58206,445,0,0,66,66,0,1,0,1,0,drop
47325,2323,0,0,60,60,0,1,0,1,0,deny
14923,51505,0,0,66,66,0,1,0,1,0,deny
28378,56205,0,0,62,62,0,1,0,1,0,deny
57918,445,0,0,70,70,0,1,0,1,0,drop
57233,50934,0,0,66,66,0,1,0,1,0,deny
443,31367,0,0,74,74,0,1,0,1,0,deny
62051,11392,0,0,66,66,0,1,0,1,0,deny
62806,445,0,0,70,70,0,1,0,1,0,drop
62804,445,0,0,70,70,0,1,0,1,0,drop
59647,47993,0,0,66,66,0,1,0,1,0,deny
45682,47993,0,0,62,62,0,1,0,1,0,deny
51414,22,0,0,60,60,0,1,0,1,0,deny
49644,30188,0,0,62,62,0,1,0,1,0,deny
57911,445,0,0,70,70,0,1,0,1,0,drop
57909,445,0,0,70,70,0,1,0,1,0,drop
58201,445,0,0,66,66,0,1,0,1,0,drop
58199,445,0,0,66,66,0,1,0,1,0,drop
65285,50584,0,0,62,62,0,1,0,1,0,deny
61150,11392,0,0,66,66,0,1,0,1,0,deny
45941,23384,0,0,60,60,0,1,0,1,0,deny
64740,53,21372,53,204,96,108,2,0,1,1,allow
59611,56205,0,0,62,62,0,1,0,1,0,deny
62109,44847,0,0,66,66,0,1,0,1,0,deny
57905,445,0,0,70,70,0,1,0,1,0,drop
9522,51505,0,0,66,66,0,1,0,1,0,deny
62796,445,0,0,70,70,0,1,0,1,0,drop
57903,445,0,0,70,70,0,1,0,1,0,drop
0,0,0,0,156,156,0,2,0,2,0,deny
0,0,0,0,156,156,0,2,0,2,0,deny
0,0,0,0,156,156,0,2,0,2,0,deny
0,0,0,0,156,156,0,2,0,2,0,deny
62783,445,0,0,70,70,0,1,0,1,0,drop
62789,445,0,0,70,70,0,1,0,1,0,drop
62785,445,0,0,70,70,0,1,0,1,0,drop
63098,35440,0,0,62,62,0,1,0,1,0,deny
10427,32480,0,0,62,62,0,1,0,1,0,deny
58193,445,0,0,66,66,0,1,0,1,0,drop
57899,445,0,0,70,70,0,1,0,1,0,deny
58185,445,0,0,66,66,0,1,0,1,0,drop
58182,445,0,0,66,66,0,1,0,1,0,drop
58190,445,0,0,66,66,0,1,0,1,0,drop
58181,445,0,0,66,66,0,1,0,1,0,drop
58180,445,0,0,66,66,0,1,0,1,0,drop
58183,445,0,0,66,66,0,1,0,1,0,drop
53208,18375,0,0,62,62,0,1,0,1,0,deny
56863,5900,0,0,60,60,0,1,0,1,0,deny
54134,64147,0,0,66,66,0,1,0,1,0,deny
51015,64147,0,0,62,62,0,1,0,1,0,deny
62779,445,0,0,70,70,0,1,0,1,0,drop
57898,445,0,0,70,70,0,1,0,1,0,drop
51096,63710,0,0,66,66,0,1,0,1,0,deny
62775,445,0,0,70,70,0,1,0,1,0,drop
62776,445,0,0,70,70,0,1,0,1,0,drop
62774,445,0,0,70,70,0,1,0,1,0,drop
51374,30317,0,0,66,66,0,1,0,1,0,deny
13484,37965,0,0,66,66,0,1,0,1,0,deny
9393,51505,0,0,66,66,0,1,0,1,0,deny
58424,52700,0,0,66,66,0,1,0,1,0,deny
51320,44847,0,0,62,62,0,1,0,1,0,deny
57893,445,0,0,70,70,0,1,0,1,0,drop
8889,60961,0,0,60,60,0,1,0,1,0,deny
50486,56205,0,0,66,66,0,1,0,1,0,deny
40099,23,0,0,60,60,0,1,0,1,0,deny
19875,30170,0,0,145,145,0,1,0,1,0,deny
62768,445,0,0,70,70,0,1,0,1,0,drop
62767,445,0,0,70,70,0,1,0,1,0,drop
62766,445,0,0,70,70,0,1,0,1,0,drop
56876,30188,0,0,66,66,0,1,0,1,0,deny
58174,445,0,0,66,66,0,1,0,1,0,drop
62764,445,0,0,70,70,0,1,0,1,0,drop
58170,445,0,0,66,66,0,1,0,1,0,drop
50095,50584,0,0,66,66,0,1,0,1,0,deny
58168,445,0,0,66,66,0,1,0,1,0,drop
58166,445,0,0,66,66,0,1,0,1,0,drop
49981,44847,0,0,62,62,0,1,0,1,0,deny
58165,445,0,0,66,66,0,1,0,1,0,drop
32609,64097,0,0,66,66,0,1,0,1,0,deny
57880,445,0,0,70,70,0,1,0,1,0,drop
55745,53,2082,53,198,101,97,2,30,1,1,allow
56137,53,13627,53,198,101,97,2,30,1,1,allow
57320,53,17715,53,802,104,698,2,30,1,1,allow
56803,53,60073,53,190,97,93,2,30,1,1,allow
45973,80,60960,80,1114,534,580,12,16,7,5,allow
56848,19556,15601,19556,66,66,0,1,5,1,0,allow
40911,443,37854,443,11095,2599,8496,45,257,22,23,allow
58887,15000,7750,15000,138,78,60,2,6,1,1,allow
41627,15000,9881,15000,130,70,60,2,5,1,1,allow
58369,443,52510,443,12779517,343310,12436207,12837,162,4589,8248,allow
56726,443,54514,443,4221,666,3555,13,15,7,6,allow
56601,53,12996,53,170,87,83,2,30,1,1,allow
65357,53,31464,53,256,93,163,2,30,1,1,allow
49560,443,58104,443,13516,6981,6535,61,2149,34,27,allow
46985,443,26507,443,4957,3488,1469,25,51,15,10,allow
33505,80,10878,80,130,70,60,2,15,1,1,allow
51905,65253,13795,65253,70,70,0,2,8,2,0,allow
38598,80,50146,80,1114,534,580,12,16,7,5,allow
53694,8999,50905,8999,1179,606,573,12,17,7,5,allow
65416,443,30210,443,3219,2242,977,19,25,9,10,allow
49708,53,19029,53,186,95,91,2,31,1,1,allow
55238,443,54700,443,6165,1407,4758,21,45,12,9,allow
65340,53,24167,53,313,110,203,4,34,2,2,allow
55011,443,43208,443,134,60,74,3,10,2,1,allow
34154,443,26311,443,6107,2012,4095,18,25,10,8,allow
56015,53,32700,53,190,97,93,2,31,1,1,allow
56754,53,1275,53,751,95,656,2,30,1,1,allow
53096,443,46942,443,13599,5335,8264,35,171,18,17,allow
51616,15000,27735,15000,130,70,60,2,6,1,1,allow
40202,5222,32011,5222,5958,2420,3538,40,25,20,20,allow
56849,23745,9953,23745,66,66,0,1,5,1,0,allow
53247,443,23976,443,10542,1216,9326,26,44,10,16,allow
55223,443,26672,443,12583,2945,9638,31,47,16,15,allow
59900,3389,59900,3389,3489,1534,1955,17,18,9,8,allow
49544,80,16588,80,10192,3818,6374,20,16,9,11,allow
64617,53,32317,53,756,95,661,2,30,1,1,allow
55747,53,60258,53,186,95,91,2,30,1,1,allow
5588,5588,0,0,3498,1872,1626,48,201,24,24,allow
50130,53,57806,53,174,89,85,2,30,1,1,allow
60116,443,14734,443,9454,2307,7147,40,19,17,23,allow
58373,443,64061,443,78832,12408,66424,109,162,46,63,allow
45120,15000,54128,15000,130,70,60,2,6,1,1,allow
55678,53,40642,53,270,88,182,4,54,2,2,allow
56847,36370,51543,36370,624,318,306,10,15,5,5,allow
63891,51350,44570,51350,312,132,180,6,7,3,3,allow
56856,47715,33664,47715,70,70,0,2,8,2,0,allow
52099,443,31661,443,39798,12257,27541,68,97,27,41,allow
53836,15000,1937,15000,130,70,60,2,5,1,1,allow
55654,18251,36307,18251,70,70,0,1,5,1,0,allow
37483,443,13150,443,70,70,0,2,5,2,0,allow
48273,15000,43622,15000,130,70,60,2,5,1,1,allow
47166,15000,45851,15000,130,70,60,2,5,1,1,allow
48978,443,3498,443,10163,3585,6578,47,26,24,23,allow
51102,80,48661,80,254,128,126,5,16,3,2,allow
40204,5222,16908,5222,5097,2196,2901,36,25,18,18,allow
49973,53,28904,53,747,93,654,2,30,1,1,allow
65028,53,48786,53,182,93,89,2,31,1,1,allow
60261,53,9176,53,233,81,152,2,31,1,1,allow
56754,53,54310,53,182,93,89,2,31,1,1,allow
58452,5228,20449,5228,2855,1780,1075,20,3600,10,10,allow
57030,53,10715,53,749,94,655,2,30,1,1,allow
57043,53,11137,53,164,84,80,2,31,1,1,allow
52744,53,32462,53,218,81,137,2,31,1,1,allow
60205,53,4372,53,491,115,376,2,31,1,1,allow
64155,53,47794,53,182,93,89,2,31,1,1,allow
57432,53,52576,53,186,95,91,2,31,1,1,allow
55057,53,28590,53,188,80,108,2,31,1,1,allow
49411,53,5629,53,764,99,665,2,31,1,1,allow
49411,53,16636,53,190,97,93,2,31,1,1,allow
64502,53,19448,53,198,101,97,2,31,1,1,allow
44847,26356,3716,26356,501,150,351,2,1200,1,1,allow
56316,53,62474,53,733,93,640,2,31,1,1,allow
57403,53,33479,53,764,99,665,2,31,1,1,allow
49901,53,43057,53,752,93,659,2,31,1,1,allow
55165,53,33843,53,186,95,91,2,31,1,1,allow
55146,53,27596,53,178,91,87,2,31,1,1,allow
55989,53,34510,53,301,80,221,2,31,1,1,allow
55865,53,59187,53,192,98,94,2,31,1,1,allow
56754,53,26868,53,182,93,89,2,31,1,1,allow
56489,53,9715,53,172,88,84,2,31,1,1,allow
43616,5228,36276,5228,2322,1296,1026,15,3600,6,9,allow
61808,443,43689,443,4625,2292,2333,14,135,7,7,allow
30960,45732,62764,45732,330,330,0,6,3610,6,0,allow
52045,443,60420,443,51604,4684,46920,70,133,28,42,allow
63951,53,13752,53,186,95,91,2,31,1,1,allow
55673,53,33131,53,174,89,85,2,31,1,1,allow
55365,53,41996,53,184,94,90,2,31,1,1,allow
55379,53,30186,53,256,93,163,2,31,1,1,allow
56304,53,54200,53,184,94,90,2,31,1,1,allow
64275,53,47758,53,192,90,102,2,31,1,1,allow
54329,443,26217,443,5850,1617,4233,28,127,13,15,allow
54330,443,28162,443,7329,3011,4318,30,127,14,16,allow
64276,53,40042,53,194,99,95,2,31,1,1,allow
54992,53,12659,53,190,97,93,2,31,1,1,allow
32520,50265,0,0,145,145,0,1,0,1,0,deny
62758,445,0,0,70,70,0,1,0,1,0,drop
60720,23718,0,0,66,66,0,1,0,1,0,deny
58976,43890,0,0,66,66,0,1,0,1,0,deny
57877,445,0,0,70,70,0,1,0,1,0,drop
62747,445,0,0,70,70,0,1,0,1,0,drop
49611,53,44426,53,184,94,90,2,30,1,1,allow
57239,53,5025,53,193,102,91,2,30,1,1,allow
64155,53,2380,53,183,94,89,2,30,1,1,allow
49554,80,58941,80,1515,481,1034,11,15,6,5,allow
56914,53,24598,53,821,102,719,2,30,1,1,allow
49738,53,2728,53,215,102,113,2,30,1,1,allow
56070,53,12726,53,193,102,91,2,30,1,1,allow
55934,53,23725,53,182,102,80,2,30,1,1,allow
49502,53,5291,53,193,102,91,2,30,1,1,allow
49713,53,16907,53,184,94,90,2,30,1,1,allow
55019,443,52718,443,6484,1915,4569,26,131,14,12,allow
50580,443,17458,443,2723,1383,1340,29,37,16,13,allow
54983,80,49933,80,27816,7362,20454,69,240,41,28,allow
65250,53,37683,53,353,98,255,4,32,2,2,allow
27005,27126,47087,27126,636020,187240,448780,2701,104,1538,1163,allow
56568,53,6901,53,365,105,260,4,47,2,2,allow
49667,443,39894,443,8329,2188,6141,29,100,16,13,allow
49275,53,55214,53,283,97,186,4,30,2,2,allow
53696,50321,3484,50321,70,70,0,1,4,1,0,allow
60107,443,49027,443,9766,3290,6476,40,57,20,20,allow
55232,443,11743,443,9619,2504,7115,28,46,15,13,allow
55236,443,64536,443,10293,2881,7412,25,45,14,11,allow
58495,443,34760,443,1638,829,809,18,43,10,8,allow
49788,53,17656,53,198,102,96,2,32,1,1,allow
56638,80,7412,80,234,234,0,4,11,4,0,allow
59277,53,14948,53,164,78,86,2,29,1,1,allow
47636,53,0,0,86,86,0,1,29,1,0,allow
56070,53,26270,53,193,102,91,2,30,1,1,allow
55657,53,52636,53,822,102,720,2,30,1,1,allow
56993,53,24692,53,184,102,82,2,29,1,1,allow
64055,53,52345,53,181,94,87,2,29,1,1,allow
34317,53,53292,53,168,78,90,2,29,1,1,allow
55549,53,24179,53,209,110,99,2,29,1,1,allow
53552,53,3574,53,168,78,90,2,29,1,1,allow
55000,53,31472,53,193,102,91,2,29,1,1,allow
56982,53,54411,53,177,94,83,2,29,1,1,allow
65040,53,11010,53,178,94,84,2,29,1,1,allow
55199,53,24591,53,152,78,74,2,29,1,1,allow
41783,443,41782,443,23344,2097,21247,39,15,18,21,allow
50529,80,9935,80,12874,6770,6104,26,28,13,13,allow
50533,80,13873,80,3672,1976,1696,12,26,7,5,allow
44921,443,18740,443,5440,846,4594,15,15,9,6,allow
49890,443,3826,443,6370237,150385,6219852,6047,138,1688,4359,allow
64903,53,4073,53,210,110,100,2,30,1,1,allow
64415,53,15855,53,221,94,127,2,30,1,1,allow
50130,53,36317,53,179,94,85,2,30,1,1,allow
55629,53,22449,53,168,86,82,2,30,1,1,allow
49567,53,35834,53,168,86,82,2,30,1,1,allow
64583,53,34573,53,179,94,85,2,30,1,1,allow
55549,53,20623,53,209,110,99,2,30,1,1,allow
56304,53,19681,53,184,94,90,2,30,1,1,allow
49724,53,16397,53,183,94,89,2,30,1,1,allow
64870,53,42981,53,200,102,98,2,33,1,1,allow
54963,53,11032,53,210,110,100,2,30,1,1,allow
36677,443,38465,443,712,374,338,11,26,6,5,allow
49141,443,32844,443,2595,1230,1365,18,16,9,9,allow
59970,443,20638,443,7448,1347,6101,24,16,13,11,allow
50534,80,11143,80,318,192,126,6,25,4,2,allow
56432,80,52279,80,17128,1499,15629,24,25,9,15,allow
50463,80,63271,80,214,140,74,4,15,3,1,allow
49713,53,39823,53,184,94,90,2,30,1,1,allow
50549,80,64687,80,378,192,186,7,21,4,3,allow
50548,80,23213,80,378,192,186,7,21,4,3,allow
56560,53,11515,53,198,102,96,2,31,1,1,allow
64859,53,38916,53,385,134,251,2,30,1,1,allow
41776,443,58103,443,3196404,47816,3148588,2668,147,469,2199,allow
54936,80,14845,80,613,539,74,7,15,6,1,allow
55934,53,17194,53,182,102,80,2,30,1,1,allow
59932,443,3310,443,6065,1772,4293,27,1587,15,12,allow
65395,53,34335,53,754,94,660,2,30,1,1,allow
59962,443,64092,443,19201,1566,17635,34,16,16,18,allow
64903,53,57537,53,210,110,100,2,30,1,1,allow
49451,53,64804,53,211,102,109,2,30,1,1,allow
63982,53,27288,53,244,94,150,2,30,1,1,allow
44922,443,33552,443,5578,764,4814,14,15,8,6,allow
64903,53,16364,53,210,110,100,2,30,1,1,allow
64870,53,51566,53,200,102,98,2,30,1,1,allow
50536,80,24703,80,24166,3105,21061,31,24,12,19,allow
64718,53,52565,53,781,94,687,2,30,1,1,allow
57043,53,58233,53,166,86,80,2,30,1,1,allow
63951,53,11656,53,193,102,91,2,30,1,1,allow
64697,53,13382,53,199,102,97,2,30,1,1,allow
55678,53,49821,53,270,88,182,4,54,2,2,allow
56015,53,29304,53,195,102,93,2,30,1,1,allow
52145,443,2383,443,190,70,120,4,15,2,2,allow
65340,53,54833,53,313,110,203,4,33,2,2,allow
59958,443,39480,443,2303,1334,969,18,16,10,8,allow
59974,443,8585,443,7820,1344,6476,24,16,13,11,allow
42154,80,50458,80,73277,3302,69975,102,16,52,50,allow
59964,443,8853,443,166170,5611,160559,189,16,78,111,allow
50547,80,14282,80,378,192,186,7,21,4,3,allow
53691,11528,36171,11528,492,306,186,8,16,5,3,allow
56758,53,14411,53,165,86,79,2,30,1,1,allow
56601,53,17234,53,177,94,83,2,30,1,1,allow
64633,53,57902,53,231,110,121,2,30,1,1,allow
56779,53,27714,53,165,86,79,2,30,1,1,allow
49502,53,58398,53,193,102,91,2,30,1,1,allow
56601,53,46710,53,177,94,83,2,30,1,1,allow
49891,53,31414,53,243,94,149,2,30,1,1,allow
1930,80,62505,80,214,140,74,4,15,3,1,allow
64664,53,7997,53,168,86,82,2,32,1,1,allow
53136,41442,55511,41442,70,70,0,1,5,1,0,allow
5238,36298,39762,36298,179518,128,179390,173,37,3,170,allow
50532,80,48066,80,4561,2110,2451,15,26,9,6,allow
57335,53,58927,53,177,94,83,2,30,1,1,allow
57335,53,28128,53,185,102,83,2,30,1,1,allow
37479,53,37479,53,214,82,132,2,30,1,1,allow
55745,53,20797,53,199,102,97,2,30,1,1,allow
59454,53,0,0,86,86,0,1,30,1,0,allow
54963,53,23635,53,210,110,100,2,30,1,1,allow
52073,443,26285,443,22714,21388,1326,33,30,22,11,allow
14435,443,15912,443,2569,1470,1099,17,15,8,9,allow
55678,53,55305,53,270,88,182,4,54,2,2,allow
38680,443,52567,443,90091,3481,86610,95,15,31,64,allow
56115,53,38646,53,278,96,182,4,54,2,2,allow
33609,443,62063,443,9348,1018,8330,22,256,11,11,allow
49655,443,28580,443,50533,7291,43242,74,61,34,40,allow
38678,443,20008,443,380978,8857,372121,373,16,115,258,allow
53697,6224,22057,6224,70,70,0,1,4,1,0,allow
33611,443,49502,443,9490,1158,8332,24,256,13,11,allow
49295,53,60133,53,194,102,92,2,32,1,1,allow
50700,80,4259,80,417,417,0,4,9,4,0,allow
59960,443,41281,443,1953,1223,730,16,16,9,7,allow
43146,80,15239,80,1102,545,557,10,16,6,4,allow
45472,443,53386,443,1568,759,809,17,43,9,8,allow
35832,443,34150,443,9276,1884,7392,23,32,13,10,allow
45470,443,49980,443,1636,827,809,18,43,10,8,allow
59972,443,22705,443,7152,1299,5853,22,16,12,10,allow
46728,443,17105,443,7087,746,6341,16,15,9,7,allow
59956,443,50575,443,2162,1113,1049,18,16,10,8,allow
35810,443,45947,443,9276,1884,7392,23,94,13,10,allow
49127,53,16761,53,199,94,105,2,29,1,1,allow
41775,443,57658,443,7036547,93047,6943500,5816,186,995,4821,allow
65499,53,38166,53,166,86,80,2,29,1,1,allow
64533,53,56786,53,183,102,81,2,29,1,1,allow
65147,53,20335,53,194,102,92,2,29,1,1,allow
41781,443,5729,443,1820,1101,719,18,82,10,8,allow
55678,53,29354,53,270,88,182,4,53,2,2,allow
64533,53,56074,53,183,102,81,2,29,1,1,allow
55513,53,52238,53,184,94,90,2,29,1,1,allow
55010,53,42242,53,195,102,93,2,29,1,1,allow
47766,53,58844,53,164,78,86,2,29,1,1,allow
64885,53,4392,53,166,86,80,2,29,1,1,allow
65398,53,64087,53,811,94,717,2,29,1,1,allow
33794,53,45704,53,168,78,90,2,29,1,1,allow
55778,53,21245,53,189,102,87,2,29,1,1,allow
65180,53,3585,53,165,86,79,2,29,1,1,allow
56866,53,6471,53,194,102,92,2,30,1,1,allow
39684,80,40129,80,680,70,610,11,392,2,9,allow
50446,443,25780,443,5471,2089,3382,17,121,8,9,allow
50265,31101,44674,31101,150,150,0,1,1200,1,0,allow
64697,53,51206,53,199,102,97,2,30,1,1,allow
49708,53,46475,53,193,102,91,2,30,1,1,allow
65058,53,6038,53,249,94,155,2,30,1,1,allow
49933,53,6937,53,178,94,84,2,31,1,1,allow
55570,53,44028,53,168,86,82,2,31,1,1,allow
34630,443,65434,443,12120,5747,6373,22,120,10,12,allow
35601,443,47260,443,6419,995,5424,21,360,11,10,allow
30188,14991,3855,14991,501,150,351,2,1200,1,1,allow
57239,53,64762,53,193,102,91,2,31,1,1,allow
55146,53,42848,53,181,94,87,2,30,1,1,allow
59936,443,30573,443,10879,3057,7822,38,32,21,17,allow
35579,443,33211,443,130,70,60,2,15,1,1,allow
51906,17491,64843,17491,70,70,0,2,8,2,0,allow
65488,443,64323,443,92286,4799,87487,107,16,43,64,allow
56668,53,7163,53,199,102,97,2,30,1,1,allow
56668,53,30534,53,199,102,97,2,30,1,1,allow
49411,53,20667,53,195,102,93,2,30,1,1,allow
55673,53,41151,53,179,94,85,2,30,1,1,allow
49724,53,47705,53,183,94,89,2,30,1,1,allow
34744,443,31137,443,13175,2432,10743,52,3587,23,29,allow
50265,18417,40558,18417,7282,4118,3164,57,1696,35,22,allow
51967,443,12004,443,21063,13499,7564,47,68,25,22,allow
65340,53,38317,53,313,110,203,4,33,2,2,allow
64614,53,45879,53,616,188,428,6,35,3,3,allow
58497,443,60144,443,1640,831,809,18,43,10,8,allow
53714,443,14989,443,9842,4572,5270,22,76,12,10,allow
50587,80,51672,80,378,192,186,7,20,4,3,allow
58492,443,51321,443,5611,1560,4051,22,266,13,9,allow
51978,80,13488,80,24474,2101,22373,38,48,19,19,allow
41779,443,29003,443,618072,8505,609567,523,87,90,433,allow
56668,53,43075,53,199,102,97,2,30,1,1,allow
49564,53,57263,53,168,78,90,2,30,1,1,allow
55851,53,30574,53,183,102,81,2,30,1,1,allow
49436,53,51466,53,765,102,663,2,30,1,1,allow
56866,53,52471,53,194,102,92,2,30,1,1,allow
50015,53,0,0,234,86,148,2,30,1,1,allow
49708,53,49250,53,193,102,91,2,30,1,1,allow
65315,53,23256,53,178,94,84,2,30,1,1,allow
49708,53,50223,53,193,102,91,2,30,1,1,allow
49724,53,13142,53,183,94,89,2,30,1,1,allow
50810,443,16412,443,10682,4653,6029,28,33,15,13,allow
59966,443,53241,443,7165,1312,5853,22,16,12,10,allow
41784,443,54389,443,20365,2035,18330,36,15,17,19,allow
65487,443,56960,443,413465,12290,401175,427,16,150,277,allow
56859,32185,46564,32185,70,70,0,1,5,1,0,allow
54631,443,8589,443,130,70,60,3,5,2,1,allow
60474,53,36065,53,195,94,101,2,30,1,1,allow
56779,53,5601,53,173,94,79,2,30,1,1,allow
55745,53,56029,53,199,102,97,2,30,1,1,allow
50237,53,33615,53,183,94,89,2,30,1,1,allow
42041,443,41646,443,2351,1546,805,20,54,11,9,allow
64697,53,40381,53,199,102,97,2,30,1,1,allow
55146,53,47251,53,181,94,87,2,30,1,1,allow
55786,53,7570,53,193,102,91,2,30,1,1,allow
54963,53,30866,53,210,110,100,2,30,1,1,allow
49431,53,23067,53,353,94,259,2,30,1,1,allow
64155,53,25938,53,183,94,89,2,30,1,1,allow
37469,53,51680,53,168,78,90,2,30,1,1,allow
56304,53,49255,53,184,94,90,2,30,1,1,allow
48954,53,0,0,86,86,0,1,30,1,0,allow
60591,53,16493,53,218,78,140,2,31,1,1,allow
56601,53,1857,53,177,94,83,2,31,1,1,allow
49411,53,10560,53,195,102,93,2,31,1,1,allow
57043,53,5336,53,166,86,80,2,31,1,1,allow
56542,53,15813,53,183,94,89,2,30,1,1,allow
65028,53,59262,53,183,94,89,2,31,1,1,allow
49398,53,12765,53,226,86,140,2,31,1,1,allow
57432,53,10564,53,193,102,91,2,31,1,1,allow
49456,53,42586,53,199,102,97,2,31,1,1,allow
59906,443,52197,443,13657,5248,8409,33,171,17,16,allow
55673,53,34197,53,179,94,85,2,31,1,1,allow
55365,53,47603,53,184,94,90,2,31,1,1,allow
49952,53,65134,53,195,102,93,2,31,1,1,allow
56587,53,8172,53,184,94,90,2,31,1,1,allow
55748,53,53147,53,194,102,92,2,31,1,1,allow
54990,53,13608,53,168,86,82,2,31,1,1,allow
50458,443,34106,443,44532,3294,41238,56,128,21,35,allow
64302,53,55170,53,258,94,164,2,31,1,1,allow
6882,51508,23505,51508,238,118,120,2,1200,1,1,allow
55636,443,29047,443,13506,5979,7527,39,127,20,19,allow
58877,53,28014,53,426,118,308,2,31,1,1,allow
64884,53,27376,53,195,102,93,2,31,1,1,allow
56542,53,32612,53,183,94,89,2,31,1,1,allow
54681,443,46461,443,4417,2187,2230,16,135,8,8,allow
57470,15870,28583,15870,149,149,0,2,1199,2,0,allow
37965,27261,16872,27261,150,150,0,1,1199,1,0,allow
38679,443,29452,443,484912,17317,467595,550,16,229,321,allow
58210,443,60868,443,14898,12644,2254,32,316,18,14,allow
4567,80,4567,80,23456,1005,22451,32,16,13,19,allow
55652,443,58286,443,6672,2258,4414,19,16,10,9,allow
49532,53,59388,53,331,92,239,4,40,2,2,allow
49392,53,35647,53,398,93,305,4,45,2,2,allow
57810,80,62948,80,104397,8436,95961,122,21,49,73,allow
59697,80,58873,80,5326946,116544,5210402,5175,111,1695,3480,allow
50278,443,27147,443,259911,11421,248490,336,92,144,192,allow
56719,80,46763,80,1462,703,759,8,16,5,3,allow
63878,50829,35363,50829,70,70,0,1,5,1,0,allow
52146,80,22638,80,1868,1374,494,12,16,7,5,allow
62748,445,0,0,70,70,0,1,0,1,0,drop
48706,23393,0,0,60,60,0,1,0,1,0,deny
1441,51221,0,0,62,62,0,1,0,1,0,deny
58154,445,0,0,66,66,0,1,0,1,0,drop
62088,56205,0,0,66,66,0,1,0,1,0,deny
57873,445,0,0,70,70,0,1,0,1,0,drop
44923,23,0,0,60,60,0,1,0,1,0,deny
57871,445,0,0,70,70,0,1,0,1,0,drop
57869,445,0,0,70,70,0,1,0,1,0,drop
58146,445,0,0,66,66,0,1,0,1,0,drop
61242,35253,0,0,62,62,0,1,0,1,0,deny
62736,445,0,0,70,70,0,1,0,1,0,drop
59364,44847,0,0,62,62,0,1,0,1,0,deny
50798,36237,0,0,146,146,0,1,0,1,0,deny
53656,31573,0,0,66,66,0,1,0,1,0,deny
58143,445,0,0,66,66,0,1,0,1,0,drop
43350,58414,0,0,66,66,0,1,0,1,0,deny
49977,57470,0,0,62,62,0,1,0,1,0,deny
58255,50584,0,0,62,62,0,1,0,1,0,deny
9687,57470,0,0,78,78,0,1,0,1,0,deny
57862,445,0,0,70,70,0,1,0,1,0,drop
1629,64147,0,0,146,146,0,1,0,1,0,deny
58135,445,0,0,66,66,0,1,0,1,0,drop
57860,445,0,0,70,70,0,1,0,1,0,drop
57874,26467,0,0,62,62,0,1,0,1,0,deny
58127,445,0,0,66,66,0,1,0,1,0,drop
60855,35440,0,0,66,66,0,1,0,1,0,deny
16215,6881,0,0,146,146,0,1,0,1,0,deny
57859,445,0,0,70,70,0,1,0,1,0,drop
15180,26467,0,0,62,62,0,1,0,1,0,deny
16522,26467,0,0,66,66,0,1,0,1,0,deny
57858,445,0,0,70,70,0,1,0,1,0,drop
57857,445,0,0,70,70,0,1,0,1,0,drop
1024,60043,0,0,145,145,0,1,0,1,0,deny
57855,445,0,0,70,70,0,1,0,1,0,drop
57851,445,0,0,70,70,0,1,0,1,0,drop
33502,5529,0,0,143,143,0,1,0,1,0,deny
11478,51221,0,0,66,66,0,1,0,1,0,deny
62029,22114,0,0,66,66,0,1,0,1,0,deny
62728,445,0,0,70,70,0,1,0,1,0,drop
62725,445,0,0,70,70,0,1,0,1,0,drop
62724,445,0,0,70,70,0,1,0,1,0,drop
58121,445,0,0,66,66,0,1,0,1,0,drop
58120,445,0,0,66,66,0,1,0,1,0,drop
58117,445,0,0,66,66,0,1,0,1,0,drop
58116,445,0,0,66,66,0,1,0,1,0,drop
58118,445,0,0,66,66,0,1,0,1,0,drop
58119,445,0,0,66,66,0,1,0,1,0,drop
58114,445,0,0,66,66,0,1,0,1,0,drop
58113,445,0,0,66,66,0,1,0,1,0,drop
47910,7454,0,0,60,60,0,1,0,1,0,deny
57839,445,0,0,70,70,0,1,0,1,0,drop
1038,37965,0,0,62,62,0,1,0,1,0,deny
57838,445,0,0,70,70,0,1,0,1,0,drop
57834,445,0,0,70,70,0,1,0,1,0,drop
57829,445,0,0,70,70,0,1,0,1,0,drop
57828,445,0,0,70,70,0,1,0,1,0,drop
52018,57866,0,0,66,66,0,1,0,1,0,deny
41840,50584,0,0,66,66,0,1,0,1,0,deny
58672,43890,0,0,62,62,0,1,0,1,0,deny
65494,53,0,0,88,88,0,1,0,1,0,deny
5688,44847,0,0,66,66,0,1,0,1,0,deny
46859,50584,0,0,62,62,0,1,0,1,0,deny
18001,35440,0,0,146,146,0,1,0,1,0,deny
19245,64147,0,0,62,62,0,1,0,1,0,deny
53667,56205,0,0,62,62,0,1,0,1,0,deny
27898,52700,0,0,62,62,0,1,0,1,0,deny
62721,445,0,0,70,70,0,1,0,1,0,drop
62714,445,0,0,70,70,0,1,0,1,0,drop
62709,445,0,0,70,70,0,1,0,1,0,drop
62707,445,0,0,70,70,0,1,0,1,0,drop
52989,51505,0,0,66,66,0,1,0,1,0,deny
2691,64147,0,0,62,62,0,1,0,1,0,deny
65515,22114,0,0,62,62,0,1,0,1,0,deny
57817,445,0,0,70,70,0,1,0,1,0,drop
58101,445,0,0,66,66,0,1,0,1,0,drop
58099,445,0,0,66,66,0,1,0,1,0,drop
58098,445,0,0,66,66,0,1,0,1,0,drop
62704,445,0,0,70,70,0,1,0,1,0,drop
7968,2767,0,0,66,66,0,1,0,1,0,deny
62699,445,0,0,70,70,0,1,0,1,0,drop
62693,445,0,0,70,70,0,1,0,1,0,drop
62697,445,0,0,70,70,0,1,0,1,0,drop
57813,445,0,0,70,70,0,1,0,1,0,drop
54552,64147,0,0,62,62,0,1,0,1,0,deny
57802,445,0,0,70,70,0,1,0,1,0,drop
57803,445,0,0,70,70,0,1,0,1,0,drop
57801,445,0,0,70,70,0,1,0,1,0,drop
20409,23,0,0,60,60,0,1,0,1,0,deny
62765,16933,0,0,66,66,0,1,0,1,0,deny
57798,445,0,0,70,70,0,1,0,1,0,drop
13287,16933,0,0,62,62,0,1,0,1,0,deny
52537,37965,0,0,66,66,0,1,0,1,0,deny
57797,445,0,0,70,70,0,1,0,1,0,drop
52711,37965,0,0,62,62,0,1,0,1,0,deny
52740,51505,0,0,66,66,0,1,0,1,0,deny
62686,445,0,0,70,70,0,1,0,1,0,drop
62685,445,0,0,70,70,0,1,0,1,0,drop
62680,445,0,0,70,70,0,1,0,1,0,drop
15875,50584,0,0,62,62,0,1,0,1,0,deny
24288,23,0,0,60,60,0,1,0,1,0,deny
45682,37965,0,0,62,62,0,1,0,1,0,deny
57790,445,0,0,70,70,0,1,0,1,0,drop
49622,50584,0,0,62,62,0,1,0,1,0,deny
53218,56205,0,0,66,66,0,1,0,1,0,deny
63027,35440,0,0,66,66,0,1,0,1,0,deny
18750,57866,0,0,146,146,0,1,0,1,0,deny
35722,30188,0,0,62,62,0,1,0,1,0,deny
0,0,0,0,156,156,0,2,0,2,0,allow
0,0,0,0,244,244,0,2,0,2,0,allow
53966,57470,0,0,62,62,0,1,0,1,0,deny
58079,445,0,0,66,66,0,1,0,1,0,drop
62679,445,0,0,70,70,0,1,0,1,0,drop
62678,445,0,0,70,70,0,1,0,1,0,drop
57783,445,0,0,70,70,0,1,0,1,0,drop
57781,445,0,0,70,70,0,1,0,1,0,drop
56186,57470,0,0,62,62,0,1,0,1,0,deny
52976,31573,0,0,62,62,0,1,0,1,0,deny
59147,51505,0,0,66,66,0,1,0,1,0,deny
18472,5278,0,0,145,145,0,1,0,1,0,deny
26758,50584,0,0,66,66,0,1,0,1,0,deny
52836,36829,0,0,66,66,0,1,0,1,0,deny
57239,161,0,0,82,82,0,1,0,1,0,deny
57239,161,0,0,85,85,0,1,0,1,0,deny
55375,44847,0,0,62,62,0,1,0,1,0,deny
58072,445,0,0,66,66,0,1,0,1,0,drop
58069,445,0,0,66,66,0,1,0,1,0,drop
10036,44847,0,0,66,66,0,1,0,1,0,deny
59095,57470,0,0,66,66,0,1,0,1,0,deny
4876,42920,0,0,146,146,0,1,0,1,0,deny
35558,15503,0,0,66,66,0,1,0,1,0,deny
61147,22114,0,0,66,66,0,1,0,1,0,deny
57777,445,0,0,70,70,0,1,0,1,0,drop
57775,445,0,0,70,70,0,1,0,1,0,drop
8536,37965,0,0,62,62,0,1,0,1,0,deny
51300,64147,0,0,66,66,0,1,0,1,0,deny
33908,48983,0,0,145,145,0,1,0,1,0,deny
61744,11392,0,0,66,66,0,1,0,1,0,deny
62668,445,0,0,70,70,0,1,0,1,0,drop
49001,40108,0,0,161,161,0,1,0,1,0,deny
62662,445,0,0,70,70,0,1,0,1,0,drop
62658,445,0,0,70,70,0,1,0,1,0,drop
62655,445,0,0,70,70,0,1,0,1,0,drop
59985,57470,0,0,66,66,0,1,0,1,0,deny
61278,56205,0,0,66,66,0,1,0,1,0,deny
58068,445,0,0,66,66,0,1,0,1,0,drop
57771,445,0,0,70,70,0,1,0,1,0,drop
51185,37965,0,0,66,66,0,1,0,1,0,deny
45908,33330,0,0,60,60,0,1,0,1,0,deny
58059,445,0,0,66,66,0,1,0,1,0,drop
58060,445,0,0,66,66,0,1,0,1,0,drop
58054,445,0,0,66,66,0,1,0,1,0,drop
58058,445,0,0,66,66,0,1,0,1,0,drop
58057,445,0,0,66,66,0,1,0,1,0,drop
58056,445,0,0,66,66,0,1,0,1,0,drop
58053,445,0,0,66,66,0,1,0,1,0,drop
57770,445,0,0,70,70,0,1,0,1,0,drop
62651,445,0,0,70,70,0,1,0,1,0,drop
62649,445,0,0,70,70,0,1,0,1,0,drop
62648,445,0,0,70,70,0,1,0,1,0,drop
62645,445,0,0,70,70,0,1,0,1,0,drop
57765,445,0,0,70,70,0,1,0,1,0,drop
60335,443,9738,443,1853,1214,639,18,77,11,7,allow
53137,35111,13746,35111,70,70,0,2,8,2,0,allow
60241,80,52293,80,29924,6743,23181,37,150,16,21,allow
60332,443,37835,443,5413,3344,2069,32,87,16,16,allow
50574,443,63021,443,7352,1023,6329,19,16,11,8,allow
47089,15000,57898,15000,138,78,60,2,5,1,1,allow
57296,53,27311,53,771,101,670,2,30,1,1,allow
58917,53,38602,53,192,82,110,2,30,1,1,allow
59905,443,11259,443,343,163,180,6,15,3,3,allow
57239,53,63537,53,186,95,91,2,31,1,1,allow
55447,53,15473,53,1449,108,1341,4,33,2,2,allow
60259,443,51277,443,3285,2009,1276,26,150,16,10,allow
60244,443,61797,443,17829,9658,8171,92,150,46,46,allow
60235,443,27735,443,7990,1730,6260,25,151,13,12,allow
60242,80,7986,80,1493,737,756,11,150,6,5,allow
64884,53,2199,53,190,97,93,2,31,1,1,allow
63934,53,45085,53,202,103,99,2,30,1,1,allow
65218,53,11039,53,188,96,92,2,30,1,1,allow
6649,80,6649,80,103631,2766,100865,110,39,38,72,allow
56942,443,55057,443,8172,2656,5516,29,330,15,14,allow
51886,35965,55520,35965,66,66,0,1,5,1,0,allow
50573,443,27732,443,7282,953,6329,18,16,10,8,allow
60304,443,14746,443,3982,2461,1521,28,144,14,14,allow
50576,443,29225,443,7282,953,6329,18,16,10,8,allow
60262,443,35496,443,6627,1780,4847,23,149,13,10,allow
19648,7000,19648,7000,3610,2043,1567,16,15,9,7,allow
60300,80,12014,80,1343,846,497,11,145,6,5,allow
60208,80,42230,80,1313,738,575,10,152,6,4,allow
60263,443,35248,443,5889,2893,2996,45,149,24,21,allow
60225,443,43705,443,8989,3335,5654,65,152,31,34,allow
59993,80,25071,80,1883,1263,620,11,83,6,5,allow
65028,53,18830,53,182,93,89,2,30,1,1,allow
64583,53,25231,53,174,89,85,2,30,1,1,allow
49611,53,14294,53,184,94,90,2,30,1,1,allow
63910,53,63969,53,178,75,103,2,30,1,1,allow
49456,53,39013,53,198,101,97,2,31,1,1,allow
54990,53,8264,53,168,86,82,2,31,1,1,allow
65315,53,47241,53,767,102,665,2,31,1,1,allow
56115,53,48441,53,278,96,182,4,54,2,2,allow
49543,80,13855,80,1548,847,701,10,15,5,5,allow
64989,53,11063,53,578,286,292,9,15,5,4,allow
65382,53,48645,53,301,108,193,4,55,2,2,allow
53133,34853,20354,34853,758,320,438,11,16,6,5,allow
46327,25903,54070,25903,134,64,70,2,10,1,1,allow
51908,38446,5874,38446,316,136,180,6,6,3,3,allow
60258,80,44486,80,3348,2437,911,12,150,7,5,allow
60331,443,58220,443,1867,1228,639,18,87,11,7,allow
60224,443,54670,443,9079,3570,5509,68,152,34,34,allow
60209,443,58823,443,26423,2338,24085,50,152,24,26,allow
60305,80,11406,80,4419,3852,567,15,144,8,7,allow
60270,80,22290,80,1528,946,582,11,149,6,5,allow
52010,53,28769,53,218,85,133,2,30,1,1,allow
55929,53,16714,53,760,97,663,2,30,1,1,allow
55742,53,3708,53,780,93,687,2,30,1,1,allow
50938,53,64544,53,209,81,128,2,30,1,1,allow
52501,53,50653,53,201,80,121,2,30,1,1,allow
49952,53,50731,53,190,97,93,2,30,1,1,allow
52648,443,16992,443,64748,15327,49421,87,273,39,48,allow
55395,53,45676,53,767,102,665,2,31,1,1,allow
55748,53,59262,53,188,96,92,2,31,1,1,allow
56587,53,5530,53,184,94,90,2,31,1,1,allow
55605,53,8091,53,190,97,93,2,31,1,1,allow
48817,6889,48817,6889,1283,666,617,6,1200,3,3,allow
45980,443,15108,443,9611,2412,7199,44,20,22,22,allow
57912,53,13801,53,295,77,218,2,30,1,1,allow
55294,53,48651,53,295,101,194,4,30,2,2,allow
64811,53,5466,53,190,97,93,2,31,1,1,allow
49999,53,5056,53,178,91,87,2,31,1,1,allow
65496,53,42568,53,96,96,0,1,31,1,0,allow
38892,443,57044,443,83444,15305,68139,121,148,51,70,allow
55451,53,63000,53,751,95,656,2,30,1,1,allow
63950,53,13148,53,200,102,98,2,31,1,1,allow
55619,53,10755,53,182,93,89,2,31,1,1,allow
64707,53,28396,53,757,98,659,2,31,1,1,allow
55950,53,65022,53,752,93,659,2,31,1,1,allow
65209,53,6472,53,164,84,80,2,31,1,1,allow
56813,53,41752,53,753,96,657,2,31,1,1,allow
55310,53,30986,53,176,90,86,2,31,1,1,allow
55076,53,45529,53,182,93,89,2,31,1,1,allow
50516,53,48548,53,772,100,672,2,31,1,1,allow
53259,123,17557,123,184,94,90,2,31,1,1,allow
63930,443,21272,443,2940,669,2271,13,122,6,7,allow
51221,49683,21900,49683,870,330,540,12,1316,6,6,allow
30960,45731,48545,45731,330,330,0,6,3610,6,0,allow
55354,53,26809,53,212,108,104,2,31,1,1,allow
64428,53,57120,53,190,97,93,2,31,1,1,allow
55531,53,35408,53,772,100,672,2,31,1,1,allow
30960,45730,17923,45730,330,330,0,6,3610,6,0,allow
57020,36237,0,0,66,66,0,1,0,1,0,deny
22300,51505,0,0,66,66,0,1,0,1,0,deny
52036,5900,0,0,60,60,0,1,0,1,0,deny
21502,44847,0,0,66,66,0,1,0,1,0,deny
62643,445,0,0,70,70,0,1,0,1,0,drop
62640,445,0,0,70,70,0,1,0,1,0,drop
54992,53,3265,53,195,102,93,2,30,1,1,allow
58263,5223,22492,5223,3721,1173,2548,18,20,11,7,allow
60210,80,21481,80,5141,3706,1435,17,151,10,7,allow
64227,53,32450,53,245,94,151,2,30,1,1,allow
55076,53,43465,53,183,94,89,2,30,1,1,allow
49450,53,29878,53,758,102,656,2,30,1,1,allow
56820,53,17754,53,199,94,105,2,30,1,1,allow
50491,443,13045,443,11995,3850,8145,44,120,23,21,allow
54373,53,8646,53,200,86,114,2,30,1,1,allow
55221,443,65521,443,10435,2860,7575,27,46,15,12,allow
44075,80,12675,80,3560,1256,2304,22,86,10,12,allow
57432,53,35465,53,193,102,91,2,29,1,1,allow
54990,53,17689,53,168,86,82,2,29,1,1,allow
56137,53,49352,53,199,102,97,2,29,1,1,allow
49456,53,3975,53,199,102,97,2,30,1,1,allow
50063,443,44505,443,39888,5010,34878,60,104,32,28,allow
56718,80,40668,80,1462,703,759,8,15,5,3,allow
47262,443,28246,443,4609,763,3846,14,14,8,6,allow
64048,53,63585,53,326,92,234,4,31,2,2,allow
55804,53,21847,53,193,102,91,2,30,1,1,allow
50263,53,23939,53,172,94,78,2,30,1,1,allow
64070,53,45355,53,337,89,248,4,38,2,2,allow
51881,17997,36769,17997,414,136,278,6,16,3,3,allow
63888,6881,1639,6881,66,66,0,2,7,2,0,allow
49593,53,57101,53,212,94,118,2,29,1,1,allow
64583,53,3855,53,179,94,85,2,29,1,1,allow
64167,53,3978,53,211,102,109,2,29,1,1,allow
55165,53,51406,53,193,102,91,2,30,1,1,allow
59666,53,55387,53,497,118,379,2,30,1,1,allow
55165,53,23562,53,193,102,91,2,29,1,1,allow
56803,53,49854,53,195,102,93,2,29,1,1,allow
49501,53,7726,53,734,94,640,2,29,1,1,allow
55865,53,59326,53,196,102,94,2,29,1,1,allow
55745,53,9375,53,199,102,97,2,29,1,1,allow
65349,53,5493,53,284,94,190,2,29,1,1,allow
46949,53,11241,53,168,78,90,2,29,1,1,allow
63934,53,38044,53,209,110,99,2,30,1,1,allow
55865,53,56628,53,196,102,94,2,30,1,1,allow
55313,53,12662,53,168,78,90,2,29,1,1,allow
64428,53,56066,53,195,102,93,2,30,1,1,allow
58034,443,56445,443,4132,2158,1974,35,255,17,18,allow
60230,443,4763,443,1868,1229,639,18,151,11,7,allow
60248,80,33298,80,22768,6548,16220,31,149,14,17,allow
60214,80,20902,80,8317,6126,2191,23,151,14,9,allow
60292,80,43938,80,1462,864,598,11,144,6,5,allow
49761,443,53360,443,36615,5107,31508,108,125,49,59,allow
56489,53,32825,53,178,94,84,2,30,1,1,allow
58654,53,55637,53,168,78,90,2,30,1,1,allow
64155,53,12235,53,183,94,89,2,30,1,1,allow
55378,53,28719,53,277,102,175,2,30,1,1,allow
56481,53,28182,53,816,102,714,2,30,1,1,allow
58768,17,58768,17,66,66,0,1,30,1,0,allow
50363,53,11154,53,214,110,104,2,30,1,1,allow
60246,80,10832,80,17231,6415,10816,26,149,12,14,allow
60256,80,21007,80,3401,2157,1244,12,149,7,5,allow
37549,443,18373,443,203299,6930,196369,231,16,92,139,allow
58379,443,57467,443,24040,4851,19189,86,160,41,45,allow
60299,80,6795,80,1557,778,779,11,144,6,5,allow
60223,80,32982,80,17923,13519,4404,41,151,26,15,allow
47141,443,51949,443,2011,1238,773,16,330,9,7,allow
56115,53,55783,53,278,96,182,4,54,2,2,allow
37009,53,17382,53,78,78,0,1,30,1,0,allow
56948,53,61880,53,183,94,89,2,30,1,1,allow
33027,443,54809,443,3723,2408,1315,28,376,15,13,allow
43222,443,24936,443,2088188,38201,2049987,1829,84,404,1425,allow
58395,53,61283,53,307,86,221,2,30,1,1,allow
55473,53,5965,53,186,102,84,2,30,1,1,allow
55605,53,27341,53,195,102,93,2,30,1,1,allow
56948,53,22387,53,183,94,89,2,30,1,1,allow
60231,443,26634,443,1868,1229,639,18,151,11,7,allow
64739,53,37126,53,193,102,91,2,30,1,1,allow
42348,53,29230,53,199,94,105,2,30,1,1,allow
60217,80,28538,80,21163,16003,5160,47,151,30,17,allow
56489,53,51415,53,178,94,84,2,30,1,1,allow
54302,53,4566,53,168,78,90,2,30,1,1,allow
60207,80,10851,80,3596,2562,1034,14,151,8,6,allow
56304,53,20690,53,184,94,90,2,30,1,1,allow
65004,53,7635,53,261,102,159,2,30,1,1,allow
60293,80,44550,80,1462,864,598,11,144,6,5,allow
55804,53,9951,53,816,102,714,2,30,1,1,allow
6973,80,6973,80,132958,3923,129035,143,38,53,90,allow
56046,53,6511,53,193,102,91,2,31,1,1,allow
60303,443,13935,443,3928,2467,1461,27,144,14,13,allow
60229,443,63895,443,19536,7593,11943,76,151,37,39,allow
60221,80,44120,80,17981,13577,4404,41,151,26,15,allow
60298,443,32921,443,9565,3317,6248,25,144,14,11,allow
60296,80,32377,80,1463,865,598,11,144,6,5,allow
57418,53,56760,53,209,102,107,2,30,1,1,allow
47918,123,27276,123,184,94,90,2,30,1,1,allow
55748,53,60711,53,194,102,92,2,30,1,1,allow
51843,45702,23719,45702,1261,637,624,9,30,5,4,allow
50698,443,13372,443,24575,6565,18010,86,275,32,54,allow
38118,443,46227,443,70,70,0,1,5,1,0,allow
60247,80,40412,80,21505,6581,14924,31,149,14,17,allow
60218,80,20948,80,8268,6054,2214,23,151,14,9,allow
55906,53,30212,53,264,110,154,2,30,1,1,allow
55473,53,63957,53,186,102,84,2,30,1,1,allow
49999,53,61068,53,181,94,87,2,30,1,1,allow
42224,123,27890,123,184,94,90,2,30,1,1,allow
55294,53,35326,53,199,102,97,2,30,1,1,allow
65218,53,38514,53,194,102,92,2,31,1,1,allow
49755,443,49571,443,447301,17016,430285,539,128,196,343,allow
65382,53,33350,53,301,108,193,4,55,2,2,allow
46265,7700,48956,7700,1440,956,484,15,35,8,7,allow
34163,443,6967,443,5035,768,4267,14,15,8,6,allow
47261,443,56817,443,4536,845,3691,16,15,9,7,allow
57595,80,64244,80,2769,1396,1373,11,29,7,4,allow
26805,443,46763,443,7697,2940,4757,25,18,13,12,allow
55226,443,46963,443,8025,3048,4977,23,45,13,10,allow
59627,443,59627,443,4401,1494,2907,19,29,11,8,allow
56496,80,21274,80,458684,19849,438835,488,66,185,303,allow
49967,53,25418,53,193,102,91,2,31,1,1,allow
50125,443,38569,443,15687,3764,11923,32,34,18,14,allow
65340,53,2059,53,313,110,203,4,32,2,2,allow
51904,51883,62551,51883,70,70,0,2,8,2,0,allow
51887,16514,28256,16514,70,70,0,1,5,1,0,allow
63876,5968,40554,5968,70,70,0,1,4,1,0,allow
60238,80,26979,80,1176,701,475,9,150,6,3,allow
60239,443,31265,443,3149,1969,1180,19,150,11,8,allow
60250,443,56947,443,12389,5180,7209,31,149,17,14,allow
60289,80,35170,80,1928,906,1022,11,145,6,5,allow
60220,80,36816,80,21108,15948,5160,47,151,30,17,allow
60301,443,3566,443,7515,2022,5493,21,144,11,10,allow
8662,80,8662,80,194259,7011,187248,211,39,80,131,allow
64583,53,5543,53,426,89,337,4,58,2,2,allow
55786,53,25615,53,816,102,714,2,29,1,1,allow
55448,53,23931,53,184,94,90,2,29,1,1,allow
54635,53,0,0,197,86,111,2,29,1,1,allow
6932,80,6932,80,124405,3747,120658,131,38,46,85,allow
55570,53,24983,53,168,86,82,2,29,1,1,allow
65382,53,24981,53,301,108,193,4,54,2,2,allow
55010,53,35689,53,195,102,93,2,29,1,1,allow
64043,53,22374,53,320,94,226,2,29,1,1,allow
49567,53,36957,53,184,102,82,2,29,1,1,allow
55365,53,10129,53,184,94,90,2,29,1,1,allow
64352,53,14227,53,213,102,111,2,29,1,1,allow
63934,53,32673,53,209,110,99,2,29,1,1,allow
49212,53,34127,53,1188,94,1094,2,29,1,1,allow
49611,53,47629,53,184,94,90,2,29,1,1,allow
64255,53,54651,53,211,102,109,2,30,1,1,allow
55448,53,34800,53,184,94,90,2,29,1,1,allow
49952,53,48831,53,195,102,93,2,30,1,1,allow
56542,53,53986,53,183,94,89,2,29,1,1,allow
56739,53,42182,53,195,102,93,2,30,1,1,allow
56015,53,39973,53,195,102,93,2,30,1,1,allow
56739,53,65216,53,195,102,93,2,30,1,1,allow
64502,53,56214,53,199,102,97,2,30,1,1,allow
54560,53,54560,53,832,106,726,2,30,1,1,allow
55556,53,12940,53,302,78,224,2,30,1,1,allow
64739,53,1998,53,816,102,714,2,30,1,1,allow
49742,53,40944,53,790,110,680,2,30,1,1,allow
56434,53,28860,53,316,94,222,2,30,1,1,allow
50363,53,62670,53,214,110,104,2,30,1,1,allow
55294,53,55276,53,199,102,97,2,30,1,1,allow
49518,53,16482,53,193,102,91,2,30,1,1,allow
56332,443,3765,443,6028,1958,4070,34,124,14,20,allow
38175,443,55489,443,10208,2219,7989,37,125,19,18,allow
37965,51498,7708,51498,158,158,0,1,1199,1,0,allow
55877,53546,37144,53546,481,150,331,2,1200,1,1,allow
60290,80,20522,80,1366,785,581,11,145,6,5,allow
60297,80,29320,80,1463,865,598,11,144,6,5,allow
55650,18073,23998,18073,504,318,186,8,15,5,3,allow
51966,443,48480,443,130,70,60,2,15,1,1,allow
46155,443,27543,443,206090,6478,199612,211,170,69,142,allow
47971,443,15056,443,130,70,60,2,15,1,1,allow
63934,53,27798,53,347,103,244,4,46,2,2,allow
56115,53,39416,53,278,96,182,4,53,2,2,allow
64502,53,21170,53,199,102,97,2,30,1,1,allow
49243,53,10757,53,452,118,334,2,30,1,1,allow
55365,53,26447,53,184,94,90,2,30,1,1,allow
64854,53,19682,53,178,94,84,2,31,1,1,allow
65343,53,2539,53,184,94,90,2,31,1,1,allow
56288,53,3353,53,200,102,98,2,30,1,1,allow
56385,53,62602,53,402,142,260,2,30,1,1,allow
48733,443,64638,443,316457,19287,297170,382,80,157,225,allow
56365,80,15105,80,1636,699,937,10,15,5,5,allow
51903,35904,6046,35904,70,70,0,2,8,2,0,allow
60232,443,3016,443,1868,1229,639,18,151,11,7,allow
60215,80,6497,80,21073,15881,5192,47,151,30,17,allow
60219,80,48945,80,1987,1593,394,10,151,6,4,allow
60245,80,28831,80,14705,6415,8290,26,149,12,14,allow
60249,80,1265,80,31138,6772,24366,40,149,17,23,allow
60294,80,59530,80,1463,865,598,11,144,6,5,allow
49933,53,13874,53,186,102,84,2,30,1,1,allow
54992,53,62120,53,195,102,93,2,30,1,1,allow
63950,53,31406,53,200,102,98,2,30,1,1,allow
57378,53,5726,53,350,94,256,2,30,1,1,allow
49611,53,14406,53,184,94,90,2,30,1,1,allow
56046,53,40264,53,193,102,91,2,30,1,1,allow
37511,443,37511,443,4673,1766,2907,19,26,11,8,allow
64502,53,7896,53,374,101,273,4,42,2,2,allow
50123,443,58250,443,15011,5619,9392,50,35,26,24,allow
60216,80,20321,80,3606,2572,1034,14,151,8,6,allow
60222,80,61233,80,1989,1365,624,11,151,6,5,allow
60284,80,50056,80,1430,754,676,11,146,6,5,allow
7030,80,7030,80,115811,3862,111949,123,38,44,79,allow
49791,53,47745,53,226,94,132,2,30,1,1,allow
40755,123,40939,123,184,94,90,2,30,1,1,allow
36307,53,54070,53,200,86,114,2,30,1,1,allow
52804,443,52702,443,70,70,0,2,154,2,0,allow
55505,53,30588,53,199,102,97,2,31,1,1,allow
54990,53,35409,53,168,86,82,2,31,1,1,allow
56369,53,3077,53,193,102,91,2,31,1,1,allow
59630,443,48650,443,3304,1468,1836,18,139,10,8,allow
56854,17067,53674,17067,70,70,0,2,8,2,0,allow
53135,14297,49248,14297,70,70,0,1,5,1,0,allow
34162,443,17948,443,4897,850,4047,15,15,9,6,allow
60234,80,15861,80,1131,772,359,10,151,6,4,allow
60295,80,60202,80,8876,1061,7815,18,144,9,9,allow
52325,443,28114,443,3188,1601,1587,34,48,18,16,allow
60213,80,54393,80,47483,13980,33503,69,151,35,34,allow
60228,80,30633,80,6854,6211,643,16,151,9,7,allow
9291,80,9291,80,208056,7568,200488,227,39,88,139,allow
57528,53,37207,53,585,192,393,6,54,3,3,allow
57382,53,15348,53,969,86,883,2,30,1,1,allow
55146,53,34694,53,181,94,87,2,30,1,1,allow
64884,53,3518,53,195,102,93,2,30,1,1,allow
56754,53,65237,53,183,94,89,2,30,1,1,allow
63951,53,30484,53,193,102,91,2,30,1,1,allow
65209,53,36498,53,166,86,80,2,30,1,1,allow
57432,53,25990,53,193,102,91,2,30,1,1,allow
64385,53,43683,53,179,94,85,2,30,1,1,allow
56587,53,37194,53,184,94,90,2,30,1,1,allow
55310,53,16833,53,180,94,86,2,30,1,1,allow
56481,53,4723,53,193,102,91,2,30,1,1,allow
64762,53,50554,53,194,102,92,2,30,1,1,allow
55310,53,54071,53,180,94,86,2,30,1,1,allow
49767,53,22379,53,177,94,83,2,31,1,1,allow
36126,53,44357,53,326,78,248,2,31,1,1,allow
50779,443,59788,443,16067,4838,11229,43,121,21,22,allow
60794,443,17248,443,796772,27151,769621,878,137,302,576,allow
46337,443,56368,443,10379011,159069,10219942,8727,252,1321,7406,allow
37965,50321,10306,50321,158,158,0,1,1199,1,0,allow
63950,53,19633,53,200,102,98,2,30,1,1,allow
51607,53,31322,53,296,94,202,2,30,1,1,allow
55619,53,46483,53,183,94,89,2,30,1,1,allow
64132,53,11636,53,179,94,85,2,30,1,1,allow
55866,53,0,0,86,86,0,1,30,1,0,allow
64884,53,55819,53,195,102,93,2,31,1,1,allow
55076,53,14239,53,183,94,89,2,30,1,1,allow
55373,53,47253,53,164,86,78,2,31,1,1,allow
55373,53,29623,53,164,86,78,2,30,1,1,allow
50002,53,11892,53,196,102,94,2,31,1,1,allow
62458,53,43371,53,429,102,327,2,31,1,1,allow
56587,53,64159,53,184,94,90,2,31,1,1,allow
64762,53,20987,53,194,102,92,2,31,1,1,allow
56560,53,21034,53,198,102,96,2,31,1,1,allow
56975,53,65042,53,197,102,95,2,31,1,1,allow
57239,53,14403,53,193,102,91,2,31,1,1,allow
50967,443,6506,443,612314,25589,586725,676,127,234,442,allow
50969,443,44036,443,7221,2265,4956,16,127,7,9,allow
37965,23215,60797,23215,537,158,379,2,1199,1,1,allow
45409,53,56925,53,307,86,221,2,31,1,1,allow
65224,53,24023,53,994,86,908,2,31,1,1,allow
58476,443,24063,443,25370,5607,19763,40,138,18,22,allow
64569,53,2461,53,214,102,112,2,31,1,1,allow
61191,443,24135,443,569471,20976,548495,666,333,273,393,allow
51634,443,38565,443,3174,346,2828,12,121,5,7,allow
42820,443,40301,443,20255,5440,14815,32,122,16,16,allow
37965,51413,17500,51413,848,252,596,4,1199,2,2,allow
43904,443,27046,443,7552,2611,4941,24,360,13,11,allow
40214,443,5611,443,3910,2223,1687,24,3676,8,16,allow
56288,53,26260,53,200,102,98,2,31,1,1,allow
55748,53,57713,53,194,102,92,2,31,1,1,allow
51843,80,51843,80,35384,3225,32159,49,26,20,29,allow
38290,443,29490,443,6978,1169,5809,22,163,12,10,allow
49942,53,42847,53,264,94,170,2,31,1,1,allow
64132,53,36663,53,179,94,85,2,31,1,1,allow
51444,3027,51444,3027,156,156,0,3,8,3,0,allow
65209,53,37823,53,166,86,80,2,31,1,1,allow
51616,443,56570,443,62241,4598,57643,82,170,35,47,allow
51845,80,51845,80,28037,2069,25968,40,26,16,24,allow
63580,443,12197,443,5759,1721,4038,20,78,11,9,allow
62639,445,0,0,70,70,0,1,0,1,0,drop
33627,36237,0,0,66,66,0,1,0,1,0,deny
58043,445,0,0,66,66,0,1,0,1,0,drop
23900,64147,0,0,62,62,0,1,0,1,0,deny
62636,445,0,0,70,70,0,1,0,1,0,drop
33651,36237,0,0,146,146,0,1,0,1,0,deny
4760,44847,0,0,62,62,0,1,0,1,0,deny
32051,37965,0,0,62,62,0,1,0,1,0,deny
58042,445,0,0,66,66,0,1,0,1,0,drop
21179,44847,0,0,146,146,0,1,0,1,0,deny
58040,445,0,0,66,66,0,1,0,1,0,drop
6224,37965,0,0,62,62,0,1,0,1,0,deny
58039,445,0,0,66,66,0,1,0,1,0,drop
27402,37965,0,0,66,66,0,1,0,1,0,deny
58036,445,0,0,66,66,0,1,0,1,0,drop
57752,445,0,0,70,70,0,1,0,1,0,drop
26229,21247,0,0,66,66,0,1,0,1,0,deny
57151,39004,0,0,66,66,0,1,0,1,0,deny
57749,445,0,0,70,70,0,1,0,1,0,drop
62635,445,0,0,70,70,0,1,0,1,0,drop
62625,445,0,0,70,70,0,1,0,1,0,drop
62624,445,0,0,70,70,0,1,0,1,0,drop
31136,50584,0,0,146,146,0,1,0,1,0,deny
61522,64147,0,0,66,66,0,1,0,1,0,deny
37121,21247,0,0,66,66,0,1,0,1,0,deny
26048,21,0,0,60,60,0,1,0,1,0,deny
58026,445,0,0,66,66,0,1,0,1,0,drop
42044,60043,0,0,66,66,0,1,0,1,0,deny
57745,445,0,0,70,70,0,1,0,1,0,drop
43868,23,0,0,60,60,0,1,0,1,0,deny
15333,44847,0,0,62,62,0,1,0,1,0,deny
57743,445,0,0,70,70,0,1,0,1,0,drop
57741,445,0,0,70,70,0,1,0,1,0,drop
58018,445,0,0,66,66,0,1,0,1,0,drop
62608,445,0,0,70,70,0,1,0,1,0,drop
62849,62413,0,0,62,62,0,1,0,1,0,deny
65529,35440,0,0,62,62,0,1,0,1,0,deny
58016,445,0,0,66,66,0,1,0,1,0,drop
57734,445,0,0,70,70,0,1,0,1,0,drop
57732,445,0,0,70,70,0,1,0,1,0,drop
27528,35440,0,0,66,66,0,1,0,1,0,deny
60361,57470,0,0,66,66,0,1,0,1,0,deny
58007,445,0,0,66,66,0,1,0,1,0,drop
56381,51505,0,0,62,62,0,1,0,1,0,deny
5462,21247,0,0,66,66,0,1,0,1,0,deny
57998,445,0,0,66,66,0,1,0,1,0,drop
51401,6881,0,0,66,66,0,1,0,1,0,deny
57731,445,0,0,70,70,0,1,0,1,0,drop
57730,445,0,0,70,70,0,1,0,1,0,drop
57729,445,0,0,70,70,0,1,0,1,0,drop
57726,445,0,0,70,70,0,1,0,1,0,drop
57723,445,0,0,70,70,0,1,0,1,0,drop
31748,56205,0,0,62,62,0,1,0,1,0,deny
30303,30303,0,0,181,181,0,1,0,1,0,deny
49329,443,27397,443,460,394,66,4,0,3,1,allow
57711,445,0,0,70,70,0,1,0,1,0,drop
57710,445,0,0,70,70,0,1,0,1,0,drop
62599,445,0,0,70,70,0,1,0,1,0,drop
62597,445,0,0,70,70,0,1,0,1,0,drop
62596,445,0,0,70,70,0,1,0,1,0,drop
57706,445,0,0,70,70,0,1,0,1,0,drop
48676,53395,0,0,60,60,0,1,0,1,0,deny
64891,22,0,0,60,60,0,1,0,1,0,deny
57993,445,0,0,66,66,0,1,0,1,0,drop
57987,445,0,0,66,66,0,1,0,1,0,drop
57992,445,0,0,66,66,0,1,0,1,0,drop
57988,445,0,0,66,66,0,1,0,1,0,drop
57986,445,0,0,66,66,0,1,0,1,0,drop
57989,445,0,0,66,66,0,1,0,1,0,drop
57985,445,0,0,66,66,0,1,0,1,0,drop
57990,445,0,0,66,66,0,1,0,1,0,drop
57700,445,0,0,70,70,0,1,0,1,0,drop
57701,445,0,0,70,70,0,1,0,1,0,drop
47105,64147,0,0,62,62,0,1,0,1,0,deny
27537,25198,0,0,148,148,0,1,0,1,0,deny
63171,2323,0,0,60,60,0,1,0,1,0,deny
59626,22114,0,0,66,66,0,1,0,1,0,deny
22130,61248,0,0,159,159,0,1,0,1,0,reset-both
56794,46824,0,0,66,66,0,1,0,1,0,deny
48488,50584,0,0,62,62,0,1,0,1,0,deny
58664,64147,0,0,62,62,0,1,0,1,0,deny
19617,39004,0,0,145,145,0,1,0,1,0,deny
50644,35440,0,0,66,66,0,1,0,1,0,deny
61135,50265,0,0,62,62,0,1,0,1,0,deny
57689,445,0,0,70,70,0,1,0,1,0,drop
16760,10214,0,0,62,62,0,1,0,1,0,deny
62595,445,0,0,70,70,0,1,0,1,0,drop
62591,445,0,0,70,70,0,1,0,1,0,drop
62579,445,0,0,70,70,0,1,0,1,0,drop
62581,445,0,0,70,70,0,1,0,1,0,drop
65317,51221,0,0,78,78,0,1,0,1,0,deny
63341,53,0,0,77,77,0,1,0,1,0,deny
41429,50584,0,0,66,66,0,1,0,1,0,deny
57972,445,0,0,66,66,0,1,0,1,0,drop
57973,445,0,0,66,66,0,1,0,1,0,drop
57970,445,0,0,66,66,0,1,0,1,0,drop
46286,21247,0,0,62,62,0,1,0,1,0,deny
38538,22,0,0,60,60,0,1,0,1,0,deny
62577,445,0,0,70,70,0,1,0,1,0,drop
57685,445,0,0,70,70,0,1,0,1,0,drop
47682,64147,0,0,66,66,0,1,0,1,0,deny
62568,445,0,0,70,70,0,1,0,1,0,drop
62570,445,0,0,70,70,0,1,0,1,0,drop
62571,445,0,0,70,70,0,1,0,1,0,drop
14844,37965,0,0,62,62,0,1,0,1,0,deny
12465,11392,0,0,62,62,0,1,0,1,0,deny
57676,445,0,0,70,70,0,1,0,1,0,drop
57673,445,0,0,70,70,0,1,0,1,0,drop
57675,445,0,0,70,70,0,1,0,1,0,drop
6014,37965,0,0,62,62,0,1,0,1,0,deny
57672,445,0,0,70,70,0,1,0,1,0,drop
57669,445,0,0,70,70,0,1,0,1,0,drop
13285,29892,0,0,145,145,0,1,0,1,0,deny
13285,29892,0,0,145,145,0,1,0,1,0,deny
1373,22114,0,0,62,62,0,1,0,1,0,deny
62089,8604,0,0,66,66,0,1,0,1,0,deny
14343,6881,0,0,146,146,0,1,0,1,0,deny
51592,51505,0,0,66,66,0,1,0,1,0,deny
43724,35440,0,0,62,62,0,1,0,1,0,deny
65085,22114,0,0,66,66,0,1,0,1,0,deny
62559,445,0,0,70,70,0,1,0,1,0,drop
62556,445,0,0,70,70,0,1,0,1,0,drop
62552,445,0,0,70,70,0,1,0,1,0,drop
43723,5900,0,0,60,60,0,1,0,1,0,deny
57662,445,0,0,70,70,0,1,0,1,0,drop
30274,23,0,0,60,60,0,1,0,1,0,deny
23126,35440,0,0,62,62,0,1,0,1,0,deny
993,4543,0,0,66,66,0,1,0,1,0,deny
57387,70,0,0,60,60,0,1,0,1,0,deny
49001,40108,0,0,161,161,0,1,0,1,0,deny
57655,445,0,0,70,70,0,1,0,1,0,drop
57653,445,0,0,70,70,0,1,0,1,0,drop
57949,445,0,0,66,66,0,1,0,1,0,drop
5617,64147,0,0,62,62,0,1,0,1,0,deny
62549,445,0,0,70,70,0,1,0,1,0,drop
62548,445,0,0,70,70,0,1,0,1,0,drop
57649,445,0,0,70,70,0,1,0,1,0,drop
57942,445,0,0,66,66,0,1,0,1,0,drop
57941,445,0,0,66,66,0,1,0,1,0,drop
57647,445,0,0,70,70,0,1,0,1,0,drop
12242,51221,0,0,62,62,0,1,0,1,0,deny
993,18732,0,0,129,129,0,1,0,1,0,deny
51581,17546,0,0,66,66,0,1,0,1,0,deny
64762,53,32990,53,188,96,92,2,30,1,1,allow
65343,53,10337,53,184,94,90,2,30,1,1,allow
64132,53,9025,53,174,89,85,2,30,1,1,allow
56369,53,8270,53,186,95,91,2,31,1,1,allow
64327,53,33651,53,204,104,100,2,31,1,1,allow
56288,53,45590,53,200,102,98,2,31,1,1,allow
49558,53,59753,53,186,95,91,2,30,1,1,allow
65386,53,20616,53,762,101,661,2,30,1,1,allow
64385,53,34139,53,174,89,85,2,30,1,1,allow
51885,64546,12386,64546,66,66,0,1,5,1,0,allow
60378,443,48147,443,22073,10774,11299,48,107,26,22,allow
55660,53,37547,53,757,98,659,2,30,1,1,allow
51840,80,51840,80,525257,17273,507984,531,26,183,348,allow
51839,80,51839,80,951054,20747,930307,902,26,276,626,allow
55005,443,32809,443,134,60,74,3,11,2,1,allow
56219,53,32903,53,762,101,661,2,31,1,1,allow
49518,53,63252,53,186,95,91,2,30,1,1,allow
55396,53,1903,53,778,103,675,2,30,1,1,allow
51830,443,51830,443,17899,5015,12884,33,36,14,19,allow
62453,443,7833,443,8698,3272,5426,22,26,11,11,allow
58370,443,50234,443,6277528,124223,6153305,5970,160,1890,4080,allow
55649,42266,57482,42266,70,70,0,1,5,1,0,allow
53134,42369,37708,42369,70,70,0,1,5,1,0,allow
65264,53,54273,53,88,88,0,1,30,1,0,allow
64122,53,44861,53,212,108,104,2,31,1,1,allow
55175,80,55175,80,7452,1052,6400,20,22,11,9,allow
40545,443,53543,443,8691,6945,1746,25,80,14,11,allow
52787,443,46630,443,352,218,134,6,28,4,2,allow
39513,443,6930,443,16012,10450,5562,33,80,18,15,allow
56268,443,24537,443,10226,4435,5791,50,256,24,26,allow
50474,80,50474,80,4994,855,4139,14,21,7,7,allow
51899,47537,54934,47537,70,70,0,2,8,2,0,allow
49273,7000,49273,7000,2163,676,1487,14,15,7,7,allow
49512,443,62361,443,12472,1628,10844,35,195,16,19,allow
65422,53,10168,53,753,96,657,2,30,1,1,allow
64854,53,42024,53,172,88,84,2,30,1,1,allow
64595,53,56793,53,182,93,89,2,30,1,1,allow
49174,53,58915,53,198,101,97,2,30,1,1,allow
64888,60038,0,0,66,66,0,1,91,1,0,allow
51221,63128,42268,63128,480,149,331,2,1201,1,1,allow
56046,53,4218,53,186,95,91,2,31,1,1,allow
49160,50321,21626,50321,150,150,0,2,1200,2,0,allow
56975,53,53582,53,194,99,95,2,30,1,1,allow
50002,53,33820,53,192,98,94,2,31,1,1,allow
56560,53,34693,53,196,100,96,2,31,1,1,allow
49800,53,22865,53,182,93,89,2,31,1,1,allow
49967,53,41633,53,186,95,91,2,31,1,1,allow
55125,53,57418,53,170,87,83,2,31,1,1,allow
49767,53,46615,53,200,102,98,2,31,1,1,allow
57083,53,25967,53,196,100,96,2,31,1,1,allow
56561,53,4757,53,166,85,81,2,31,1,1,allow
49262,53,27998,53,168,86,82,2,31,1,1,allow
65307,53,2186,53,184,94,90,2,31,1,1,allow
55265,53,19057,53,740,93,647,2,31,1,1,allow
49531,53,21298,53,740,93,647,2,31,1,1,allow
15503,42286,2173,42286,480,149,331,2,1200,1,1,allow
58988,443,31183,443,4330,1777,2553,18,122,9,9,allow
56955,53,2081,53,182,93,89,2,31,1,1,allow
55760,53,53617,53,180,92,88,2,31,1,1,allow
49752,53,46099,53,180,92,88,2,31,1,1,allow
54351,443,26403,443,7900,2042,5858,27,36,15,12,allow
50557,53,32584,53,758,93,665,2,31,1,1,allow
56589,53,29325,53,198,101,97,2,31,1,1,allow
35608,443,39608,443,5007,3053,1954,24,394,8,16,allow
62670,443,51023,443,6179,3326,2853,26,186,12,14,allow
44884,443,19838,443,36435,28844,7591,65,396,35,30,allow
59242,443,7294,443,7192,2002,5190,24,360,11,13,allow
57643,445,0,0,70,70,0,1,0,1,0,drop
6889,48817,0,0,143,143,0,1,0,1,0,deny
62528,445,0,0,70,70,0,1,0,1,0,drop
62530,445,0,0,70,70,0,1,0,1,0,drop
62527,445,0,0,70,70,0,1,0,1,0,drop
32342,62413,0,0,66,66,0,1,0,1,0,deny
55733,51505,0,0,66,66,0,1,0,1,0,deny
57937,445,0,0,66,66,0,1,0,1,0,drop
53971,50265,0,0,66,66,0,1,0,1,0,deny
57642,445,0,0,70,70,0,1,0,1,0,drop
59511,21247,0,0,62,62,0,1,0,1,0,deny
57926,445,0,0,66,66,0,1,0,1,0,drop
57929,445,0,0,66,66,0,1,0,1,0,drop
57927,445,0,0,66,66,0,1,0,1,0,drop
57934,445,0,0,66,66,0,1,0,1,0,drop
57933,445,0,0,66,66,0,1,0,1,0,drop
57928,445,0,0,66,66,0,1,0,1,0,drop
57924,445,0,0,66,66,0,1,0,1,0,drop
64122,53,29748,53,214,110,104,2,30,1,1,allow
65343,53,12113,53,184,94,90,2,30,1,1,allow
62524,445,0,0,70,70,0,1,0,1,0,drop
62521,445,0,0,70,70,0,1,0,1,0,drop
62517,445,0,0,70,70,0,1,0,1,0,drop
62519,445,0,0,70,70,0,1,0,1,0,drop
63589,44847,0,0,66,66,0,1,0,1,0,deny
57637,445,0,0,70,70,0,1,0,1,0,drop
56418,41615,0,0,143,143,0,1,0,1,0,deny
51259,1433,0,0,60,60,0,1,0,1,0,deny
27869,51221,0,0,66,66,0,1,0,1,0,deny
6546,37965,0,0,62,62,0,1,0,1,0,deny
26448,41864,0,0,145,145,0,1,0,1,0,deny
11066,50584,0,0,66,66,0,1,0,1,0,deny
50292,22114,0,0,66,66,0,1,0,1,0,deny
44821,64147,0,0,62,62,0,1,0,1,0,deny
13968,29376,0,0,62,62,0,1,0,1,0,reset-both
54778,22114,0,0,62,62,0,1,0,1,0,deny
8486,56205,0,0,62,62,0,1,0,1,0,deny
62516,445,0,0,70,70,0,1,0,1,0,drop
62512,445,0,0,70,70,0,1,0,1,0,drop
62509,445,0,0,70,70,0,1,0,1,0,drop
32156,51505,0,0,146,146,0,1,0,1,0,deny
57918,445,0,0,66,66,0,1,0,1,0,drop
62508,445,0,0,70,70,0,1,0,1,0,drop
7181,64147,0,0,66,66,0,1,0,1,0,deny
64603,53,6564,53,258,102,156,2,30,1,1,allow
36531,443,53488,443,123782,10685,113097,157,180,65,92,allow
54982,53,55508,53,282,96,186,4,48,2,2,allow
45525,53,45525,53,469,165,304,4,30,2,2,allow
49406,53,22949,53,215,102,113,2,30,1,1,allow
64982,53,55675,53,215,102,113,2,30,1,1,allow
65172,53,25157,53,306,110,196,2,30,1,1,allow
49262,53,60170,53,168,86,82,2,30,1,1,allow
49603,53,29581,53,199,102,97,2,30,1,1,allow
53248,443,60652,443,532222,22112,510110,645,232,259,386,allow
38370,443,49097,443,9194,5026,4168,24,32,11,13,allow
55625,443,33412,443,96323,4044,92279,113,139,44,69,allow
55165,53,3036,53,193,102,91,2,29,1,1,allow
55605,53,24748,53,195,102,93,2,29,1,1,allow
50339,53,28610,53,498,204,294,6,29,3,3,allow
64811,53,22274,53,195,102,93,2,29,1,1,allow
64233,53,2922,53,257,126,131,2,29,1,1,allow
50289,443,30139,443,9571,2811,6760,45,87,24,21,allow
54989,443,3314,443,7745,2583,5162,27,100,15,12,allow
65382,53,20387,53,301,108,193,4,54,2,2,allow
50578,123,63477,123,184,94,90,2,30,1,1,allow
50258,443,57201,443,7975,1974,6001,31,210,15,16,allow
43220,443,18756,443,3178535,62767,3115768,2800,83,626,2174,allow
47817,443,22532,443,190,70,120,4,14,2,2,allow
38291,443,42711,443,6737,1006,5731,20,162,11,9,allow
42980,80,62897,80,944,529,415,11,315,6,5,allow
58363,443,44841,443,46992,4773,42219,89,160,36,53,allow
36325,443,45107,443,2930,1614,1316,16,249,9,7,allow
55220,80,9309,80,1146,606,540,8,45,5,3,allow
53710,27935,28057,27935,70,70,0,2,7,2,0,allow
55222,443,38278,443,5312,1510,3802,18,45,11,7,allow
55219,443,55870,443,6528,1918,4610,23,45,13,10,allow
60772,40010,29000,40010,316,136,180,6,5,3,3,allow
38368,443,41740,443,4392,1164,3228,17,34,9,8,allow
51907,47518,40645,47518,316,136,180,6,5,3,3,allow
53713,26085,43109,26085,70,70,0,2,7,2,0,allow
33069,80,38685,80,1899,1172,727,17,284,10,7,allow
64275,53,47631,53,324,90,234,4,35,2,2,allow
39208,5900,39208,5900,152,66,86,2,10,1,1,allow
51500,993,4543,993,14747,5073,9674,109,45,51,58,allow
42385,443,44650,443,26481,1832,24649,40,330,18,22,allow
36108,8245,12106,8245,280,214,66,2,29,1,1,allow
64132,53,49481,53,179,94,85,2,29,1,1,allow
65343,53,41692,53,184,94,90,2,29,1,1,allow
55599,53,39999,53,258,94,164,2,29,1,1,allow
50263,53,56865,53,164,86,78,2,29,1,1,allow
49381,53,64109,53,230,102,128,2,29,1,1,allow
64276,53,39382,53,197,102,95,2,29,1,1,allow
55354,53,62421,53,214,110,104,2,30,1,1,allow
49548,53,36556,53,198,94,104,2,29,1,1,allow
49952,53,64431,53,195,102,93,2,29,1,1,allow
51979,80,28537,80,6083,699,5384,14,46,7,7,allow
51965,80,35850,80,106904,5958,100946,139,66,62,77,allow
55821,53,65311,53,196,102,94,2,31,1,1,allow
64304,53,40913,53,1054,293,761,8,94,4,4,allow
62456,443,40302,443,8678,3253,5425,22,25,11,11,allow
49948,80,2205,80,19740,993,18747,28,15,12,16,allow
49862,53,51904,53,194,102,92,2,30,1,1,allow
64935,53,3553,53,198,102,96,2,30,1,1,allow
55076,53,24944,53,183,94,89,2,30,1,1,allow
65251,53,19717,53,819,102,717,2,30,1,1,allow
35824,443,2741,443,7237,2204,5033,15,120,7,8,allow
42289,443,63031,443,6827,1776,5051,26,121,13,13,allow
55052,53,42687,53,198,102,96,2,30,1,1,allow
65307,53,63090,53,184,94,90,2,30,1,1,allow
49174,53,59747,53,199,102,97,2,33,1,1,allow
55748,443,39721,443,21446,1599,19847,35,154,16,19,allow
49904,53,21659,53,749,94,655,2,30,1,1,allow
55354,53,63415,53,214,110,104,2,30,1,1,allow
49947,80,44031,80,362232,10443,351789,387,15,147,240,allow
50305,53,38735,53,209,110,99,2,30,1,1,allow
42904,53,51732,53,308,118,190,2,30,1,1,allow
55114,443,11994,443,14680,6119,8561,35,152,16,19,allow
54953,443,55555,443,9996,2043,7953,42,271,20,22,allow
56786,53,1954,53,194,102,92,2,30,1,1,allow
37067,443,4326,443,21446,1599,19847,35,155,16,19,allow
59834,80,63639,80,943291,17238,926053,869,72,249,620,allow
64854,53,27051,53,178,94,84,2,30,1,1,allow
55236,53,57748,53,216,102,114,2,30,1,1,allow
57315,443,45136,443,77504,4494,73010,112,200,54,58,allow
59773,53,31376,53,193,94,99,2,30,1,1,allow
55036,53,3360,53,177,94,83,2,30,1,1,allow
49999,53,62191,53,316,91,225,4,46,2,2,allow
49198,53,53619,53,308,118,190,2,30,1,1,allow
60381,443,9520,443,24271,17315,6956,53,107,34,19,allow
35201,53,32554,53,308,118,190,2,30,1,1,allow
56786,53,65502,53,817,102,715,2,30,1,1,allow
65251,53,30637,53,196,102,94,2,30,1,1,allow
50615,53,31516,53,785,110,675,2,30,1,1,allow
49360,53,51221,53,321,102,219,2,30,1,1,allow
55619,53,64151,53,183,94,89,2,30,1,1,allow
64684,53,23170,53,199,94,105,2,30,1,1,allow
64385,53,23181,53,179,94,85,2,30,1,1,allow
41641,443,28317,443,13106,6413,6693,24,121,12,12,allow
51973,80,59636,80,21570,1613,19957,33,54,16,17,allow
51966,80,56206,80,83302,3780,79522,105,66,47,58,allow
59874,443,18993,443,1066,545,521,11,28,5,6,allow
56637,80,52477,80,234,234,0,4,12,4,0,allow
56846,26665,43590,26665,70,70,0,1,5,1,0,allow
47258,443,16882,443,50898,2733,48165,73,218,33,40,allow
49946,80,45099,80,31517,1203,30314,38,15,15,23,allow
49943,80,26149,80,10767,783,9984,19,15,9,10,allow
57007,5333,59200,5333,7194101,1949033,5245068,50585,1008,24913,25672,allow
45525,53,45525,53,86,86,0,1,30,1,0,allow
55354,53,21132,53,214,110,104,2,30,1,1,allow
56955,53,1466,53,183,94,89,2,30,1,1,allow
50305,53,8454,53,209,110,99,2,30,1,1,allow
49514,443,28704,443,28361,1861,26500,49,195,19,30,allow
40527,443,2355,443,21750,1903,19847,39,154,20,19,allow
56687,443,11163,443,21086,2515,18571,42,25,21,21,allow
62454,443,55667,443,18884,4117,14767,37,25,16,21,allow
51929,80,26646,80,1213,821,392,8,15,6,2,allow
45300,443,4696,443,11748,7422,4326,59,113,31,28,allow
55564,80,32717,80,944,529,415,11,315,6,5,allow
64854,53,60425,53,178,94,84,2,30,1,1,allow
65486,53,61924,53,216,102,114,2,30,1,1,allow
64327,53,41700,53,210,110,100,2,30,1,1,allow
55605,53,6586,53,195,102,93,2,30,1,1,allow
57008,123,60959,123,184,94,90,2,30,1,1,allow
33706,80,48762,80,1265,473,792,8,15,5,3,allow
38700,443,49227,443,130,70,60,2,14,1,1,allow
50711,443,57174,443,7240,2265,4975,24,351,13,11,allow
42595,443,30091,443,190565,9979,180586,272,244,140,132,allow
49456,53,22820,53,308,101,207,4,32,2,2,allow
55740,8060,29494,8060,70,70,0,2,7,2,0,allow
51884,22828,1526,22828,70,70,0,1,5,1,0,allow
53249,443,17659,443,3292049,87705,3204344,3470,232,1188,2282,allow
36471,443,15597,443,83203,3599,79604,101,138,41,60,allow
62455,443,9859,443,8302,2895,5407,22,25,11,11,allow
49952,80,46004,80,4023,620,3403,14,15,7,7,allow
35991,443,26374,443,190,70,120,4,14,2,2,allow
51844,80,51844,80,72734,3432,69302,83,25,31,52,allow
51842,80,51842,80,407760,15074,392686,424,25,154,270,allow
50172,443,57262,443,130,70,60,2,14,1,1,allow
63863,34678,27822,34678,504,382,122,8,15,6,2,allow
51974,80,47213,80,38272,2881,35391,54,54,26,28,allow
53714,6882,37422,6882,70,70,0,2,7,2,0,allow
56369,53,59261,53,193,102,91,2,29,1,1,allow
55865,53,14766,53,325,98,227,4,40,2,2,allow
65447,53,50068,53,277,102,175,2,29,1,1,allow
49951,80,47463,80,38898,1623,37275,49,15,21,28,allow
29677,53,29677,53,218,90,128,2,29,1,1,allow
55294,53,64912,53,199,102,97,2,29,1,1,allow
56292,53,0,0,238,94,144,2,29,1,1,allow
64621,53,52780,53,387,134,253,2,29,1,1,allow
64428,53,23839,53,621,196,425,6,59,3,3,allow
49767,53,20343,53,177,94,83,2,29,1,1,allow
55619,53,44719,53,183,94,89,2,29,1,1,allow
65007,53,49517,53,330,94,236,4,55,2,2,allow
64595,53,56897,53,183,94,89,2,29,1,1,allow
64327,53,51961,53,210,110,100,2,30,1,1,allow
54992,53,53080,53,195,102,93,2,29,1,1,allow
49558,53,38507,53,193,102,91,2,29,1,1,allow
56489,53,35362,53,178,94,84,2,29,1,1,allow
55365,53,11222,53,214,110,104,2,29,1,1,allow
65221,53,38871,53,258,102,156,2,29,1,1,allow
64852,53,7184,53,248,102,146,2,29,1,1,allow
49999,53,13553,53,181,94,87,2,29,1,1,allow
55365,53,5213,53,214,110,104,2,29,1,1,allow
55505,53,4978,53,199,102,97,2,29,1,1,allow
56399,53,36148,53,498,204,294,6,29,3,3,allow
56975,53,38883,53,197,102,95,2,29,1,1,allow
55052,53,1245,53,198,102,96,2,30,1,1,allow
65411,53,34611,53,354,102,252,2,30,1,1,allow
64962,53,10417,53,196,94,102,2,30,1,1,allow
57005,53,13005,53,199,94,105,2,30,1,1,allow
49848,53,31476,53,167,86,81,2,30,1,1,allow
55760,53,12734,53,182,94,88,2,30,1,1,allow
64122,53,40984,53,214,110,104,2,30,1,1,allow
52566,443,55072,443,8594,1042,7552,16,120,7,9,allow
51629,443,13664,443,19743,2133,17610,32,187,11,21,allow
52100,443,14481,443,7711,1717,5994,26,361,13,13,allow
49301,53,26968,53,353,118,235,2,31,1,1,allow
44721,443,28122,443,24317,1518,22799,38,218,16,22,allow
63950,53,3217,53,348,102,246,4,39,2,2,allow
49950,80,54747,80,3991,620,3371,14,15,7,7,allow
49944,80,31108,80,3695,550,3145,12,15,6,6,allow
55036,53,7624,53,177,94,83,2,30,1,1,allow
55125,53,47085,53,177,94,83,2,30,1,1,allow
55872,53,55193,53,819,102,717,2,30,1,1,allow
50425,53,24348,53,199,102,97,2,30,1,1,allow
55405,53,55361,53,199,102,97,2,30,1,1,allow
49928,443,36059,443,11646,4774,6872,29,32,18,11,allow
56688,443,28124,443,19185,2445,16740,40,25,20,20,allow
49183,443,49342,443,473744,13158,460586,495,20,183,312,allow
63885,6969,1755,6969,66,66,0,2,8,2,0,allow
47828,443,4397,443,512466,48982,463484,912,124,446,466,allow
57240,443,57240,443,4623,1716,2907,19,26,11,8,allow
59873,443,3851,443,1066,545,521,11,28,5,6,allow
35212,443,35212,443,4700,1793,2907,19,27,11,8,allow
64811,53,57822,53,314,97,217,4,47,2,2,allow
65436,53,49533,53,286,90,196,4,55,2,2,allow
49862,53,59363,53,817,102,715,2,30,1,1,allow
50002,53,25520,53,196,102,94,2,30,1,1,allow
64935,53,55369,53,198,102,96,2,30,1,1,allow
64122,53,11077,53,214,110,104,2,30,1,1,allow
49800,53,14799,53,183,94,89,2,30,1,1,allow
49949,80,34072,80,16663,923,15740,25,15,11,14,allow
50477,80,50477,80,20873,1203,19670,30,21,13,17,allow
34746,443,4348,443,284320,14149,270171,398,244,203,195,allow
53675,29970,54968,29970,612,426,186,10,22,7,3,allow
49945,80,12569,80,4215,620,3595,14,15,7,7,allow
51980,80,55042,80,4247,699,3548,13,46,7,6,allow
51977,80,44699,80,4305,699,3606,13,46,7,6,allow
65497,53,19517,53,490,111,379,4,54,2,2,allow
57185,53,50357,53,784,94,690,2,30,1,1,allow
52780,53,38802,53,338,94,244,2,30,1,1,allow
49425,53,61081,53,772,102,670,2,30,1,1,allow
55821,53,40795,53,196,102,94,2,30,1,1,allow
56955,53,34703,53,183,94,89,2,30,1,1,allow
64945,53,35387,53,240,86,154,2,30,1,1,allow
64605,53,20190,53,183,94,89,2,31,1,1,allow
33313,443,29395,443,9675,2389,7286,43,143,21,22,allow
49657,80,55424,80,1278,774,504,12,361,7,5,allow
49781,53,21515,53,194,102,92,2,30,1,1,allow
55872,53,6785,53,196,102,94,2,30,1,1,allow
59283,53,37048,53,359,86,273,2,30,1,1,allow
49319,53,45899,53,166,86,80,2,30,1,1,allow
56979,53,50230,53,209,110,99,2,30,1,1,allow
50520,53,46734,53,732,86,646,2,30,1,1,allow
64762,53,37992,53,194,102,92,2,30,1,1,allow
49767,53,43872,53,200,102,98,2,31,1,1,allow
55310,53,54905,53,180,94,86,2,31,1,1,allow
49703,53,23224,53,288,102,186,2,31,1,1,allow
60796,443,14652,443,69973,4662,65311,108,135,43,65,allow
49573,443,42644,443,111881,6152,105729,137,139,51,86,allow
56288,53,47353,53,200,102,98,2,30,1,1,allow
49848,53,25784,53,167,86,81,2,30,1,1,allow
56430,53,26813,53,199,102,97,2,30,1,1,allow
50002,53,41135,53,196,102,94,2,30,1,1,allow
49800,53,2151,53,183,94,89,2,31,1,1,allow
56589,53,43560,53,166,86,80,2,31,1,1,allow
49518,53,53885,53,193,102,91,2,30,1,1,allow
57058,53,2739,53,167,86,81,2,31,1,1,allow
50523,53,46429,53,376,78,298,2,31,1,1,allow
55760,53,35277,53,182,94,88,2,31,1,1,allow
64022,53,48680,53,197,102,95,2,31,1,1,allow
49898,443,38870,443,8191,2343,5848,33,394,11,22,allow
6881,48608,12608,48608,228,118,110,2,1199,1,1,allow
46838,443,19080,443,10876,3774,7102,12,145,5,7,allow
43791,443,3031,443,6933,1677,5256,22,305,12,10,allow
56369,53,59110,53,193,102,91,2,31,1,1,allow
49973,53,27114,53,261,94,167,2,30,1,1,allow
57083,53,27580,53,198,102,96,2,30,1,1,allow
55405,53,37369,53,199,102,97,2,30,1,1,allow
56975,53,33537,53,197,102,95,2,30,1,1,allow
56743,53,62302,53,209,110,99,2,31,1,1,allow
55505,53,51745,53,199,102,97,2,31,1,1,allow
49820,53,29495,53,193,102,91,2,31,1,1,allow
55125,53,32465,53,177,94,83,2,31,1,1,allow
64327,53,41348,53,210,110,100,2,31,1,1,allow
56743,53,46707,53,209,110,99,2,30,1,1,allow
49809,53,6008,53,386,134,252,2,30,1,1,allow
57083,53,19689,53,198,102,96,2,30,1,1,allow
56589,53,12890,53,199,102,97,2,31,1,1,allow
56869,53,8171,53,198,94,104,2,31,1,1,allow
53709,15000,7812,15000,320,140,180,6,7,3,3,allow
50726,443,17287,443,6464,2707,3757,39,151,18,21,allow
49558,53,10290,53,193,102,91,2,30,1,1,allow
56589,53,14177,53,166,86,80,2,30,1,1,allow
49615,53,30558,53,413,170,243,6,31,3,3,allow
50291,443,61794,443,11617,4358,7259,48,86,26,22,allow
49967,53,25573,53,445,95,350,4,50,2,2,allow
5588,5588,0,0,3562,1936,1626,48,193,24,24,allow
57914,445,0,0,66,66,0,1,0,1,0,drop
23537,35253,0,0,66,66,0,1,0,1,0,deny
57624,445,0,0,70,70,0,1,0,1,0,drop
57911,445,0,0,66,66,0,1,0,1,0,drop
57910,445,0,0,66,66,0,1,0,1,0,drop
33543,44847,0,0,66,66,0,1,0,1,0,deny
57908,445,0,0,66,66,0,1,0,1,0,drop
9017,6881,0,0,66,66,0,1,0,1,0,deny
65179,44847,0,0,66,66,0,1,0,1,0,deny
9687,57470,0,0,78,78,0,1,0,1,0,deny
57621,445,0,0,70,70,0,1,0,1,0,drop
12128,37965,0,0,62,62,0,1,0,1,0,deny
50222,42873,0,0,66,66,0,1,0,1,0,deny
62504,445,0,0,70,70,0,1,0,1,0,drop
62498,445,0,0,70,70,0,1,0,1,0,drop
62497,445,0,0,70,70,0,1,0,1,0,drop
16883,22,0,0,60,60,0,1,0,1,0,deny
57617,445,0,0,70,70,0,1,0,1,0,drop
64115,2767,0,0,66,66,0,1,0,1,0,deny
39244,36829,0,0,62,62,0,1,0,1,0,deny
57987,56125,0,0,90,90,0,1,0,1,0,deny
57615,445,0,0,70,70,0,1,0,1,0,drop
39742,62413,0,0,66,66,0,1,0,1,0,deny
57898,445,0,0,66,66,0,1,0,1,0,drop
30039,7363,0,0,145,145,0,1,0,1,0,deny
57613,445,0,0,70,70,0,1,0,1,0,drop
5894,44847,0,0,66,66,0,1,0,1,0,deny
55874,64147,0,0,66,66,0,1,0,1,0,deny
61527,51050,0,0,66,66,0,1,0,1,0,deny
54458,64147,0,0,62,62,0,1,0,1,0,deny
54300,22114,0,0,66,66,0,1,0,1,0,deny
51262,35440,0,0,66,66,0,1,0,1,0,deny
58888,23718,0,0,62,62,0,1,0,1,0,deny
57890,445,0,0,66,66,0,1,0,1,0,drop
62484,445,0,0,70,70,0,1,0,1,0,drop
50470,61463,0,0,86,86,0,1,0,1,0,deny
48079,43227,0,0,66,66,0,1,0,1,0,deny
50283,49169,0,0,66,66,0,1,0,1,0,deny
57606,445,0,0,70,70,0,1,0,1,0,drop
57887,445,0,0,66,66,0,1,0,1,0,drop
57604,445,0,0,70,70,0,1,0,1,0,drop
39531,19473,0,0,62,62,0,1,0,1,0,deny
59227,11392,0,0,62,62,0,1,0,1,0,deny
61563,37807,0,0,62,62,0,1,0,1,0,deny
40216,50265,0,0,62,62,0,1,0,1,0,deny
57698,64147,0,0,66,66,0,1,0,1,0,deny
57603,445,0,0,70,70,0,1,0,1,0,drop
57879,445,0,0,66,66,0,1,0,1,0,drop
57602,445,0,0,70,70,0,1,0,1,0,drop
58085,57470,0,0,66,66,0,1,0,1,0,deny
49426,57470,0,0,66,66,0,1,0,1,0,deny
57601,445,0,0,70,70,0,1,0,1,0,drop
65096,37807,0,0,62,62,0,1,0,1,0,deny
57870,445,0,0,66,66,0,1,0,1,0,drop
57596,445,0,0,70,70,0,1,0,1,0,drop
57595,445,0,0,70,70,0,1,0,1,0,drop
1038,37965,0,0,62,62,0,1,0,1,0,deny
22346,51505,0,0,62,62,0,1,0,1,0,deny
57583,445,0,0,70,70,0,1,0,1,0,drop
57576,445,0,0,70,70,0,1,0,1,0,drop
58338,3363,0,0,60,60,0,1,0,1,0,deny
57572,445,0,0,70,70,0,1,0,1,0,drop
57573,445,0,0,70,70,0,1,0,1,0,drop
60962,64147,0,0,66,66,0,1,0,1,0,deny
47910,7454,0,0,60,60,0,1,0,1,0,deny
49001,40108,0,0,161,161,0,1,0,1,0,deny
62473,445,0,0,70,70,0,1,0,1,0,drop
62469,445,0,0,70,70,0,1,0,1,0,drop
62468,445,0,0,70,70,0,1,0,1,0,drop
30782,36237,0,0,62,62,0,1,0,1,0,deny
57863,445,0,0,66,66,0,1,0,1,0,drop
57864,445,0,0,66,66,0,1,0,1,0,drop
57859,445,0,0,66,66,0,1,0,1,0,drop
57862,445,0,0,66,66,0,1,0,1,0,drop
57861,445,0,0,66,66,0,1,0,1,0,drop
57858,445,0,0,66,66,0,1,0,1,0,drop
57860,445,0,0,66,66,0,1,0,1,0,drop
57857,445,0,0,66,66,0,1,0,1,0,drop
62051,11392,0,0,66,66,0,1,0,1,0,deny
42968,56205,0,0,62,62,0,1,0,1,0,deny
62388,39004,0,0,62,62,0,1,0,1,0,deny
62150,23718,0,0,66,66,0,1,0,1,0,deny
19068,37965,0,0,62,62,0,1,0,1,0,deny
57561,445,0,0,70,70,0,1,0,1,0,drop
39981,57470,0,0,62,62,0,1,0,1,0,deny
43584,24748,0,0,156,156,0,1,0,1,0,deny
43584,24748,0,0,156,156,0,1,0,1,0,deny
43584,24748,0,0,156,156,0,1,0,1,0,deny
64962,64147,0,0,66,66,0,1,0,1,0,deny
36738,123,0,0,234,234,0,1,0,1,0,deny
62463,445,0,0,70,70,0,1,0,1,0,drop
62461,445,0,0,70,70,0,1,0,1,0,drop
62453,445,0,0,70,70,0,1,0,1,0,drop
37927,50265,0,0,66,66,0,1,0,1,0,deny
15581,46713,0,0,66,66,0,1,0,1,0,deny
53465,57470,0,0,62,62,0,1,0,1,0,deny
46600,443,0,0,1097,1097,0,1,0,1,0,deny
2740,22,0,0,60,60,0,1,0,1,0,deny
57845,445,0,0,66,66,0,1,0,1,0,drop
57843,445,0,0,66,66,0,1,0,1,0,drop
57842,445,0,0,66,66,0,1,0,1,0,drop
59509,64147,0,0,62,62,0,1,0,1,0,deny
62451,445,0,0,70,70,0,1,0,1,0,drop
46409,35440,0,0,66,66,0,1,0,1,0,deny
57557,445,0,0,70,70,0,1,0,1,0,drop
63196,445,0,0,66,66,0,1,0,1,0,deny
57987,56125,0,0,90,90,0,1,0,1,0,deny
50298,37965,0,0,66,66,0,1,0,1,0,deny
62448,445,0,0,70,70,0,1,0,1,0,drop
60052,37965,0,0,66,66,0,1,0,1,0,deny
62443,445,0,0,70,70,0,1,0,1,0,drop
62444,445,0,0,70,70,0,1,0,1,0,drop
62438,445,0,0,70,70,0,1,0,1,0,drop
51505,17372,0,0,66,66,0,1,0,1,0,deny
57545,445,0,0,70,70,0,1,0,1,0,drop
57548,445,0,0,70,70,0,1,0,1,0,drop
57547,445,0,0,70,70,0,1,0,1,0,drop
60969,48637,0,0,78,78,0,1,0,1,0,deny
57543,445,0,0,70,70,0,1,0,1,0,drop
57541,445,0,0,70,70,0,1,0,1,0,drop
40642,23889,0,0,146,146,0,1,0,1,0,deny
9393,51505,0,0,66,66,0,1,0,1,0,deny
26750,57470,0,0,66,66,0,1,0,1,0,deny
51374,30317,0,0,66,66,0,1,0,1,0,deny
22390,19473,0,0,66,66,0,1,0,1,0,deny
34301,21247,0,0,62,62,0,1,0,1,0,deny
6661,23,0,0,60,60,0,1,0,1,0,deny
62431,445,0,0,70,70,0,1,0,1,0,drop
62430,445,0,0,70,70,0,1,0,1,0,drop
62424,445,0,0,70,70,0,1,0,1,0,drop
57535,445,0,0,70,70,0,1,0,1,0,drop
15955,48817,0,0,140,140,0,1,0,1,0,deny
57527,445,0,0,70,70,0,1,0,1,0,drop
56495,53,29192,53,198,101,97,2,30,1,1,allow
48757,80,48757,80,560,264,296,9,44,5,4,allow
41098,80,34310,80,1937,1193,744,12,16,7,5,allow
64605,53,39152,53,182,93,89,2,30,1,1,allow
56623,53,18777,53,771,101,670,2,30,1,1,allow
55934,53,51844,53,731,85,646,2,30,1,1,allow
64312,53,26634,53,202,103,99,2,31,1,1,allow
64485,53,38773,53,182,93,89,2,30,1,1,allow
49781,53,57974,53,188,96,92,2,30,1,1,allow
55581,53,6182,53,166,85,81,2,30,1,1,allow
56855,64607,58491,64607,316,136,180,6,6,3,3,allow
38660,15000,20760,15000,138,78,60,2,5,1,1,allow
13371,2323,13371,2323,124,60,64,2,5,1,1,allow
54958,53,54115,53,1413,85,1328,4,47,2,2,allow
24624,443,24624,443,5198,2221,2977,19,16,10,9,allow
54612,443,39989,443,6110,857,5253,17,16,9,8,allow
10216,80,10216,80,7548,1586,5962,18,21,8,10,allow
56824,3389,56824,3389,3910,1805,2105,20,18,12,8,allow
55028,443,52319,443,6791,1415,5376,19,51,12,7,allow
46986,443,11457,443,2809,1884,925,19,27,11,8,allow
64087,443,64087,443,150808,48110,102698,173,173,82,91,allow
51839,80,34402,80,3240,1194,2046,14,20,9,5,allow
56389,53,50951,53,279,93,186,4,32,2,2,allow
54982,53,63300,53,282,96,186,4,48,2,2,allow
46475,80,46475,80,8300,966,7334,14,20,6,8,allow
53897,443,3893,443,10781,3635,7146,27,221,15,12,allow
3234,80,3234,80,12425,835,11590,19,17,8,11,allow
56743,53,16205,53,202,103,99,2,30,1,1,allow
55966,53,62624,53,747,92,655,2,30,1,1,allow
6881,6881,56597,6881,231,111,120,2,1200,1,1,allow
55560,53,1916,53,164,84,80,2,31,1,1,allow
57028,53,32039,53,776,102,674,2,31,1,1,allow
6881,6889,18694,6889,221,111,110,2,1200,1,1,allow
30188,15370,58525,15370,10190,4774,5416,64,1490,32,32,allow
64127,53,29234,53,170,87,83,2,31,1,1,allow
65140,53,5924,53,774,101,673,2,31,1,1,allow
30960,45722,27416,45722,396,396,0,7,3616,7,0,allow
55859,53,35635,53,778,103,675,2,31,1,1,allow
49820,53,12064,53,186,95,91,2,31,1,1,allow
56946,53,14578,53,732,89,643,2,31,1,1,allow
46445,443,57162,443,13942,8293,5649,59,172,31,28,allow
50408,53,64657,53,755,94,661,2,31,1,1,allow
64525,53,31849,53,198,101,97,2,31,1,1,allow
49780,53,7446,53,182,93,89,2,31,1,1,allow
50273,443,63017,443,13363,4645,8718,54,241,32,22,allow
38059,443,31779,443,25214,14000,11214,66,99,34,32,allow
56674,53,43592,53,182,93,89,2,31,1,1,allow
55706,53,9914,53,202,103,99,2,31,1,1,allow
51229,443,49748,443,8590,1038,7552,16,120,7,9,allow
59658,443,33900,443,5433,925,4508,19,360,10,9,allow
6881,49001,20436,49001,210,111,99,2,1201,1,1,allow
55720,53,40889,53,774,101,673,2,31,1,1,allow
30960,45727,32973,45727,330,330,0,6,3610,6,0,allow
56876,30188,0,0,66,66,0,1,0,1,0,deny
57524,445,0,0,70,70,0,1,0,1,0,drop
25222,37965,0,0,62,62,0,1,0,1,0,deny
32609,64097,0,0,66,66,0,1,0,1,0,deny
57821,445,0,0,66,66,0,1,0,1,0,drop
62421,445,0,0,70,70,0,1,0,1,0,drop
62420,445,0,0,70,70,0,1,0,1,0,drop
65265,55067,0,0,62,62,0,1,0,1,0,deny
50470,61463,0,0,86,86,0,1,0,1,0,deny
57521,445,0,0,70,70,0,1,0,1,0,drop
13840,37965,0,0,146,146,0,1,0,1,0,deny
57585,19750,0,0,66,66,0,1,0,1,0,deny
57519,445,0,0,70,70,0,1,0,1,0,drop
35494,22114,0,0,66,66,0,1,0,1,0,deny
58976,43890,0,0,66,66,0,1,0,1,0,deny
57816,445,0,0,66,66,0,1,0,1,0,drop
57817,445,0,0,66,66,0,1,0,1,0,drop
64546,57470,0,0,66,66,0,1,0,1,0,deny
36301,443,2134,443,7316,1933,5383,27,15,15,12,allow
59675,80,26404,80,3437462,77916,3359546,3384,134,1140,2244,allow
57241,443,46273,443,1167125,49170,1117955,1459,92,635,824,allow
45964,3111,0,0,60,60,0,1,0,1,0,deny
57515,445,0,0,70,70,0,1,0,1,0,drop
62412,445,0,0,70,70,0,1,0,1,0,drop
57514,445,0,0,70,70,0,1,0,1,0,drop
35261,15503,0,0,74,74,0,1,0,1,0,deny
55565,64147,0,0,62,62,0,1,0,1,0,deny
62406,445,0,0,70,70,0,1,0,1,0,drop
62405,445,0,0,70,70,0,1,0,1,0,drop
62401,445,0,0,70,70,0,1,0,1,0,drop
57810,445,0,0,66,66,0,1,0,1,0,drop
52714,64147,0,0,66,66,0,1,0,1,0,deny
57806,445,0,0,66,66,0,1,0,1,0,drop
57805,445,0,0,66,66,0,1,0,1,0,drop
57804,445,0,0,66,66,0,1,0,1,0,drop
57803,445,0,0,66,66,0,1,0,1,0,drop
57800,445,0,0,66,66,0,1,0,1,0,drop
57799,445,0,0,66,66,0,1,0,1,0,drop
57795,445,0,0,66,66,0,1,0,1,0,drop
62396,445,0,0,70,70,0,1,0,1,0,drop
53656,31573,0,0,66,66,0,1,0,1,0,deny
57509,445,0,0,70,70,0,1,0,1,0,drop
62393,445,0,0,70,70,0,1,0,1,0,drop
62392,445,0,0,70,70,0,1,0,1,0,drop
62389,445,0,0,70,70,0,1,0,1,0,drop
29159,39004,0,0,62,62,0,1,0,1,0,deny
43350,58414,0,0,66,66,0,1,0,1,0,deny
53608,39004,0,0,66,66,0,1,0,1,0,deny
45051,23,0,0,60,60,0,1,0,1,0,deny
56794,46824,0,0,66,66,0,1,0,1,0,deny
60136,56205,0,0,66,66,0,1,0,1,0,deny
41165,23,0,0,60,60,0,1,0,1,0,deny
59668,51505,0,0,62,62,0,1,0,1,0,deny
49160,34068,0,0,146,146,0,1,0,1,0,deny
45908,3383,0,0,60,60,0,1,0,1,0,deny
443,64347,0,0,131,131,0,1,0,1,0,deny
9687,57470,0,0,78,78,0,1,0,1,0,deny
62387,445,0,0,70,70,0,1,0,1,0,drop
62386,445,0,0,70,70,0,1,0,1,0,drop
62384,445,0,0,70,70,0,1,0,1,0,drop
54742,37965,0,0,66,66,0,1,0,1,0,deny
58255,50584,0,0,62,62,0,1,0,1,0,deny
57789,445,0,0,66,66,0,1,0,1,0,drop
56743,53,5034,53,209,110,99,2,30,1,1,allow
57066,53,30352,53,197,94,103,2,30,1,1,allow
49752,53,61999,53,182,94,88,2,30,1,1,allow
49752,53,1168,53,182,94,88,2,30,1,1,allow
65067,53,22984,53,327,102,225,2,30,1,1,allow
48755,80,48755,80,630,264,366,10,44,5,5,allow
56697,443,50660,443,3593,2749,844,18,22,11,7,allow
53679,24300,62271,24300,1656,914,742,13,21,9,4,allow
35292,8100,19734,8100,234,234,0,4,11,4,0,allow
53693,26515,57249,26515,70,70,0,1,4,1,0,allow
49666,53,61369,53,392,124,268,4,35,2,2,allow
53145,27067,38874,27067,1231702,397859,833843,10382,185,4780,5602,allow
59703,443,2631,443,8867,2701,6166,21,105,9,12,allow
38779,80,43301,80,540,540,0,10,186,10,0,allow
38676,443,23921,443,101056,3737,97319,107,15,35,72,allow
64086,443,64086,443,79107,10743,68364,96,172,42,54,allow
52079,443,42023,443,4735,3589,1146,18,15,10,8,allow
42485,443,17248,443,130,70,60,3,5,2,1,allow
58865,443,1630,443,505070,16437,488633,543,45,187,356,allow
53690,42301,12821,42301,1821,1088,733,17,15,9,8,allow
64595,53,13089,53,299,93,206,4,35,2,2,allow
39818,443,44736,443,2211,1181,1030,23,40,11,12,allow
58293,443,58293,443,7134,2478,4656,18,75,10,8,allow
49319,53,1935,53,166,86,80,2,29,1,1,allow
64605,53,57757,53,183,94,89,2,29,1,1,allow
55125,53,57865,53,177,94,83,2,29,1,1,allow
55119,53,12117,53,994,86,908,2,29,1,1,allow
55943,53,30420,53,448,184,264,6,29,3,3,allow
56979,53,46725,53,209,110,99,2,29,1,1,allow
49253,53,38638,53,727,86,641,2,29,1,1,allow
49781,53,14753,53,194,102,92,2,30,1,1,allow
56533,53,7408,53,199,102,97,2,29,1,1,allow
49847,53,33024,53,448,184,264,6,29,3,3,allow
50216,443,60442,443,6320,1382,4938,24,167,13,11,allow
57598,443,59383,443,3323,2398,925,18,21,10,8,allow
56561,53,63189,53,167,86,81,2,30,1,1,allow
56589,53,29602,53,199,102,97,2,30,1,1,allow
54448,53,29193,53,70,70,0,1,30,1,0,allow
49820,53,34423,53,193,102,91,2,30,1,1,allow
56389,53,30370,53,279,93,186,4,31,2,2,allow
36717,443,50144,443,232,172,60,3,5,2,1,allow
56292,443,36478,443,10839,2145,8694,32,140,14,18,allow
55715,443,55715,443,4575,1668,2907,19,30,11,8,allow
38673,443,39946,443,379440,8281,371159,362,16,106,256,allow
59320,443,31815,443,4573,2614,1959,25,80,13,12,allow
64095,443,63841,443,9895,2094,7801,52,262,23,29,allow
60796,53,60796,53,248,106,142,2,30,1,1,allow
37993,49152,8346,49152,156,156,0,3,8,3,0,allow
64022,53,64185,53,197,102,95,2,30,1,1,allow
55581,53,26872,53,167,86,81,2,30,1,1,allow
37994,49152,32893,49152,156,156,0,3,8,3,0,allow
56094,443,60801,443,5616,3106,2510,22,223,13,9,allow
56955,53,43873,53,183,94,89,2,30,1,1,allow
38675,443,44099,443,90810,3417,87393,94,16,30,64,allow
60901,443,55846,443,622058,33681,588377,765,65,327,438,allow
56535,53,61823,53,200,94,106,2,30,1,1,allow
56782,53,51399,53,197,94,103,2,30,1,1,allow
59840,80,40850,80,469946,11862,458084,482,68,173,309,allow
56922,53,56922,53,219,98,121,2,30,1,1,allow
57083,53,55638,53,198,102,96,2,30,1,1,allow
56871,53,27631,53,198,86,112,2,30,1,1,allow
64813,16385,22226,16385,432,192,240,8,30,4,4,allow
35515,53,35515,53,235,98,137,2,30,1,1,allow
64525,53,63463,53,199,102,97,2,30,1,1,allow
50803,443,13145,443,98472,44922,53550,491,658,181,310,allow
56560,53,48488,53,198,102,96,2,30,1,1,allow
42408,443,51647,443,13108,2630,10478,26,120,12,14,allow
64485,53,11274,53,183,94,89,2,30,1,1,allow
56389,53,40774,53,279,93,186,4,32,2,2,allow
51882,15733,3672,15733,70,70,0,1,5,1,0,allow
34657,443,31367,443,448,78,370,6,25,1,5,allow
50985,80,61422,80,613,539,74,7,15,6,1,allow
39690,443,65323,443,5806,3167,2639,29,221,16,13,allow
65437,53,59504,53,488,111,377,4,53,2,2,allow
55524,53,46955,53,413,170,243,6,30,3,3,allow
55560,53,36102,53,166,86,80,2,30,1,1,allow
63068,443,30672,443,2928239,68426,2859813,2888,37,955,1933,allow
55029,443,56750,443,35270,2782,32488,48,51,22,26,allow
38677,443,24014,443,89883,3417,86466,94,15,30,64,allow
34135,443,33569,443,9932,1987,7945,22,16,12,10,allow
65307,53,33704,53,365,94,271,4,58,2,2,allow
56561,53,36683,53,167,86,81,2,30,1,1,allow
57027,53,20222,53,198,94,104,2,30,1,1,allow
55581,53,16064,53,167,86,81,2,30,1,1,allow
64485,53,10635,53,183,94,89,2,30,1,1,allow
60048,443,33885,443,12254,3186,9068,27,171,13,14,allow
58862,443,37549,443,1068717,27931,1040786,1093,45,351,742,allow
58864,443,26989,443,312852,8845,304007,317,45,99,218,allow
56588,443,28580,443,10615,5909,4706,28,42,14,14,allow
55625,80,27507,80,389326,9849,379477,391,21,138,253,allow
9109,443,23310,443,4400,433,3967,12,15,6,6,allow
47053,80,59078,80,1188,463,725,8,15,5,3,allow
49951,80,39870,80,1706,505,1201,8,14,5,3,allow
45074,443,48285,443,4493,2566,1927,40,130,21,19,allow
53706,59208,33732,59208,258,70,188,4,8,2,2,allow
48756,80,48756,80,560,264,296,9,44,5,4,allow
49531,53,39343,53,289,94,195,4,31,2,2,allow
49569,53,55862,53,181,94,87,2,31,1,1,allow
64144,53,27291,53,193,102,91,2,31,1,1,allow
64461,53,32838,53,350,89,261,4,53,2,2,allow
56046,53,55070,53,193,102,91,2,31,1,1,allow
65307,53,59322,53,184,94,90,2,29,1,1,allow
45052,443,37093,443,131573,4926,126647,152,152,55,97,allow
54982,53,58418,53,282,96,186,4,47,2,2,allow
60432,54312,22904,54312,701,455,246,8,15,4,4,allow
65532,53,6977,53,255,102,153,2,29,1,1,allow
48754,80,48754,80,560,264,296,9,44,5,4,allow
56611,443,56611,443,4530,1623,2907,19,26,11,8,allow
56495,53,8652,53,199,102,97,2,30,1,1,allow
33115,443,15120,443,75816,2178,73638,72,16,20,52,allow
54982,53,26204,53,282,96,186,4,48,2,2,allow
49429,53,3365,53,199,102,97,2,29,1,1,allow
55760,53,9967,53,182,94,88,2,30,1,1,allow
49863,8100,50615,8100,234,234,0,4,11,4,0,allow
56842,24233,45791,24233,70,70,0,1,5,1,0,allow
56495,53,46439,53,199,102,97,2,30,1,1,allow
49331,53,38875,53,200,94,106,2,29,1,1,allow
49262,53,13310,53,168,86,82,2,29,1,1,allow
49429,53,51638,53,199,102,97,2,29,1,1,allow
45589,53,45589,53,225,106,119,2,30,1,1,allow
64485,53,6047,53,183,94,89,2,30,1,1,allow
50405,53,35754,53,200,102,98,2,30,1,1,allow
55560,53,7666,53,166,86,80,2,30,1,1,allow
64334,53,44519,53,200,94,106,2,31,1,1,allow
55560,53,43077,53,166,86,80,2,30,1,1,allow
35868,123,20404,123,184,94,90,2,30,1,1,allow
56561,53,4933,53,167,86,81,2,30,1,1,allow
35099,53,35099,53,225,106,119,2,30,1,1,allow
65410,53,40006,53,229,110,119,2,31,1,1,allow
49780,53,9183,53,183,94,89,2,31,1,1,allow
57470,1337,6563,1337,330,330,0,6,1200,6,0,allow
49673,5223,52043,5223,4266,1448,2818,22,3088,13,9,allow
55086,53,37200,53,328,90,238,4,37,2,2,allow
56691,443,56691,443,4378,1471,2907,19,29,11,8,allow
44983,443,63267,443,4991,3096,1895,22,220,13,9,allow
60902,443,20935,443,924886,40519,884367,1075,65,442,633,allow
49831,53,63335,53,198,94,104,2,30,1,1,allow
55581,53,6275,53,167,86,81,2,30,1,1,allow
53443,123,34007,123,184,94,90,2,30,1,1,allow
64312,53,19518,53,209,110,99,2,30,1,1,allow
55622,53,55622,53,235,98,137,2,30,1,1,allow
64312,53,39914,53,209,110,99,2,30,1,1,allow
53864,53,0,0,181,86,95,2,30,1,1,allow
64567,53,38980,53,199,102,97,2,30,1,1,allow
65367,53,6408,53,251,94,157,2,30,1,1,allow
64257,53,61085,53,211,78,133,2,30,1,1,allow
48480,443,23315,443,10409,2670,7739,94,5805,17,77,allow
54349,443,33751,443,14063,6328,7735,33,37,16,17,allow
56389,53,5155,53,279,93,186,4,32,2,2,allow
65075,53,3072,53,278,100,178,4,31,2,2,allow
36368,80,28918,80,78,78,0,2,8,2,0,allow
49767,53,48677,53,200,102,98,2,30,1,1,allow
36003,123,29238,123,184,94,90,2,30,1,1,allow
56495,53,40690,53,199,102,97,2,30,1,1,allow
53771,53,15804,53,168,78,90,2,30,1,1,allow
50436,53,50436,53,248,106,142,2,30,1,1,allow
49767,53,59870,53,200,102,98,2,30,1,1,allow
64127,53,25934,53,177,94,83,2,30,1,1,allow
64814,16386,26637,16386,432,192,240,8,30,4,4,allow
64812,16384,57833,16384,556,256,300,10,30,5,5,allow
56589,53,35173,53,199,102,97,2,30,1,1,allow
64605,53,37496,53,183,94,89,2,30,1,1,allow
56913,53,26881,53,193,102,91,2,30,1,1,allow
46087,123,1853,123,184,94,90,2,30,1,1,allow
43224,443,58496,443,2027060,31188,1995872,1708,77,321,1387,allow
62984,8920,64791,8920,829,583,246,9,15,5,4,allow
51898,50677,11184,50677,70,70,0,2,8,2,0,allow
39691,443,19471,443,6219,4130,2089,29,221,16,13,allow
51594,443,50600,443,5854,1148,4706,18,23,10,8,allow
57058,53,29046,53,167,86,81,2,30,1,1,allow
47749,53,47749,53,248,106,142,2,30,1,1,allow
49212,53,2222,53,183,94,89,2,30,1,1,allow
54590,443,20540,443,12094,4159,7935,21,135,10,11,allow
64567,53,24261,53,199,102,97,2,30,1,1,allow
49262,53,46554,53,168,86,82,2,30,1,1,allow
50759,53,50759,53,225,106,119,2,30,1,1,allow
65468,53,8938,53,200,94,106,2,30,1,1,allow
57027,123,48138,123,184,94,90,2,30,1,1,allow
55261,53,52795,53,183,94,89,2,30,1,1,allow
65080,53,25627,53,209,110,99,2,30,1,1,allow
50686,443,65474,443,6586,1807,4779,23,360,12,11,allow
10151,54168,22661,54168,479,150,329,2,1200,1,1,allow
57265,53,29608,53,200,102,98,2,31,1,1,allow
41027,80,63019,80,540,540,0,10,186,10,0,allow
61229,443,47952,443,12708,2798,9910,36,258,13,23,allow
50802,443,32989,443,207859,77557,130302,849,753,312,537,allow
57470,20433,47061,20433,726,726,0,12,1200,12,0,allow
65080,53,11923,53,209,110,99,2,30,1,1,allow
50477,443,26806,443,55388,4069,51319,94,240,46,48,allow
57470,59208,35897,59208,1367,664,703,16,1199,9,7,allow
56674,53,17434,53,183,94,89,2,31,1,1,allow
65354,53,35359,53,272,94,178,2,31,1,1,allow
57470,10154,49581,10154,924,924,0,15,1200,15,0,allow
64085,53,40904,53,195,94,101,2,31,1,1,allow
49740,53,60867,53,341,85,256,4,42,2,2,allow
62021,443,62021,443,4625,1718,2907,19,27,11,8,allow
53272,80,30742,80,11060,3925,7135,24,108,13,11,allow
56950,443,41087,443,5601,1203,4398,14,60,9,5,allow
39880,80,44153,80,1779,793,986,17,58,6,11,allow
50825,443,14787,443,6601,1120,5481,17,116,9,8,allow
56260,80,50522,80,72600,58760,13840,186,1232,107,79,allow
56951,443,11252,443,5601,1203,4398,14,60,9,5,allow
43412,443,47585,443,2423,1465,958,18,171,10,8,allow
39743,80,10677,80,1563,570,993,10,16,6,4,allow
49415,53,12077,53,313,83,230,4,54,2,2,allow
63870,6881,25073,6881,70,70,0,1,5,1,0,allow
63864,44139,53899,44139,70,70,0,1,5,1,0,allow
56947,443,19771,443,5601,1203,4398,14,60,9,5,allow
56952,443,36539,443,5601,1203,4398,14,60,9,5,allow
49740,53,35003,53,167,86,81,2,30,1,1,allow
62068,64147,0,0,66,66,0,1,0,1,0,deny
57496,445,0,0,70,70,0,1,0,1,0,drop
62380,445,0,0,70,70,0,1,0,1,0,drop
57786,445,0,0,66,66,0,1,0,1,0,drop
57784,445,0,0,66,66,0,1,0,1,0,drop
57782,445,0,0,66,66,0,1,0,1,0,drop
28176,35440,0,0,146,146,0,1,0,1,0,deny
57493,445,0,0,70,70,0,1,0,1,0,drop
57780,445,0,0,66,66,0,1,0,1,0,drop
56646,48817,0,0,62,62,0,1,0,1,0,deny
53543,44847,0,0,146,146,0,1,0,1,0,deny
41840,50584,0,0,66,66,0,1,0,1,0,deny
40731,2323,0,0,60,60,0,1,0,1,0,deny
52472,51221,0,0,74,74,0,1,0,1,0,deny
62375,445,0,0,70,70,0,1,0,1,0,drop
26085,51221,0,0,72,72,0,1,0,1,0,deny
62371,445,0,0,70,70,0,1,0,1,0,drop
62369,445,0,0,70,70,0,1,0,1,0,drop
57488,445,0,0,70,70,0,1,0,1,0,drop
5688,44847,0,0,66,66,0,1,0,1,0,deny
63096,44847,0,0,66,66,0,1,0,1,0,deny
57487,445,0,0,70,70,0,1,0,1,0,drop
29017,2222,0,0,60,60,0,1,0,1,0,deny
28754,50584,0,0,62,62,0,1,0,1,0,deny
6666,50070,0,0,60,60,0,1,0,1,0,deny
46829,64147,0,0,146,146,0,1,0,1,0,deny
54280,3398,0,0,60,60,0,1,0,1,0,deny
57485,445,0,0,70,70,0,1,0,1,0,drop
53667,56205,0,0,62,62,0,1,0,1,0,deny
6721,37965,0,0,66,66,0,1,0,1,0,deny
17800,3389,17800,3389,293,223,70,4,0,3,1,reset-both
22285,3389,22285,3389,293,223,70,4,0,3,1,reset-both
19626,3389,19626,3389,293,223,70,4,0,3,1,reset-both
57769,445,0,0,66,66,0,1,0,1,0,drop
61945,48817,0,0,62,62,0,1,0,1,0,deny
12226,37965,0,0,62,62,0,1,0,1,0,deny
44529,6881,0,0,146,146,0,1,0,1,0,deny
57762,445,0,0,66,66,0,1,0,1,0,drop
62352,445,0,0,70,70,0,1,0,1,0,drop
57478,445,0,0,70,70,0,1,0,1,0,drop
57476,445,0,0,70,70,0,1,0,1,0,drop
52537,37965,0,0,66,66,0,1,0,1,0,deny
57760,445,0,0,66,66,0,1,0,1,0,drop
23969,57470,0,0,62,62,0,1,0,1,0,deny
57475,445,0,0,70,70,0,1,0,1,0,drop
54552,64147,0,0,62,62,0,1,0,1,0,deny
58973,57470,0,0,66,66,0,1,0,1,0,deny
16134,45680,0,0,148,148,0,1,0,1,0,deny
57474,445,0,0,70,70,0,1,0,1,0,drop
57473,445,0,0,70,70,0,1,0,1,0,drop
57987,56125,0,0,90,90,0,1,0,1,0,deny
57467,445,0,0,70,70,0,1,0,1,0,drop
57470,445,0,0,70,70,0,1,0,1,0,drop
57752,445,0,0,66,66,0,1,0,1,0,drop
57750,445,0,0,66,66,0,1,0,1,0,drop
58226,52848,0,0,62,62,0,1,0,1,0,deny
50470,61463,0,0,86,86,0,1,0,1,0,deny
57455,445,0,0,70,70,0,1,0,1,0,drop
57454,445,0,0,70,70,0,1,0,1,0,drop
60426,57470,0,0,62,62,0,1,0,1,0,deny
57450,445,0,0,70,70,0,1,0,1,0,drop
57445,445,0,0,70,70,0,1,0,1,0,drop
57444,445,0,0,70,70,0,1,0,1,0,drop
26937,23,0,0,60,60,0,1,0,1,0,deny
29011,32468,0,0,62,62,0,1,0,1,0,deny
49001,40108,0,0,161,161,0,1,0,1,0,deny
26048,21,0,0,60,60,0,1,0,1,0,deny
49305,57470,0,0,66,66,0,1,0,1,0,deny
62343,445,0,0,70,70,0,1,0,1,0,drop
50156,53,2104,53,777,87,690,2,0,1,1,allow
62341,445,0,0,70,70,0,1,0,1,0,drop
62340,445,0,0,70,70,0,1,0,1,0,drop
57729,445,0,0,66,66,0,1,0,1,0,drop
57732,445,0,0,66,66,0,1,0,1,0,drop
57736,445,0,0,66,66,0,1,0,1,0,drop
57737,445,0,0,66,66,0,1,0,1,0,drop
57733,445,0,0,66,66,0,1,0,1,0,drop
57734,445,0,0,66,66,0,1,0,1,0,drop
57730,445,0,0,66,66,0,1,0,1,0,drop
57731,445,0,0,66,66,0,1,0,1,0,drop
63027,35440,0,0,66,66,0,1,0,1,0,deny
1038,37965,0,0,62,62,0,1,0,1,0,deny
9529,26467,0,0,62,62,0,1,0,1,0,deny
52459,33890,0,0,60,60,0,1,0,1,0,deny
57433,445,0,0,70,70,0,1,0,1,0,drop
63288,52848,0,0,66,66,0,1,0,1,0,deny
59147,51505,0,0,66,66,0,1,0,1,0,deny
52459,33890,0,0,60,60,0,1,0,1,0,deny
62347,25,62347,25,291,126,165,4,0,2,2,deny
61147,22114,0,0,66,66,0,1,0,1,0,deny
59095,57470,0,0,66,66,0,1,0,1,0,deny
62336,445,0,0,70,70,0,1,0,1,0,drop
62329,445,0,0,70,70,0,1,0,1,0,drop
2691,64147,0,0,62,62,0,1,0,1,0,deny
62324,445,0,0,70,70,0,1,0,1,0,drop
55386,37965,0,0,66,66,0,1,0,1,0,deny
68,67,0,0,594,594,0,1,0,1,0,deny
2705,37,0,0,60,60,0,1,0,1,0,deny
51300,64147,0,0,66,66,0,1,0,1,0,deny
57717,445,0,0,66,66,0,1,0,1,0,drop
57716,445,0,0,66,66,0,1,0,1,0,drop
57714,445,0,0,66,66,0,1,0,1,0,drop
49159,23,0,0,60,60,0,1,0,1,0,deny
61744,11392,0,0,66,66,0,1,0,1,0,deny
57429,445,0,0,70,70,0,1,0,1,0,drop
52711,37965,0,0,62,62,0,1,0,1,0,deny
44569,3389,0,0,60,60,0,1,0,1,0,deny
62322,445,0,0,70,70,0,1,0,1,0,drop
57148,23,0,0,60,60,0,1,0,1,0,deny
41197,30188,0,0,146,146,0,1,0,1,0,deny
26351,22114,0,0,62,62,0,1,0,1,0,deny
51185,37965,0,0,66,66,0,1,0,1,0,deny
59563,30188,0,0,66,66,0,1,0,1,0,deny
59985,57470,0,0,66,66,0,1,0,1,0,deny
56186,57470,0,0,62,62,0,1,0,1,0,deny
6881,33156,0,0,146,146,0,1,0,1,0,deny
57419,445,0,0,70,70,0,1,0,1,0,drop
57417,445,0,0,70,70,0,1,0,1,0,drop
57420,445,0,0,70,70,0,1,0,1,0,drop
62320,445,0,0,70,70,0,1,0,1,0,drop
19875,30170,0,0,145,145,0,1,0,1,0,deny
57415,445,0,0,70,70,0,1,0,1,0,drop
62316,445,0,0,70,70,0,1,0,1,0,drop
62315,445,0,0,70,70,0,1,0,1,0,drop
62310,445,0,0,70,70,0,1,0,1,0,drop
57412,445,0,0,70,70,0,1,0,1,0,drop
60857,61689,0,0,146,146,0,1,0,1,0,deny
34983,26543,0,0,145,145,0,1,0,1,0,deny
63765,51221,0,0,62,62,0,1,0,1,0,deny
27898,52700,0,0,62,62,0,1,0,1,0,deny
58207,51505,0,0,62,62,0,1,0,1,0,deny
42044,60043,0,0,66,66,0,1,0,1,0,deny
17781,50265,0,0,62,62,0,1,0,1,0,deny
64614,53,3667,53,186,95,91,2,30,1,1,allow
8883,443,24361,443,9742,2044,7698,30,391,12,18,allow
56745,443,56745,443,101899,20048,81851,132,62,67,65,allow
60433,6881,35052,6881,70,70,0,1,5,1,0,allow
36417,443,45000,443,3579,1914,1665,23,291,8,15,allow
56552,443,10361,443,9518,3057,6461,21,43,12,9,allow
65315,53,25956,53,172,88,84,2,30,1,1,allow
52781,443,23345,443,1581,924,657,15,125,7,8,allow
55784,53,41751,53,184,94,90,2,30,1,1,allow
50082,53,42387,53,774,101,673,2,30,1,1,allow
50318,53,63172,53,732,89,643,2,30,1,1,allow
38065,443,63899,443,15799,7457,8342,42,98,22,20,allow
56746,443,56746,443,68504,9909,58595,93,62,46,47,allow
56957,443,26018,443,4359,924,3435,15,59,9,6,allow
56956,443,35896,443,4359,924,3435,15,59,9,6,allow
50906,443,11737,443,124,64,60,2,15,1,1,allow
52056,80,60936,80,3641,846,2795,18,44,7,11,allow
10047,443,65295,443,25316,10344,14972,84,170,48,36,allow
64567,53,15933,53,198,101,97,2,30,1,1,allow
50905,443,13622,443,124,64,60,2,15,1,1,allow
52783,443,32956,443,1581,924,657,15,125,7,8,allow
55018,53,31411,53,174,89,85,2,30,1,1,allow
53718,443,33767,443,318,192,126,6,16,4,2,allow
64144,53,48969,53,186,95,91,2,30,1,1,allow
63866,17623,15201,17623,66,66,0,1,5,1,0,allow
38058,443,33797,443,22970,12439,10531,61,98,32,29,allow
51317,443,42808,443,3565,640,2925,16,153,7,9,allow
51900,15755,25086,15755,316,136,180,6,6,3,3,allow
56388,53,28613,53,186,95,91,3,46,2,1,allow
55655,63670,23563,63670,70,70,0,2,8,2,0,allow
47642,443,46910,443,12735,10573,2162,33,316,16,17,allow
38545,443,54573,443,4961,2148,2813,30,90,13,17,allow
57290,53,48036,53,758,93,665,2,30,1,1,allow
49418,53,11471,53,776,102,674,2,30,1,1,allow
62063,443,35010,443,25511,1260,24251,34,121,13,21,allow
57308,443,38390,443,36373,15248,21125,172,123,69,103,allow
56853,13203,65279,13203,316,136,180,6,6,3,3,allow
52782,443,35099,443,1581,924,657,15,125,7,8,allow
55658,45261,40194,45261,70,70,0,2,8,2,0,allow
53465,80,64691,80,1360,540,820,20,187,10,10,allow
47728,443,8590,443,8404,3653,4751,25,256,14,11,allow
63865,48610,9039,48610,66,66,0,1,5,1,0,allow
50999,443,32321,443,3051,1801,1250,18,16,8,10,allow
11295,40002,5818,40002,356,170,186,6,53,3,3,allow
5588,5588,0,0,3562,1936,1626,48,195,24,24,allow
65321,53,29738,53,166,85,81,2,30,1,1,allow
65175,53,9313,53,778,103,675,2,30,1,1,allow
55821,53,64842,53,192,98,94,2,30,1,1,allow
49740,53,20760,53,166,85,81,2,30,1,1,allow
49573,443,16183,443,7332,2197,5135,18,135,8,10,allow
51772,443,20083,443,2320,327,1993,11,135,5,6,allow
56448,53,33079,53,200,102,98,2,30,1,1,allow
64331,53,12876,53,174,89,85,2,31,1,1,allow
56655,53,60599,53,168,86,82,2,31,1,1,allow
58986,443,40709,443,10624,6845,3779,50,123,25,25,allow
49351,53,12256,53,164,84,80,2,30,1,1,allow
50534,53,37578,53,168,86,82,2,31,1,1,allow
64967,53,49030,53,184,94,90,2,31,1,1,allow
49350,80,49350,80,450,246,204,8,142,5,3,allow
49346,80,49346,80,450,246,204,8,142,5,3,allow
49345,80,49345,80,450,246,204,8,142,5,3,allow
56331,443,61535,443,1786,172,1614,7,121,3,4,allow
49531,53,3594,53,182,93,89,2,31,1,1,allow
65341,53,36456,53,200,102,98,2,31,1,1,allow
53284,443,5586,443,4579,2245,2334,12,122,6,6,allow
48909,5228,27859,5228,11007,2491,8516,44,4411,18,26,allow
57078,443,63821,443,4730,2569,2161,16,135,8,8,allow
6882,6889,29221,6889,221,111,110,2,1201,1,1,allow
9144,3389,9144,3389,293,223,70,4,1,3,1,reset-both
38554,3389,38554,3389,293,223,70,4,1,3,1,reset-both
24041,55783,0,0,62,62,0,1,0,1,0,deny
57406,445,0,0,70,70,0,1,0,1,0,drop
38126,3389,38126,3389,293,223,70,4,1,3,1,reset-both
57020,36237,0,0,66,66,0,1,0,1,0,deny
58922,57470,0,0,66,66,0,1,0,1,0,deny
62301,445,0,0,70,70,0,1,0,1,0,drop
62297,445,0,0,70,70,0,1,0,1,0,drop
62296,445,0,0,70,70,0,1,0,1,0,drop
37075,3389,37075,3389,293,223,70,4,1,3,1,reset-both
10967,3389,10967,3389,293,223,70,4,1,3,1,reset-both
55706,53,61735,53,209,110,99,2,30,1,1,allow
64144,53,47875,53,193,102,91,2,30,1,1,allow
59728,80,65227,80,821011,16040,804971,778,100,238,540,allow
64373,53,26971,53,554,96,458,4,60,2,2,allow
54435,443,54824,443,18802,3386,15416,54,293,28,26,allow
57163,53,34170,53,209,110,99,2,30,1,1,allow
58049,443,10248,443,8242,1641,6601,22,360,12,10,allow
49435,443,28726,443,8602,1050,7552,16,120,7,9,allow
54763,443,60297,443,7136,5777,1359,22,200,13,9,allow
38671,443,56566,443,90139,3545,86594,96,15,32,64,allow
56948,443,19472,443,5601,1203,4398,14,59,9,5,allow
53712,44822,45976,44822,320,140,180,6,5,3,3,allow
63868,60392,13062,60392,70,70,0,1,4,1,0,allow
64519,53,14591,53,195,102,93,2,29,1,1,allow
49740,53,58621,53,167,86,81,2,29,1,1,allow
60520,53,60520,53,248,106,142,2,29,1,1,allow
51822,80,12401,80,3709,1390,2319,17,19,10,7,allow
54489,53,0,0,418,154,264,4,33,2,2,allow
38670,443,55536,443,501559,13849,487710,527,15,193,334,allow
8380,80,8380,80,25613,1592,24021,32,22,9,23,allow
64604,53,45485,53,429,109,320,4,37,2,2,allow
10011,443,63236,443,14565,3464,11101,59,151,31,28,allow
56497,80,9145,80,410119,16112,394007,424,63,155,269,allow
56949,443,2703,443,5601,1203,4398,14,59,9,5,allow
53711,30355,27778,30355,320,140,180,6,5,3,3,allow
53703,16426,15322,16426,70,70,0,2,7,2,0,allow
49752,53,44269,53,182,94,88,2,29,1,1,allow
65321,53,58472,53,167,86,81,2,29,1,1,allow
63867,43618,49838,43618,70,70,0,1,4,1,0,allow
64312,53,28741,53,209,110,99,2,29,1,1,allow
64127,53,58268,53,177,94,83,2,30,1,1,allow
56388,53,20730,53,275,95,180,4,44,2,2,allow
53704,15000,2505,15000,70,70,0,2,7,2,0,allow
55018,53,64174,53,312,89,223,4,36,2,2,allow
49781,53,31272,53,194,102,92,2,29,1,1,allow
56747,443,56747,443,33901,9598,24303,56,61,32,24,allow
56913,53,31255,53,193,102,91,2,29,1,1,allow
65321,53,36858,53,167,86,81,2,29,1,1,allow
49351,53,13338,53,166,86,80,2,30,1,1,allow
54463,53,52007,53,164,78,86,2,30,1,1,allow
51295,443,51295,443,4334,1427,2907,19,27,11,8,allow
51902,443,16953,443,6155,888,5267,17,15,8,9,allow
63859,80,37247,80,314,192,122,6,15,4,2,allow
56674,53,20676,53,183,94,89,2,30,1,1,allow
55706,53,23729,53,209,110,99,2,30,1,1,allow
50707,53,59770,53,181,86,95,2,30,1,1,allow
20746,53,43830,53,191,86,105,2,30,1,1,allow
57282,53,14101,53,199,102,97,2,30,1,1,allow
56491,443,52771,443,6066,1016,5050,20,26,11,9,allow
65136,53,56790,53,335,84,251,4,32,2,2,allow
51879,38564,56529,38564,70,70,0,1,5,1,0,allow
56636,80,30803,80,234,234,0,4,12,4,0,allow
40512,80,26257,80,2543,691,1852,13,17,8,5,allow
56499,80,63072,80,277848,13775,264073,301,63,118,183,allow
46778,53,46778,53,214,82,132,2,30,1,1,allow
56492,443,53818,443,6066,1016,5050,20,26,11,9,allow
56734,443,56734,443,373876,52153,321723,424,87,185,239,allow
34001,53,36189,53,225,78,147,2,30,1,1,allow
49627,443,59623,443,20583,3435,17148,54,95,27,27,allow
49806,53,63116,53,242,118,124,2,30,1,1,allow
54375,443,15828,443,5642,3872,1770,32,81,17,15,allow
64744,3389,64744,3389,3428,1714,1714,16,33,8,8,allow
55784,53,32669,53,184,94,90,2,30,1,1,allow
55706,53,42379,53,209,110,99,2,30,1,1,allow
56674,53,8365,53,183,94,89,2,30,1,1,allow
56448,53,9031,53,200,102,98,2,30,1,1,allow
55784,53,2771,53,184,94,90,2,30,1,1,allow
56500,80,50985,80,177736,11174,166562,198,63,77,121,allow
38666,443,18669,443,94827,3328,91499,97,16,30,67,allow
65445,53,54616,53,199,102,97,2,30,1,1,allow
56448,53,7304,53,200,102,98,2,30,1,1,allow
64614,53,56180,53,193,102,91,2,30,1,1,allow
56498,53,39557,53,199,102,97,2,30,1,1,allow
21147,53,21147,53,1413,688,725,3,30,2,1,allow
19473,13315,3345,13315,460,150,310,2,1200,1,1,allow
53328,53,0,0,418,154,264,4,33,2,2,allow
60766,28080,32813,28080,70,70,0,1,5,1,0,allow
36230,443,36230,443,4681,1774,2907,19,30,11,8,allow
35584,80,52820,80,1507,454,1053,10,15,5,5,allow
56498,80,33330,80,174021,11443,162578,197,63,81,116,allow
47161,443,37026,443,11342,3715,7627,28,92,17,11,allow
47045,53,20106,53,225,78,147,2,30,1,1,allow
65162,53,50444,53,328,102,226,2,30,1,1,allow
50542,53,12388,53,782,110,672,2,30,1,1,allow
53238,443,11082,443,27650,12347,15303,47,53,24,23,allow
50483,443,61825,443,12462,2612,9850,37,80,19,18,allow
51957,443,52201,443,3516,1732,1784,34,42,19,15,allow
50232,28356,48349,28356,4728691,2246710,2481981,40252,1121,19716,20536,allow
60111,443,2026,443,11519,3163,8356,51,25,26,25,allow
60770,40010,17084,40010,316,136,180,6,6,3,3,allow
51902,55933,35723,55933,316,136,180,6,5,3,3,allow
64420,53,3288,53,194,102,92,2,31,1,1,allow
51880,18468,34831,18468,70,70,0,1,5,1,0,allow
53702,51413,14183,51413,70,70,0,2,7,2,0,allow
51894,26116,38290,26116,70,70,0,2,8,2,0,allow
63869,34368,37141,34368,70,70,0,1,4,1,0,allow
51901,443,44241,443,6215,948,5267,18,15,9,9,allow
55648,80,35736,80,70,70,0,1,5,1,0,allow
51903,443,13827,443,1612,1089,523,12,15,7,5,allow
53402,443,53402,443,4582,1675,2907,19,29,11,8,allow
65382,443,15464,443,15607,5238,10369,36,126,19,17,allow
53623,50093,42211,50093,552,306,246,9,38,5,4,allow
9100,443,50468,443,4945,431,4514,12,15,6,6,allow
49212,53,38007,53,183,94,89,2,29,1,1,allow
56501,80,5186,80,300370,14101,286269,313,63,116,197,allow
55261,53,52324,53,183,94,89,2,29,1,1,allow
64525,53,5631,53,199,102,97,2,29,1,1,allow
57265,53,15033,53,200,102,98,2,30,1,1,allow
49780,53,34638,53,183,94,89,2,29,1,1,allow
56498,53,6287,53,199,102,97,2,30,1,1,allow
49800,53,33373,53,183,94,89,2,29,1,1,allow
55018,53,37429,53,179,94,85,2,30,1,1,allow
56388,53,28849,53,193,102,91,2,29,1,1,allow
50405,53,20541,53,200,102,98,2,29,1,1,allow
56305,53,56939,53,242,118,124,2,30,1,1,allow
64022,53,2782,53,197,102,95,2,30,1,1,allow
52361,53,7907,53,186,78,108,2,29,1,1,allow
49979,53,49459,53,197,94,103,2,30,1,1,allow
50013,53,7317,53,199,102,97,2,30,1,1,allow
60166,53,7820,53,258,94,164,2,30,1,1,allow
64567,53,19362,53,199,102,97,2,30,1,1,allow
57163,53,45195,53,209,110,99,2,30,1,1,allow
27327,53,27327,53,823,98,725,2,30,1,1,allow
56655,53,60035,53,168,86,82,2,30,1,1,allow
44913,80,22574,80,1270,387,883,16,393,4,12,allow
57470,6881,33137,6881,792,792,0,13,1200,13,0,allow
64525,53,61457,53,199,102,97,2,30,1,1,allow
49384,53,48199,53,193,102,91,2,31,1,1,allow
49632,53,3027,53,199,102,97,2,31,1,1,allow
51909,80,5336,80,6057,4543,1514,16,15,9,7,allow
11295,40033,3453,40033,213,89,124,4,32,2,2,allow
55656,31165,21172,31165,70,70,0,2,8,2,0,allow
51893,63924,11081,63924,70,70,0,2,8,2,0,allow
51896,43357,29923,43357,70,70,0,2,8,2,0,allow
26943,443,22865,443,21275,16156,5119,41,22,23,18,allow
52624,443,65468,443,5837,1982,3855,19,19,11,8,allow
64425,53,23618,53,289,134,155,2,30,1,1,allow
49351,53,27652,53,166,86,80,2,30,1,1,allow
57047,53,31984,53,198,94,104,2,31,1,1,allow
49516,53,42173,53,183,94,89,2,30,1,1,allow
55657,37273,33354,37273,70,70,0,2,8,2,0,allow
51895,17172,52457,17172,70,70,0,2,8,2,0,allow
51897,57057,49158,57057,70,70,0,2,8,2,0,allow
48371,443,24225,443,3908,630,3278,12,17,7,5,allow
9105,443,49589,443,4077,438,3639,12,15,6,6,allow
37236,53,35776,53,223,78,145,2,30,1,1,allow
50013,53,8187,53,199,102,97,2,30,1,1,allow
65315,53,36625,53,94,94,0,1,30,1,0,allow
38667,443,44334,443,496852,12216,484636,499,16,167,332,allow
53504,443,31592,443,2291912,60511,2231401,2353,196,863,1490,allow
60431,52867,18137,52867,70,70,0,1,5,1,0,allow
55784,53,64875,53,330,94,236,4,48,2,2,allow
56388,53,34689,53,275,95,180,4,49,2,2,allow
49460,53,64925,53,458,188,270,6,30,3,3,allow
65445,53,31304,53,199,102,97,2,30,1,1,allow
56432,53,34927,53,458,188,270,6,30,3,3,allow
52501,443,44230,443,163226,10147,153079,233,101,101,132,allow
55018,53,50628,53,179,94,85,2,30,1,1,allow
49531,53,34898,53,183,94,89,2,30,1,1,allow
65228,53,53617,53,212,86,126,2,30,1,1,allow
49997,53,1711,53,209,110,99,2,30,1,1,allow
64967,53,49368,53,184,94,90,2,31,1,1,allow
65365,53,42836,53,196,102,94,2,31,1,1,allow
41876,80,9169,80,1740,708,1032,19,396,6,13,allow
34548,443,60764,443,11549,3378,8171,33,196,16,17,allow
49348,80,49348,80,450,246,204,8,142,5,3,allow
45780,443,35080,443,7847,1591,6256,23,186,13,10,allow
57470,6881,47770,6881,330,330,0,6,1200,6,0,allow
21133,18719,1173,18719,150,150,0,1,1200,1,0,allow
57018,53,4073,53,209,110,99,2,30,1,1,allow
65341,53,7483,53,200,102,98,2,30,1,1,allow
49737,53,3736,53,338,110,228,2,30,1,1,allow
64331,53,26878,53,324,89,235,4,31,2,2,allow
51208,443,14745,443,3477,1216,2261,16,136,8,8,allow
52201,443,3597,443,5681,1441,4240,21,51,11,10,allow
63861,37832,64694,37832,70,70,0,1,5,1,0,allow
51089,80,45189,80,6240,4510,1730,40,131,22,18,allow
50286,443,30253,443,10203,2365,7838,40,86,22,18,allow
33150,53,60040,53,816,228,588,8,30,4,4,allow
63959,53,54075,53,246,102,144,2,31,1,1,allow
59851,80,45085,80,307815,6418,301397,285,63,84,201,allow
57593,80,6872,80,486,280,206,8,26,5,3,allow
65155,53,63407,53,295,103,192,4,49,2,2,allow
50021,53,58776,53,963,391,572,10,83,5,5,allow
51901,15860,21103,15860,316,136,180,6,6,3,3,allow
52327,443,53473,443,134,60,74,3,6,2,1,allow
51092,80,39250,80,3974,2713,1261,34,131,19,15,allow
49278,80,32439,80,991,525,466,10,136,6,4,allow
64331,53,61619,53,179,94,85,2,30,1,1,allow
56636,53,19411,53,302,86,216,2,30,1,1,allow
50534,53,27625,53,168,86,82,2,30,1,1,allow
64933,53,11327,53,349,94,255,2,30,1,1,allow
21502,44847,0,0,66,66,0,1,0,1,0,deny
57399,445,0,0,70,70,0,1,0,1,0,drop
443,36576,0,0,60,60,0,1,0,1,0,deny
57398,445,0,0,70,70,0,1,0,1,0,drop
62115,57470,0,0,66,66,0,1,0,1,0,deny
26793,3389,26793,3389,293,223,70,4,1,3,1,reset-both
64605,35993,0,0,62,62,0,1,0,1,0,deny
12604,3389,12604,3389,293,223,70,4,1,3,1,reset-both
57392,445,0,0,70,70,0,1,0,1,0,drop
57692,445,0,0,66,66,0,1,0,1,0,drop
32707,11392,0,0,146,146,0,1,0,1,0,deny
62292,445,0,0,70,70,0,1,0,1,0,drop
62294,445,0,0,70,70,0,1,0,1,0,drop
57389,445,0,0,70,70,0,1,0,1,0,drop
56413,51221,0,0,66,66,0,1,0,1,0,deny
1030,44847,0,0,146,146,0,1,0,1,0,deny
57151,39004,0,0,66,66,0,1,0,1,0,deny
45908,3383,0,0,60,60,0,1,0,1,0,deny
6881,6881,0,0,146,146,0,1,0,1,0,deny
44568,3389,0,0,60,60,0,1,0,1,0,deny
28809,50584,0,0,66,66,0,1,0,1,0,deny
57689,445,0,0,66,66,0,1,0,1,0,drop
57687,445,0,0,66,66,0,1,0,1,0,drop
61522,64147,0,0,66,66,0,1,0,1,0,deny
23900,64147,0,0,62,62,0,1,0,1,0,deny
57385,445,0,0,70,70,0,1,0,1,0,drop
37121,21247,0,0,66,66,0,1,0,1,0,deny
49622,50584,0,0,62,62,0,1,0,1,0,deny
61788,20000,0,0,60,60,0,1,0,1,0,deny
57384,445,0,0,70,70,0,1,0,1,0,drop
15333,44847,0,0,62,62,0,1,0,1,0,deny
62284,445,0,0,70,70,0,1,0,1,0,drop
62278,445,0,0,70,70,0,1,0,1,0,drop
62277,445,0,0,70,70,0,1,0,1,0,drop
62276,445,0,0,70,70,0,1,0,1,0,drop
57987,56125,0,0,90,90,0,1,0,1,0,deny
57684,445,0,0,66,66,0,1,0,1,0,drop
56693,1900,0,0,139,139,0,1,0,1,0,deny
57673,445,0,0,66,66,0,1,0,1,0,drop
57668,445,0,0,66,66,0,1,0,1,0,drop
57670,445,0,0,66,66,0,1,0,1,0,drop
57676,445,0,0,66,66,0,1,0,1,0,drop
57667,445,0,0,66,66,0,1,0,1,0,drop
57672,445,0,0,66,66,0,1,0,1,0,drop
57678,445,0,0,66,66,0,1,0,1,0,drop
14997,57470,0,0,72,72,0,1,0,1,0,deny
57379,445,0,0,70,70,0,1,0,1,0,drop
9687,57470,0,0,78,78,0,1,0,1,0,deny
50470,61463,0,0,86,86,0,1,0,1,0,deny
62267,445,0,0,70,70,0,1,0,1,0,drop
17344,62413,0,0,66,66,0,1,0,1,0,deny
33786,23,0,0,60,60,0,1,0,1,0,deny
62265,445,0,0,70,70,0,1,0,1,0,drop
62261,445,0,0,70,70,0,1,0,1,0,drop
62263,445,0,0,70,70,0,1,0,1,0,drop
56944,35894,0,0,62,62,0,1,0,1,0,deny
26953,30317,0,0,62,62,0,1,0,1,0,deny
65388,55783,0,0,66,66,0,1,0,1,0,deny
27528,35440,0,0,66,66,0,1,0,1,0,deny
60361,57470,0,0,66,66,0,1,0,1,0,deny
51401,6881,0,0,66,66,0,1,0,1,0,deny
57366,445,0,0,70,70,0,1,0,1,0,drop
65494,53,0,0,88,88,0,1,0,1,0,deny
62259,445,0,0,70,70,0,1,0,1,0,drop
62257,445,0,0,70,70,0,1,0,1,0,drop
62255,445,0,0,70,70,0,1,0,1,0,drop
57662,445,0,0,66,66,0,1,0,1,0,drop
62252,445,0,0,70,70,0,1,0,1,0,drop
61336,61689,0,0,62,62,0,1,0,1,0,deny
57657,445,0,0,66,66,0,1,0,1,0,drop
31748,56205,0,0,62,62,0,1,0,1,0,deny
57363,445,0,0,70,70,0,1,0,1,0,drop
57656,445,0,0,66,66,0,1,0,1,0,drop
57655,445,0,0,66,66,0,1,0,1,0,drop
57652,445,0,0,66,66,0,1,0,1,0,drop
40369,57470,0,0,62,62,0,1,0,1,0,deny
29300,35440,0,0,146,146,0,1,0,1,0,deny
45690,60038,0,0,62,62,0,1,0,1,0,reset-both
55505,53,61786,53,198,101,97,2,1,1,1,allow
57665,52700,0,0,66,66,0,1,0,1,0,deny
58743,35894,0,0,62,62,0,1,0,1,0,deny
57358,445,0,0,70,70,0,1,0,1,0,drop
62247,445,0,0,70,70,0,1,0,1,0,drop
57357,445,0,0,70,70,0,1,0,1,0,drop
62243,445,0,0,70,70,0,1,0,1,0,drop
62235,445,0,0,70,70,0,1,0,1,0,drop
57355,445,0,0,70,70,0,1,0,1,0,drop
38400,51505,0,0,146,146,0,1,0,1,0,deny
47515,5900,0,0,60,60,0,1,0,1,0,deny
57641,445,0,0,66,66,0,1,0,1,0,drop
27209,30170,0,0,145,145,0,1,0,1,0,deny
37420,44847,0,0,62,62,0,1,0,1,0,deny
1024,62609,0,0,148,148,0,1,0,1,0,deny
47134,37965,0,0,62,62,0,1,0,1,0,deny
57348,445,0,0,70,70,0,1,0,1,0,drop
11574,51505,0,0,66,66,0,1,0,1,0,deny
57634,445,0,0,66,66,0,1,0,1,0,drop
16654,50265,0,0,62,62,0,1,0,1,0,deny
28899,37965,0,0,62,62,0,1,0,1,0,deny
62225,445,0,0,70,70,0,1,0,1,0,drop
64681,35993,0,0,62,62,0,1,0,1,0,deny
57346,445,0,0,70,70,0,1,0,1,0,drop
57987,56125,0,0,90,90,0,1,0,1,0,deny
48841,51221,0,0,62,62,0,1,0,1,0,deny
57345,445,0,0,70,70,0,1,0,1,0,drop
57632,445,0,0,66,66,0,1,0,1,0,drop
57344,445,0,0,70,70,0,1,0,1,0,drop
57343,445,0,0,70,70,0,1,0,1,0,drop
57340,445,0,0,70,70,0,1,0,1,0,drop
57339,445,0,0,70,70,0,1,0,1,0,drop
28824,44847,0,0,62,62,0,1,0,1,0,deny
48219,55442,0,0,66,66,0,1,0,1,0,deny
44855,58414,0,0,62,62,0,1,0,1,0,deny
52432,50265,0,0,66,66,0,1,0,1,0,deny
57625,445,0,0,66,66,0,1,0,1,0,drop
0,0,0,0,320,320,0,5,0,5,0,allow
50767,57470,0,0,66,66,0,1,0,1,0,deny
57620,445,0,0,66,66,0,1,0,1,0,drop
57325,445,0,0,70,70,0,1,0,1,0,drop
57324,445,0,0,70,70,0,1,0,1,0,drop
57322,445,0,0,70,70,0,1,0,1,0,drop
62089,8604,0,0,66,66,0,1,0,1,0,deny
52614,44847,0,0,66,66,0,1,0,1,0,deny
57314,445,0,0,70,70,0,1,0,1,0,drop
57315,445,0,0,70,70,0,1,0,1,0,drop
57849,50584,0,0,66,66,0,1,0,1,0,deny
43724,35440,0,0,62,62,0,1,0,1,0,deny
18876,44847,0,0,66,66,0,1,0,1,0,deny
9522,51505,0,0,66,66,0,1,0,1,0,deny
62307,8055,0,0,159,159,0,1,0,1,0,deny
55553,37965,0,0,66,66,0,1,0,1,0,deny
50292,22114,0,0,66,66,0,1,0,1,0,deny
51015,64147,0,0,145,145,0,1,0,1,0,deny
62215,445,0,0,70,70,0,1,0,1,0,drop
62213,445,0,0,70,70,0,1,0,1,0,drop
62212,445,0,0,70,70,0,1,0,1,0,drop
57608,445,0,0,66,66,0,1,0,1,0,drop
57606,445,0,0,66,66,0,1,0,1,0,drop
57607,445,0,0,66,66,0,1,0,1,0,drop
57602,445,0,0,66,66,0,1,0,1,0,drop
57603,445,0,0,66,66,0,1,0,1,0,drop
57601,445,0,0,66,66,0,1,0,1,0,drop
20508,57470,0,0,62,62,0,1,0,1,0,deny
40521,23117,0,0,62,62,0,1,0,1,0,deny
51581,17546,0,0,66,66,0,1,0,1,0,deny
10436,37965,0,0,62,62,0,1,0,1,0,deny
57237,21247,0,0,62,62,0,1,0,1,0,deny
57303,445,0,0,70,70,0,1,0,1,0,drop
61150,11392,0,0,66,66,0,1,0,1,0,deny
59008,51221,0,0,62,62,0,1,0,1,0,deny
1078,30975,0,0,143,143,0,1,0,1,0,deny
42429,22114,0,0,146,146,0,1,0,1,0,deny
57500,23,0,0,60,60,0,1,0,1,0,deny
50470,61463,0,0,86,86,0,1,0,1,0,deny
61408,30188,0,0,66,66,0,1,0,1,0,deny
53147,37965,0,0,62,62,0,1,0,1,0,deny
15933,64147,0,0,62,62,0,1,0,1,0,deny
62207,445,0,0,70,70,0,1,0,1,0,drop
62211,445,0,0,70,70,0,1,0,1,0,drop
62197,445,0,0,70,70,0,1,0,1,0,drop
57299,445,0,0,70,70,0,1,0,1,0,drop
57589,445,0,0,66,66,0,1,0,1,0,drop
57588,445,0,0,66,66,0,1,0,1,0,drop
57586,445,0,0,66,66,0,1,0,1,0,drop
443,38385,0,0,66,66,0,1,90,1,0,allow
59723,443,54726,443,8380,1882,6498,29,396,9,20,allow
65075,53,1890,53,278,100,178,4,31,2,2,allow
65365,53,19962,53,192,98,94,2,30,1,1,allow
49384,53,2964,53,186,95,91,2,30,1,1,allow
34924,443,1749,443,2401,1149,1252,14,982,7,7,allow
61735,443,32889,443,57467,4506,52961,86,30,42,44,allow
60384,443,14731,443,130,70,60,2,15,1,1,allow
42602,443,64444,443,2378,1126,1252,14,982,7,7,allow
35702,443,5840,443,6751,1889,4862,24,316,13,11,allow
60187,443,37474,443,5656,1936,3720,23,57,11,12,allow
48268,443,29893,443,18462,11672,6790,47,63,26,21,allow
43415,443,53448,443,130,70,60,2,15,1,1,allow
60362,443,18140,443,130,70,60,2,15,1,1,allow
56852,49677,39171,49677,130,70,60,2,5,1,1,allow
50998,443,19722,443,3482,1985,1497,21,17,10,11,allow
50997,443,46270,443,3772,2099,1673,22,18,11,11,allow
53131,44021,31517,44021,698,320,378,10,16,6,4,allow
39572,443,3299,443,2396,1144,1252,14,982,7,7,allow
45363,443,50809,443,2396,1144,1252,14,982,7,7,allow
56772,53,9066,53,168,86,82,2,30,1,1,allow
41632,443,56228,443,8507,4462,4045,27,141,14,13,allow
47595,33439,0,0,106,106,0,1,60,1,0,allow
39716,443,56404,443,131171,10346,120825,183,150,93,90,allow
65155,53,8256,53,295,103,192,4,48,2,2,allow
60378,443,38205,443,130,70,60,2,15,1,1,allow
59835,53,53528,53,168,78,90,2,30,1,1,allow
55644,45579,20057,45579,70,70,0,1,5,1,0,allow
43423,443,64524,443,130,70,60,2,15,1,1,allow
35178,8635,35178,8635,138,78,60,2,5,1,1,allow
55000,5222,35744,5222,32608,22014,10594,225,215,124,101,allow
48269,443,55381,443,4800,3396,1404,19,60,10,9,allow
50996,443,8675,443,3536,2039,1497,22,18,11,11,allow
50661,80,9944,80,2693,461,2232,14,17,6,8,allow
56945,443,12296,443,7818,2136,5682,31,322,14,17,allow
50990,443,22704,443,6090,2628,3462,21,24,11,10,allow
49516,53,51751,53,182,93,89,2,30,1,1,allow
55945,53,51093,53,733,86,647,2,30,1,1,allow
56946,443,38559,443,10408,4790,5618,34,322,16,18,allow
51142,80,61764,80,1114,534,580,12,16,7,5,allow
44912,80,52893,80,1602,1282,320,10,15,5,5,allow
50988,443,14910,443,6938,2686,4252,25,27,12,13,allow
60374,443,9623,443,130,70,60,2,15,1,1,allow
64245,53,8045,53,198,101,97,2,31,1,1,allow
60167,5222,36653,5222,908,650,258,11,20,7,4,allow
56948,53,35699,53,93,93,0,1,30,1,0,allow
63882,49163,63411,49163,66,66,0,2,8,2,0,allow
51878,9999,7906,9999,66,66,0,1,5,1,0,allow
55169,53,64266,53,775,103,672,2,30,1,1,allow
55272,53,11966,53,285,103,182,4,51,2,2,allow
52414,80,51546,80,9534,746,8788,18,49,9,9,allow
55821,53,40940,53,168,86,82,2,30,1,1,allow
57282,53,60817,53,198,101,97,2,30,1,1,allow
64420,53,14172,53,188,96,92,2,30,1,1,allow
49632,53,30803,53,198,101,97,2,30,1,1,allow
58279,443,21713,443,3878,1156,2722,14,136,7,7,allow
52682,443,30711,443,5406,922,4484,19,360,10,9,allow
30188,32873,43392,32873,502,150,352,2,1200,1,1,allow
59772,443,48331,443,181413,11493,169920,167,85,41,126,allow
64483,53,26683,53,168,86,82,2,31,1,1,allow
55714,443,18718,443,11626,4173,7453,25,121,12,13,allow
62616,443,35713,443,32504,1730,30774,44,122,17,27,allow
53283,443,51039,443,3369,1036,2333,11,121,5,6,allow
44858,5228,3088,5228,6819,1586,5233,18,3603,9,9,allow
58080,443,57943,443,646,358,288,10,133,6,4,allow
50303,443,16402,443,13459,1604,11855,27,187,14,13,allow
62194,445,0,0,70,70,0,1,0,1,0,drop
57287,445,0,0,70,70,0,1,0,1,0,drop
57290,445,0,0,70,70,0,1,0,1,0,drop
55733,51505,0,0,66,66,0,1,0,1,0,deny
57289,445,0,0,70,70,0,1,0,1,0,drop
53971,50265,0,0,66,66,0,1,0,1,0,deny
57286,445,0,0,70,70,0,1,0,1,0,drop
12060,37965,0,0,66,66,0,1,0,1,0,deny
61135,50265,0,0,62,62,0,1,0,1,0,deny
53971,55442,0,0,66,66,0,1,0,1,0,deny
57282,445,0,0,70,70,0,1,0,1,0,drop
54423,21247,0,0,62,62,0,1,0,1,0,deny
62192,445,0,0,70,70,0,1,0,1,0,drop
63589,44847,0,0,66,66,0,1,0,1,0,deny
62188,445,0,0,70,70,0,1,0,1,0,drop
62184,445,0,0,70,70,0,1,0,1,0,drop
62180,445,0,0,70,70,0,1,0,1,0,drop
24311,22617,0,0,60,60,0,1,0,1,0,deny
64958,53,33266,53,395,102,293,2,30,1,1,allow
55272,53,17246,53,285,103,182,4,50,2,2,allow
50580,80,18240,80,1513,694,819,10,15,5,5,allow
53815,44847,0,0,62,62,0,1,0,1,0,deny
10396,62609,0,0,148,148,0,1,0,1,0,deny
33896,57470,0,0,74,74,0,1,0,1,0,deny
12074,10197,0,0,72,72,0,1,0,1,0,deny
63080,37965,0,0,66,66,0,1,0,1,0,deny
57276,445,0,0,70,70,0,1,0,1,0,drop
50442,37807,0,0,66,66,0,1,0,1,0,deny
12242,51221,0,0,62,62,0,1,0,1,0,deny
11066,50584,0,0,66,66,0,1,0,1,0,deny
27869,51221,0,0,66,66,0,1,0,1,0,deny
62175,445,0,0,70,70,0,1,0,1,0,drop
62172,445,0,0,70,70,0,1,0,1,0,drop
49531,53,38676,53,183,94,89,2,29,1,1,allow
64967,53,8909,53,184,94,90,2,29,1,1,allow
63380,443,31712,443,4704,2139,2565,13,119,7,6,allow
48265,443,35728,443,7379,2268,5111,18,134,8,10,allow
56622,443,37505,443,3575,1079,2496,15,155,7,8,allow
51087,80,58473,80,6363,3093,3270,36,130,19,17,allow
57594,80,6266,80,486,280,206,8,25,5,3,allow
51091,80,22433,80,4033,2712,1321,35,130,19,16,allow
63457,443,6711,443,606,300,306,11,60,6,5,allow
50669,443,15933,443,8464,2256,6208,25,255,13,12,allow
46505,443,30509,443,59700,5399,54301,109,32,57,52,allow
57282,53,4028,53,199,102,97,2,29,1,1,allow
51086,80,8200,80,6365,3093,3272,36,130,19,17,allow
49820,53,16935,53,193,102,91,2,29,1,1,allow
65315,53,35548,53,178,94,84,2,29,1,1,allow
65341,53,19741,53,200,102,98,2,29,1,1,allow
57018,53,62434,53,209,110,99,2,29,1,1,allow
56948,53,55604,53,183,94,89,2,29,1,1,allow
49307,53,61453,53,210,102,108,2,29,1,1,allow
57282,53,23204,53,199,102,97,2,29,1,1,allow
64144,53,4671,53,193,102,91,2,29,1,1,allow
55809,443,23452,443,180,180,0,4,11,4,0,allow
49165,53,17672,53,212,102,110,2,29,1,1,allow
65075,53,49710,53,278,100,178,4,30,2,2,allow
51675,8245,24099,8245,346,214,132,3,29,1,2,allow
49780,53,4418,53,183,94,89,2,29,1,1,allow
52312,443,50036,443,1574859,55851,1519008,1758,185,656,1102,allow
49312,53,8379,53,216,94,122,2,29,1,1,allow
51890,31122,40957,31122,70,70,0,2,8,2,0,allow
51892,46647,34851,46647,70,70,0,2,8,2,0,allow
55272,53,42714,53,285,103,182,4,50,2,2,allow
49884,53,44954,53,232,110,122,2,30,1,1,allow
55646,14420,30714,14420,70,70,0,1,5,1,0,allow
50552,80,61160,80,2367,1240,1127,10,16,5,5,allow
65486,443,40088,443,375786,11380,364406,388,16,137,251,allow
50594,80,12498,80,1635,824,811,10,15,5,5,allow
56841,29753,13885,29753,70,70,0,1,5,1,0,allow
49500,443,11255,443,16888,2692,14196,42,150,22,20,allow
65319,53,47160,53,285,103,182,4,44,2,2,allow
63458,443,33627,443,7934,1372,6562,25,63,12,13,allow
42595,443,31051,443,1093,606,487,11,15,7,4,allow
65485,443,65115,443,92447,4519,87928,105,16,39,66,allow
53684,25933,35129,25933,552,306,246,9,15,5,4,allow
65341,53,20700,53,200,102,98,2,30,1,1,allow
49621,443,59596,443,14888,3555,11333,58,256,23,35,allow
45891,443,41811,443,5718,1527,4191,24,22,13,11,allow
56772,53,56028,53,168,86,82,2,30,1,1,allow
49632,53,14328,53,199,102,97,2,30,1,1,allow
64245,53,44468,53,199,102,97,2,30,1,1,allow
56341,443,63475,443,8325,1483,6842,24,47,13,11,allow
59065,443,57168,443,25840,18434,7406,45,171,26,19,allow
38579,80,3885,80,996,507,489,10,200,5,5,allow
50467,80,50467,80,886702,38812,847890,1134,23,558,576,allow
52133,443,32677,443,7601,1919,5682,24,76,13,11,allow
49632,53,26153,53,199,102,97,2,30,1,1,allow
58209,53,58209,53,645,90,555,2,30,1,1,allow
42050,53,28616,53,168,78,90,2,30,1,1,allow
54063,443,37024,443,1313,652,661,13,185,7,6,allow
65155,53,21805,53,295,103,192,4,48,2,2,allow
53717,443,48427,443,318,192,126,6,15,4,2,allow
39612,443,50624,443,482030,16677,465353,539,28,207,332,allow
58506,443,5356,443,2408,1399,1009,18,274,9,9,allow
49349,80,49349,80,450,246,204,8,141,5,3,allow
63460,443,27370,443,502,250,252,9,63,5,4,allow
49997,53,42691,53,209,110,99,2,29,1,1,allow
50655,80,3910,80,1507,682,825,13,20,8,5,allow
57584,443,57584,443,8019,4063,3956,33,92,16,17,allow
51891,23238,33315,23238,70,70,0,2,8,2,0,allow
43376,443,45691,443,7123,1331,5792,22,81,11,11,allow
53719,443,60186,443,70,70,0,1,5,1,0,allow
62776,443,62776,443,4398,1491,2907,19,26,11,8,allow
60591,53,64106,53,78,78,0,1,29,1,0,allow
64967,53,42572,53,184,94,90,2,29,1,1,allow
56448,53,62354,53,200,102,98,2,29,1,1,allow
41029,53,0,0,86,86,0,1,29,1,0,allow
56655,53,54773,53,86,86,0,1,29,1,0,allow
51582,5223,65291,5223,4183,1283,2900,23,163,13,10,allow
49973,80,59362,80,1352,364,988,13,15,6,7,allow
64331,53,48009,53,179,94,85,2,29,1,1,allow
65194,53,28428,53,196,94,102,2,29,1,1,allow
56655,53,28955,53,168,86,82,2,29,1,1,allow
64844,53,45693,53,733,86,647,2,29,1,1,allow
55821,53,13953,53,196,102,94,2,29,1,1,allow
49516,53,31257,53,183,94,89,2,29,1,1,allow
49351,53,56042,53,166,86,80,2,29,1,1,allow
49516,53,60499,53,183,94,89,2,29,1,1,allow
59902,53,0,0,220,83,137,2,30,1,1,allow
57305,53,52868,53,168,86,82,2,29,1,1,allow
65365,53,13159,53,196,102,94,2,30,1,1,allow
64292,53,46657,53,199,94,105,2,30,1,1,allow
42291,53,6078,53,168,78,90,2,30,1,1,allow
49600,53,23356,53,243,94,149,2,30,1,1,allow
44847,6881,3314,6881,501,150,351,2,1200,1,1,allow
59560,443,54712,443,4038,1219,2819,22,135,9,13,allow
65155,53,9340,53,613,200,413,6,59,3,3,allow
57867,27019,59183,27019,802,472,330,8,30,5,3,allow
56937,8200,16885,8200,78,78,0,1,30,1,0,allow
63975,53,64486,53,316,94,222,2,30,1,1,allow
55629,53,49009,53,208,94,114,2,30,1,1,allow
9087,53,9087,53,178,82,96,2,30,1,1,allow
65422,53,59464,53,208,94,114,2,30,1,1,allow
64298,443,45877,443,115035,5282,109753,128,120,44,84,allow
60434,11339,49665,11339,70,70,0,2,8,2,0,allow
34158,443,8410,443,130,70,60,2,15,1,1,allow
56772,53,47377,53,168,86,82,2,30,1,1,allow
64348,53,23011,53,321,102,219,2,30,1,1,allow
49724,53,34584,53,210,102,108,2,30,1,1,allow
64245,53,47905,53,199,102,97,2,30,1,1,allow
56772,53,27354,53,168,86,82,2,30,1,1,allow
65292,53,10766,53,385,106,279,4,33,2,2,allow
51889,44348,63585,44348,70,70,0,2,8,2,0,allow
55272,53,40097,53,599,198,401,6,50,3,3,allow
58017,53,58017,53,832,106,726,2,30,1,1,allow
64420,53,3880,53,194,102,92,2,30,1,1,allow
55258,443,6481,443,1786,172,1614,7,120,3,4,allow
46334,443,50617,443,9759,2304,7455,28,138,14,14,allow
65075,53,30736,53,278,100,178,4,30,2,2,allow
49347,80,49347,80,450,246,204,8,141,5,3,allow
56524,443,14904,443,344632,9074,335558,354,121,122,232,allow
57470,58125,57009,58125,1572,664,908,14,1200,9,5,allow
54121,443,19391,443,26357358,863775,25493583,27347,208,8650,18697,allow
55345,53,38199,53,255,102,153,2,30,1,1,allow
39208,53,0,0,86,86,0,1,30,1,0,allow
50407,8080,50407,8080,378,180,198,7,33,4,3,allow
53697,6224,21795,6224,70,70,0,2,8,2,0,allow
53683,30218,33662,30218,492,306,186,8,15,5,3,allow
38654,443,36804,443,9144,1783,7361,19,16,10,9,allow
53698,8120,50996,8120,70,70,0,2,8,2,0,allow
55026,53,55024,53,196,94,102,2,30,1,1,allow
64245,53,26898,53,199,102,97,2,30,1,1,allow
64726,53,58493,53,352,94,258,2,30,1,1,allow
56947,53,11234,53,239,102,137,2,30,1,1,allow
62169,445,0,0,70,70,0,1,0,1,0,drop
56636,43890,0,0,66,66,0,1,0,1,0,deny
57269,445,0,0,70,70,0,1,0,1,0,drop
28009,36237,0,0,146,146,0,1,0,1,0,deny
57268,445,0,0,70,70,0,1,0,1,0,drop
47910,7461,0,0,60,60,0,1,0,1,0,deny
23537,35253,0,0,66,66,0,1,0,1,0,deny
57263,445,0,0,70,70,0,1,0,1,0,drop
6666,138,0,0,60,60,0,1,0,1,0,deny
1972,57470,0,0,78,78,0,1,0,1,0,deny
6881,6881,0,0,62,62,0,1,0,1,0,deny
65179,44847,0,0,66,66,0,1,0,1,0,deny
57261,445,0,0,70,70,0,1,0,1,0,drop
57566,445,0,0,66,66,0,1,0,1,0,drop
52569,30188,0,0,66,66,0,1,0,1,0,deny
62167,445,0,0,70,70,0,1,0,1,0,drop
62164,445,0,0,70,70,0,1,0,1,0,drop
22922,35440,0,0,66,66,0,1,0,1,0,deny
27272,64147,0,0,66,66,0,1,0,1,0,deny
18754,30188,0,0,62,62,0,1,0,1,0,deny
57257,445,0,0,70,70,0,1,0,1,0,drop
50529,44847,0,0,66,66,0,1,0,1,0,deny
61925,51505,0,0,62,62,0,1,0,1,0,deny
41381,23,0,0,60,60,0,1,0,1,0,deny
57558,445,0,0,66,66,0,1,0,1,0,drop
57557,445,0,0,66,66,0,1,0,1,0,drop
58501,44847,0,0,66,66,0,1,0,1,0,deny
52626,44847,0,0,66,66,0,1,0,1,0,deny
57256,445,0,0,70,70,0,1,0,1,0,drop
64115,2767,0,0,66,66,0,1,0,1,0,deny
9687,57470,0,0,78,78,0,1,0,1,0,deny
443,7387,0,0,60,60,0,1,0,1,0,deny
52472,51221,0,0,74,74,0,1,0,1,0,deny
61559,23,0,0,60,60,0,1,0,1,0,deny
62155,445,0,0,70,70,0,1,0,1,0,drop
35120,26467,0,0,62,62,0,1,0,1,0,deny
62150,445,0,0,70,70,0,1,0,1,0,drop
62149,445,0,0,70,70,0,1,0,1,0,drop
62147,445,0,0,70,70,0,1,0,1,0,drop
61527,51050,0,0,66,66,0,1,0,1,0,deny
45941,23386,0,0,60,60,0,1,0,1,0,deny
57554,445,0,0,66,66,0,1,0,1,0,drop
49367,51505,0,0,62,62,0,1,0,1,0,deny
57251,445,0,0,70,70,0,1,0,1,0,drop
41954,2323,0,0,60,60,0,1,0,1,0,deny
51222,35440,0,0,62,62,0,1,0,1,0,deny
48676,53395,0,0,60,60,0,1,0,1,0,deny
57550,445,0,0,66,66,0,1,0,1,0,drop
57546,445,0,0,66,66,0,1,0,1,0,drop
57541,445,0,0,66,66,0,1,0,1,0,drop
57542,445,0,0,66,66,0,1,0,1,0,drop
57547,445,0,0,66,66,0,1,0,1,0,drop
57545,445,0,0,66,66,0,1,0,1,0,drop
57539,445,0,0,66,66,0,1,0,1,0,drop
38852,37965,0,0,62,62,0,1,0,1,0,deny
62140,445,0,0,70,70,0,1,0,1,0,drop
57987,56125,0,0,90,90,0,1,0,1,0,deny
2705,37,0,0,60,60,0,1,0,1,0,deny
62137,445,0,0,70,70,0,1,0,1,0,drop
62136,445,0,0,70,70,0,1,0,1,0,drop
62133,445,0,0,70,70,0,1,0,1,0,drop
57698,64147,0,0,66,66,0,1,0,1,0,deny
44821,64147,0,0,62,62,0,1,0,1,0,deny
13727,13751,0,0,148,148,0,1,0,1,0,deny
59227,11392,0,0,62,62,0,1,0,1,0,deny
16994,57866,0,0,146,146,0,1,0,1,0,deny
49426,57470,0,0,66,66,0,1,0,1,0,deny
16001,48817,0,0,143,143,0,1,0,1,0,deny
48079,43227,0,0,66,66,0,1,0,1,0,deny
2170,43227,0,0,62,62,0,1,0,1,0,deny
57238,445,0,0,70,70,0,1,0,1,0,drop
30797,23,0,0,60,60,0,1,0,1,0,deny
64022,53,20960,53,194,99,95,2,1,1,1,allow
17010,57470,0,0,62,62,0,1,0,1,0,deny
62130,445,0,0,70,70,0,1,0,1,0,drop
62129,445,0,0,70,70,0,1,0,1,0,drop
62126,445,0,0,70,70,0,1,0,1,0,drop
57235,445,0,0,70,70,0,1,0,1,0,drop
57533,445,0,0,66,66,0,1,0,1,0,drop
22346,51505,0,0,62,62,0,1,0,1,0,deny
19004,51505,0,0,62,62,0,1,0,1,0,deny
62124,445,0,0,70,70,0,1,0,1,0,drop
50470,61463,0,0,86,86,0,1,0,1,0,deny
57529,445,0,0,66,66,0,1,0,1,0,drop
60962,64147,0,0,66,66,0,1,0,1,0,deny
57526,445,0,0,66,66,0,1,0,1,0,drop
57528,445,0,0,66,66,0,1,0,1,0,drop
57525,445,0,0,66,66,0,1,0,1,0,drop
57231,445,0,0,70,70,0,1,0,1,0,drop
50298,37965,0,0,66,66,0,1,0,1,0,deny
57229,445,0,0,70,70,0,1,0,1,0,drop
19068,37965,0,0,62,62,0,1,0,1,0,deny
50066,30188,0,0,62,62,0,1,0,1,0,deny
57227,445,0,0,70,70,0,1,0,1,0,drop
62119,445,0,0,70,70,0,1,0,1,0,drop
65285,50584,0,0,66,66,0,1,0,1,0,deny
49644,30188,0,0,66,66,0,1,0,1,0,deny
62107,445,0,0,70,70,0,1,0,1,0,drop
62110,445,0,0,70,70,0,1,0,1,0,drop
59611,56205,0,0,66,66,0,1,0,1,0,deny
54167,50584,0,0,62,62,0,1,0,1,0,deny
40216,50265,0,0,62,62,0,1,0,1,0,deny
37927,50265,0,0,66,66,0,1,0,1,0,deny
37343,21247,0,0,62,62,0,1,0,1,0,deny
57513,445,0,0,66,66,0,1,0,1,0,drop
65317,51221,0,0,78,78,0,1,0,1,0,deny
63927,50265,0,0,62,62,0,1,0,1,0,deny
39244,36829,0,0,62,62,0,1,0,1,0,deny
57220,445,0,0,70,70,0,1,0,1,0,drop
0,0,0,0,82,82,0,1,0,1,0,deny
0,0,0,0,480,244,236,4,0,2,2,allow
60674,8055,0,0,145,145,0,1,0,1,0,deny
52658,64147,0,0,145,145,0,1,0,1,0,deny
63196,445,0,0,66,66,0,1,0,1,0,deny
57218,445,0,0,70,70,0,1,0,1,0,drop
63098,35440,0,0,66,66,0,1,0,1,0,deny
46409,35440,0,0,66,66,0,1,0,1,0,deny
57633,50584,0,0,146,146,0,1,0,1,0,deny
57506,445,0,0,66,66,0,1,0,1,0,drop
5222,18733,0,0,66,66,0,1,0,1,0,deny
10427,32480,0,0,66,66,0,1,0,1,0,deny
62096,445,0,0,70,70,0,1,0,1,0,drop
29951,34021,0,0,62,62,0,1,0,1,0,reset-both
6546,37965,0,0,62,62,0,1,0,1,0,deny
57217,445,0,0,70,70,0,1,0,1,0,drop
57216,445,0,0,70,70,0,1,0,1,0,drop
39390,15503,0,0,74,74,0,1,0,1,0,deny
57215,445,0,0,70,70,0,1,0,1,0,drop
57212,445,0,0,70,70,0,1,0,1,0,drop
57211,445,0,0,70,70,0,1,0,1,0,drop
51505,17372,0,0,66,66,0,1,0,1,0,deny
57503,445,0,0,66,66,0,1,0,1,0,drop
57987,56125,0,0,90,90,0,1,0,1,0,deny
57131,35776,0,0,145,145,0,1,0,1,0,deny
2828,35253,0,0,66,66,0,1,0,1,0,deny
39981,57470,0,0,62,62,0,1,0,1,0,deny
61404,52700,0,0,72,72,0,1,0,1,0,deny
58424,52700,0,0,66,66,0,1,0,1,0,deny
57497,445,0,0,66,66,0,1,0,1,0,drop
57197,445,0,0,70,70,0,1,0,1,0,drop
57196,445,0,0,70,70,0,1,0,1,0,drop
57192,445,0,0,70,70,0,1,0,1,0,drop
19161,26296,0,0,159,159,0,1,0,1,0,deny
34301,21247,0,0,62,62,0,1,0,1,0,deny
51320,44847,0,0,66,66,0,1,0,1,0,deny
57491,445,0,0,66,66,0,1,0,1,0,drop
57186,445,0,0,70,70,0,1,0,1,0,drop
57187,445,0,0,70,70,0,1,0,1,0,drop
22390,19473,0,0,66,66,0,1,0,1,0,deny
39531,19473,0,0,62,62,0,1,0,1,0,deny
5222,1504,0,0,66,66,0,1,0,1,0,deny
50090,50265,0,0,62,62,0,1,0,1,0,deny
62089,445,0,0,70,70,0,1,0,1,0,drop
62085,445,0,0,70,70,0,1,0,1,0,drop
62084,445,0,0,70,70,0,1,0,1,0,drop
26448,9192,0,0,145,145,0,1,0,1,0,deny
57475,445,0,0,66,66,0,1,0,1,0,drop
57476,445,0,0,66,66,0,1,0,1,0,drop
57478,445,0,0,66,66,0,1,0,1,0,drop
57477,445,0,0,66,66,0,1,0,1,0,drop
57479,445,0,0,66,66,0,1,0,1,0,drop
57480,445,0,0,66,66,0,1,0,1,0,drop
57474,445,0,0,66,66,0,1,0,1,0,drop
57473,445,0,0,66,66,0,1,0,1,0,drop
57175,445,0,0,70,70,0,1,0,1,0,drop
23277,53733,0,0,62,62,0,1,0,1,0,deny
58574,21247,0,0,66,66,0,1,0,1,0,deny
62132,42873,0,0,66,66,0,1,0,1,0,deny
46662,36237,0,0,62,62,0,1,0,1,0,deny
35494,22114,0,0,66,66,0,1,0,1,0,deny
63037,443,11934,443,303,85,218,2,31,1,1,allow
63038,53,49856,53,303,85,218,2,31,1,1,allow
53216,443,34085,443,14933,1671,13262,31,66,15,16,allow
50523,443,44131,443,1389,868,521,12,25,6,6,allow
53676,80,62250,80,154478,6934,147544,194,24,86,108,allow
65319,53,30506,53,285,103,182,4,44,2,2,allow
59867,443,26148,443,6197,843,5354,21,27,10,11,allow
45346,443,29212,443,2438,1442,996,21,20,12,9,allow
56848,19556,62974,19556,70,70,0,2,8,2,0,allow
53052,443,55345,443,214,140,74,4,15,3,1,allow
52009,443,21173,443,10339,2028,8311,28,46,16,12,allow
50546,80,2878,80,1990,812,1178,9,15,5,4,allow
63045,443,61231,443,510,164,346,2,30,1,1,allow
63046,53,33586,53,510,164,346,2,30,1,1,allow
50521,80,1574,80,454,262,192,8,25,5,3,allow
50468,80,50468,80,90393,7684,82709,132,22,69,63,allow
49555,53,60187,53,578,286,292,9,15,5,4,allow
61714,443,1566,443,2484,330,2154,12,135,5,7,allow
53253,443,34431,443,36393,27741,8652,147,210,76,71,allow
47289,443,7853,443,16114,7882,8232,37,104,15,22,allow
53217,443,21683,443,6058,1038,5020,20,66,11,9,allow
28755,80,28755,80,21270,2178,19092,35,29,15,20,allow
50466,80,50466,80,78335,7114,71221,114,22,60,54,allow
49655,80,18992,80,1056,682,374,10,15,6,4,allow
55654,18251,23263,18251,70,70,0,2,8,2,0,allow
51877,13472,45197,13472,66,66,0,1,5,1,0,allow
38634,443,16123,443,9096,1676,7420,20,18,10,10,allow
49292,443,18411,443,80199,66182,14017,134,163,87,47,allow
50408,8080,50408,8080,378,180,198,7,32,4,3,allow
46383,443,46383,443,4661,1754,2907,19,30,11,8,allow
44638,443,36875,443,20062,11233,8829,48,94,29,19,allow
49525,443,29311,443,14786,2845,11941,32,121,17,15,allow
59787,443,61520,443,20036,2088,17948,51,334,21,30,allow
58854,443,61370,443,19134,6811,12323,39,83,18,21,allow
50524,443,21568,443,1389,868,521,12,25,6,6,allow
56849,23745,4233,23745,70,70,0,2,8,2,0,allow
41247,80,52056,80,234,234,0,4,12,4,0,allow
63461,443,13278,443,622,310,312,11,59,6,5,allow
33383,443,13969,443,24440,2215,22225,46,316,20,26,allow
53223,443,54102,443,7457,1726,5731,25,65,13,12,allow
45019,53,52189,53,168,78,90,2,30,1,1,allow
53224,443,28053,443,6001,982,5019,19,65,10,9,allow
47196,443,63403,443,2701330,44089,2657241,2230,134,296,1934,allow
33775,80,33775,80,424,198,226,7,142,4,3,allow
57170,445,0,0,70,70,0,1,0,1,0,drop
62081,445,0,0,70,70,0,1,0,1,0,drop
62075,445,0,0,70,70,0,1,0,1,0,drop
62068,445,0,0,70,70,0,1,0,1,0,drop
30782,36237,0,0,62,62,0,1,0,1,0,deny
64546,57470,0,0,66,66,0,1,0,1,0,deny
53465,57470,0,0,62,62,0,1,0,1,0,deny
57461,445,0,0,66,66,0,1,0,1,0,drop
57460,445,0,0,66,66,0,1,0,1,0,drop
57458,445,0,0,66,66,0,1,0,1,0,drop
57159,445,0,0,70,70,0,1,0,1,0,drop
57162,445,0,0,70,70,0,1,0,1,0,drop
57161,445,0,0,70,70,0,1,0,1,0,drop
57157,445,0,0,70,70,0,1,0,1,0,drop
62067,445,0,0,70,70,0,1,0,1,0,drop
57154,445,0,0,70,70,0,1,0,1,0,drop
36963,23,0,0,60,60,0,1,0,1,0,deny
52714,64147,0,0,66,66,0,1,0,1,0,deny
62064,445,0,0,70,70,0,1,0,1,0,drop
19885,64147,0,0,62,62,0,1,0,1,0,deny
61981,9000,0,0,60,60,0,1,0,1,0,deny
61242,35253,0,0,66,66,0,1,0,1,0,deny
62059,445,0,0,70,70,0,1,0,1,0,drop
50470,61463,0,0,86,86,0,1,0,1,0,deny
62060,445,0,0,70,70,0,1,0,1,0,drop
62055,445,0,0,70,70,0,1,0,1,0,drop
48706,23393,0,0,60,60,0,1,0,1,0,deny
1441,51221,0,0,62,62,0,1,0,1,0,deny
59364,44847,0,0,66,66,0,1,0,1,0,deny
1171,18375,0,0,146,146,0,1,0,1,0,deny
56653,22114,0,0,66,66,0,1,0,1,0,deny
57148,445,0,0,70,70,0,1,0,1,0,drop
53608,39004,0,0,66,66,0,1,0,1,0,deny
29159,39004,0,0,62,62,0,1,0,1,0,deny
2705,37,0,0,60,60,0,1,0,1,0,deny
45007,22114,0,0,146,146,0,1,0,1,0,deny
57141,445,0,0,70,70,0,1,0,1,0,drop
62045,445,0,0,70,70,0,1,0,1,0,drop
62044,445,0,0,70,70,0,1,0,1,0,drop
62041,445,0,0,70,70,0,1,0,1,0,drop
57140,445,0,0,70,70,0,1,0,1,0,drop
25222,37965,0,0,62,62,0,1,0,1,0,deny
54742,37965,0,0,66,66,0,1,0,1,0,deny
60136,56205,0,0,66,66,0,1,0,1,0,deny
16001,48817,0,0,143,143,0,1,0,1,0,deny
8194,21247,0,0,146,146,0,1,0,1,0,deny
49977,57470,0,0,62,62,0,1,0,1,0,deny
57134,445,0,0,70,70,0,1,0,1,0,drop
53132,29384,35704,29384,70,70,0,1,5,1,0,allow
64255,53,15083,53,260,86,174,2,30,1,1,allow
64516,53,21568,53,215,94,121,2,30,1,1,allow
48658,53,48919,53,368,80,288,4,30,2,2,allow
52997,443,53080,443,17380,7747,9633,52,121,23,29,allow
55421,53,63396,53,168,78,90,2,30,1,1,allow
39385,443,14896,443,89229,6918,82311,131,33,63,68,allow
50531,80,35066,80,21782,2162,19620,28,20,11,17,allow
65029,53,39227,53,214,102,112,2,29,1,1,allow
64020,53,46952,53,302,118,184,2,29,1,1,allow
60232,53,0,0,202,86,116,2,29,1,1,allow
59537,80,26442,80,3892,1824,2068,21,187,12,9,allow
57470,47099,22688,47099,330,330,0,6,1199,6,0,allow
45624,443,55280,443,6697,1606,5091,23,17,13,10,allow
59350,443,59350,443,4401,1494,2907,19,27,11,8,allow
60014,443,21323,443,10021,3035,6986,30,46,17,13,allow
65528,53,22092,53,199,86,113,2,29,1,1,allow
65108,53,46911,53,195,94,101,2,29,1,1,allow
59928,53,57258,53,320,94,226,2,29,1,1,allow
53696,50321,25044,50321,70,70,0,2,7,2,0,allow
64537,53,43379,53,251,102,149,2,30,1,1,allow
53236,443,39010,443,41247,1363,39884,51,37,13,38,allow
65055,53,62687,53,225,86,139,2,30,1,1,allow
53282,443,30859,443,1786,172,1614,7,119,3,4,allow
53232,443,62934,443,102629,3555,99074,114,58,40,74,allow
51876,35624,49210,35624,70,70,0,1,5,1,0,allow
63050,53,33894,53,384,166,218,2,30,1,1,allow
65018,53,20967,53,310,102,208,2,30,1,1,allow
50265,18659,34655,18659,481,150,331,2,1200,1,1,allow
53212,443,62292,443,81114,4708,76406,108,66,39,69,allow
64734,53,19737,53,383,90,293,4,43,2,2,allow
49944,80,49944,80,220279,13007,207272,266,22,115,151,allow
63041,53,42776,53,448,166,282,2,30,1,1,allow
12477,80,12477,80,6835,961,5874,17,27,9,8,allow
53219,443,33001,443,6058,1038,5020,20,66,11,9,allow
53228,443,43258,443,5026,973,4053,19,59,10,9,allow
53231,443,2130,443,8906,1533,7373,32,58,16,16,allow
53230,443,3800,443,6177,1038,5139,22,58,11,11,allow
49941,80,49941,80,493003,23995,469008,578,22,246,332,allow
60770,443,16135,443,4239,2026,2213,15,120,7,8,allow
65276,53,33888,53,226,86,140,2,30,1,1,allow
44911,443,42749,443,10194,2176,8018,25,186,14,11,allow
31956,53,16501,53,268,94,174,2,30,1,1,allow
63047,443,26730,443,304,86,218,2,30,1,1,allow
53234,443,53501,443,6059,1040,5019,20,58,11,9,allow
62464,41090,36975,41090,454923,271912,183011,516,549,295,221,allow
8449,80,8449,80,48320,1685,46635,57,126,22,35,allow
53136,41442,29017,41442,70,70,0,2,8,2,0,allow
57432,66,52808,66,70,70,0,1,5,1,0,allow
49943,80,49943,80,254742,14106,240636,305,22,131,174,allow
49942,80,49942,80,323714,18296,305418,384,22,165,219,allow
60387,80,36861,80,214,140,74,4,15,3,1,allow
52119,443,11235,443,10583,3353,7230,32,83,16,16,allow
63048,53,53568,53,304,86,218,2,30,1,1,allow
64109,53,30318,53,225,102,123,2,30,1,1,allow
64004,53,17770,53,247,94,153,2,30,1,1,allow
14697,8000,59482,8000,212,150,62,2,30,1,1,allow
37857,443,49755,443,7051,5086,1965,32,100,18,14,allow
56635,80,4559,80,234,234,0,4,12,4,0,allow
55974,80,55609,80,613,539,74,7,15,6,1,allow
50463,80,50463,80,210639,12949,197690,287,23,147,140,allow
63042,443,30142,443,512,166,346,2,30,1,1,allow
17750,25326,52113,25326,491,150,341,2,1200,1,1,allow
56521,443,40583,443,11375,1770,9605,27,55,15,12,allow
49218,5222,44351,5222,85080,31769,53311,661,1172,305,356,allow
48191,5223,34035,5223,4164,1264,2900,23,1140,13,10,allow
65319,53,38266,53,285,103,182,4,43,2,2,allow
38653,443,4233,443,9664,1703,7961,22,15,11,11,allow
53685,53,0,0,547,97,450,4,40,2,2,allow
53328,53,0,0,232,77,155,2,32,1,1,allow
50464,80,50464,80,218570,13559,205011,291,22,146,145,allow
55032,5222,63875,5222,138,64,74,3,5,2,1,allow
65319,53,28841,53,285,103,182,4,43,2,2,allow
50465,80,50465,80,202622,12371,190251,264,22,132,132,allow
60386,80,35408,80,214,140,74,4,15,3,1,allow
59837,80,33837,80,830733,17622,813111,789,66,245,544,allow
65021,53,29449,53,589,91,498,4,54,2,2,allow
65365,53,10909,53,196,102,94,2,29,1,1,allow
49384,53,22527,53,193,102,91,2,29,1,1,allow
64483,53,53474,53,168,86,82,2,29,1,1,allow
64256,53,36499,53,211,78,133,2,29,1,1,allow
56738,53,53123,53,242,110,132,2,29,1,1,allow
38629,443,15765,443,9198,2279,6919,18,18,9,9,allow
64483,53,39103,53,168,86,82,2,29,1,1,allow
31201,53,38511,53,197,78,119,2,30,1,1,allow
49385,53,9929,53,843,285,558,8,56,4,4,allow
26690,53,55791,53,197,94,103,2,29,1,1,allow
49742,53,9539,53,213,102,111,2,29,1,1,allow
49208,53,8830,53,216,94,122,2,29,1,1,allow
53229,443,57933,443,91414,11700,79714,174,59,65,109,allow
64089,53,20449,53,197,94,103,2,30,1,1,allow
63049,443,56063,443,384,166,218,2,30,1,1,allow
57174,53,49148,53,210,94,116,2,30,1,1,allow
53221,443,43184,443,57706,2486,55220,67,65,23,44,allow
53227,443,7377,443,16336,3219,13117,46,59,21,25,allow
64483,53,3911,53,168,86,82,2,30,1,1,allow
50820,443,50820,443,37757,4416,33341,44,32,17,27,allow
65216,53,59898,53,244,94,150,2,30,1,1,allow
56891,53,21983,53,200,94,106,2,30,1,1,allow
39758,53,26339,53,86,86,0,1,30,1,0,allow
53233,443,34879,443,6059,1040,5019,20,58,11,9,allow
64753,53,4084,53,287,102,185,2,30,1,1,allow
36387,443,45505,443,7139,1751,5388,32,1372,10,22,allow
37827,443,64403,443,424,210,214,7,131,4,3,allow
60388,80,19317,80,214,140,74,4,15,3,1,allow
38633,443,44108,443,3448,1619,1829,18,18,8,10,allow
19874,3389,19874,3389,4145,1976,2169,22,18,13,9,allow
53235,443,2490,443,11111,1014,10097,24,37,10,14,allow
53226,443,20634,443,5993,974,5019,19,59,10,9,allow
53222,443,42780,443,4531,974,3557,18,65,10,8,allow
53218,443,1969,443,245772,8639,237133,291,66,103,188,allow
56350,53,30997,53,287,102,185,2,30,1,1,allow
33497,53,21271,53,168,78,90,2,30,1,1,allow
63043,53,52366,53,448,166,282,2,30,1,1,allow
38174,443,51209,443,7034,1885,5149,28,95,15,13,allow
62896,993,16279,993,9831,4069,5762,88,192,40,48,allow
50028,53,16611,53,210,102,108,2,30,1,1,allow
63044,443,58831,443,512,166,346,2,30,1,1,allow
61465,443,63826,443,9619,879,8740,19,135,8,11,allow
59538,80,24164,80,3835,1767,2068,21,187,12,9,allow
25,63566,25,63566,102,102,0,1,5,1,0,allow
46286,443,2203,443,1053,566,487,10,41,6,4,allow
28509,80,28509,80,10145,1446,8699,23,29,11,12,allow
49476,53,2698,53,200,94,106,2,30,1,1,allow
49257,80,49257,80,19393,1504,17889,30,32,12,18,allow
63876,5968,28223,5968,66,66,0,2,8,2,0,allow
53687,51471,5153,51471,70,70,0,1,5,1,0,allow
63034,443,35751,443,304,86,218,2,30,1,1,allow
47010,53,59094,53,294,94,200,2,30,1,1,allow
59166,443,40050,443,130458,7920,122538,199,359,94,105,allow
63033,53,19877,53,304,86,218,2,30,1,1,allow
49977,53,37356,53,212,94,118,2,30,1,1,allow
9067,443,32087,443,11768028,275478,11492550,12305,77,4158,8147,allow
63878,50829,45177,50829,66,66,0,2,8,2,0,allow
63032,53,34881,53,304,86,218,2,30,1,1,allow
56702,53,49433,53,168,78,90,2,30,1,1,allow
9055,443,33529,443,6594797,175738,6419059,6398,123,1755,4643,allow
55770,443,27394,443,40169,4646,35523,61,122,24,37,allow
28897,35440,0,0,62,62,0,1,0,1,0,deny
57133,445,0,0,70,70,0,1,0,1,0,drop
62029,22114,0,0,66,66,0,1,0,1,0,deny
11478,51221,0,0,66,66,0,1,0,1,0,deny
9743,23,0,0,60,60,0,1,0,1,0,deny
9687,57470,0,0,78,78,0,1,0,1,0,deny
60126,35440,0,0,62,62,0,1,0,1,0,deny
58128,44847,0,0,146,146,0,1,0,1,0,deny
57439,445,0,0,66,66,0,1,0,1,0,drop
62037,445,0,0,70,70,0,1,0,1,0,drop
62035,445,0,0,70,70,0,1,0,1,0,drop
57129,445,0,0,70,70,0,1,0,1,0,drop
58672,43890,0,0,66,66,0,1,0,1,0,deny
7274,64147,0,0,62,62,0,1,0,1,0,deny
52472,51221,0,0,74,74,0,1,0,1,0,deny
60646,11392,0,0,66,66,0,1,0,1,0,deny
65494,53,0,0,88,88,0,1,0,1,0,deny
57128,445,0,0,70,70,0,1,0,1,0,drop
19245,64147,0,0,66,66,0,1,0,1,0,deny
57432,445,0,0,66,66,0,1,0,1,0,drop
57429,445,0,0,66,66,0,1,0,1,0,drop
37701,23,0,0,60,60,0,1,0,1,0,deny
41220,59356,0,0,62,62,0,1,0,1,0,deny
2705,37,0,0,60,60,0,1,0,1,0,deny
63096,44847,0,0,66,66,0,1,0,1,0,deny
6721,37965,0,0,66,66,0,1,0,1,0,deny
65515,22114,0,0,66,66,0,1,0,1,0,deny
62026,445,0,0,70,70,0,1,0,1,0,drop
52989,51505,0,0,66,66,0,1,0,1,0,deny
34306,37965,0,0,62,62,0,1,0,1,0,deny
48576,443,26108,443,476,410,66,4,0,3,1,allow
9522,51505,0,0,66,66,0,1,0,1,0,deny
57123,445,0,0,70,70,0,1,0,1,0,drop
62019,445,0,0,70,70,0,1,0,1,0,drop
62018,445,0,0,70,70,0,1,0,1,0,drop
62015,445,0,0,70,70,0,1,0,1,0,drop
57987,56125,0,0,90,90,0,1,0,1,0,deny
55174,53,1640,53,774,101,673,2,0,1,1,allow
57428,445,0,0,66,66,0,1,0,1,0,drop
43611,1879,0,0,145,145,0,1,0,1,0,deny
50877,35776,0,0,159,159,0,1,0,1,0,deny
57412,445,0,0,66,66,0,1,0,1,0,drop
57419,445,0,0,66,66,0,1,0,1,0,drop
57413,445,0,0,66,66,0,1,0,1,0,drop
57418,445,0,0,66,66,0,1,0,1,0,drop
57417,445,0,0,66,66,0,1,0,1,0,drop
57414,445,0,0,66,66,0,1,0,1,0,drop
57411,445,0,0,66,66,0,1,0,1,0,drop
57874,26467,0,0,62,62,0,1,0,1,0,deny
62012,445,0,0,70,70,0,1,0,1,0,drop
10775,35440,0,0,62,62,0,1,0,1,0,deny
62007,445,0,0,70,70,0,1,0,1,0,drop
62005,445,0,0,70,70,0,1,0,1,0,drop
62004,445,0,0,70,70,0,1,0,1,0,drop
43129,15503,0,0,62,62,0,1,0,1,0,deny
55766,36237,0,0,146,146,0,1,0,1,0,deny
53090,59356,0,0,66,66,0,1,0,1,0,deny
63340,53,0,0,84,84,0,1,0,1,0,deny
40185,64147,0,0,62,62,0,1,0,1,0,deny
57110,445,0,0,70,70,0,1,0,1,0,drop
65526,28793,0,0,62,62,0,1,0,1,0,deny
25565,44521,0,0,60,60,0,1,0,1,0,deny
57107,445,0,0,70,70,0,1,0,1,0,drop
15875,50584,0,0,62,62,0,1,0,1,0,deny
62003,445,0,0,70,70,0,1,0,1,0,drop
62002,445,0,0,70,70,0,1,0,1,0,drop
61999,445,0,0,70,70,0,1,0,1,0,drop
443,41545,0,0,60,60,0,1,0,1,0,deny
57403,445,0,0,66,66,0,1,0,1,0,drop
61995,445,0,0,70,70,0,1,0,1,0,drop
57402,445,0,0,66,66,0,1,0,1,0,drop
57400,445,0,0,66,66,0,1,0,1,0,drop
57399,445,0,0,66,66,0,1,0,1,0,drop
47381,8305,0,0,159,159,0,1,0,1,0,deny
57103,445,0,0,70,70,0,1,0,1,0,drop
57396,445,0,0,66,66,0,1,0,1,0,drop
45682,37965,0,0,62,62,0,1,0,1,0,deny
15641,26467,0,0,62,62,0,1,0,1,0,deny
57101,445,0,0,70,70,0,1,0,1,0,drop
57612,28793,0,0,66,66,0,1,0,1,0,deny
57099,445,0,0,70,70,0,1,0,1,0,drop
61085,37965,0,0,62,62,0,1,0,1,0,deny
53966,57470,0,0,62,62,0,1,0,1,0,deny
61990,445,0,0,70,70,0,1,0,1,0,drop
59435,37807,0,0,62,62,0,1,0,1,0,deny
1040,37965,0,0,62,62,0,1,0,1,0,deny
52976,31573,0,0,66,66,0,1,0,1,0,deny
61984,445,0,0,70,70,0,1,0,1,0,drop
61981,445,0,0,70,70,0,1,0,1,0,drop
35558,15503,0,0,66,66,0,1,0,1,0,deny
60060,443,0,0,1097,1097,0,1,0,1,0,deny
50470,61463,0,0,86,86,0,1,0,1,0,deny
10036,44847,0,0,66,66,0,1,0,1,0,deny
55375,44847,0,0,66,66,0,1,0,1,0,deny
57385,445,0,0,66,66,0,1,0,1,0,drop
57092,445,0,0,70,70,0,1,0,1,0,drop
27018,61508,0,0,753,753,0,1,0,1,0,deny
27018,61508,0,0,753,753,0,1,0,1,0,deny
50901,26467,0,0,66,66,0,1,0,1,0,deny
57090,445,0,0,70,70,0,1,0,1,0,drop
61510,37965,0,0,66,66,0,1,0,1,0,deny
59563,30188,0,0,66,66,0,1,0,1,0,deny
57089,445,0,0,70,70,0,1,0,1,0,drop
57378,445,0,0,66,66,0,1,0,1,0,drop
61968,445,0,0,70,70,0,1,0,1,0,drop
57088,445,0,0,70,70,0,1,0,1,0,drop
8536,37965,0,0,62,62,0,1,0,1,0,deny
57087,445,0,0,70,70,0,1,0,1,0,drop
47910,7464,0,0,60,60,0,1,0,1,0,deny
56752,44847,0,0,62,62,0,1,0,1,0,deny
59352,37965,0,0,66,66,0,1,0,1,0,deny
57082,445,0,0,70,70,0,1,0,1,0,drop
57083,445,0,0,70,70,0,1,0,1,0,drop
57376,445,0,0,66,66,0,1,0,1,0,drop
48681,11392,0,0,62,62,0,1,0,1,0,deny
57069,445,0,0,70,70,0,1,0,1,0,drop
57068,445,0,0,70,70,0,1,0,1,0,drop
57066,445,0,0,70,70,0,1,0,1,0,drop
8080,37965,0,0,62,62,0,1,0,1,0,deny
47091,5228,39353,5228,3113,1395,1718,20,3608,8,12,allow
52064,443,64308,443,9003,2598,6405,33,345,15,18,allow
57470,41024,3847,41024,330,330,0,6,1200,6,0,allow
55172,80,55172,80,268230,8528,259702,292,231,106,186,allow
47293,443,64269,443,6318,1025,5293,17,31,9,8,allow
59866,443,32010,443,6135,843,5292,20,26,10,10,allow
57470,58973,26085,58973,330,330,0,6,1200,6,0,allow
33795,80,33795,80,490,264,226,8,142,5,3,allow
40866,8434,40866,8434,156,156,0,3,8,3,0,allow
53685,38978,33015,38978,70,70,0,1,5,1,0,allow
50542,80,60343,80,1607,970,637,8,16,5,3,allow
51209,443,64337,443,84768,21103,63665,136,133,58,78,allow
49941,443,34505,443,8754,2895,5859,26,16,15,11,allow
51886,35965,10726,35965,70,70,0,2,8,2,0,allow
51874,43161,26415,43161,66,66,0,1,5,1,0,allow
64335,443,56064,443,230615,48569,182046,379,176,157,222,allow
57470,6881,6226,6881,453,251,202,4,1200,2,2,allow
59868,443,32881,443,502,250,252,9,26,5,4,allow
42473,80,36510,80,1737,796,941,12,16,7,5,allow
45345,443,9986,443,2438,1442,996,21,27,12,9,allow
53681,31466,20007,31466,70,70,0,1,5,1,0,allow
56840,20413,2836,20413,66,66,0,1,5,1,0,allow
8282,40200,5762,40200,133,64,69,3,30,2,1,allow
57470,6881,28610,6881,396,396,0,7,1200,7,0,allow
57470,24260,9692,24260,806,163,643,2,1201,1,1,allow
57058,445,0,0,70,70,0,1,0,1,0,drop
57059,445,0,0,70,70,0,1,0,1,0,drop
57369,445,0,0,66,66,0,1,0,1,0,drop
25565,58771,0,0,60,60,0,1,0,1,0,deny
60854,42873,0,0,66,66,0,1,0,1,0,deny
57361,445,0,0,66,66,0,1,0,1,0,drop
26351,22114,0,0,62,62,0,1,0,1,0,deny
48020,7484,0,0,60,60,0,1,0,1,0,deny
57987,56125,0,0,90,90,0,1,0,1,0,deny
58922,57470,0,0,66,66,0,1,0,1,0,deny
54028,37965,0,0,62,62,0,1,0,1,0,deny
29787,37965,0,0,62,62,0,1,0,1,0,deny
50325,80,28914,80,19438,12019,7419,53,312,30,23,allow
59974,443,38243,443,354,140,214,6,130,3,3,allow
57047,445,0,0,70,70,0,1,0,1,0,drop
61960,445,0,0,70,70,0,1,0,1,0,drop
61956,445,0,0,70,70,0,1,0,1,0,drop
15403,51505,0,0,66,66,0,1,0,1,0,deny
57347,445,0,0,66,66,0,1,0,1,0,drop
57352,445,0,0,66,66,0,1,0,1,0,drop
57349,445,0,0,66,66,0,1,0,1,0,drop
57350,445,0,0,66,66,0,1,0,1,0,drop
57353,445,0,0,66,66,0,1,0,1,0,drop
57348,445,0,0,66,66,0,1,0,1,0,drop
57346,445,0,0,66,66,0,1,0,1,0,drop
57345,445,0,0,66,66,0,1,0,1,0,drop
40260,44610,0,0,145,145,0,1,0,1,0,deny
26058,1433,0,0,60,60,0,1,0,1,0,deny
60405,5900,0,0,60,60,0,1,0,1,0,deny
56413,51221,0,0,66,66,0,1,0,1,0,deny
63765,51221,0,0,62,62,0,1,0,1,0,deny
27401,37965,0,0,66,66,0,1,0,1,0,deny
45964,2666,0,0,60,60,0,1,0,1,0,deny
57042,445,0,0,70,70,0,1,0,1,0,drop
31613,23,0,0,60,60,0,1,0,1,0,deny
28809,50584,0,0,66,66,0,1,0,1,0,deny
55459,50584,0,0,62,62,0,1,0,1,0,deny
61953,445,0,0,70,70,0,1,0,1,0,drop
57470,3800,54639,3800,150,150,0,1,1199,1,0,allow
33538,80,33538,80,424,198,226,7,141,4,3,allow
47918,443,24262,443,7936,2847,5089,15,120,7,8,allow
53689,42719,50216,42719,70,70,0,1,4,1,0,allow
51956,443,47122,443,8256,3157,5099,28,46,16,12,allow
63039,443,48295,443,448,166,282,2,29,1,1,allow
63031,443,4313,443,304,86,218,2,29,1,1,allow
50083,80,45276,80,38045,26409,11636,105,476,68,37,allow
59744,80,14710,80,699554,16426,683128,701,95,244,457,allow
58707,80,41124,80,2542,1879,663,12,14,6,6,allow
56850,64932,41419,64932,70,70,0,1,5,1,0,allow
63036,53,45835,53,304,86,218,2,29,1,1,allow
50608,443,53757,443,8058,2722,5336,17,31,10,7,allow
40342,53,32234,53,168,78,90,2,29,1,1,allow
57593,443,14217,443,7037,1786,5251,23,200,13,10,allow
59865,443,51225,443,502,250,252,9,26,5,4,allow
54768,25,54768,25,194,66,128,3,15,1,2,allow
41945,443,44467,443,12146,2681,9465,63,4156,25,38,allow
60782,3389,60782,3389,3504,1790,1714,17,33,9,8,allow
61571,53,17660,53,211,78,133,2,30,1,1,allow
51887,16514,22575,16514,70,70,0,2,8,2,0,allow
51875,25072,3449,25072,70,70,0,1,5,1,0,allow
33871,443,48273,443,11277,2233,9044,43,215,20,23,allow
34739,5222,35050,5222,26914,4119,22795,85,539,41,44,allow
59559,443,17669,443,6328,1536,4792,23,17,12,11,allow
53452,443,10617,443,15368,8643,6725,36,49,19,17,allow
49708,80,56764,80,179277,5324,173953,171,108,49,122,allow
49707,80,15833,80,196092,6387,189705,189,108,57,132,allow
49704,80,31664,80,217502,6597,210905,211,109,62,149,allow
55665,443,34619,443,6291,1499,4792,22,17,11,11,allow
64484,53,32900,53,732,239,493,6,51,3,3,allow
49454,443,27908,443,7212,1757,5455,20,17,10,10,allow
49221,80,26224,80,214,140,74,4,15,3,1,allow
51776,8000,6250,8000,328,142,186,6,90,3,3,allow
65298,53,43096,53,246,102,144,2,30,1,1,allow
56438,3389,56438,3389,3425,1470,1955,16,17,8,8,allow
44521,443,14957,443,6502,1347,5155,31,1195,10,21,allow
36712,53,0,0,139,70,69,2,30,1,1,allow
42770,443,4955,443,8820,2996,5824,27,95,14,13,allow
56800,443,21923,443,79399,4048,75351,90,120,32,58,allow
57470,5254,14927,5254,453,251,202,4,1200,2,2,allow
43346,443,33396,443,3691281,56325,3634956,3201,138,570,2631,allow
49705,80,59166,80,132198,5466,126732,140,109,45,95,allow
9074,443,22062,443,318,192,126,6,29,4,2,allow
45042,443,17332,443,8445,2120,6325,27,107,15,12,allow
44509,80,44509,80,84030,4287,79743,107,145,47,60,allow
62453,53,64784,53,441,162,279,6,32,3,3,allow
53135,14297,19034,14297,70,70,0,2,8,2,0,allow
36367,443,61564,443,1209,709,500,14,26,8,6,allow
37390,443,2795,443,4859,964,3895,17,26,10,7,allow
59713,3389,59713,3389,4213,2429,1784,18,32,9,9,allow
64698,53,34866,53,211,102,109,2,30,1,1,allow
50012,53,31232,53,209,102,107,2,30,1,1,allow
65164,53,35312,53,262,94,168,2,30,1,1,allow
56995,53,19045,53,196,94,102,2,30,1,1,allow
57470,6885,1463,6885,616,414,202,5,1200,3,2,allow
57470,32251,57534,32251,132,132,0,3,1199,3,0,allow
59862,443,40236,443,5301,953,4348,17,28,9,8,allow
57402,443,10569,443,6649,1556,5093,23,21,13,10,allow
51712,443,2406,443,66148,6145,60003,116,80,60,56,allow
53686,8999,26730,8999,70,70,0,1,4,1,0,allow
53682,20884,50647,20884,70,70,0,1,4,1,0,allow
60060,22,60060,22,7974,3469,4505,57,40,28,29,allow
53688,17106,13403,17106,70,70,0,1,4,1,0,allow
57266,443,13002,443,16452,7129,9323,44,47,25,19,allow
63040,53,20975,53,512,166,346,2,29,1,1,allow
49839,53,59644,53,258,110,148,2,29,1,1,allow
63035,443,45890,443,304,86,218,2,29,1,1,allow
49230,53,36534,53,351,94,257,2,30,1,1,allow
50265,37449,54760,37449,925,594,331,11,2335,10,1,allow
56992,53,30426,53,355,102,253,2,30,1,1,allow
58771,443,41397,443,4726,2487,2239,19,305,9,10,allow
33367,80,33367,80,424,198,226,7,141,4,3,allow
34285,80,34285,80,424,198,226,7,141,4,3,allow
9064,443,8179,443,11738,6980,4758,34,81,19,15,allow
47245,443,62935,443,1989,1183,806,16,94,9,7,allow
51873,19311,22096,19311,70,70,0,1,5,1,0,allow
49709,80,35500,80,128214,4961,123253,134,108,43,91,allow
63995,53,52864,53,212,94,118,2,30,1,1,allow
49213,53,44755,53,211,102,109,2,30,1,1,allow
53719,443,54352,443,3225,1939,1286,26,139,14,12,allow
35954,443,60270,443,6406,1614,4792,24,17,13,11,allow
64801,7000,64801,7000,2269,815,1454,14,15,7,7,allow
56679,443,4543,443,7941,1952,5989,20,15,11,9,allow
59595,80,6644,80,1052,612,440,10,15,5,5,allow
64925,53,10435,53,338,110,228,2,30,1,1,allow
57470,6881,57710,6881,453,251,202,4,1200,2,2,allow
56523,443,56096,443,28479,3138,25341,42,42,17,25,allow
44850,443,60943,443,4502,895,3607,15,25,9,6,allow
56680,443,53449,443,7889,1900,5989,20,15,11,9,allow
59864,443,10819,443,6066,833,5233,19,26,10,9,allow
59863,443,41870,443,622,310,312,11,28,6,5,allow
40175,80,8302,80,130,70,60,2,15,1,1,allow
49706,80,39061,80,118813,4128,114685,122,108,38,84,allow
49667,53,38974,53,261,94,167,2,30,1,1,allow
53895,443,14973,443,390740,13639,377101,441,132,152,289,allow
65219,443,28202,443,4748,2193,2555,14,135,7,7,allow
6881,45711,37473,45711,228,118,110,2,1199,1,1,allow
49160,38552,12049,38552,868,150,718,4,1200,2,2,allow
57470,6881,64620,6881,577,251,326,4,1200,2,2,allow
37965,15509,12475,15509,481,150,331,2,1199,1,1,allow
27005,1301,24545,1301,860,126,734,2,30,1,1,allow
27005,1303,22373,1303,868,126,742,2,30,1,1,allow
41891,443,2286,443,235626,4546,231080,232,339,53,179,allow
60768,40010,23273,40010,316,136,180,6,7,3,3,allow
50985,80,32837,80,5823,1570,4253,17,20,10,7,allow
53233,443,40528,443,47830,23388,24442,74,51,37,37,allow
49206,443,6191,443,15982,9199,6783,95,160,40,55,allow
37026,80,28562,80,2849,1631,1218,9,721,5,4,allow
80,13743,80,13743,70,70,0,1,5,1,0,allow
27005,1201,20493,1201,867,126,741,2,30,1,1,allow
33443,443,53620,443,14402,2801,11601,28,205,11,17,allow
50983,80,17764,80,7765,2215,5550,20,20,12,8,allow
13375,53,13375,53,213,82,131,2,30,1,1,allow
61949,445,0,0,70,70,0,1,0,1,0,drop
61939,445,0,0,70,70,0,1,0,1,0,drop
57034,445,0,0,70,70,0,1,0,1,0,drop
57031,445,0,0,70,70,0,1,0,1,0,drop
57032,445,0,0,70,70,0,1,0,1,0,drop
57029,445,0,0,70,70,0,1,0,1,0,drop
57026,445,0,0,70,70,0,1,0,1,0,drop
57333,445,0,0,66,66,0,1,0,1,0,drop
57331,445,0,0,66,66,0,1,0,1,0,drop
57330,445,0,0,66,66,0,1,0,1,0,drop
61937,445,0,0,70,70,0,1,0,1,0,drop
61935,445,0,0,70,70,0,1,0,1,0,drop
51313,64147,0,0,62,62,0,1,0,1,0,deny
61933,445,0,0,70,70,0,1,0,1,0,drop
61929,445,0,0,70,70,0,1,0,1,0,drop
61927,445,0,0,70,70,0,1,0,1,0,drop
62849,62413,0,0,66,66,0,1,0,1,0,deny
34809,57470,0,0,66,66,0,1,0,1,0,deny
17344,62413,0,0,66,66,0,1,0,1,0,deny
40500,25356,0,0,146,146,0,1,0,1,0,deny
57020,445,0,0,70,70,0,1,0,1,0,drop
46365,53413,0,0,71,71,0,1,0,1,0,deny
6224,37965,0,0,62,62,0,1,0,1,0,deny
26921,57470,0,0,62,62,0,1,0,1,0,deny
10028,25604,0,0,62,62,0,1,0,1,0,deny
56463,17,0,0,60,60,0,1,0,1,0,deny
14997,57470,0,0,72,72,0,1,0,1,0,deny
9687,57470,0,0,78,78,0,1,0,1,0,deny
62625,37965,0,0,62,62,0,1,0,1,0,deny
57013,445,0,0,70,70,0,1,0,1,0,drop
35261,15503,0,0,74,74,0,1,0,1,0,deny
57010,445,0,0,70,70,0,1,0,1,0,drop
51163,23,0,0,60,60,0,1,0,1,0,deny
6881,6881,0,0,62,62,0,1,0,1,0,deny
61916,445,0,0,70,70,0,1,0,1,0,drop
61918,445,0,0,70,70,0,1,0,1,0,drop
61915,445,0,0,70,70,0,1,0,1,0,drop
443,62451,0,0,60,60,0,1,0,1,0,deny
65494,53,0,0,88,88,0,1,0,1,0,deny
47910,7461,0,0,60,60,0,1,0,1,0,deny
57007,445,0,0,70,70,0,1,0,1,0,drop
50470,61463,0,0,86,86,0,1,0,1,0,deny
22528,48817,0,0,148,148,0,1,0,1,0,deny
65494,53,0,0,88,88,0,1,0,1,0,deny
57005,445,0,0,70,70,0,1,0,1,0,drop
61195,56205,0,0,62,62,0,1,0,1,0,deny
53781,37965,0,0,62,62,0,1,0,1,0,deny
57001,445,0,0,70,70,0,1,0,1,0,drop
49293,22,0,0,60,60,0,1,0,1,0,deny
57310,445,0,0,66,66,0,1,0,1,0,drop
61908,445,0,0,70,70,0,1,0,1,0,drop
61907,445,0,0,70,70,0,1,0,1,0,drop
59889,30188,0,0,62,62,0,1,0,1,0,deny
47105,64147,0,0,62,62,0,1,0,1,0,deny
57000,445,0,0,70,70,0,1,0,1,0,drop
61681,23,0,0,60,60,0,1,0,1,0,deny
58664,64147,0,0,66,66,0,1,0,1,0,deny
57305,445,0,0,66,66,0,1,0,1,0,drop
57302,445,0,0,66,66,0,1,0,1,0,drop
45941,23384,0,0,60,60,0,1,0,1,0,deny
52410,8604,0,0,66,66,0,1,0,1,0,deny
1024,64147,0,0,62,62,0,1,0,1,0,deny
58884,23,0,0,60,60,0,1,0,1,0,deny
16687,10214,0,0,66,66,0,1,0,1,0,deny
56995,445,0,0,70,70,0,1,0,1,0,drop
61897,445,0,0,70,70,0,1,0,1,0,drop
41429,50584,0,0,66,66,0,1,0,1,0,deny
5222,32859,0,0,66,66,0,1,0,1,0,deny
61891,445,0,0,70,70,0,1,0,1,0,drop
61892,445,0,0,70,70,0,1,0,1,0,drop
61887,445,0,0,70,70,0,1,0,1,0,drop
57298,445,0,0,66,66,0,1,0,1,0,drop
57287,445,0,0,66,66,0,1,0,1,0,drop
57292,445,0,0,66,66,0,1,0,1,0,drop
57281,445,0,0,66,66,0,1,0,1,0,drop
57284,445,0,0,66,66,0,1,0,1,0,drop
57280,445,0,0,66,66,0,1,0,1,0,drop
57285,445,0,0,66,66,0,1,0,1,0,drop
57279,445,0,0,66,66,0,1,0,1,0,drop
49248,35993,0,0,66,66,0,1,0,1,0,deny
57987,56125,0,0,90,90,0,1,0,1,0,deny
11574,51505,0,0,66,66,0,1,0,1,0,deny
50644,35440,0,0,66,66,0,1,0,1,0,deny
47682,64147,0,0,66,66,0,1,0,1,0,deny
61884,445,0,0,70,70,0,1,0,1,0,drop
33931,50584,0,0,146,146,0,1,0,1,0,deny
50327,1433,0,0,60,60,0,1,0,1,0,deny
59965,36237,0,0,62,62,0,1,0,1,0,deny
6014,37965,0,0,66,66,0,1,0,1,0,deny
61880,445,0,0,70,70,0,1,0,1,0,drop
61879,445,0,0,70,70,0,1,0,1,0,drop
61876,445,0,0,70,70,0,1,0,1,0,drop
45908,3383,0,0,60,60,0,1,0,1,0,deny
56982,445,0,0,70,70,0,1,0,1,0,drop
44855,58414,0,0,62,62,0,1,0,1,0,deny
55022,23,0,0,60,60,0,1,0,1,0,deny
48219,55442,0,0,66,66,0,1,0,1,0,deny
16654,50265,0,0,62,62,0,1,0,1,0,deny
1373,22114,0,0,66,66,0,1,0,1,0,deny
52432,50265,0,0,66,66,0,1,0,1,0,deny
56376,44847,0,0,62,62,0,1,0,1,0,deny
56979,445,0,0,70,70,0,1,0,1,0,drop
51093,57470,0,0,66,66,0,1,0,1,0,deny
40369,57470,0,0,62,62,0,1,0,1,0,deny
50783,23,0,0,60,60,0,1,0,1,0,deny
65317,51221,0,0,78,78,0,1,0,1,0,deny
52614,44847,0,0,66,66,0,1,0,1,0,deny
10348,25604,0,0,62,62,0,1,0,1,0,deny
61875,445,0,0,70,70,0,1,0,1,0,drop
61872,445,0,0,70,70,0,1,0,1,0,drop
61868,445,0,0,70,70,0,1,0,1,0,drop
27621,50584,0,0,146,146,0,1,0,1,0,deny
57849,50584,0,0,66,66,0,1,0,1,0,deny
57277,445,0,0,66,66,0,1,0,1,0,drop
18876,44847,0,0,66,66,0,1,0,1,0,deny
61867,445,0,0,70,70,0,1,0,1,0,drop
26953,30317,0,0,62,62,0,1,0,1,0,deny
6824,26467,0,0,62,62,0,1,0,1,0,deny
57273,445,0,0,66,66,0,1,0,1,0,drop
56975,445,0,0,70,70,0,1,0,1,0,drop
28899,37965,0,0,62,62,0,1,0,1,0,deny
50767,57470,0,0,66,66,0,1,0,1,0,deny
57272,445,0,0,66,66,0,1,0,1,0,drop
57271,445,0,0,66,66,0,1,0,1,0,drop
56973,445,0,0,70,70,0,1,0,1,0,drop
57268,445,0,0,66,66,0,1,0,1,0,drop
42389,42873,0,0,74,74,0,1,0,1,0,deny
56971,445,0,0,70,70,0,1,0,1,0,drop
47134,37965,0,0,62,62,0,1,0,1,0,deny
20939,60461,0,0,60,60,0,1,0,1,0,deny
40834,50584,0,0,146,146,0,1,0,1,0,deny
53513,56205,0,0,62,62,0,1,0,1,0,deny
55553,37965,0,0,66,66,0,1,0,1,0,deny
27323,23117,0,0,146,146,0,1,0,1,0,deny
61862,445,0,0,70,70,0,1,0,1,0,drop
23126,35440,0,0,66,66,0,1,0,1,0,deny
61855,445,0,0,70,70,0,1,0,1,0,drop
61858,445,0,0,70,70,0,1,0,1,0,drop
19875,30170,0,0,145,145,0,1,0,1,0,deny
61408,30188,0,0,66,66,0,1,0,1,0,deny
56964,445,0,0,70,70,0,1,0,1,0,drop
57258,445,0,0,66,66,0,1,0,1,0,drop
56962,445,0,0,70,70,0,1,0,1,0,drop
39351,23,0,0,60,60,0,1,0,1,0,deny
60222,22114,0,0,62,62,0,1,0,1,0,deny
56961,445,0,0,70,70,0,1,0,1,0,drop
56960,445,0,0,70,70,0,1,0,1,0,drop
56959,445,0,0,70,70,0,1,0,1,0,drop
56957,445,0,0,70,70,0,1,0,1,0,drop
26900,27017,16696,27017,168,82,86,2,30,1,1,allow
5237,30128,2836,30128,621281,256,621025,881,49,5,876,allow
26900,27017,64848,27017,422,164,258,6,30,3,3,allow
37390,80,53231,80,78,78,0,1,5,1,0,allow
63855,29799,41914,29799,66,66,0,1,5,1,0,allow
26900,27017,27524,27017,422,164,258,6,30,3,3,allow
57255,443,56046,443,36865,3692,33173,61,47,30,31,allow
50613,80,39114,80,85306,4735,80571,120,22,55,65,allow
50660,80,5489,80,875,327,548,9,15,5,4,allow
26900,27017,46103,27017,422,164,258,6,30,3,3,allow
52669,443,6202,443,18814,2623,16191,54,25,26,28,allow
26900,27017,33807,27017,422,164,258,6,30,3,3,allow
60174,80,16526,80,1564,990,574,15,24,8,7,allow
51885,64546,64002,64546,70,70,0,2,8,2,0,allow
55649,42266,41427,42266,70,70,0,2,8,2,0,allow
53134,42369,45499,42369,70,70,0,2,8,2,0,allow
63856,6881,31846,6881,66,66,0,1,5,1,0,allow
56558,443,2694,443,7702,2155,5547,19,39,11,8,allow
42388,161,0,0,109,109,0,2,35,2,0,allow
50814,53,0,0,82,82,0,1,30,1,0,allow
54346,443,54346,443,4651,1744,2907,19,27,11,8,allow
49869,80,36356,80,43386,3876,39510,79,22,42,37,allow
57275,53,57275,53,217,86,131,2,30,1,1,allow
50968,443,5698,443,7532,3051,4481,13,120,6,7,allow
42460,443,50577,443,2907,1719,1188,17,361,9,8,allow
38611,443,14308,443,22215289,662818,21552471,25924,349,8862,17062,allow
58702,80,13752,80,2424,529,1895,11,75,6,5,allow
45523,443,20387,443,8636,1914,6722,31,95,16,15,allow
43028,443,42197,443,6748,1643,5105,26,138,14,12,allow
57843,443,8573,443,25053,19627,5426,38,76,23,15,allow
57894,443,47420,443,85263,3763,81500,115,216,46,69,allow
61489,443,14014,443,7299,4561,2738,32,193,16,16,allow
9061,80,4144,80,639,279,360,8,121,4,4,allow
51442,443,61245,443,4591,3237,1354,18,271,10,8,allow
41852,443,11364,443,22648,14673,7975,96,245,45,51,allow
56210,5228,6603,5228,7061,1730,5331,21,3600,11,10,allow
26900,27017,2558,27017,422,164,258,6,30,3,3,allow
55594,53,15652,53,202,83,119,2,31,1,1,allow
55767,443,58129,443,1786,172,1614,7,122,3,4,allow
57470,14435,56762,14435,1035,253,782,4,1200,2,2,allow
50265,45682,46008,45682,402,132,270,6,1209,3,3,allow
64085,443,64085,443,140818,8751,132067,156,168,57,99,allow
59278,443,45402,443,10495,9044,1451,29,35,18,11,allow
27005,27216,53096,27216,883,126,757,2,31,1,1,allow
49097,80,63676,80,1739,740,999,17,235,5,12,allow
45155,443,55125,443,4000,1726,2274,13,135,6,7,allow
59275,443,56019,443,242735602,5306961,237428641,238334,3604,81340,156994,allow
56954,445,0,0,70,70,0,1,0,1,0,drop
53971,55442,0,0,66,66,0,1,0,1,0,deny
59511,21247,0,0,66,66,0,1,0,1,0,deny
57250,445,0,0,66,66,0,1,0,1,0,drop
61839,445,0,0,70,70,0,1,0,1,0,drop
993,54748,0,0,66,66,0,1,0,1,0,deny
54000,53,0,0,202,86,116,2,30,1,1,allow
49453,443,59315,443,8251,2124,6127,21,16,11,10,allow
58831,443,5275,443,8004,2236,5768,41,18,23,18,allow
51884,22828,5463,22828,70,70,0,2,8,2,0,allow
50470,61463,0,0,86,86,0,1,0,1,0,deny
57247,445,0,0,66,66,0,1,0,1,0,drop
56941,445,0,0,70,70,0,1,0,1,0,drop
56940,445,0,0,70,70,0,1,0,1,0,drop
56938,445,0,0,70,70,0,1,0,1,0,drop
19096,64147,0,0,62,62,0,1,0,1,0,deny
56930,445,0,0,70,70,0,1,0,1,0,drop
56931,445,0,0,70,70,0,1,0,1,0,drop
57240,445,0,0,66,66,0,1,0,1,0,drop
51164,64147,0,0,62,62,0,1,0,1,0,deny
57235,445,0,0,66,66,0,1,0,1,0,drop
50442,37807,0,0,66,66,0,1,0,1,0,deny
8486,56205,0,0,66,66,0,1,0,1,0,deny
56919,445,0,0,70,70,0,1,0,1,0,drop
54778,22114,0,0,66,66,0,1,0,1,0,deny
49242,22114,0,0,62,62,0,1,0,1,0,deny
50137,1433,0,0,60,60,0,1,0,1,0,deny
61830,445,0,0,70,70,0,1,0,1,0,drop
61827,445,0,0,70,70,0,1,0,1,0,drop
61828,445,0,0,70,70,0,1,0,1,0,drop
56636,43890,0,0,66,66,0,1,0,1,0,deny
57222,445,0,0,66,66,0,1,0,1,0,drop
57217,445,0,0,66,66,0,1,0,1,0,drop
57221,445,0,0,66,66,0,1,0,1,0,drop
57223,445,0,0,66,66,0,1,0,1,0,drop
57225,445,0,0,66,66,0,1,0,1,0,drop
57220,445,0,0,66,66,0,1,0,1,0,drop
57218,445,0,0,66,66,0,1,0,1,0,drop
57224,445,0,0,66,66,0,1,0,1,0,drop
50470,61463,0,0,86,86,0,1,0,1,0,deny
15933,64147,0,0,62,62,0,1,0,1,0,deny
27272,64147,0,0,66,66,0,1,0,1,0,deny
59699,55783,0,0,62,62,0,1,0,1,0,deny
51745,57470,0,0,62,62,0,1,0,1,0,deny
56915,445,0,0,70,70,0,1,0,1,0,drop
50222,42873,0,0,66,66,0,1,0,1,0,deny
22922,35440,0,0,66,66,0,1,0,1,0,deny
58131,15503,0,0,146,146,0,1,0,1,0,deny
5617,64147,0,0,62,62,0,1,0,1,0,deny
65285,44847,0,0,146,146,0,1,0,1,0,deny
50529,44847,0,0,66,66,0,1,0,1,0,deny
61925,51505,0,0,62,62,0,1,0,1,0,deny
56906,445,0,0,70,70,0,1,0,1,0,drop
56904,445,0,0,70,70,0,1,0,1,0,drop
56903,445,0,0,70,70,0,1,0,1,0,drop
58501,44847,0,0,66,66,0,1,0,1,0,deny
56901,445,0,0,70,70,0,1,0,1,0,drop
52626,44847,0,0,66,66,0,1,0,1,0,deny
63938,3389,63938,3389,3364,1714,1650,15,32,8,7,allow
50988,80,43692,80,5956,1595,4361,17,19,10,7,allow
55747,53,47798,53,199,94,105,2,29,1,1,allow
58058,53,63439,53,168,78,90,2,29,1,1,allow
55760,443,60909,443,12723734,404530,12319204,13539,134,4494,9045,allow
34085,80,34085,80,490,264,226,8,140,5,3,allow
26900,27017,2675,27017,422,164,258,6,30,3,3,allow
42119,443,42119,443,9299,1697,7602,21,146,12,9,allow
36505,443,41059,443,6293,1501,4792,22,16,11,11,allow
56678,443,56425,443,7889,1900,5989,20,15,11,9,allow
26900,27017,59495,27017,422,164,258,6,30,3,3,allow
50986,80,14169,80,8074,2261,5813,22,19,13,9,allow
54437,80,15743,80,95298,61941,33357,182,929,95,87,allow
37780,443,60477,443,134,60,74,3,5,2,1,allow
44300,443,36814,443,7746,2015,5731,29,15,16,13,allow
50530,80,18434,80,3561,1337,2224,13,20,7,6,allow
63853,10659,8048,10659,70,70,0,1,4,1,0,allow
33922,443,8890,443,6084,1842,4242,26,329,14,12,allow
63854,16437,6082,16437,70,70,0,1,4,1,0,allow
27005,1107,18135,1107,824,126,698,2,29,1,1,allow
49937,80,61073,80,1130,613,517,11,15,6,5,allow
26900,27017,17453,27017,172,86,86,2,29,1,1,allow
27005,1304,58771,1304,859,126,733,2,29,1,1,allow
51880,8001,53470,8001,86,86,0,1,29,1,0,allow
52925,53,48232,53,168,78,90,2,29,1,1,allow
26900,27017,4107,27017,422,164,258,6,29,3,3,allow
51880,8000,3169,8000,172,94,78,2,29,1,1,allow
8358,80,8358,80,1875,567,1308,11,31,6,5,allow
7197,80,7197,80,450,246,204,8,31,5,3,allow
54797,80,8308,80,8957,4075,4882,32,416,17,15,allow
56634,80,24022,80,234,234,0,4,12,4,0,allow
60429,46854,20959,46854,70,70,0,1,5,1,0,allow
54828,443,1359,443,150,150,0,1,5,1,0,allow
51692,993,54748,993,11462,4282,7180,61,37,28,33,allow
60037,443,12655,443,6194,1289,4905,23,66,12,11,allow
46278,443,29099,443,6685,4843,1842,29,17,18,11,allow
63847,45598,22596,45598,376,254,122,6,15,4,2,allow
49943,53,23345,53,596,90,506,4,59,2,2,allow
26900,27017,44727,27017,422,164,258,6,30,3,3,allow
26900,27017,63917,27017,422,164,258,6,30,3,3,allow
33564,443,54838,443,314376,14130,300246,399,246,169,230,allow
56675,443,33305,443,7941,1952,5989,20,15,11,9,allow
49568,443,30225,443,6408,2531,3877,21,16,11,10,allow
49875,53,45365,53,445,94,351,2,30,1,1,allow
64577,443,50601,443,24686,1935,22751,36,16,17,19,allow
63875,43485,59709,43485,312,132,180,6,6,3,3,allow
50089,443,20398,443,292,172,120,4,15,2,2,allow
26900,27017,11839,27017,422,164,258,6,30,3,3,allow
49294,53,7678,53,287,94,193,2,30,1,1,allow
64505,53,32135,53,214,102,112,2,30,1,1,allow
51872,48108,27950,48108,70,70,0,1,5,1,0,allow
40980,443,52078,443,567854,22650,545204,713,158,311,402,allow
53375,53,19528,53,298,86,212,2,30,1,1,allow
46964,80,54750,80,1687,951,736,10,93,6,4,allow
55894,53,40691,53,216,102,114,2,30,1,1,allow
65169,53,4248,53,211,102,109,2,30,1,1,allow
55161,53,36813,53,197,94,103,2,30,1,1,allow
26900,27017,46394,27017,422,164,258,6,30,3,3,allow
56846,26665,12553,26665,70,70,0,2,8,2,0,allow
51870,40490,51955,40490,70,70,0,1,5,1,0,allow
53403,443,55979,443,38342,14090,24252,83,159,40,43,allow
50517,80,5050,80,502,256,246,9,25,5,4,allow
51548,80,13460,80,1861,1219,642,10,15,5,5,allow
49940,80,46739,80,1130,613,517,11,15,6,5,allow
56254,80,61838,80,1196,682,514,12,15,6,6,allow
26900,27017,28688,27017,422,164,258,6,30,3,3,allow
57731,53,26408,53,237,86,151,2,30,1,1,allow
26900,27017,53527,27017,254,82,172,4,30,2,2,allow
50394,443,24134,443,60424,4482,55942,101,686,39,62,allow
56677,443,24316,443,7941,1952,5989,20,15,11,9,allow
57804,443,57804,443,4378,1471,2907,19,26,11,8,allow
50984,80,27335,80,8706,2289,6417,22,19,13,9,allow
50987,80,34293,80,8047,2291,5756,22,19,13,9,allow
65278,53,33473,53,403,91,312,4,34,2,2,allow
38369,443,64342,443,434,226,208,7,28,4,3,allow
56676,443,53618,443,7889,1900,5989,20,15,11,9,allow
53132,443,46008,443,6515,1516,4999,23,16,12,11,allow
58547,53,0,0,86,86,0,1,29,1,0,allow
26900,27017,49129,27017,422,164,258,6,30,3,3,allow
50817,53,0,0,182,73,109,2,30,1,1,allow
36949,443,20544,443,7474,1298,6176,25,81,11,14,allow
61862,80,50297,80,9747,537,9210,14,16,6,8,allow
49205,443,49232,443,512444,20822,491622,555,159,191,364,allow
61049,53,17729,53,525,150,375,6,33,3,3,allow
60430,51413,49908,51413,70,70,0,1,5,1,0,allow
54347,443,29019,443,9976,3230,6746,22,58,13,9,allow
54279,443,54279,443,4699,1792,2907,19,28,11,8,allow
50516,80,41134,80,502,256,246,9,25,5,4,allow
26900,27017,30872,27017,422,164,258,6,29,3,3,allow
63578,5228,10061,5228,8544,2633,5911,51,154,28,23,allow
50512,80,4579,80,318,192,126,6,25,4,2,allow
26900,27017,12522,27017,422,164,258,6,30,3,3,allow
54000,53,38105,53,294,86,208,2,30,1,1,allow
26900,27017,60227,27017,422,164,258,6,30,3,3,allow
46189,443,46189,443,4398,1491,2907,19,30,11,8,allow
64817,53,59265,53,199,94,105,2,29,1,1,allow
58427,53,30619,53,197,94,103,2,30,1,1,allow
26900,27017,22476,27017,422,164,258,6,30,3,3,allow
57470,6881,12266,6881,453,251,202,4,1199,2,2,allow
55877,6380,28997,6380,149,149,0,2,1200,2,0,allow
52660,443,21035,443,5042,2002,3040,14,119,7,7,allow
19412,53,19412,53,229,98,131,2,30,1,1,allow
26900,27017,5951,27017,422,164,258,6,30,3,3,allow
26900,27017,3690,27017,422,164,258,6,30,3,3,allow
54978,53,3492,53,198,94,104,2,30,1,1,allow
49976,53,44388,53,245,110,135,2,30,1,1,allow
27005,1302,11338,1302,862,126,736,2,30,1,1,allow
27005,27015,49083,27015,872,126,746,2,30,1,1,allow
27005,1401,26580,1401,864,126,738,2,30,1,1,allow
49932,53,19133,53,237,86,151,2,30,1,1,allow
51091,53,0,0,325,75,250,2,30,1,1,allow
56224,53,54618,53,221,102,119,2,30,1,1,allow
56972,53,60729,53,301,126,175,2,30,1,1,allow
65145,53,64400,53,338,110,228,2,30,1,1,allow
42433,443,64701,443,6381,3801,2580,19,135,10,9,allow
62073,443,18581,443,7989,4098,3891,34,136,15,19,allow
41498,443,27057,443,2733,1555,1178,22,275,11,11,allow
57470,6881,1701,6881,453,251,202,4,1199,2,2,allow
27005,27272,38443,27272,887,126,761,2,30,1,1,allow
57430,80,9392,80,4509,2976,1533,13,15,6,7,allow
53378,443,65278,443,5090,1692,3398,19,82,11,8,allow
50510,80,5594,80,378,192,186,7,25,4,3,allow
17046,53,17046,53,220,90,130,2,30,1,1,allow
26900,27017,1204,27017,422,164,258,6,30,3,3,allow
49597,53,64001,53,216,102,114,2,30,1,1,allow
64975,53,43514,53,198,94,104,2,30,1,1,allow
54656,443,58488,443,6509,1635,4874,21,186,11,10,allow
37653,5223,42431,5223,142,142,0,1,5,1,0,allow
50513,80,33823,80,318,192,126,6,25,4,2,allow
49939,80,14388,80,1130,613,517,11,15,6,5,allow
49938,80,5232,80,1130,613,517,11,15,6,5,allow
50511,80,14463,80,318,192,126,6,25,4,2,allow
34313,53,0,0,184,86,98,2,30,1,1,allow
11236,53,11236,53,197,90,107,2,30,1,1,allow
36942,53,36942,53,197,90,107,2,30,1,1,allow
49903,443,11070,443,355761,14847,340914,423,33,183,240,allow
54846,53,32938,53,168,78,90,2,30,1,1,allow
64888,53,40321,53,767,102,665,2,30,1,1,allow
26900,27017,39625,27017,422,164,258,6,30,3,3,allow
61700,53,61700,53,221,90,131,2,30,1,1,allow
37748,80,57196,80,1090,609,481,13,329,7,6,allow
51437,443,45199,443,6286,1494,4792,22,16,11,11,allow
60277,443,60277,443,7428,729,6699,19,80,7,12,allow
58439,443,16787,443,232,172,60,3,5,2,1,allow
48462,80,48462,80,19738,890,18848,25,20,9,16,allow
50131,443,16533,443,12716,2575,10141,55,141,27,28,allow
56610,80,6975,80,1604,700,904,15,116,7,8,allow
64243,53,51060,53,258,102,156,2,30,1,1,allow
6881,13929,23344,13929,502,150,352,2,1200,1,1,allow
6881,25243,30519,25243,498,150,348,4,1273,2,2,allow
55732,53,56337,53,280,126,154,2,30,1,1,allow
60597,53,0,0,344,94,250,2,30,1,1,allow
64784,53,44632,53,195,102,93,2,30,1,1,allow
27005,1403,18731,1403,857,126,731,2,30,1,1,allow
56901,53,16725,53,264,94,170,2,31,1,1,allow
49583,443,53752,443,10877,2925,7952,56,285,23,33,allow
54970,443,62898,443,251620,16028,235592,353,371,159,194,allow
27005,1307,27385,1307,857,126,731,2,30,1,1,allow
64558,53,57812,53,321,102,219,2,31,1,1,allow
9057,443,55377,443,7769,3958,3811,17,121,9,8,allow
60206,443,52179,443,4706,2475,2231,13,120,7,6,allow
41787,443,37748,443,34237,22442,11795,86,131,41,45,allow
61113,443,60052,443,23915,14776,9139,66,136,35,31,allow
6881,31026,35308,31026,509,150,359,2,1199,1,1,allow
48817,11373,48817,11373,481,150,331,2,1200,1,1,allow
27005,1101,40896,1101,902,126,776,2,30,1,1,allow
63616,443,48346,443,1296,612,684,18,120,9,9,allow
60026,443,38651,443,3643,607,3036,13,120,6,7,allow
64510,443,61997,443,18370,2434,15936,26,120,11,15,allow
33654,443,14790,443,8628,2898,5730,20,144,9,11,allow
63992,443,1306,443,4360,2142,2218,15,120,7,8,allow
37965,39108,36972,39108,1056,1056,0,17,1550,17,0,allow
57470,6969,61511,6969,37677,7875,29802,115,3342,58,57,allow
54961,443,45503,443,25572,2605,22967,56,133,29,27,allow
51888,42529,42090,42529,316,136,180,6,6,3,3,allow
56691,443,48234,443,3986,2645,1341,18,18,10,8,allow
56692,443,32743,443,3932,2581,1351,18,18,10,8,allow
37570,443,52731,443,130,64,66,3,6,2,1,allow
40231,443,30990,443,10401,3375,7026,33,22,17,16,allow
56694,443,2147,443,3723,2372,1351,18,18,10,8,allow
56690,443,32613,443,3936,2585,1351,18,18,10,8,allow
50257,3389,50257,3389,3473,1518,1955,17,18,9,8,allow
56693,443,44446,443,3886,2545,1341,18,18,10,8,allow
50688,5222,59884,5222,402,342,60,2,15,1,1,allow
34170,80,4419,80,2865,2000,865,12,16,7,5,allow
55214,443,10396,443,10048,2128,7920,44,118,24,20,allow
53816,22114,0,0,146,146,0,1,0,1,0,deny
61818,445,0,0,70,70,0,1,0,1,0,drop
61813,445,0,0,70,70,0,1,0,1,0,drop
61811,445,0,0,70,70,0,1,0,1,0,drop
56898,445,0,0,70,70,0,1,0,1,0,drop
57205,445,0,0,66,66,0,1,0,1,0,drop
57203,445,0,0,66,66,0,1,0,1,0,drop
57202,445,0,0,66,66,0,1,0,1,0,drop
61810,445,0,0,70,70,0,1,0,1,0,drop
58888,23718,0,0,66,66,0,1,0,1,0,deny
61808,445,0,0,70,70,0,1,0,1,0,drop
443,48346,0,0,81,81,0,1,0,1,0,deny
56892,445,0,0,70,70,0,1,0,1,0,drop
61803,445,0,0,70,70,0,1,0,1,0,drop
61800,445,0,0,70,70,0,1,0,1,0,drop
61802,445,0,0,70,70,0,1,0,1,0,drop
9528,44847,0,0,146,146,0,1,0,1,0,deny
61563,37807,0,0,66,66,0,1,0,1,0,deny
56885,445,0,0,70,70,0,1,0,1,0,drop
13911,57470,0,0,60,60,0,1,0,1,0,deny
12128,37965,0,0,62,62,0,1,0,1,0,deny
56882,445,0,0,70,70,0,1,0,1,0,drop
56127,35440,0,0,62,62,0,1,0,1,0,deny
65096,37807,0,0,66,66,0,1,0,1,0,deny
54489,53,0,0,232,77,155,2,2,1,1,allow
61787,445,0,0,70,70,0,1,0,1,0,drop
61788,445,0,0,70,70,0,1,0,1,0,drop
61784,445,0,0,70,70,0,1,0,1,0,drop
9327,57470,0,0,62,62,0,1,0,1,0,deny
56879,445,0,0,70,70,0,1,0,1,0,drop
56877,445,0,0,70,70,0,1,0,1,0,drop
60462,47967,0,0,148,148,0,1,0,1,0,deny
56873,445,0,0,70,70,0,1,0,1,0,drop
60248,30188,0,0,62,62,0,1,0,1,0,deny
52672,22114,0,0,146,146,0,1,0,1,0,deny
50713,57470,0,0,62,62,0,1,0,1,0,deny
57649,6881,0,0,62,62,0,1,0,1,0,deny
56872,445,0,0,70,70,0,1,0,1,0,drop
57182,445,0,0,66,66,0,1,0,1,0,drop
61781,445,0,0,70,70,0,1,0,1,0,drop
61779,445,0,0,70,70,0,1,0,1,0,drop
59611,56205,0,0,66,66,0,1,0,1,0,deny
62150,23718,0,0,66,66,0,1,0,1,0,deny
15854,50584,0,0,62,62,0,1,0,1,0,deny
56867,445,0,0,70,70,0,1,0,1,0,drop
12074,10197,0,0,72,72,0,1,0,1,0,deny
57176,445,0,0,66,66,0,1,0,1,0,drop
58341,10197,0,0,78,78,0,1,0,1,0,deny
57173,445,0,0,66,66,0,1,0,1,0,drop
40161,443,23210,443,13459,1604,11855,27,66,14,13,allow
61769,445,0,0,70,70,0,1,0,1,0,drop
49644,30188,0,0,66,66,0,1,0,1,0,deny
1038,37965,0,0,62,62,0,1,0,1,0,deny
61764,445,0,0,70,70,0,1,0,1,0,drop
61761,445,0,0,70,70,0,1,0,1,0,drop
61760,445,0,0,70,70,0,1,0,1,0,drop
57169,445,0,0,66,66,0,1,0,1,0,drop
65285,50584,0,0,66,66,0,1,0,1,0,deny
63098,35440,0,0,66,66,0,1,0,1,0,deny
10427,32480,0,0,66,66,0,1,0,1,0,deny
65317,51221,0,0,78,78,0,1,0,1,0,deny
26969,29434,0,0,146,146,0,1,0,1,0,deny
61755,445,0,0,70,70,0,1,0,1,0,drop
56854,445,0,0,70,70,0,1,0,1,0,drop
61751,445,0,0,70,70,0,1,0,1,0,drop
61750,445,0,0,70,70,0,1,0,1,0,drop
61748,445,0,0,70,70,0,1,0,1,0,drop
57162,445,0,0,66,66,0,1,0,1,0,drop
30169,35776,0,0,159,159,0,1,0,1,0,deny
57158,445,0,0,66,66,0,1,0,1,0,drop
57157,445,0,0,66,66,0,1,0,1,0,drop
57156,445,0,0,66,66,0,1,0,1,0,drop
56851,445,0,0,70,70,0,1,0,1,0,drop
26729,57470,0,0,66,66,0,1,0,1,0,deny
57153,445,0,0,66,66,0,1,0,1,0,drop
57152,445,0,0,66,66,0,1,0,1,0,drop
57151,445,0,0,66,66,0,1,0,1,0,drop
61404,52700,0,0,72,72,0,1,0,1,0,deny
58424,52700,0,0,66,66,0,1,0,1,0,deny
51320,44847,0,0,66,66,0,1,0,1,0,deny
64276,26467,0,0,66,66,0,1,0,1,0,deny
61743,445,0,0,70,70,0,1,0,1,0,drop
61742,445,0,0,70,70,0,1,0,1,0,drop
61741,445,0,0,70,70,0,1,0,1,0,drop
59509,64147,0,0,62,62,0,1,0,1,0,deny
56846,445,0,0,70,70,0,1,0,1,0,drop
57148,445,0,0,66,66,0,1,0,1,0,drop
61739,445,0,0,70,70,0,1,0,1,0,drop
30016,36237,0,0,62,62,0,1,0,1,0,deny
56845,445,0,0,70,70,0,1,0,1,0,drop
57146,445,0,0,66,66,0,1,0,1,0,drop
60052,37965,0,0,66,66,0,1,0,1,0,deny
56843,445,0,0,70,70,0,1,0,1,0,drop
57142,445,0,0,66,66,0,1,0,1,0,drop
57143,445,0,0,66,66,0,1,0,1,0,drop
48840,50584,0,0,146,146,0,1,0,1,0,deny
57140,445,0,0,66,66,0,1,0,1,0,drop
2681,48817,0,0,146,146,0,1,0,1,0,deny
65265,55067,0,0,66,66,0,1,0,1,0,deny
61738,445,0,0,70,70,0,1,0,1,0,drop
34311,5900,0,0,60,60,0,1,0,1,0,deny
49807,443,23954,443,2796,1730,1066,15,126,9,6,allow
49911,80,3385,80,1519,787,732,10,110,6,4,allow
62325,443,62325,443,1210,637,573,14,51,7,7,allow
49761,80,17829,80,2113,1181,932,10,127,6,4,allow
49712,443,1489,443,11365,1278,10087,23,131,10,13,allow
49750,443,8728,443,7370,1474,5896,19,128,10,9,allow
59219,80,51900,80,1658,1344,314,10,15,5,5,allow
49639,443,37506,443,7521,2117,5404,22,89,12,10,allow
49765,443,44439,443,17982,2337,15645,34,127,16,18,allow
49760,80,15959,80,2113,1181,932,10,127,6,4,allow
49805,443,42807,443,2839,1654,1185,15,126,9,6,allow
49808,443,22176,443,1101,654,447,12,126,7,5,allow
43184,80,44137,80,1972,1464,508,15,16,7,8,allow
55177,80,55177,80,374,240,134,7,15,5,2,allow
57911,443,43527,443,9662,4079,5583,66,194,30,36,allow
49706,443,36455,443,32941,1850,31091,46,131,19,27,allow
49803,80,1813,80,2553,1621,932,13,126,8,5,allow
49746,443,2591,443,54014,2565,51449,65,128,24,41,allow
48837,53,7815,53,198,93,105,2,30,1,1,allow
57078,3389,57078,3389,3407,1518,1889,16,17,9,7,allow
62328,443,62328,443,1210,637,573,14,51,7,7,allow
43309,80,55504,80,805,665,140,6,32,4,2,allow
49813,443,15951,443,10103,3140,6963,29,126,16,13,allow
55176,80,55176,80,374,240,134,7,15,5,2,allow
49769,443,60646,443,14166,2015,12151,27,127,11,16,allow
49277,80,55324,80,254,128,126,5,16,3,2,allow
49762,80,8921,80,2114,1182,932,10,127,6,4,allow
51145,80,51145,80,33072,3959,29113,40,46,14,26,allow
49774,443,35552,443,26623,5756,20867,42,126,18,24,allow
55178,80,55178,80,374,240,134,7,15,5,2,allow
49749,443,40981,443,7398,1597,5801,20,128,10,10,allow
49246,443,11384,443,29705,9203,20502,41,18,21,20,allow
51760,443,1508,443,1569,1044,525,14,94,9,5,allow
57913,443,36692,443,10457,4216,6241,70,194,31,39,allow
49718,80,57630,80,11291,1348,9943,17,131,6,11,allow
49811,443,7864,443,7551,2453,5098,22,126,12,10,allow
62329,443,62329,443,1210,637,573,14,51,7,7,allow
49912,80,32939,80,1590,858,732,10,110,6,4,allow
57596,80,43063,80,1231,726,505,10,18,6,4,allow
62327,443,62327,443,1210,637,573,14,51,7,7,allow
60681,443,60681,443,5667,1393,4274,19,16,9,10,allow
35894,53,14493,53,198,93,105,2,30,1,1,allow
57597,443,32556,443,12528,7238,5290,26,91,15,11,allow
62962,443,7055,443,5036,2564,2472,15,125,8,7,allow
30960,45724,8617,45724,330,330,0,6,3609,6,0,allow
65415,443,12568,443,2494,1643,851,17,26,9,8,allow
56527,53,0,0,206,83,123,2,31,1,1,allow
42601,443,30864,443,10845900,123386,10722514,8862,139,1081,7781,allow
45941,23386,0,0,60,60,0,1,0,1,0,deny
61729,445,0,0,70,70,0,1,0,1,0,drop
61723,445,0,0,70,70,0,1,0,1,0,drop
56836,445,0,0,70,70,0,1,0,1,0,drop
56834,445,0,0,70,70,0,1,0,1,0,drop
9283,57470,0,0,66,66,0,1,0,1,0,deny
54099,80,63919,80,214,140,74,4,15,3,1,allow
37780,443,37780,443,4294,695,3599,15,20,8,7,allow
49748,443,24833,443,7084,1703,5381,19,128,10,9,allow
50338,443,61638,443,6441,1651,4790,22,53,12,10,allow
49782,443,2557,443,7757,1997,5760,23,126,13,10,allow
57129,445,0,0,66,66,0,1,0,1,0,drop
57987,56125,0,0,90,90,0,1,0,1,0,deny
56833,445,0,0,70,70,0,1,0,1,0,drop
56832,445,0,0,70,70,0,1,0,1,0,drop
56831,445,0,0,70,70,0,1,0,1,0,drop
56825,445,0,0,70,70,0,1,0,1,0,drop
56828,445,0,0,70,70,0,1,0,1,0,drop
33896,57470,0,0,74,74,0,1,0,1,0,deny
57131,26296,0,0,145,145,0,1,0,1,0,deny
55565,64147,0,0,66,66,0,1,0,1,0,deny
13281,51050,0,0,62,62,0,1,0,1,0,deny
51324,11392,0,0,66,66,0,1,0,1,0,deny
54210,36237,0,0,62,62,0,1,0,1,0,deny
57122,445,0,0,66,66,0,1,0,1,0,drop
61711,445,0,0,70,70,0,1,0,1,0,drop
63447,44847,0,0,62,62,0,1,0,1,0,deny
56256,62413,0,0,62,62,0,1,0,1,0,deny
61242,35253,0,0,66,66,0,1,0,1,0,deny
13462,35440,0,0,62,62,0,1,0,1,0,deny
56811,445,0,0,70,70,0,1,0,1,0,drop
56810,445,0,0,70,70,0,1,0,1,0,drop
443,21255,0,0,66,66,0,1,0,1,0,deny
45964,55559,0,0,60,60,0,1,0,1,0,deny
56806,445,0,0,70,70,0,1,0,1,0,drop
59364,44847,0,0,66,66,0,1,0,1,0,deny
56800,445,0,0,70,70,0,1,0,1,0,drop
56801,445,0,0,70,70,0,1,0,1,0,drop
56646,48817,0,0,62,62,0,1,0,1,0,deny
61945,48817,0,0,66,66,0,1,0,1,0,deny
57120,445,0,0,66,66,0,1,0,1,0,drop
41282,53,19391,53,168,78,90,2,30,1,1,allow
56744,53,53021,53,274,110,164,2,30,1,1,allow
49951,53,52674,53,525,110,415,2,30,1,1,allow
57470,41813,46944,41813,519,166,353,2,1200,1,1,allow
15503,48319,24114,48319,481,150,331,2,1199,1,1,allow
49816,443,49816,443,4682,1775,2907,19,28,11,8,allow
61407,443,61407,443,4552,1645,2907,19,26,11,8,allow
56695,443,49657,443,3874,2523,1351,18,17,10,8,allow
49777,443,39129,443,8638,2215,6423,24,126,14,10,allow
64784,53,28832,53,195,102,93,2,29,1,1,allow
57470,18634,6347,18634,594,594,0,10,1199,10,0,allow
49828,443,43122,443,7284,1353,5931,26,186,14,12,allow
53237,443,24814,443,33472,16066,17406,57,48,29,28,allow
42156,80,29548,80,891,536,355,10,255,6,4,allow
51612,443,45282,443,6777,3431,3346,27,15,14,13,allow
53693,26515,52761,26515,70,70,0,2,7,2,0,allow
63846,80,10554,80,314,192,122,6,15,4,2,allow
51465,443,37534,443,318,70,248,5,17,1,4,allow
51443,443,10966,443,1048,1048,0,9,16,9,0,allow
48187,443,22685,443,1515,568,947,14,82,6,8,allow
51690,993,38356,993,15022,5202,9820,113,36,53,60,allow
55179,80,55179,80,374,240,134,7,15,5,2,allow
49747,443,22101,443,7087,1705,5382,19,128,10,9,allow
49714,80,42166,80,2096,1011,1085,11,130,6,5,allow
65173,53,61112,53,508,186,322,6,51,3,3,allow
49527,53,42526,53,268,94,174,2,29,1,1,allow
27005,27015,16145,27015,879,126,753,2,29,1,1,allow
50509,80,1536,80,49872,11098,38774,65,24,27,38,allow
49775,80,20586,80,1302,849,453,10,126,6,4,allow
49711,443,12474,443,18088,1844,16244,34,130,14,20,allow
49779,443,29819,443,10057,1887,8170,23,126,12,11,allow
49838,443,6189,443,8555,1821,6734,24,123,13,11,allow
54654,6881,17557,6881,470,348,122,6,26,4,2,allow
59001,80,22174,80,1266,383,883,16,393,4,12,allow
36513,443,42006,443,4216,2615,1601,26,80,13,13,allow
62326,443,62326,443,1210,637,573,14,51,7,7,allow
51461,443,45147,443,318,70,248,5,17,1,4,allow
55733,53,46441,53,463,128,335,4,41,2,2,allow
51867,48059,47188,48059,160,70,90,2,5,1,1,allow
49740,443,61794,443,7554,2281,5273,22,129,13,9,allow
49766,443,21804,443,12026,1450,10576,27,127,12,15,allow
49741,443,56871,443,6060,1553,4507,18,129,10,8,allow
49738,443,60730,443,5572,1446,4126,17,129,10,7,allow
49786,443,41630,443,10079,2855,7224,23,126,12,11,allow
49715,443,3770,443,7681,1658,6023,21,130,11,10,allow
49716,443,11903,443,9323,3144,6179,24,130,14,10,allow
49809,443,59332,443,83683,2747,80936,92,125,32,60,allow
49700,80,32872,80,56411,2447,53964,58,130,19,39,allow
49801,443,19605,443,44380,1589,42791,48,126,14,34,allow
49743,443,63725,443,157156,3872,153284,160,128,48,112,allow
49736,443,65019,443,52574,2783,49791,61,129,19,42,allow
49745,443,54598,443,4043,1781,2262,19,128,11,8,allow
49791,443,8451,443,6057,767,5290,16,126,8,8,allow
62732,443,28854,443,50000,36438,13562,98,336,61,37,allow
49719,443,9783,443,40332,2476,37856,57,130,26,31,allow
35452,443,39555,443,5120,3761,1359,21,49,12,9,allow
49710,443,57720,443,9772,1954,7818,23,130,12,11,allow
54926,6789,33904,6789,124239,48650,75589,1342,84,628,714,allow
64772,53,64772,53,241,98,143,2,30,1,1,allow
49834,443,28335,443,9890,4516,5374,26,124,14,12,allow
49835,443,4788,443,10066,4676,5390,27,123,15,12,allow
65232,53,42020,53,311,94,217,2,30,1,1,allow
55411,53,35188,53,200,94,106,2,30,1,1,allow
49183,53,43011,53,592,198,394,6,78,3,3,allow
48189,443,41896,443,1343,616,727,14,82,7,7,allow
51868,30305,17475,30305,70,70,0,1,5,1,0,allow
33858,443,46476,443,12017,2031,9986,38,216,18,20,allow
49778,443,56574,443,10105,1951,8154,24,126,13,11,allow
49727,443,62181,443,1461,761,700,15,130,8,7,allow
65052,53,65052,53,240,98,142,2,30,1,1,allow
41321,443,40754,443,6989232,188564,6800668,7110,288,2412,4698,allow
56076,53,58265,53,311,94,217,2,30,1,1,allow
34306,53,34306,53,241,98,143,2,30,1,1,allow
49981,53,18517,53,200,94,106,2,30,1,1,allow
50288,443,59061,443,8207,2558,5649,41,80,23,18,allow
49702,80,20428,80,2014,1216,798,13,130,8,5,allow
49780,80,65003,80,1429,931,498,10,126,6,4,allow
49783,443,33987,443,10095,2871,7224,23,126,12,11,allow
49836,443,16827,443,6611,2169,4442,20,123,12,8,allow
49812,443,57189,443,6503,2037,4466,24,125,13,11,allow
49763,443,64834,443,8439,1840,6599,21,127,11,10,allow
55142,443,55142,443,4480,555,3925,11,20,6,5,allow
64272,53,63528,53,626,190,436,6,60,3,3,allow
57167,53,41895,53,195,102,93,2,30,1,1,allow
56659,53,34690,53,199,94,105,2,30,1,1,allow
9047,443,22557,443,3645,609,3036,13,120,6,7,allow
57150,53,63337,53,286,97,189,4,47,2,2,allow
49810,80,21965,80,1469,979,490,10,125,6,4,allow
41133,443,38649,443,6964782,246690,6718092,7203,184,2494,4709,allow
49815,443,20999,443,3964,780,3184,14,125,8,6,allow
42186,443,43705,443,10165,2433,7732,19,49,10,9,allow
63590,443,25710,443,6187,933,5254,18,147,10,8,allow
53912,443,53912,443,4447,1540,2907,19,30,11,8,allow
44890,443,40961,443,2134,1397,737,18,1162,10,8,allow
56674,443,42391,443,7889,1900,5989,20,15,11,9,allow
52077,443,25258,443,6317,2196,4121,19,15,10,9,allow
56842,24233,12414,24233,70,70,0,2,8,2,0,allow
49795,443,22996,443,7243,777,6466,17,126,8,9,allow
10165,80,10165,80,6714,929,5785,17,33,8,9,allow
49826,443,35074,443,5635,1599,4036,19,125,11,8,allow
56696,443,27730,443,3140,1782,1358,18,17,10,8,allow
48509,443,53083,443,4922,950,3972,17,34,10,7,allow
41685,161,0,0,109,109,0,2,34,2,0,allow
55174,80,55174,80,374,240,134,7,15,5,2,allow
49701,80,18933,80,6132,634,5498,13,130,6,7,allow
58682,443,48693,443,5061,876,4185,16,70,8,8,allow
49490,53,6765,53,364,92,272,4,38,2,2,allow
14394,443,16776,443,4649,2928,1721,40,415,21,19,allow
49806,443,11715,443,37255,2202,35053,46,125,17,29,allow
41487,443,27679,443,7112,5916,1196,20,30,10,10,allow
49717,443,12194,443,20576,8959,11617,42,130,24,18,allow
62730,443,41025,443,12539,6472,6067,81,406,37,44,allow
49790,80,49818,80,1769,1271,498,10,126,6,4,allow
49731,80,40624,80,318,192,126,6,130,4,2,allow
34767,443,6327,443,6313,1368,4945,21,846,11,10,allow
49788,443,22621,443,74171,1888,72283,72,126,18,54,allow
49734,80,8310,80,88983,2379,86604,92,129,30,62,allow
60425,60425,17270,60425,1728,1031,697,14,17,8,6,allow
27005,1402,23160,1402,870,126,744,2,29,1,1,allow
49817,443,20632,443,4504,839,3665,16,125,8,8,allow
48186,443,28155,443,1947,688,1259,18,82,8,10,allow
37462,53,30454,53,207,86,121,2,30,1,1,allow
46384,443,46384,443,4594,1687,2907,19,30,11,8,allow
56306,53,41144,53,228,94,134,2,30,1,1,allow
34995,443,34995,443,1542,489,1053,8,20,5,3,allow
60597,53,0,0,344,94,250,2,29,1,1,allow
57470,22646,6893,22646,353,166,187,2,1200,1,1,allow
64944,53,42030,53,228,94,134,2,30,1,1,allow
50975,53,27923,53,199,94,105,2,30,1,1,allow
22583,53,22583,53,213,82,131,2,30,1,1,allow
55638,53,61828,53,184,86,98,2,30,1,1,allow
57167,53,27604,53,195,102,93,2,30,1,1,allow
46385,53,10375,53,199,94,105,2,30,1,1,allow
54320,27016,15570,27016,924,924,0,3,30,3,0,allow
52883,53,22567,53,339,94,245,2,30,1,1,allow
47037,80,10159,80,613,539,74,7,15,6,1,allow
38897,443,50921,443,11019,4204,6815,23,49,13,10,allow
51869,25355,56016,25355,70,70,0,1,5,1,0,allow
49767,443,22404,443,11883,1419,10464,26,127,11,15,allow
49735,443,18914,443,1143,672,471,12,129,7,5,allow
49792,443,3776,443,6089,799,5290,16,126,8,8,allow
49781,443,43148,443,7877,1949,5928,24,126,12,12,allow
49794,443,25276,443,7307,841,6466,18,126,9,9,allow
39762,443,10128,443,9264,2848,6416,31,100,16,15,allow
49804,443,24644,443,5938,1521,4417,20,125,10,10,allow
49837,443,60962,443,9634,2232,7402,24,123,12,12,allow
49764,443,53395,443,7128,865,6263,19,127,9,10,allow
58536,53,40631,53,522,162,360,6,64,3,3,allow
55595,443,57179,443,448,166,282,2,30,1,1,allow
58302,443,57426,443,4568,2059,2509,17,33,9,8,allow
56673,443,15225,443,7941,1952,5989,20,15,11,9,allow
39820,443,46872,443,2190,1249,941,23,26,12,11,allow
51882,15733,38796,15733,70,70,0,2,8,2,0,allow
49742,443,32248,443,4490,750,3740,16,128,8,8,allow
49785,443,35177,443,7757,1949,5808,22,126,12,10,allow
49732,80,4505,80,2052,711,1341,10,130,6,4,allow
49787,443,47487,443,34175,1680,32495,42,126,15,27,allow
49713,80,27859,80,5029,1986,3043,16,130,8,8,allow
56672,443,28399,443,7888,1899,5989,20,15,11,9,allow
39814,443,9384,443,5761,3561,2200,45,51,23,22,allow
54685,53,54685,53,832,106,726,2,30,1,1,allow
55768,443,42706,443,5263,2534,2729,16,120,8,8,allow
27005,27212,63313,27212,889,126,763,2,30,1,1,allow
56615,443,28312,443,4425,2899,1526,24,34,14,10,allow
49768,443,40344,443,12934,1419,11515,27,127,11,16,allow
50999,443,48896,443,33716,17750,15966,134,329,72,62,allow
57948,443,51203,443,6885,3239,3646,53,190,24,29,allow
59480,443,64952,443,5058,2667,2391,25,92,13,12,allow
49737,443,56529,443,5566,1444,4122,17,129,10,7,allow
49784,443,6049,443,7805,1949,5856,22,126,12,10,allow
64335,53,51507,53,293,95,198,4,46,2,2,allow
64222,53,1206,53,264,94,170,2,30,1,1,allow
6881,35045,1586,35045,475,150,325,2,1200,1,1,allow
61569,53,2254,53,211,78,133,2,30,1,1,allow
55829,53,23534,53,168,78,90,2,30,1,1,allow
64706,27065,4529,27065,924,924,0,3,30,3,0,allow
56707,443,58509,443,40263,17490,22773,75,403,35,40,allow
15503,7750,61935,7750,858,858,0,14,1200,14,0,allow
34878,53,44059,53,339,94,245,2,30,1,1,allow
53260,53,10585,53,199,94,105,2,30,1,1,allow
57008,53,37986,53,255,110,145,2,30,1,1,allow
27005,27237,36473,27237,876,126,750,2,30,1,1,allow
49737,53,34228,53,184,86,98,2,31,1,1,allow
55312,53,28336,53,195,102,93,2,31,1,1,allow
55766,443,53751,443,1864,250,1614,8,120,4,4,allow
37580,443,41939,443,24810,10597,14213,51,123,22,29,allow
57470,13551,21268,13551,761,166,595,2,1200,1,1,allow
57470,21178,29997,21178,166,166,0,1,1200,1,0,allow
27005,27268,57130,27268,884,126,758,2,30,1,1,allow
57470,6889,19938,6889,546,166,380,2,1200,1,1,allow
8979,443,54799,443,62149740,2002795,60146945,62894,211,19380,43514,allow
56845,27201,52716,27201,316,136,180,6,7,3,3,allow
57582,443,57582,443,2506,1461,1045,21,88,10,11,allow
48188,443,44045,443,1263,536,727,13,82,6,7,allow
11296,443,11296,443,1311,782,529,12,23,7,5,allow
53666,50321,61664,50321,736,490,246,8,17,4,4,allow
9073,443,37513,443,4187235,99258,4087977,4375,28,1464,2911,allow
38087,443,27935,443,6147,910,5237,18,100,10,8,allow
56671,443,59090,443,7940,1951,5989,20,16,11,9,allow
57641,80,57641,80,35197,3040,32157,40,32,14,26,allow
63869,34368,47992,34368,66,66,0,2,8,2,0,allow
11319,443,11319,443,179461,16904,162557,220,36,105,115,allow
11992,443,11992,443,12020,5977,6043,38,30,23,15,allow
11028,443,11028,443,6671,3244,3427,26,30,16,10,allow
10886,51505,0,0,62,62,0,1,0,1,0,deny
37343,21247,0,0,62,62,0,1,0,1,0,deny
443,48346,0,0,81,81,0,1,0,1,0,deny
993,38356,0,0,66,66,0,1,0,1,0,deny
27785,37965,0,0,66,66,0,1,0,1,0,deny
57111,445,0,0,66,66,0,1,0,1,0,drop
59668,51505,0,0,66,66,0,1,0,1,0,deny
57109,445,0,0,66,66,0,1,0,1,0,drop
51413,48637,0,0,72,72,0,1,0,1,0,deny
50674,35440,0,0,146,146,0,1,0,1,0,deny
50637,44847,0,0,62,62,0,1,0,1,0,deny
46662,36237,0,0,62,62,0,1,0,1,0,deny
56789,445,0,0,70,70,0,1,0,1,0,drop
65285,44847,0,0,62,62,0,1,0,1,0,deny
52720,35894,0,0,62,62,0,1,0,1,0,deny
50470,61463,0,0,86,86,0,1,0,1,0,deny
50716,50584,0,0,70,70,0,1,0,1,0,deny
61701,445,0,0,70,70,0,1,0,1,0,drop
61702,445,0,0,70,70,0,1,0,1,0,drop
61700,445,0,0,70,70,0,1,0,1,0,drop
40474,23117,0,0,146,146,0,1,0,1,0,deny
1441,51221,0,0,62,62,0,1,0,1,0,deny
11478,51221,0,0,66,66,0,1,0,1,0,deny
57092,445,0,0,66,66,0,1,0,1,0,drop
62029,22114,0,0,66,66,0,1,0,1,0,deny
57090,445,0,0,66,66,0,1,0,1,0,drop
57097,445,0,0,66,66,0,1,0,1,0,drop
57094,445,0,0,66,66,0,1,0,1,0,drop
57095,445,0,0,66,66,0,1,0,1,0,drop
57096,445,0,0,66,66,0,1,0,1,0,drop
57093,445,0,0,66,66,0,1,0,1,0,drop
57091,445,0,0,66,66,0,1,0,1,0,drop
56835,35894,0,0,66,66,0,1,0,1,0,deny
56785,445,0,0,70,70,0,1,0,1,0,drop
27783,57470,0,0,62,62,0,1,0,1,0,deny
35261,15503,0,0,74,74,0,1,0,1,0,deny
58672,43890,0,0,66,66,0,1,0,1,0,deny
56773,445,0,0,70,70,0,1,0,1,0,drop
56775,445,0,0,70,70,0,1,0,1,0,drop
56776,445,0,0,70,70,0,1,0,1,0,drop
56772,445,0,0,70,70,0,1,0,1,0,drop
56768,445,0,0,70,70,0,1,0,1,0,drop
28754,50584,0,0,66,66,0,1,0,1,0,deny
61696,445,0,0,70,70,0,1,0,1,0,drop
61691,445,0,0,70,70,0,1,0,1,0,drop
61683,445,0,0,70,70,0,1,0,1,0,drop
62068,64147,0,0,66,66,0,1,0,1,0,deny
59564,57470,0,0,66,66,0,1,0,1,0,deny
42379,443,23985,443,499,425,74,4,0,3,1,allow
20400,64147,0,0,62,62,0,1,0,1,0,deny
57074,445,0,0,66,66,0,1,0,1,0,drop
57076,445,0,0,66,66,0,1,0,1,0,drop
57075,445,0,0,66,66,0,1,0,1,0,drop
65515,22114,0,0,66,66,0,1,0,1,0,deny
13911,57470,0,0,60,60,0,1,0,1,0,deny
3996,57470,0,0,62,62,0,1,0,1,0,deny
52989,51505,0,0,66,66,0,1,0,1,0,deny
61682,445,0,0,70,70,0,1,0,1,0,drop
25348,23,0,0,60,60,0,1,0,1,0,deny
64903,51050,0,0,62,62,0,1,0,1,0,deny
23770,50584,0,0,62,62,0,1,0,1,0,deny
48706,23393,0,0,60,60,0,1,0,1,0,deny
19245,64147,0,0,66,66,0,1,0,1,0,deny
56763,445,0,0,70,70,0,1,0,1,0,drop
59874,22114,0,0,146,146,0,1,0,1,0,deny
61679,445,0,0,70,70,0,1,0,1,0,drop
34193,17,0,0,60,60,0,1,0,1,0,deny
45344,443,7513,443,2593,1394,1199,20,13,11,9,allow
48230,57866,0,0,146,146,0,1,0,1,0,deny
61669,445,0,0,70,70,0,1,0,1,0,drop
61672,445,0,0,70,70,0,1,0,1,0,drop
61671,445,0,0,70,70,0,1,0,1,0,drop
63867,64147,0,0,62,62,0,1,0,1,0,deny
57987,56125,0,0,90,90,0,1,0,1,0,deny
56755,445,0,0,70,70,0,1,0,1,0,drop
56754,445,0,0,70,70,0,1,0,1,0,drop
23969,57470,0,0,62,62,0,1,0,1,0,deny
443,48346,0,0,81,81,0,1,0,1,0,deny
15875,50584,0,0,62,62,0,1,0,1,0,deny
56748,445,0,0,70,70,0,1,0,1,0,drop
8889,33698,0,0,60,60,0,1,0,1,0,deny
56747,445,0,0,70,70,0,1,0,1,0,drop
58226,52848,0,0,62,62,0,1,0,1,0,deny
61662,445,0,0,70,70,0,1,0,1,0,drop
61661,445,0,0,70,70,0,1,0,1,0,drop
61659,445,0,0,70,70,0,1,0,1,0,drop
1972,57470,0,0,78,78,0,1,0,1,0,deny
60426,57470,0,0,62,62,0,1,0,1,0,deny
8297,37965,0,0,62,62,0,1,0,1,0,deny
26085,51221,0,0,72,72,0,1,0,1,0,deny
48258,37965,0,0,62,62,0,1,0,1,0,deny
56743,445,0,0,70,70,0,1,0,1,0,drop
49305,57470,0,0,66,66,0,1,0,1,0,deny
56742,445,0,0,70,70,0,1,0,1,0,drop
57874,26467,0,0,62,62,0,1,0,1,0,deny
13285,29892,0,0,145,145,0,1,0,1,0,deny
57054,445,0,0,66,66,0,1,0,1,0,drop
13285,29892,0,0,145,145,0,1,0,1,0,deny
61653,445,0,0,70,70,0,1,0,1,0,drop
61652,445,0,0,70,70,0,1,0,1,0,drop
12226,37965,0,0,62,62,0,1,0,1,0,deny
53966,57470,0,0,62,62,0,1,0,1,0,deny
49977,57470,0,0,62,62,0,1,0,1,0,deny
45099,57470,0,0,62,62,0,1,0,1,0,deny
60423,35440,0,0,62,62,0,1,0,1,0,deny
443,32698,0,0,89,89,0,1,0,1,0,deny
56737,445,0,0,70,70,0,1,0,1,0,drop
52976,31573,0,0,66,66,0,1,0,1,0,deny
63288,52848,0,0,66,66,0,1,0,1,0,deny
55386,37965,0,0,66,66,0,1,0,1,0,deny
35558,15503,0,0,66,66,0,1,0,1,0,deny
65317,51221,0,0,78,78,0,1,0,1,0,deny
443,48346,0,0,81,81,0,1,0,1,0,deny
46518,44847,0,0,62,62,0,1,0,1,0,deny
10036,44847,0,0,66,66,0,1,0,1,0,deny
55375,44847,0,0,66,66,0,1,0,1,0,deny
57049,445,0,0,66,66,0,1,0,1,0,drop
43129,15503,0,0,62,62,0,1,0,1,0,deny
57045,445,0,0,66,66,0,1,0,1,0,drop
80,37649,0,0,60,60,0,1,0,1,0,deny
61642,445,0,0,70,70,0,1,0,1,0,drop
55394,123,0,0,234,234,0,1,0,1,0,deny
61638,445,0,0,70,70,0,1,0,1,0,drop
61637,445,0,0,70,70,0,1,0,1,0,drop
61630,445,0,0,70,70,0,1,0,1,0,drop
57044,445,0,0,66,66,0,1,0,1,0,drop
50470,61463,0,0,86,86,0,1,0,1,0,deny
56724,445,0,0,70,70,0,1,0,1,0,drop
58381,57470,0,0,66,66,0,1,0,1,0,deny
61626,445,0,0,70,70,0,1,0,1,0,drop
60192,35440,0,0,146,146,0,1,0,1,0,deny
443,48346,0,0,81,81,0,1,0,1,0,deny
61624,445,0,0,70,70,0,1,0,1,0,drop
61622,445,0,0,70,70,0,1,0,1,0,drop
61620,445,0,0,70,70,0,1,0,1,0,drop
56721,445,0,0,70,70,0,1,0,1,0,drop
58207,51505,0,0,66,66,0,1,0,1,0,deny
57034,445,0,0,66,66,0,1,0,1,0,drop
57987,56125,0,0,90,90,0,1,0,1,0,deny
25254,5555,0,0,60,60,0,1,0,1,0,deny
50052,65008,0,0,60,60,0,1,0,1,0,deny
57033,445,0,0,66,66,0,1,0,1,0,drop
57030,445,0,0,66,66,0,1,0,1,0,drop
57027,445,0,0,66,66,0,1,0,1,0,drop
48706,23393,0,0,60,60,0,1,0,1,0,deny
48681,11392,0,0,62,62,0,1,0,1,0,deny
53625,64147,0,0,62,62,0,1,0,1,0,deny
48681,11392,0,0,146,146,0,1,0,1,0,deny
57026,445,0,0,66,66,0,1,0,1,0,drop
57025,445,0,0,66,66,0,1,0,1,0,drop
57023,445,0,0,66,66,0,1,0,1,0,drop
30960,45723,17261,45723,330,330,0,6,3608,6,0,allow
55312,53,10081,53,190,97,93,2,30,1,1,allow
56684,443,25036,443,8737,1821,6916,23,23,14,9,allow
59930,80,22245,80,1638,1324,314,10,15,5,5,allow
63849,16632,40129,16632,66,66,0,1,5,1,0,allow
51104,13011,33495,13011,948,473,475,13,15,7,6,allow
14272,53,14272,53,1415,689,726,3,31,2,1,allow
58478,443,30017,443,19356,2148,17208,34,112,17,17,allow
45343,443,52570,443,2312,1382,930,19,26,11,8,allow
53508,80,33768,80,16965052,382638,16582414,16619,61,5458,11161,allow
60113,443,5252,443,704,280,424,11,19,5,6,allow
54448,443,65424,443,1786,172,1614,7,120,3,4,allow
57470,6881,39218,6881,517,163,354,2,1200,1,1,allow
11761,443,11761,443,5626,2487,3139,23,29,14,9,allow
51412,443,11649,443,8933,1958,6975,25,81,14,11,allow
56683,443,10179,443,8735,1819,6916,23,23,14,9,allow
63865,48610,16202,48610,66,66,0,2,8,2,0,allow
52829,80,23872,80,2078,726,1352,10,15,5,5,allow
57830,7635,57830,7635,138,78,60,2,5,1,1,allow
57639,80,57639,80,104868,1493,103375,90,31,17,73,allow
49131,443,28166,443,6150,914,5236,18,97,10,8,allow
57636,80,57636,80,147506,3521,143985,125,32,23,102,allow
32899,443,18208,443,47948,40338,7610,82,17,43,39,allow
35078,443,18726,443,78,78,0,1,5,1,0,allow
57638,80,57638,80,29263,2432,26831,36,31,13,23,allow
37561,80,40884,80,1630,918,712,12,16,7,5,allow
57642,80,57642,80,220515,3488,217027,180,31,31,149,allow
47471,80,60446,80,1114,534,580,12,16,7,5,allow
38502,443,34798,443,2378,1126,1252,14,978,7,7,allow
57581,443,57581,443,2512,1465,1047,21,87,10,11,allow
48726,80,33900,80,1794,1480,314,13,15,8,5,allow
59809,443,46540,443,35140,3700,31440,67,76,30,37,allow
51501,993,18732,993,12667,4060,8607,87,32,39,48,allow
47947,80,61494,80,2917,870,2047,14,16,8,6,allow
54693,443,58435,443,5220,922,4298,17,100,10,7,allow
27452,5222,13129,5222,3751,1007,2744,35,425,11,24,allow
50995,443,19177,443,3115,1849,1266,18,16,8,10,allow
36276,7000,36276,7000,3638,2027,1611,17,15,9,8,allow
41151,80,58286,80,1711,786,925,12,16,7,5,allow
63866,17623,35380,17623,66,66,0,2,8,2,0,allow
38433,443,38484,443,33344,25806,7538,105,130,56,49,allow
40909,443,25631,443,1062,724,338,16,41,11,5,allow
60433,6881,42209,6881,70,70,0,2,8,2,0,allow
37716,443,28375,443,14009,10561,3448,30,135,16,14,allow
27005,27241,34573,27241,885,126,759,2,30,1,1,allow
50265,50262,19967,50262,3758,2456,1302,52,2355,31,21,allow
51221,55497,56542,55497,528,528,0,9,1200,9,0,allow
61192,35440,0,0,146,146,0,1,0,1,0,deny
60854,42873,0,0,66,66,0,1,0,1,0,deny
1138,42873,0,0,62,62,0,1,0,1,0,deny
24041,55783,0,0,62,62,0,1,0,1,0,deny
56717,445,0,0,70,70,0,1,0,1,0,drop
56715,445,0,0,70,70,0,1,0,1,0,drop
29011,32468,0,0,66,66,0,1,0,1,0,deny
61619,445,0,0,70,70,0,1,0,1,0,drop
61616,445,0,0,70,70,0,1,0,1,0,drop
61614,445,0,0,70,70,0,1,0,1,0,drop
33801,62413,0,0,62,62,0,1,0,1,0,deny
46945,64147,0,0,62,62,0,1,0,1,0,deny
57020,445,0,0,66,66,0,1,0,1,0,drop
26180,35440,0,0,62,62,0,1,0,1,0,deny
61611,445,0,0,70,70,0,1,0,1,0,drop
56713,445,0,0,70,70,0,1,0,1,0,drop
57017,445,0,0,66,66,0,1,0,1,0,drop
57016,445,0,0,66,66,0,1,0,1,0,drop
52281,161,0,0,550,550,0,6,35,6,0,allow
54974,443,56766,443,8670,2248,6422,36,90,21,15,allow
52313,443,33219,443,52235,4973,47262,81,179,39,42,allow
56361,80,32552,80,9997,1306,8691,17,25,8,9,allow
11901,443,11901,443,5599,2459,3140,23,29,14,9,allow
11801,443,11801,443,19187,5127,14060,38,22,23,15,allow
63850,6881,4556,6881,70,70,0,1,4,1,0,allow
50460,443,12819,443,1346,918,428,10,31,6,4,allow
53912,443,35610,443,1346,918,428,10,33,6,4,allow
47600,53,23679,53,168,78,90,2,29,1,1,allow
27005,27015,28770,27015,879,126,753,2,29,1,1,allow
27005,27207,59346,27207,875,126,749,2,29,1,1,allow
54322,27015,26816,27015,924,924,0,3,29,3,0,allow
42587,53,63043,53,199,94,105,2,30,1,1,allow
65455,3389,65455,3389,4350,2261,2089,21,17,11,10,allow
57470,50321,46751,50321,538,166,372,2,1199,1,1,allow
12157,80,12157,80,2144,1519,625,9,29,6,3,allow
49567,443,55321,443,6408,2531,3877,21,15,11,10,allow
46409,80,63158,80,1053,613,440,10,15,5,5,allow
63848,48560,32430,48560,70,70,0,1,4,1,0,allow
60973,443,19022,443,398300,18473,379827,492,72,222,270,allow
51880,18468,1087,18468,70,70,0,2,8,2,0,allow
60977,443,59690,443,275026,15030,259996,353,72,167,186,allow
56970,53,57331,53,428,103,325,4,34,2,2,allow
63867,43618,62706,43618,66,66,0,2,7,2,0,allow
64900,53,36772,53,314,102,212,2,29,1,1,allow
56081,53,45307,53,237,94,143,2,29,1,1,allow
56314,53,21778,53,211,102,109,2,29,1,1,allow
61568,53,62912,53,260,86,174,2,29,1,1,allow
54321,27015,42449,27015,924,924,0,3,29,3,0,allow
64998,27037,18339,27037,3287,2072,1215,12,30,6,6,allow
27005,27203,54242,27203,871,126,745,2,29,1,1,allow
37611,53,57023,53,199,94,105,2,30,1,1,allow
57298,53,55060,53,323,110,213,2,30,1,1,allow
49663,53,0,0,86,86,0,1,30,1,0,allow
51455,443,21298,443,8618,3110,5508,34,1695,18,16,allow
60766,28080,64298,28080,70,70,0,2,8,2,0,allow
33243,443,33380,443,1067,650,417,10,31,6,4,allow
56669,443,61657,443,8058,2038,6020,20,15,11,9,allow
56100,53,62385,53,211,102,109,2,30,1,1,allow
56637,443,17039,443,8865,1819,7046,24,30,14,10,allow
33231,443,11220,443,1067,650,417,10,35,6,4,allow
41547,80,41547,80,120443,1965,118478,108,20,21,87,allow
49424,53,53979,53,228,110,118,2,30,1,1,allow
43391,80,44561,80,1560,684,876,10,15,5,5,allow
33834,443,55526,443,1178,820,358,9,15,6,3,allow
37893,53,0,0,86,86,0,1,30,1,0,allow
6189,53,29429,53,229,86,143,2,30,1,1,allow
35106,53,20275,53,271,102,169,2,30,1,1,allow
51221,15886,64989,15886,481,150,331,2,1200,1,1,allow
64573,53,28615,53,380,110,270,2,30,1,1,allow
64566,53,50358,53,347,107,240,4,42,2,2,allow
50448,443,19311,443,1346,918,428,10,35,6,4,allow
60425,80,53766,80,186,64,122,4,28,2,2,allow
58676,443,61726,443,6144,939,5205,18,70,9,9,allow
37846,443,26954,443,30620,20855,9765,91,112,45,46,allow
41914,123,34175,123,184,94,90,2,30,1,1,allow
37923,443,39242,443,2593394,70243,2523151,2678,303,908,1770,allow
51221,55497,24312,55497,330,330,0,6,1200,6,0,allow
50968,443,1299,443,10759,3158,7601,29,75,16,13,allow
56670,443,11392,443,8006,1986,6020,20,15,11,9,allow
65483,443,48950,443,92479,4869,87610,109,16,44,65,allow
56431,80,21703,80,17248,1619,15629,26,25,11,15,allow
49540,53,16812,53,279,94,185,2,30,1,1,allow
33539,53,23280,53,336,231,105,3,30,2,1,allow
43680,53,64871,53,271,102,169,2,30,1,1,allow
10151,60419,62503,60419,479,150,329,2,1200,1,1,allow
53911,443,57422,443,1346,918,428,10,33,6,4,allow
60974,443,22731,443,166465,9498,156967,220,72,100,120,allow
60975,443,27000,443,333131,17461,315670,435,72,211,224,allow
53958,80,17834,80,23134,15926,7208,53,541,32,21,allow
50750,443,64318,443,70,70,0,2,171,2,0,allow
50749,443,31608,443,70,70,0,2,171,2,0,allow
57586,443,57586,443,13517,1521,11996,32,87,11,21,allow
63870,6881,42274,6881,66,66,0,2,7,2,0,allow
54657,443,15364,443,7070,1030,6040,19,33,11,8,allow
34308,3389,34308,3389,4930,2691,2239,24,19,14,10,allow
60409,80,41783,80,10970,7709,3261,24,29,13,11,allow
60427,80,8033,80,186,64,122,4,28,2,2,allow
57583,443,57583,443,2512,1466,1046,21,87,10,11,allow
46256,443,26728,443,15090,9197,5893,33,97,19,14,allow
56633,80,19210,80,234,234,0,4,12,4,0,allow
11897,443,11897,443,1452,817,635,16,29,9,7,allow
60431,52867,31778,52867,70,70,0,2,8,2,0,allow
63864,44139,1189,44139,66,66,0,2,7,2,0,allow
12266,443,12266,443,18634,3895,14739,48,29,27,21,allow
60741,443,38588,443,2042,559,1483,20,89,6,14,allow
57640,80,57640,80,64437,2630,61807,64,31,18,46,allow
57585,443,57585,443,2504,1458,1046,21,87,10,11,allow
51879,38564,27585,38564,70,70,0,2,8,2,0,allow
50016,53,35137,53,275,94,181,2,29,1,1,allow
55312,53,37351,53,195,102,93,2,29,1,1,allow
27005,27214,50051,27214,876,126,750,2,29,1,1,allow
63868,60392,39941,60392,66,66,0,2,7,2,0,allow
56639,443,6220,443,10138,2213,7925,27,30,16,11,allow
55713,53,11593,53,308,94,214,2,30,1,1,allow
57414,53,33094,53,214,102,112,2,29,1,1,allow
50242,80,35975,80,2793,1071,1722,14,105,7,7,allow
65484,443,29745,443,148284,6200,142084,165,16,63,102,allow
56634,443,43198,443,8865,1819,7046,24,30,14,10,allow
27005,27015,21869,27015,877,126,751,2,29,1,1,allow
51550,443,50088,443,13331,2421,10910,38,209,20,18,allow
27005,27202,9481,27202,872,126,746,2,29,1,1,allow
55773,53,51846,53,102,102,0,1,60,1,0,allow
65406,53,1627,53,102,102,0,1,60,1,0,allow
40931,443,31983,443,7399,3328,4071,76,4153,33,43,allow
32806,7275,35238,7275,130,70,60,2,15,1,1,allow
54935,443,10103,443,10198,3881,6317,46,146,26,20,allow
55648,80,53307,80,70,70,0,2,8,2,0,allow
51865,14732,14153,14732,70,70,0,1,5,1,0,allow
60556,28678,33348,28678,1806,1806,0,22,224,22,0,allow
60583,443,60583,443,1315,786,529,12,36,7,5,allow
56668,443,3930,443,8005,1985,6020,20,15,11,9,allow
49128,53,21318,53,199,94,105,2,30,1,1,allow
58890,53,58890,53,198,90,108,2,30,1,1,allow
36851,53,52640,53,404,261,143,3,30,2,1,allow
55281,53,41810,53,236,94,142,2,30,1,1,allow
57015,53,23440,53,363,102,261,2,30,1,1,allow
53565,443,13839,443,12007,942,11065,19,120,8,11,allow
44847,12269,58091,12269,502,150,352,2,1200,1,1,allow
39105,443,21624,443,2853588,73973,2779615,2907,129,994,1913,allow
53692,16624,3177,16624,320,140,180,6,6,3,3,allow
51866,23431,28853,23431,70,70,0,1,5,1,0,allow
50476,80,25570,80,5049,4344,705,11,30,6,5,allow
54453,443,45461,443,4227,1086,3141,15,29,8,7,allow
56636,443,16823,443,8865,1819,7046,24,30,14,10,allow
55887,53,35825,53,339,98,241,4,47,2,2,allow
64265,53,25534,53,550,133,417,4,47,2,2,allow
55470,53,60625,53,310,94,216,2,30,1,1,allow
31602,53,0,0,327,102,225,2,30,1,1,allow
50278,443,50420,443,36958,2966,33992,48,120,18,30,allow
57097,443,3043,443,3578432,133577,3444855,4291,426,1634,2657,allow
50584,51413,31327,51413,498,150,348,4,2396,2,2,allow
56640,443,54047,443,8735,1819,6916,23,30,14,9,allow
56682,443,39754,443,8735,1819,6916,23,22,14,9,allow
33725,53,33725,53,216,90,126,2,30,1,1,allow
56135,53,30728,53,258,118,140,2,30,1,1,allow
64564,53,49143,53,273,94,179,2,30,1,1,allow
46838,80,4801,80,70,70,0,1,120,1,0,allow
51221,62348,26234,62348,132,132,0,3,1200,3,0,allow
44871,53,64533,53,164,78,86,2,31,1,1,allow
64516,443,9177,443,2649258,1156086,1493172,7283,5215,3384,3899,allow
6882,40796,60379,40796,228,118,110,2,1200,1,1,allow
57470,38871,35688,38871,545,166,379,2,1199,1,1,allow
53678,31592,21651,31592,70,70,0,1,5,1,0,allow
6666,21,6666,21,66,66,0,1,5,1,0,allow
59626,443,63020,443,5837,1982,3855,19,18,11,8,allow
56667,443,7226,443,8057,2037,6020,20,16,11,9,allow
49911,53,3623,53,200,94,106,2,30,1,1,allow
55144,53,47771,53,209,102,107,2,30,1,1,allow
55312,53,24613,53,195,102,93,2,30,1,1,allow
27005,27240,14670,27240,868,126,742,2,31,1,1,allow
63123,443,2036,443,5530,2343,3187,22,128,10,12,allow
50277,443,37349,443,3182,1568,1614,8,120,4,4,allow
55105,53,24892,53,194,94,100,2,30,1,1,allow
45035,80,33169,80,3720,1663,2057,17,186,10,7,allow
56845,53,65473,53,233,102,131,2,30,1,1,allow
49278,53,60636,53,200,94,106,2,30,1,1,allow
65036,53,31003,53,209,94,115,2,30,1,1,allow
27005,27016,20035,27016,903,126,777,2,31,1,1,allow
51806,443,31513,443,19093,3390,15703,26,126,10,16,allow
57470,52177,52924,52177,1980,1980,0,31,2321,31,0,allow
57014,445,0,0,66,66,0,1,0,1,0,drop
57433,21247,0,0,66,66,0,1,0,1,0,deny
45941,23386,0,0,60,60,0,1,0,1,0,deny
57012,445,0,0,66,66,0,1,0,1,0,drop
64605,35993,0,0,66,66,0,1,0,1,0,deny
62115,57470,0,0,66,66,0,1,0,1,0,deny
8536,37965,0,0,62,62,0,1,0,1,0,deny
27401,37965,0,0,66,66,0,1,0,1,0,deny
56706,445,0,0,70,70,0,1,0,1,0,drop
443,48346,0,0,81,81,0,1,0,1,0,deny
61610,445,0,0,70,70,0,1,0,1,0,drop
9529,26467,0,0,62,62,0,1,0,1,0,deny
61599,445,0,0,70,70,0,1,0,1,0,drop
61593,445,0,0,70,70,0,1,0,1,0,drop
56704,445,0,0,70,70,0,1,0,1,0,drop
56703,445,0,0,70,70,0,1,0,1,0,drop
45964,55559,0,0,60,60,0,1,0,1,0,deny
57002,445,0,0,66,66,0,1,0,1,0,drop
56702,445,0,0,70,70,0,1,0,1,0,drop
56701,445,0,0,70,70,0,1,0,1,0,drop
56699,445,0,0,70,70,0,1,0,1,0,drop
56697,445,0,0,70,70,0,1,0,1,0,drop
28385,50584,0,0,146,146,0,1,0,1,0,deny
80,53945,0,0,60,60,0,1,0,1,0,deny
12107,22114,0,0,62,62,0,1,0,1,0,deny
52318,17,0,0,60,60,0,1,0,1,0,deny
56994,445,0,0,66,66,0,1,0,1,0,drop
56683,445,0,0,70,70,0,1,0,1,0,drop
56682,445,0,0,70,70,0,1,0,1,0,drop
61585,445,0,0,70,70,0,1,0,1,0,drop
56676,445,0,0,70,70,0,1,0,1,0,drop
14165,51050,0,0,146,146,0,1,0,1,0,deny
56672,445,0,0,70,70,0,1,0,1,0,drop
56673,445,0,0,70,70,0,1,0,1,0,drop
1026,30188,0,0,62,62,0,1,0,1,0,deny
62849,62413,0,0,66,66,0,1,0,1,0,deny
8239,37965,0,0,146,146,0,1,0,1,0,deny
56991,445,0,0,66,66,0,1,0,1,0,drop
65388,55783,0,0,66,66,0,1,0,1,0,deny
28424,35440,0,0,66,66,0,1,0,1,0,deny
443,22323,0,0,61,61,0,1,0,1,0,deny
443,22323,0,0,83,83,0,1,0,1,0,deny
56983,445,0,0,66,66,0,1,0,1,0,drop
56980,445,0,0,66,66,0,1,0,1,0,drop
56661,445,0,0,70,70,0,1,0,1,0,drop
59772,62413,0,0,62,62,0,1,0,1,0,deny
48125,7548,0,0,60,60,0,1,0,1,0,deny
50470,61463,0,0,86,86,0,1,0,1,0,deny
54118,6004,0,0,66,66,0,1,0,1,0,deny
64693,26467,0,0,62,62,0,1,0,1,0,deny
58743,35894,0,0,66,66,0,1,0,1,0,deny
35261,15503,0,0,74,74,0,1,0,1,0,deny
55600,22,0,0,60,60,0,1,0,1,0,deny
61574,445,0,0,70,70,0,1,0,1,0,drop
61571,445,0,0,70,70,0,1,0,1,0,drop
56656,445,0,0,70,70,0,1,0,1,0,drop
56969,445,0,0,66,66,0,1,0,1,0,drop
56961,445,0,0,66,66,0,1,0,1,0,drop
56965,445,0,0,66,66,0,1,0,1,0,drop
56967,445,0,0,66,66,0,1,0,1,0,drop
56968,445,0,0,66,66,0,1,0,1,0,drop
56963,445,0,0,66,66,0,1,0,1,0,drop
56962,445,0,0,66,66,0,1,0,1,0,drop
56964,445,0,0,66,66,0,1,0,1,0,drop
61336,61689,0,0,66,66,0,1,0,1,0,deny
13911,57470,0,0,60,60,0,1,0,1,0,deny
56648,445,0,0,70,70,0,1,0,1,0,drop
56645,445,0,0,70,70,0,1,0,1,0,drop
56646,445,0,0,70,70,0,1,0,1,0,drop
56643,445,0,0,70,70,0,1,0,1,0,drop
56640,445,0,0,70,70,0,1,0,1,0,drop
6224,37965,0,0,62,62,0,1,0,1,0,deny
58664,64147,0,0,66,66,0,1,0,1,0,deny
59724,64147,0,0,62,62,0,1,0,1,0,deny
61569,445,0,0,70,70,0,1,0,1,0,drop
61560,445,0,0,70,70,0,1,0,1,0,drop
61555,445,0,0,70,70,0,1,0,1,0,drop
16687,10214,0,0,66,66,0,1,0,1,0,deny
37420,44847,0,0,66,66,0,1,0,1,0,deny
56948,445,0,0,66,66,0,1,0,1,0,drop
56946,445,0,0,66,66,0,1,0,1,0,drop
56947,445,0,0,66,66,0,1,0,1,0,drop
7947,50584,0,0,62,62,0,1,0,1,0,deny
65495,11392,0,0,62,62,0,1,0,1,0,deny
41429,50584,0,0,66,66,0,1,0,1,0,deny
45908,33330,0,0,60,60,0,1,0,1,0,deny
56635,445,0,0,70,70,0,1,0,1,0,drop
61554,445,0,0,70,70,0,1,0,1,0,drop
17561,52700,0,0,62,62,0,1,0,1,0,deny
33528,23,0,0,60,60,0,1,0,1,0,deny
61057,31573,0,0,146,146,0,1,0,1,0,deny
6014,37965,0,0,66,66,0,1,0,1,0,deny
56026,51505,0,0,146,146,0,1,0,1,0,deny
52870,22197,0,0,62,62,0,1,0,1,0,deny
61551,445,0,0,70,70,0,1,0,1,0,drop
64681,35993,0,0,66,66,0,1,0,1,0,deny
61550,445,0,0,70,70,0,1,0,1,0,drop
61548,445,0,0,70,70,0,1,0,1,0,drop
61543,445,0,0,70,70,0,1,0,1,0,drop
50470,61463,0,0,86,86,0,1,0,1,0,deny
47682,64147,0,0,66,66,0,1,0,1,0,deny
47105,64147,0,0,62,62,0,1,0,1,0,deny
52724,64147,0,0,62,62,0,1,0,1,0,deny
56627,445,0,0,70,70,0,1,0,1,0,drop
50644,35440,0,0,66,66,0,1,0,1,0,deny
56624,445,0,0,70,70,0,1,0,1,0,drop
19698,502,0,0,60,60,0,1,0,1,0,deny
28824,44847,0,0,66,66,0,1,0,1,0,deny
54530,35440,0,0,66,66,0,1,0,1,0,deny
56619,445,0,0,70,70,0,1,0,1,0,drop
56618,445,0,0,70,70,0,1,0,1,0,drop
1373,22114,0,0,66,66,0,1,0,1,0,deny
28135,34021,0,0,62,62,0,1,0,1,0,reset-both
57472,44847,0,0,62,62,0,1,0,1,0,deny
0,0,0,0,156,156,0,2,0,2,0,allow
0,0,0,0,707,707,0,2,0,2,0,allow
0,0,0,0,1188,1188,0,2,0,2,0,allow
0,0,0,0,244,244,0,2,0,2,0,allow
57665,52700,0,0,66,66,0,1,0,1,0,deny
61533,445,0,0,70,70,0,1,0,1,0,drop
61532,445,0,0,70,70,0,1,0,1,0,drop
61530,445,0,0,70,70,0,1,0,1,0,drop
58131,3855,0,0,146,146,0,1,0,1,0,deny
28124,37965,0,0,62,62,0,1,0,1,0,deny
56614,445,0,0,70,70,0,1,0,1,0,drop
65317,51221,0,0,78,78,0,1,0,1,0,deny
56613,445,0,0,70,70,0,1,0,1,0,drop
43657,50011,0,0,62,62,0,1,0,1,0,deny
20170,23,0,0,60,60,0,1,0,1,0,deny
48841,51221,0,0,62,62,0,1,0,1,0,deny
40521,23117,0,0,66,66,0,1,0,1,0,deny
10436,37965,0,0,62,62,0,1,0,1,0,deny
56925,445,0,0,66,66,0,1,0,1,0,drop
443,20995,0,0,83,83,0,1,0,1,0,deny
20508,57470,0,0,62,62,0,1,0,1,0,deny
61524,445,0,0,70,70,0,1,0,1,0,drop
61522,445,0,0,70,70,0,1,0,1,0,drop
26183,22114,0,0,62,62,0,1,0,1,0,deny
57234,21247,0,0,66,66,0,1,0,1,0,deny
56608,445,0,0,70,70,0,1,0,1,0,drop
59008,51221,0,0,66,66,0,1,0,1,0,deny
49367,51505,0,0,66,66,0,1,0,1,0,deny
6881,33454,0,0,100,100,0,1,0,1,0,deny
17719,49153,0,0,145,145,0,1,0,1,0,deny
54047,50011,0,0,62,62,0,1,0,1,0,deny
56919,445,0,0,66,66,0,1,0,1,0,drop
49160,57470,0,0,146,146,0,1,0,1,0,deny
56916,445,0,0,66,66,0,1,0,1,0,drop
61514,445,0,0,70,70,0,1,0,1,0,drop
47396,23,0,0,60,60,0,1,0,1,0,deny
55644,45579,38445,45579,70,70,0,2,8,2,0,allow
48440,53,22120,53,198,93,105,2,30,1,1,allow
52993,443,64908,443,16229,3316,12913,23,125,9,14,allow
61591,80,1732,80,124,64,60,2,16,1,1,allow
5588,5588,0,0,3562,1936,1626,48,194,24,24,allow
27005,27216,33781,27216,872,126,746,2,30,1,1,allow
19473,12345,64156,12345,478,149,329,2,1200,1,1,allow
54993,443,50582,443,38985,4250,34735,58,19,27,31,allow
27005,27246,16977,27246,865,126,739,2,30,1,1,allow
56330,53,24669,53,711,87,624,2,30,1,1,allow
49858,443,3076,443,16232,3319,12913,23,124,9,14,allow
54994,443,29516,443,13580,3864,9716,40,18,23,17,allow
51411,443,6428,443,5550,1177,4373,24,80,13,11,allow
57470,6346,6625,6346,330,330,0,6,1200,6,0,allow
47595,33438,0,0,106,106,0,1,60,1,0,allow
58496,53,58496,53,204,92,112,2,30,1,1,allow
45341,443,7736,443,2754,1394,1360,22,36,11,11,allow
46860,15000,54542,15000,130,70,60,2,6,1,1,allow
54991,443,1653,443,20604,3530,17074,40,19,21,19,allow
53662,443,56042,443,7471,2800,4671,21,76,13,8,allow
50518,80,23907,80,2864,1338,1526,17,21,9,8,allow
36631,443,36631,443,4568,1661,2907,19,29,11,8,allow
44682,443,42842,443,2750,1891,859,17,25,10,7,allow
51878,9999,48543,9999,70,70,0,2,8,2,0,allow
56522,443,44815,443,43823,7381,36442,84,38,42,42,allow
48483,443,20913,443,60944,9555,51389,71,362,25,46,allow
64224,443,1301,443,24320,6711,17609,45,122,20,25,allow
58911,443,49541,443,23915,4341,19574,37,120,15,22,allow
54988,443,63071,443,69664,6958,62706,98,23,46,52,allow
58705,5228,47511,5228,4706,2850,1856,44,6872,25,19,allow
54995,443,42324,443,13281,4753,8528,32,17,18,14,allow
59772,80,1176,80,5558,3386,2172,29,36,15,14,allow
59276,443,40586,443,16232,3319,12913,23,125,9,14,allow
50994,443,10248,443,3137,1855,1282,19,16,9,10,allow
56125,80,28714,80,891,536,355,10,255,6,4,allow
52261,53,8647,53,578,286,292,9,15,5,4,allow
27005,27255,55228,27255,879,126,753,2,30,1,1,allow
35644,53,9492,53,198,93,105,2,30,1,1,allow
58642,443,2998,443,7127,3015,4112,24,144,12,12,allow
44822,11848,0,0,148,148,0,1,0,1,0,reset-both
61508,445,0,0,70,70,0,1,0,1,0,drop
61509,445,0,0,70,70,0,1,0,1,0,drop
61507,445,0,0,70,70,0,1,0,1,0,drop
23126,35440,0,0,66,66,0,1,0,1,0,deny
1821,64147,0,0,66,66,0,1,0,1,0,deny
56914,445,0,0,66,66,0,1,0,1,0,drop
56595,445,0,0,70,70,0,1,0,1,0,drop
53147,37965,0,0,62,62,0,1,0,1,0,deny
12060,37965,0,0,66,66,0,1,0,1,0,deny
59511,21247,0,0,66,66,0,1,0,1,0,deny
54423,21247,0,0,66,66,0,1,0,1,0,deny
40100,17,0,0,60,60,0,1,0,1,0,deny
61499,445,0,0,70,70,0,1,0,1,0,drop
56592,445,0,0,70,70,0,1,0,1,0,drop
6881,45711,0,0,100,100,0,1,0,1,0,deny
6881,57470,0,0,100,100,0,1,0,1,0,deny
53815,44847,0,0,66,66,0,1,0,1,0,deny
49254,53,34045,53,214,102,112,2,30,1,1,allow
39077,443,60900,443,24631,1902,22729,37,215,17,20,allow
55646,14420,49852,14420,70,70,0,2,8,2,0,allow
51861,23919,4159,23919,70,70,0,1,5,1,0,allow
65297,53,52505,53,241,118,123,2,30,1,1,allow
61496,445,0,0,70,70,0,1,0,1,0,drop
61494,445,0,0,70,70,0,1,0,1,0,drop
61492,445,0,0,70,70,0,1,0,1,0,drop
56905,445,0,0,66,66,0,1,0,1,0,drop
56900,445,0,0,66,66,0,1,0,1,0,drop
56901,445,0,0,66,66,0,1,0,1,0,drop
56899,445,0,0,66,66,0,1,0,1,0,drop
56897,445,0,0,66,66,0,1,0,1,0,drop
56896,445,0,0,66,66,0,1,0,1,0,drop
56895,445,0,0,66,66,0,1,0,1,0,drop
63080,37965,0,0,66,66,0,1,0,1,0,deny
33896,57470,0,0,74,74,0,1,0,1,0,deny
53513,56205,0,0,62,62,0,1,0,1,0,deny
56587,445,0,0,70,70,0,1,0,1,0,drop
8999,48817,0,0,146,146,0,1,0,1,0,deny
57093,26467,0,0,62,62,0,1,0,1,0,deny
24260,50584,0,0,62,62,0,1,0,1,0,deny
52754,26467,0,0,62,62,0,1,0,1,0,deny
56586,445,0,0,70,70,0,1,0,1,0,drop
8486,56205,0,0,66,66,0,1,0,1,0,deny
56584,445,0,0,70,70,0,1,0,1,0,drop
33563,14037,0,0,78,78,0,1,0,1,0,deny
61491,445,0,0,70,70,0,1,0,1,0,drop
61488,445,0,0,70,70,0,1,0,1,0,drop
63861,37832,6242,37832,66,66,0,2,7,2,0,allow
53677,10657,55902,10657,70,70,0,1,4,1,0,allow
51862,27758,53526,27758,70,70,0,1,5,1,0,allow
64208,53,37921,53,194,94,100,2,29,1,1,allow
56983,53,62235,53,221,94,127,2,29,1,1,allow
52327,53,21249,53,224,94,130,2,29,1,1,allow
49790,53,34832,53,195,102,93,2,30,1,1,allow
57470,19641,64041,19641,132,132,0,3,1199,3,0,allow
58183,443,49158,443,841459,41656,799803,1083,141,389,694,allow
34344,443,5583,443,9167,2205,6962,37,120,19,18,allow
53674,31724,6450,31724,70,70,0,1,4,1,0,allow
60272,443,56856,443,13199834,344312,12855522,13125,121,3739,9386,allow
32296,443,32296,443,5421,2444,2977,20,15,11,9,allow
49917,53,46665,53,168,78,90,2,29,1,1,allow
27005,27237,41184,27237,891,126,765,2,30,1,1,allow
40808,53,41572,53,168,78,90,2,29,1,1,allow
27005,27257,60876,27257,883,126,757,2,30,1,1,allow
57048,53,62627,53,512,95,417,4,34,2,2,allow
39488,53,45099,53,199,94,105,2,29,1,1,allow
64330,53,63113,53,200,94,106,2,29,1,1,allow
27005,27017,51500,27017,901,126,775,2,30,1,1,allow
64394,443,20424,443,3182,1568,1614,8,120,4,4,allow
27005,27269,13554,27269,886,126,760,2,30,1,1,allow
37087,443,26551,443,9710,2136,7574,26,363,11,15,allow
49542,443,22517,443,9824,1839,7985,27,172,13,14,allow
64347,53,35603,53,321,109,212,4,47,2,2,allow
35742,53,48792,53,199,94,105,2,30,1,1,allow
46965,53,4424,53,199,94,105,2,30,1,1,allow
56164,53,3250,53,226,110,116,2,30,1,1,allow
39716,53,15462,53,86,86,0,1,30,1,0,allow
33262,443,40811,443,4067,2672,1395,23,23,14,9,allow
56841,29753,27881,29753,70,70,0,2,8,2,0,allow
45551,443,60203,443,6964,2091,4873,20,15,10,10,allow
55410,80,63972,80,1250,472,778,13,46,3,10,allow
51863,22038,12301,22038,70,70,0,1,5,1,0,allow
41472,53,41472,53,218,90,128,2,30,1,1,allow
34366,443,52089,443,520306,17622,502684,582,210,210,372,allow
35263,443,2697,443,22457,12680,9777,65,20,34,31,allow
44047,443,38951,443,6750,4410,2340,19,120,9,10,allow
56004,53,16480,53,177,94,83,2,30,1,1,allow
41316,443,15056,443,4997074,153969,4843105,5249,343,1861,3388,allow
37965,58909,50714,58909,1577,594,983,20,1724,10,10,allow
56004,53,53891,53,177,94,83,2,30,1,1,allow
58797,443,26512,443,3311,1069,2242,13,135,6,7,allow
55930,443,56260,443,6271,1354,4917,25,113,14,11,allow
53660,443,7808,443,9028,3897,5131,24,83,15,9,allow
54992,443,45267,443,31183,3879,27304,52,19,26,26,allow
40988,80,28753,80,19112,2192,16920,46,90,23,23,allow
65236,53,36812,53,215,102,113,2,30,1,1,allow
57073,53,17930,53,197,102,95,2,35,1,1,allow
59609,443,2759,443,7762,1777,5985,22,80,13,9,allow
64709,53,12288,53,229,110,119,2,30,1,1,allow
55127,80,31027,80,4239,2334,1905,17,187,10,7,allow
60921,443,34285,443,9869,2448,7421,61,1253,24,37,allow
58848,443,23115,443,1362,627,735,14,81,7,7,allow
51883,16325,58501,16325,316,136,180,6,6,3,3,allow
41693,443,28921,443,27069,3064,24005,44,178,19,25,allow
26865,443,22998,443,21239,16302,4937,35,20,20,15,allow
60426,80,65008,80,4515,3889,626,11,27,6,5,allow
53719,443,48486,443,70,70,0,2,8,2,0,allow
56844,44445,50438,44445,70,70,0,1,5,1,0,allow
64683,53,5338,53,376,95,281,4,36,2,2,allow
41868,443,44888,443,6204,1328,4876,21,139,12,9,allow
53676,3678,50673,3678,70,70,0,1,4,1,0,allow
33259,443,58382,443,4193,2689,1504,23,23,14,9,allow
57555,443,43596,443,25519,7061,18458,37,16,20,17,allow
53444,443,53444,443,960,539,421,9,30,5,4,allow
53445,443,53445,443,960,539,421,9,30,5,4,allow
49668,53,59883,53,200,94,106,2,29,1,1,allow
42089,53,62601,53,199,94,105,2,29,1,1,allow
53127,30467,24380,30467,314,128,186,6,18,3,3,allow
56665,443,40335,443,8058,2038,6020,20,15,11,9,allow
24891,53,42889,53,168,78,90,2,30,1,1,allow
57600,53,41878,53,168,78,90,2,30,1,1,allow
54262,53,54262,53,198,90,108,2,30,1,1,allow
27005,27015,15539,27015,881,126,755,2,30,1,1,allow
44949,53,44949,53,198,90,108,2,30,1,1,allow
34167,80,27156,80,3643,1738,1905,17,187,10,7,allow
57360,53,29113,53,231,110,121,2,30,1,1,allow
50279,443,56387,443,1786,172,1614,7,119,3,4,allow
56666,443,25263,443,8006,1986,6020,20,15,11,9,allow
33258,443,43741,443,6958,4394,2564,30,28,17,13,allow
40203,80,61605,80,28577,1878,26699,47,31,23,24,allow
57139,53,26096,53,181,86,95,2,30,1,1,allow
64864,53,28778,53,275,126,149,2,30,1,1,allow
65425,53,4149,53,402,142,260,2,30,1,1,allow
42184,53,42184,53,334,226,108,3,30,2,1,allow
40836,443,10613,443,9524,3934,5590,20,135,10,10,allow
38083,443,10081,443,2465,1356,1109,18,180,8,10,allow
50126,443,42712,443,8464,2699,5765,48,147,26,22,allow
53447,443,53447,443,960,539,421,9,30,5,4,allow
17176,443,17176,443,6311,1229,5082,18,16,8,10,allow
35207,53,52779,53,168,78,90,2,30,1,1,allow
65374,53,60025,53,261,102,159,2,30,1,1,allow
59101,53,46129,53,195,94,101,2,30,1,1,allow
50694,80,52061,80,3481,1576,1905,17,187,10,7,allow
33260,443,40517,443,4051,2618,1433,21,23,13,8,allow
54452,443,13624,443,4227,1086,3141,15,28,8,7,allow
56843,64277,53228,64277,70,70,0,1,5,1,0,allow
59828,443,59390,443,7083,2786,4297,24,81,14,10,allow
53446,443,53446,443,960,539,421,9,30,5,4,allow
56358,80,8330,80,1569,1077,492,11,30,6,5,allow
37835,443,55999,443,63724,45783,17941,171,123,85,86,allow
56952,53,53652,53,487,136,351,4,46,2,2,allow
65182,53,61284,53,634,199,435,6,79,3,3,allow
61838,53,61838,53,216,90,126,2,30,1,1,allow
65270,53,38040,53,226,110,116,2,30,1,1,allow
52361,443,27364,443,7488,2474,5014,23,3600,12,11,allow
60767,40010,24332,40010,316,136,180,6,6,3,3,allow
48743,443,24308,443,26609,2444,24165,45,21,21,24,allow
36841,443,36841,443,4401,1494,2907,19,27,11,8,allow
56486,443,16895,443,2673671,30446,2643225,2145,125,234,1911,allow
49547,443,61463,443,7817,1780,6037,26,172,13,13,allow
48744,443,35880,443,2098,1239,859,22,20,12,10,allow
26499,80,26499,80,168957,11365,157592,202,31,90,112,allow
26501,80,26501,80,93644,8868,84776,131,31,64,67,allow
26504,80,26504,80,13592,1419,12173,25,31,13,12,allow
49276,80,4660,80,254,128,126,5,16,3,2,allow
46555,53,62486,53,168,78,90,2,30,1,1,allow
27005,27015,37450,27015,879,126,753,2,31,1,1,allow
61484,445,0,0,70,70,0,1,0,1,0,drop
56893,445,0,0,66,66,0,1,0,1,0,drop
61483,445,0,0,70,70,0,1,0,1,0,drop
56888,445,0,0,66,66,0,1,0,1,0,drop
54778,22114,0,0,66,66,0,1,0,1,0,deny
45941,23388,0,0,60,60,0,1,0,1,0,deny
56885,445,0,0,66,66,0,1,0,1,0,drop
56887,445,0,0,66,66,0,1,0,1,0,drop
6881,6881,0,0,62,62,0,1,0,1,0,deny
56883,445,0,0,66,66,0,1,0,1,0,drop
48676,53393,0,0,60,60,0,1,0,1,0,deny
8889,47679,0,0,60,60,0,1,0,1,0,deny
56577,445,0,0,70,70,0,1,0,1,0,drop
11880,36829,0,0,146,146,0,1,0,1,0,deny
57131,8055,0,0,145,145,0,1,0,1,0,deny
443,15564,0,0,85,85,0,1,0,1,0,deny
52569,30188,0,0,66,66,0,1,0,1,0,deny
56575,445,0,0,70,70,0,1,0,1,0,drop
11030,37965,0,0,62,62,0,1,0,1,0,deny
61478,445,0,0,70,70,0,1,0,1,0,drop
20198,17372,0,0,62,62,0,1,0,1,0,deny
50222,42873,0,0,66,66,0,1,0,1,0,deny
61467,445,0,0,70,70,0,1,0,1,0,drop
61465,445,0,0,70,70,0,1,0,1,0,drop
18754,30188,0,0,66,66,0,1,0,1,0,deny
56574,445,0,0,70,70,0,1,0,1,0,drop
16430,31573,0,0,62,62,0,1,0,1,0,deny
56573,445,0,0,70,70,0,1,0,1,0,drop
56572,445,0,0,70,70,0,1,0,1,0,drop
56568,445,0,0,70,70,0,1,0,1,0,drop
56569,445,0,0,70,70,0,1,0,1,0,drop
57987,56125,0,0,90,90,0,1,0,1,0,deny
22981,15503,0,0,62,62,0,1,0,1,0,deny
56872,445,0,0,66,66,0,1,0,1,0,drop
23197,44847,0,0,62,62,0,1,0,1,0,deny
443,9986,0,0,669,669,0,1,0,1,0,deny
63213,15503,0,0,62,62,0,1,0,1,0,deny
56554,445,0,0,70,70,0,1,0,1,0,drop
56552,445,0,0,70,70,0,1,0,1,0,drop
56547,445,0,0,70,70,0,1,0,1,0,drop
58550,21247,0,0,62,62,0,1,0,1,0,deny
56543,445,0,0,70,70,0,1,0,1,0,drop
56544,445,0,0,70,70,0,1,0,1,0,drop
56148,37965,0,0,66,66,0,1,0,1,0,deny
56865,445,0,0,66,66,0,1,0,1,0,drop
38852,37965,0,0,62,62,0,1,0,1,0,deny
61455,445,0,0,70,70,0,1,0,1,0,drop
58888,23718,0,0,66,66,0,1,0,1,0,deny
51222,35440,0,0,66,66,0,1,0,1,0,deny
56862,445,0,0,66,66,0,1,0,1,0,drop
53459,37807,0,0,146,146,0,1,0,1,0,deny
3980,63710,0,0,62,62,0,1,0,1,0,deny
61563,37807,0,0,66,66,0,1,0,1,0,deny
13911,57470,0,0,60,60,0,1,0,1,0,deny
56532,445,0,0,70,70,0,1,0,1,0,drop
56855,445,0,0,66,66,0,1,0,1,0,drop
47210,50584,0,0,146,146,0,1,0,1,0,deny
56846,445,0,0,66,66,0,1,0,1,0,drop
65096,37807,0,0,66,66,0,1,0,1,0,deny
56380,36829,0,0,66,66,0,1,0,1,0,deny
25067,50265,0,0,145,145,0,1,0,1,0,deny
17010,57470,0,0,62,62,0,1,0,1,0,deny
19004,51505,0,0,66,66,0,1,0,1,0,deny
45941,23386,0,0,60,60,0,1,0,1,0,deny
56528,445,0,0,70,70,0,1,0,1,0,drop
61447,445,0,0,70,70,0,1,0,1,0,drop
61444,445,0,0,70,70,0,1,0,1,0,drop
61443,445,0,0,70,70,0,1,0,1,0,drop
56840,445,0,0,66,66,0,1,0,1,0,drop
56838,445,0,0,66,66,0,1,0,1,0,drop
56839,445,0,0,66,66,0,1,0,1,0,drop
56835,445,0,0,66,66,0,1,0,1,0,drop
56834,445,0,0,66,66,0,1,0,1,0,drop
56836,445,0,0,66,66,0,1,0,1,0,drop
56837,445,0,0,66,66,0,1,0,1,0,drop
56832,445,0,0,66,66,0,1,0,1,0,drop
56519,445,0,0,70,70,0,1,0,1,0,drop
56516,445,0,0,70,70,0,1,0,1,0,drop
56517,445,0,0,70,70,0,1,0,1,0,drop
56514,445,0,0,70,70,0,1,0,1,0,drop
35120,26467,0,0,62,62,0,1,0,1,0,deny
42465,57470,0,0,60,60,0,1,0,1,0,deny
56511,445,0,0,70,70,0,1,0,1,0,drop
21459,23,0,0,60,60,0,1,0,1,0,deny
41586,1900,0,0,139,139,0,1,0,1,0,deny
3730,37965,0,0,62,62,0,1,0,1,0,deny
46108,48817,0,0,145,145,0,1,0,1,0,deny
50066,30188,0,0,66,66,0,1,0,1,0,deny
62150,23718,0,0,66,66,0,1,0,1,0,deny
54167,50584,0,0,66,66,0,1,0,1,0,deny
443,20995,0,0,83,83,0,1,0,1,0,deny
1972,57470,0,0,78,78,0,1,0,1,0,deny
51676,23718,0,0,62,62,0,1,0,1,0,deny
61435,445,0,0,70,70,0,1,0,1,0,drop
61428,445,0,0,70,70,0,1,0,1,0,drop
56505,445,0,0,70,70,0,1,0,1,0,drop
56817,445,0,0,66,66,0,1,0,1,0,drop
56820,445,0,0,66,66,0,1,0,1,0,drop
56819,445,0,0,66,66,0,1,0,1,0,drop
53003,11392,0,0,66,66,0,1,0,1,0,deny
5617,64147,0,0,62,62,0,1,0,1,0,deny
61425,445,0,0,70,70,0,1,0,1,0,drop
0,0,0,0,320,320,0,5,0,5,0,allow
63927,50265,0,0,62,62,0,1,0,1,0,deny
45832,51050,0,0,62,62,0,1,0,1,0,deny
61423,445,0,0,70,70,0,1,0,1,0,drop
56498,445,0,0,70,70,0,1,0,1,0,drop
50881,50584,0,0,66,66,0,1,0,1,0,deny
2828,35253,0,0,66,66,0,1,0,1,0,deny
56496,445,0,0,70,70,0,1,0,1,0,drop
61420,445,0,0,70,70,0,1,0,1,0,drop
61417,445,0,0,70,70,0,1,0,1,0,drop
61414,445,0,0,70,70,0,1,0,1,0,drop
1038,37965,0,0,62,62,0,1,0,1,0,deny
60052,37965,0,0,66,66,0,1,0,1,0,deny
64362,35253,0,0,146,146,0,1,0,1,0,deny
65317,51221,0,0,78,78,0,1,0,1,0,deny
56491,445,0,0,70,70,0,1,0,1,0,drop
26729,57470,0,0,66,66,0,1,0,1,0,deny
56490,445,0,0,70,70,0,1,0,1,0,drop
61406,445,0,0,70,70,0,1,0,1,0,drop
61404,445,0,0,70,70,0,1,0,1,0,drop
61403,445,0,0,70,70,0,1,0,1,0,drop
56486,445,0,0,70,70,0,1,0,1,0,drop
50470,61463,0,0,86,86,0,1,0,1,0,deny
12128,37965,0,0,62,62,0,1,0,1,0,deny
45941,23388,0,0,60,60,0,1,0,1,0,deny
56485,445,0,0,70,70,0,1,0,1,0,drop
19875,30170,0,0,145,145,0,1,0,1,0,deny
80,9918,0,0,60,60,0,1,0,1,0,deny
61945,48817,0,0,66,66,0,1,0,1,0,deny
56646,48817,0,0,62,62,0,1,0,1,0,deny
40294,28680,0,0,145,145,0,1,0,1,0,deny
58574,21247,0,0,66,66,0,1,0,1,0,deny
55642,26872,27323,26872,70,70,0,1,5,1,0,allow
5588,5588,0,0,3562,1936,1626,48,196,24,24,allow
43923,5222,15090,5222,3007,1354,1653,28,83,15,13,allow
53129,38413,41585,38413,70,70,0,1,5,1,0,allow
57335,443,6083,443,4048,3089,959,24,15,13,11,allow
34837,80,34635,80,7794,1470,6324,18,151,9,9,allow
55377,3389,55377,3389,3343,1454,1889,15,16,8,7,allow
51858,44647,20973,44647,66,66,0,1,5,1,0,allow
49258,80,49258,80,17197,1551,15646,29,27,13,16,allow
26503,80,26503,80,225609,13986,211623,285,31,134,151,allow
27005,30002,50231,30002,1780,252,1528,5,44,3,2,allow
50987,443,24921,443,3278,1962,1316,20,20,9,11,allow
53668,50678,10621,50678,70,70,0,1,5,1,0,allow
26496,80,26496,80,160989,10162,150827,189,31,81,108,allow
27992,443,34351,443,7775,3104,4671,18,76,10,8,allow
50116,443,45796,443,48255,4798,43457,100,149,47,53,allow
37309,53,0,0,82,82,0,1,30,1,0,allow
53669,59056,20109,59056,70,70,0,1,5,1,0,allow
55706,22,55706,22,252,60,192,5,14,2,3,allow
51102,443,51987,443,13990,9102,4888,28,15,16,12,allow
50124,443,10944,443,48860,5749,43111,91,147,47,44,allow
51877,13472,10032,13472,70,70,0,2,8,2,0,allow
56908,443,5972,443,187104,26358,160746,205,190,58,147,allow
34814,80,10830,80,9105,1930,7175,18,16,9,9,allow
49790,53,24988,53,190,97,93,2,30,1,1,allow
43536,443,9827,443,13710,4975,8735,22,121,9,13,allow
54660,443,15942,443,7077,3245,3832,24,173,12,12,allow
38795,40032,51125,40032,243,180,63,2,31,1,1,allow
57744,53,14767,53,198,93,105,2,31,1,1,allow
53350,443,63189,443,2950,679,2271,13,120,6,7,allow
57470,50321,43161,50321,9414,7249,2165,91,3838,76,15,allow
61688,443,16509,443,14462,3625,10837,31,63,16,15,allow
54586,161,0,0,14172,5597,8575,50,31,25,25,allow
47355,161,0,0,7809,3013,4796,28,31,14,14,allow
42162,53,42162,53,227,88,139,2,31,1,1,allow
59371,161,59371,161,2085,880,1205,10,31,5,5,allow
50719,443,22608,443,17803069,497380,17305689,17583,219,5899,11684,allow
57807,443,2939,443,9783,5855,3928,22,122,11,11,allow
49160,6889,21794,6889,311,311,0,3,1200,3,0,allow
21133,54322,33050,54322,480,149,331,2,1200,1,1,allow
47058,443,44896,443,328838,76878,251960,449,243,185,264,allow
11988,48817,0,0,66,66,0,1,0,1,0,deny
63271,52752,0,0,78,78,0,1,0,1,0,deny
56480,445,0,0,70,70,0,1,0,1,0,drop
56798,445,0,0,66,66,0,1,0,1,0,drop
61398,445,0,0,70,70,0,1,0,1,0,drop
61395,445,0,0,70,70,0,1,0,1,0,drop
23277,53733,0,0,66,66,0,1,0,1,0,deny
57987,56125,0,0,90,90,0,1,0,1,0,deny
65265,55067,0,0,66,66,0,1,0,1,0,deny
3818,37965,0,0,66,66,0,1,0,1,0,deny
56790,445,0,0,66,66,0,1,0,1,0,drop
443,20995,0,0,83,83,0,1,0,1,0,deny
60426,25988,33152,25988,70,70,0,1,5,1,0,allow
51859,35365,59521,35365,70,70,0,1,5,1,0,allow
58442,123,61048,123,184,94,90,2,30,1,1,allow
34367,443,31324,443,25205,2243,22962,41,149,17,24,allow
53671,60416,30870,60416,70,70,0,1,4,1,0,allow
27005,27016,31585,27016,876,126,750,2,30,1,1,allow
61009,27065,32929,27065,1582,1386,196,6,30,4,2,allow
49255,7000,49255,7000,2163,676,1487,14,14,7,7,allow
41410,80,40896,80,1484,877,607,11,34,6,5,allow
56909,443,38825,443,31860,21778,10082,84,190,42,42,allow
41409,80,32220,80,1484,877,607,11,34,6,5,allow
39483,443,14932,443,3884,1859,2025,20,255,10,10,allow
26500,80,26500,80,57276,6978,50298,77,30,34,43,allow
41484,443,11902,443,10024,6237,3787,22,27,11,11,allow
53670,32016,15201,32016,70,70,0,1,4,1,0,allow
64323,53,33071,53,376,126,250,2,30,1,1,allow
27005,27015,15962,27015,906,126,780,2,30,1,1,allow
27005,28115,50771,28115,910,126,784,2,30,1,1,allow
27005,28315,51531,28315,875,126,749,2,30,1,1,allow
27005,28015,54917,28015,888,126,762,2,30,1,1,allow
40695,53,6681,53,168,78,90,2,29,1,1,allow
27005,27015,43397,27015,884,126,758,2,30,1,1,allow
52125,53,31811,53,205,86,119,2,29,1,1,allow
9042,443,33866,443,15177,5713,9464,37,120,17,20,allow
56661,443,32722,443,8059,2039,6020,20,15,11,9,allow
27005,27019,20474,27019,2024,504,1520,7,33,5,2,allow
56632,80,25180,80,234,234,0,4,12,4,0,allow
28238,443,59283,443,8456,3501,4955,20,90,11,9,allow
34373,28678,41304,28678,1806,1806,0,22,224,22,0,allow
49549,443,52947,443,7896,1770,6126,26,171,13,13,allow
37314,80,28984,80,1348,844,504,13,255,8,5,allow
47650,443,47650,443,4585,1678,2907,19,28,11,8,allow
38123,443,24032,443,15449,1976,13473,32,16,16,16,allow
55367,53,25329,53,215,102,113,2,30,1,1,allow
59597,443,2305,443,10310,2469,7841,35,255,18,17,allow
53132,29384,28228,29384,70,70,0,2,8,2,0,allow
65074,53,29931,53,284,118,166,2,30,1,1,allow
56663,443,10408,443,8057,2037,6020,20,15,11,9,allow
49180,443,17664,443,888019,22655,865364,902,18,322,580,allow
49790,53,51287,53,195,102,93,2,30,1,1,allow
41037,80,6510,80,613,539,74,7,15,6,1,allow
38082,443,40503,443,9037,1851,7186,26,180,14,12,allow
56925,443,10686,443,33095,18485,14610,73,185,43,30,allow
50324,443,12034,443,13002,1895,11107,31,202,17,14,allow
38121,443,50120,443,1515436,54168,1461268,1689,16,687,1002,allow
57402,2258,57402,2258,156,156,0,3,8,3,0,allow
51860,53854,59221,53854,70,70,0,1,5,1,0,allow
60410,80,39027,80,186,64,122,4,27,2,2,allow
65337,53,53258,53,460,112,348,4,56,2,2,allow
58849,443,31441,443,1366,631,735,14,81,7,7,allow
56664,443,21855,443,8005,1985,6020,20,15,11,9,allow
60374,443,14239,443,15475,7059,8416,33,97,18,15,allow
60380,443,36908,443,24243,17180,7063,52,97,33,19,allow
49538,443,16302,443,2926,1825,1101,22,171,11,11,allow
51876,35624,28526,35624,70,70,0,2,8,2,0,allow
56830,17793,18491,17793,564,318,246,9,15,5,4,allow
26502,80,26502,80,184480,11115,173365,239,30,116,123,allow
57054,80,1820,80,25138,16043,9095,79,2410,53,26,allow
57084,443,60490,443,9905,4321,5584,27,315,13,14,allow
49219,443,60965,443,70,70,0,2,4,2,0,allow
51857,40561,47310,40561,70,70,0,1,5,1,0,allow
37712,443,12957,443,7660,2239,5421,32,255,16,16,allow
53672,20380,47465,20380,70,70,0,1,4,1,0,allow
49790,53,41551,53,195,102,93,2,29,1,1,allow
55641,61762,29914,61762,70,70,0,1,5,1,0,allow
53280,443,38767,443,4228,1083,3145,15,31,8,7,allow
27005,27016,51239,27016,888,126,762,2,30,1,1,allow
27005,27015,1608,27015,888,126,762,2,30,1,1,allow
58648,443,61974,443,7509,1262,6247,22,16,12,10,allow
51412,53,4036,53,252,78,174,2,30,1,1,allow
57508,443,43486,443,6749,2649,4100,19,142,9,10,allow
27005,28215,29356,28215,879,126,753,2,30,1,1,allow
54417,53,12775,53,259,86,173,2,30,1,1,allow
37965,33622,23125,33622,132,132,0,3,1199,3,0,allow
60427,61137,28150,61137,70,70,0,1,5,1,0,allow
59314,443,58564,443,16862,7584,9278,97,8912,60,37,allow
42630,443,10044,443,6039,1327,4712,19,121,11,8,allow
47387,443,50220,443,3930,392,3538,9,15,4,5,allow
60428,80,55142,80,20301,1264,19037,28,26,11,17,allow
57370,6969,42648,6969,70,70,0,1,5,1,0,allow
56662,443,9856,443,8007,1987,6020,20,15,11,9,allow
57507,7000,57507,7000,3562,1995,1567,16,15,9,7,allow
54618,53,15831,53,263,86,177,2,30,1,1,allow
62952,443,20995,443,1304,612,692,18,120,9,9,allow
59912,443,31539,443,7763,1354,6409,25,82,13,12,allow
57432,66,6875,66,70,70,0,2,8,2,0,allow
53540,443,65354,443,20948,4141,16807,76,616,37,39,allow
49699,443,3417,443,9968,2106,7862,27,128,14,13,allow
42090,443,42090,443,3509,1693,1816,21,96,10,11,allow
52955,443,44904,443,3617,2035,1582,30,346,15,15,allow
64708,53,55981,53,294,134,160,2,30,1,1,allow
64968,27030,53742,27030,735,462,273,2,30,1,1,allow
46009,53,4263,53,199,94,105,2,30,1,1,allow
50915,53,63317,53,168,78,90,2,30,1,1,allow
49589,53,16073,53,214,102,112,2,31,1,1,allow
62928,443,42185,443,52219,4148,48071,75,125,33,42,allow
27005,27015,24637,27015,1630,126,1504,4,31,2,2,allow
27005,27021,42135,27021,1708,126,1582,4,31,2,2,allow
27005,30015,42725,30015,1700,126,1574,4,31,2,2,allow
60295,53,27114,53,224,94,130,2,30,1,1,allow
47969,53,59484,53,199,94,105,2,30,1,1,allow
52258,443,2636,443,3757,356,3401,12,120,5,7,allow
35205,53,35205,53,240,98,142,2,30,1,1,allow
64185,53,32210,53,403,110,293,2,31,1,1,allow
38544,161,0,0,8977,3570,5407,30,31,15,15,allow
59424,443,28784,443,2288,1131,1157,25,119,12,13,allow
35145,443,40787,443,3542,1045,2497,13,120,6,7,allow
51765,443,19120,443,3026,965,2061,14,135,7,7,allow
57626,443,3957,443,3858,1277,2581,12,120,6,6,allow
53688,17106,21939,17106,70,70,0,2,8,2,0,allow
54455,443,48160,443,282,148,134,5,27,3,2,allow
56673,443,23897,443,6693,1072,5621,18,26,10,8,allow
58209,53,48023,53,259,86,173,2,30,1,1,allow
45325,53,64530,53,168,78,90,2,30,1,1,allow
55647,61042,18333,61042,320,140,180,6,7,3,3,allow
53687,51471,3936,51471,70,70,0,2,8,2,0,allow
60281,80,39760,80,1151,711,440,10,16,5,5,allow
64910,53,52147,53,259,86,173,2,30,1,1,allow
27005,27016,48849,27016,1688,126,1562,4,31,2,2,allow
27005,27016,24190,27016,1696,126,1570,4,31,2,2,allow
41230,443,13536,443,78,78,0,1,5,1,0,allow
35756,80,35756,80,364170,17670,346500,412,31,170,242,allow
51240,443,5101,443,9668,4688,4980,42,16,25,17,allow
39387,443,57166,443,204,70,134,4,26,2,2,allow
51241,443,60698,443,8083,2502,5581,40,16,22,18,allow
40358,443,63081,443,626,352,274,10,16,6,4,allow
56788,445,0,0,66,66,0,1,0,1,0,drop
61384,445,0,0,70,70,0,1,0,1,0,drop
50090,50265,0,0,66,66,0,1,0,1,0,deny
62872,50584,0,0,62,62,0,1,0,1,0,deny
33896,57470,0,0,74,74,0,1,0,1,0,deny
33193,50584,0,0,62,62,0,1,0,1,0,deny
61381,445,0,0,70,70,0,1,0,1,0,drop
61379,445,0,0,70,70,0,1,0,1,0,drop
61375,445,0,0,70,70,0,1,0,1,0,drop
56467,445,0,0,70,70,0,1,0,1,0,drop
56784,445,0,0,66,66,0,1,0,1,0,drop
10000,10214,0,0,62,62,0,1,0,1,0,deny
55565,64147,0,0,66,66,0,1,0,1,0,deny
59509,64147,0,0,62,62,0,1,0,1,0,deny
61053,44847,0,0,66,66,0,1,0,1,0,deny
42389,42873,0,0,74,74,0,1,0,1,0,deny
56464,445,0,0,70,70,0,1,0,1,0,drop
2422,50584,0,0,62,62,0,1,0,1,0,deny
61370,445,0,0,70,70,0,1,0,1,0,drop
443,20087,0,0,83,83,0,1,0,1,0,deny
15854,50584,0,0,62,62,0,1,0,1,0,deny
61368,445,0,0,70,70,0,1,0,1,0,drop
61365,445,0,0,70,70,0,1,0,1,0,drop
61366,445,0,0,70,70,0,1,0,1,0,drop
56653,22114,0,0,66,66,0,1,0,1,0,deny
52430,35440,0,0,62,62,0,1,0,1,0,deny
56778,445,0,0,66,66,0,1,0,1,0,drop
26333,23,0,0,60,60,0,1,0,1,0,deny
56776,445,0,0,66,66,0,1,0,1,0,drop
56774,445,0,0,66,66,0,1,0,1,0,drop
56773,445,0,0,66,66,0,1,0,1,0,drop
56460,445,0,0,70,70,0,1,0,1,0,drop
33563,14037,0,0,78,78,0,1,0,1,0,deny
56769,445,0,0,66,66,0,1,0,1,0,drop
56768,445,0,0,66,66,0,1,0,1,0,drop
56767,445,0,0,66,66,0,1,0,1,0,drop
56458,445,0,0,70,70,0,1,0,1,0,drop
59668,51505,0,0,66,66,0,1,0,1,0,deny
39056,22114,0,0,62,62,0,1,0,1,0,deny
56456,445,0,0,70,70,0,1,0,1,0,drop
65285,44847,0,0,62,62,0,1,0,1,0,deny
443,20995,0,0,83,83,0,1,0,1,0,deny
61361,445,0,0,70,70,0,1,0,1,0,drop
61360,445,0,0,70,70,0,1,0,1,0,drop
61363,445,0,0,70,70,0,1,0,1,0,drop
56764,445,0,0,66,66,0,1,0,1,0,drop
45941,23386,0,0,60,60,0,1,0,1,0,deny
42252,33303,0,0,60,60,0,1,0,1,0,deny
61355,445,0,0,70,70,0,1,0,1,0,drop
56761,445,0,0,66,66,0,1,0,1,0,drop
45654,67,0,0,60,60,0,1,0,1,0,deny
56759,445,0,0,66,66,0,1,0,1,0,drop
56757,445,0,0,66,66,0,1,0,1,0,drop
56755,445,0,0,66,66,0,1,0,1,0,drop
31330,15503,0,0,145,145,0,1,0,1,0,deny
56449,445,0,0,70,70,0,1,0,1,0,drop
28897,35440,0,0,66,66,0,1,0,1,0,deny
60168,35440,0,0,66,66,0,1,0,1,0,deny
56447,445,0,0,70,70,0,1,0,1,0,drop
65064,30188,0,0,66,66,0,1,0,1,0,deny
61350,445,0,0,70,70,0,1,0,1,0,drop
56446,445,0,0,70,70,0,1,0,1,0,drop
51413,48637,0,0,72,72,0,1,0,1,0,deny
56445,445,0,0,70,70,0,1,0,1,0,drop
61341,445,0,0,70,70,0,1,0,1,0,drop
61338,445,0,0,70,70,0,1,0,1,0,drop
56444,445,0,0,70,70,0,1,0,1,0,drop
443,20995,0,0,83,83,0,1,0,1,0,deny
56442,445,0,0,70,70,0,1,0,1,0,drop
56438,445,0,0,70,70,0,1,0,1,0,drop
60646,11392,0,0,66,66,0,1,0,1,0,deny
7273,64147,0,0,66,66,0,1,0,1,0,deny
28754,50584,0,0,66,66,0,1,0,1,0,deny
20005,37965,0,0,62,62,0,1,0,1,0,deny
56456,1433,0,0,60,60,0,1,0,1,0,deny
56745,445,0,0,66,66,0,1,0,1,0,drop
62068,64147,0,0,66,66,0,1,0,1,0,deny
56426,445,0,0,70,70,0,1,0,1,0,drop
56425,445,0,0,70,70,0,1,0,1,0,drop
56423,445,0,0,70,70,0,1,0,1,0,drop
60126,35440,0,0,66,66,0,1,0,1,0,deny
56415,445,0,0,70,70,0,1,0,1,0,drop
56416,445,0,0,70,70,0,1,0,1,0,drop
6881,21416,0,0,146,146,0,1,0,1,0,deny
32727,23,0,0,60,60,0,1,0,1,0,deny
56737,445,0,0,66,66,0,1,0,1,0,drop
41220,59356,0,0,62,62,0,1,0,1,0,deny
61327,445,0,0,70,70,0,1,0,1,0,drop
52200,23,0,0,60,60,0,1,0,1,0,deny
56734,445,0,0,66,66,0,1,0,1,0,drop
45342,443,2921,443,2378,1382,996,20,21,11,9,allow
10775,35440,0,0,66,66,0,1,0,1,0,deny
28764,2323,0,0,60,60,0,1,0,1,0,deny
56404,445,0,0,70,70,0,1,0,1,0,drop
51910,37965,0,0,62,62,0,1,0,1,0,deny
53090,59356,0,0,66,66,0,1,0,1,0,deny
40185,64147,0,0,66,66,0,1,0,1,0,deny
33012,50265,0,0,145,145,0,1,0,1,0,deny
443,20995,0,0,83,83,0,1,0,1,0,deny
65526,28793,0,0,66,66,0,1,0,1,0,deny
14350,56205,0,0,146,146,0,1,0,1,0,deny
42465,57470,0,0,60,60,0,1,0,1,0,deny
56719,445,0,0,66,66,0,1,0,1,0,drop
34306,37965,0,0,62,62,0,1,0,1,0,deny
63779,26467,0,0,62,62,0,1,0,1,0,deny
52282,37965,0,0,66,66,0,1,0,1,0,deny
45941,23388,0,0,60,60,0,1,0,1,0,deny
56399,445,0,0,70,70,0,1,0,1,0,drop
38093,11392,0,0,146,146,0,1,0,1,0,deny
23969,57470,0,0,62,62,0,1,0,1,0,deny
10886,51505,0,0,62,62,0,1,0,1,0,deny
61085,37965,0,0,62,62,0,1,0,1,0,deny
49305,57470,0,0,66,66,0,1,0,1,0,deny
1972,57470,0,0,78,78,0,1,0,1,0,deny
56390,445,0,0,70,70,0,1,0,1,0,drop
56391,445,0,0,70,70,0,1,0,1,0,drop
56389,445,0,0,70,70,0,1,0,1,0,drop
61318,445,0,0,70,70,0,1,0,1,0,drop
61315,445,0,0,70,70,0,1,0,1,0,drop
61316,445,0,0,70,70,0,1,0,1,0,drop
56369,22114,0,0,62,62,0,1,0,1,0,deny
1523,22,0,0,60,60,0,1,0,1,0,deny
56387,445,0,0,70,70,0,1,0,1,0,drop
56706,445,0,0,66,66,0,1,0,1,0,drop
56710,445,0,0,66,66,0,1,0,1,0,drop
56709,445,0,0,66,66,0,1,0,1,0,drop
56707,445,0,0,66,66,0,1,0,1,0,drop
56704,445,0,0,66,66,0,1,0,1,0,drop
56712,445,0,0,66,66,0,1,0,1,0,drop
56711,445,0,0,66,66,0,1,0,1,0,drop
56705,445,0,0,66,66,0,1,0,1,0,drop
56383,445,0,0,70,70,0,1,0,1,0,drop
45682,1,0,0,62,62,0,1,0,1,0,deny
57612,28793,0,0,66,66,0,1,0,1,0,deny
41022,30975,0,0,157,157,0,1,0,1,0,deny
52144,49344,0,0,62,62,0,1,0,1,0,deny
1040,37965,0,0,62,62,0,1,0,1,0,deny
59435,37807,0,0,66,66,0,1,0,1,0,deny
65317,51221,0,0,78,78,0,1,0,1,0,deny
26085,51221,0,0,72,72,0,1,0,1,0,deny
57987,56125,0,0,90,90,0,1,0,1,0,deny
15641,26467,0,0,62,62,0,1,0,1,0,deny
60423,35440,0,0,62,62,0,1,0,1,0,deny
31995,61689,0,0,146,146,0,1,0,1,0,deny
61313,445,0,0,70,70,0,1,0,1,0,drop
56377,445,0,0,70,70,0,1,0,1,0,drop
61307,445,0,0,70,70,0,1,0,1,0,drop
61301,445,0,0,70,70,0,1,0,1,0,drop
63288,52848,0,0,66,66,0,1,0,1,0,deny
58226,52848,0,0,62,62,0,1,0,1,0,deny
9473,26467,0,0,66,66,0,1,0,1,0,deny
56690,445,0,0,66,66,0,1,0,1,0,drop
56691,445,0,0,66,66,0,1,0,1,0,drop
56689,445,0,0,66,66,0,1,0,1,0,drop
36227,23,0,0,60,60,0,1,0,1,0,deny
50901,26467,0,0,66,66,0,1,0,1,0,deny
61298,445,0,0,70,70,0,1,0,1,0,drop
56370,445,0,0,70,70,0,1,0,1,0,drop
52830,22114,0,0,146,146,0,1,0,1,0,deny
56367,445,0,0,70,70,0,1,0,1,0,drop
55386,37965,0,0,66,66,0,1,0,1,0,deny
12226,37965,0,0,62,62,0,1,0,1,0,deny
61295,445,0,0,70,70,0,1,0,1,0,drop
61294,445,0,0,70,70,0,1,0,1,0,drop
61292,445,0,0,70,70,0,1,0,1,0,drop
61288,445,0,0,70,70,0,1,0,1,0,drop
56752,44847,0,0,66,66,0,1,0,1,0,deny
17532,23,0,0,60,60,0,1,0,1,0,deny
56363,445,0,0,70,70,0,1,0,1,0,drop
56362,445,0,0,70,70,0,1,0,1,0,drop
33595,23,0,0,60,60,0,1,0,1,0,deny
26799,6881,0,0,146,146,0,1,0,1,0,deny
58207,51505,0,0,66,66,0,1,0,1,0,deny
47910,7461,0,0,60,60,0,1,0,1,0,deny
61510,37965,0,0,66,66,0,1,0,1,0,deny
56358,445,0,0,70,70,0,1,0,1,0,drop
59352,37965,0,0,66,66,0,1,0,1,0,deny
63271,52752,0,0,78,78,0,1,0,1,0,deny
51412,51505,0,0,62,62,0,1,0,1,0,deny
45405,161,0,0,5858,2302,3556,22,30,11,11,allow
32833,53,32833,53,227,88,139,2,30,1,1,allow
22199,443,22199,443,79787,12741,67046,117,31,65,52,allow
22773,443,22773,443,6993,960,6033,17,31,10,7,allow
54553,443,44028,443,68345,58488,9857,122,329,62,60,allow
56840,20413,10874,20413,70,70,0,2,8,2,0,allow
35753,80,35753,80,158890,11318,147572,182,30,74,108,allow
60374,80,60374,80,118413,7486,110927,151,33,70,81,allow
27331,443,27331,443,1251,722,529,11,147,6,5,allow
26961,443,26961,443,1251,722,529,11,147,6,5,allow
5588,5588,0,0,3562,1936,1626,48,193,24,24,allow
56680,161,0,0,15721,6203,9518,50,30,25,25,allow
51385,161,51385,161,2315,979,1336,10,30,5,5,allow
8069,80,8069,80,638,306,332,11,84,6,5,allow
56976,80,37703,80,214,140,74,4,35,3,1,allow
8389,80,8389,80,1700,1073,627,15,84,8,7,allow
62440,443,45155,443,28183,7016,21167,51,45,23,28,allow
26504,443,26504,443,1251,722,529,11,147,6,5,allow
39287,53,1937,53,198,93,105,2,30,1,1,allow
45000,443,43427,443,2227,1018,1209,17,16,8,9,allow
56978,80,63683,80,214,140,74,4,35,3,1,allow
49181,2710,52440,2710,66,66,0,1,5,1,0,allow
27008,443,27008,443,1251,722,529,11,147,6,5,allow
39915,443,44120,443,6922156,117604,6804552,6122,50,1519,4603,allow
43310,443,13938,443,60,60,0,1,5,1,0,allow
10344,80,10344,80,6705,702,6003,13,16,6,7,allow
56975,80,23804,80,214,140,74,4,35,3,1,allow
56988,80,5679,80,214,140,74,4,35,3,1,allow
56624,443,46421,443,12807,129,12678,13,147,2,11,allow
47748,161,0,0,6387,2535,3852,22,30,11,11,allow
54234,80,54234,80,2334,1575,759,11,148,6,5,allow
22678,443,22678,443,18172,3573,14599,39,26,20,19,allow
35755,80,35755,80,201552,13184,188368,245,30,111,134,allow
22939,443,22939,443,6993,960,6033,17,31,10,7,allow
35752,80,35752,80,871846,24071,847775,900,30,326,574,allow
22376,443,22376,443,6620,3193,3427,23,26,13,10,allow
22404,443,22404,443,5576,2436,3140,21,26,12,9,allow
38852,443,38852,443,4747,1840,2907,19,28,11,8,allow
43309,443,32781,443,60,60,0,1,5,1,0,allow
16262,80,16262,80,14671,951,13720,23,16,10,13,allow
60112,443,25865,443,572,280,292,9,16,5,4,allow
8160,80,8160,80,1670,1044,626,15,84,8,7,allow
56828,53156,12395,53156,66,66,0,1,5,1,0,allow
53660,18599,61340,18599,492,306,186,8,16,5,3,allow
56979,80,46084,80,214,140,74,4,35,3,1,allow
55645,18904,52547,18904,320,140,180,6,6,3,3,allow
51077,13021,36103,13021,154976,25739,129237,605,387,321,284,allow
51874,43161,58126,43161,70,70,0,2,8,2,0,allow
27005,27016,32182,27016,1648,126,1522,4,30,2,2,allow
57577,443,53525,443,4752,2561,2191,32,256,16,16,allow
56977,80,20065,80,214,140,74,4,35,3,1,allow
64216,53,64216,53,220,100,120,2,30,1,1,allow
61053,443,61053,443,40415,2911,37504,57,18,27,30,allow
8485,80,8485,80,572,240,332,10,84,5,5,allow
41528,161,0,0,14381,5620,8761,50,30,25,25,allow
53132,22448,0,0,66,66,0,1,90,1,0,allow
50265,38203,29229,38203,480,149,331,2,1200,1,1,allow
53685,38978,44279,38978,70,70,0,2,8,2,0,allow
43308,443,4843,443,120,120,0,2,5,2,0,allow
53681,31466,64750,31466,70,70,0,2,8,2,0,allow
57878,80,49228,80,5518,527,4991,13,75,6,7,allow
54028,443,7656,443,11123,4258,6865,48,197,27,21,allow
27005,27015,49049,27015,1610,126,1484,4,30,2,2,allow
64091,443,50015,443,3258,1197,2061,14,136,7,7,allow
60306,443,16522,443,2866,623,2243,13,136,6,7,allow
55288,443,7334,443,15679,1532,14147,16,139,3,13,allow
27005,30002,14816,30002,1652,126,1526,4,31,2,2,allow
61275,445,0,0,70,70,0,1,0,1,0,drop
61276,445,0,0,70,70,0,1,0,1,0,drop
61273,445,0,0,70,70,0,1,0,1,0,drop
34273,36829,0,0,146,146,0,1,0,1,0,deny
56357,445,0,0,70,70,0,1,0,1,0,drop
50341,37965,0,0,62,62,0,1,0,1,0,deny
54028,37965,0,0,66,66,0,1,0,1,0,deny
49191,35440,0,0,62,62,0,1,0,1,0,deny
29011,32468,0,0,66,66,0,1,0,1,0,deny
15403,51505,0,0,66,66,0,1,0,1,0,deny
54869,35440,0,0,146,146,0,1,0,1,0,deny
62115,57470,0,0,66,66,0,1,0,1,0,deny
53294,443,27871,443,7740,4267,3473,39,97,21,18,allow
23066,443,23066,443,5573,2434,3139,21,25,12,9,allow
56980,80,6065,80,214,140,74,4,35,3,1,allow
7660,443,7660,443,5640,2394,3246,25,82,13,12,allow
60426,57470,0,0,62,62,0,1,0,1,0,deny
64605,35993,0,0,66,66,0,1,0,1,0,deny
56670,445,0,0,66,66,0,1,0,1,0,drop
61270,445,0,0,70,70,0,1,0,1,0,drop
61268,445,0,0,70,70,0,1,0,1,0,drop
37662,2323,0,0,60,60,0,1,0,1,0,deny
6712,5632,0,0,60,60,0,1,0,1,0,deny
50470,61463,0,0,86,86,0,1,0,1,0,deny
29787,37965,0,0,62,62,0,1,0,1,0,deny
55373,1,0,0,66,66,0,1,0,1,0,deny
56662,445,0,0,66,66,0,1,0,1,0,drop
56339,445,0,0,70,70,0,1,0,1,0,drop
50025,53,43960,53,536,120,416,4,59,2,2,allow
49760,1443,52471,1443,626,352,274,10,15,6,4,allow
60375,80,60375,80,172473,8713,163760,205,33,91,114,allow
35754,80,35754,80,141193,10612,130581,165,30,69,96,allow
49928,443,22562,443,9330,2410,6920,25,81,13,12,allow
7797,443,7797,443,1474,697,777,18,82,8,10,allow
43156,53,17212,53,168,78,90,2,29,1,1,allow
65001,53,54840,53,224,78,146,2,30,1,1,allow
58278,443,51446,443,7349712,213635,7136077,7600,192,2303,5297,allow
35094,53,9610,53,371,94,277,2,30,1,1,allow
40941,443,61408,443,9794,2178,7616,26,48,16,10,allow
38936,80,38936,80,8429,1098,7331,16,20,8,8,allow
53278,443,21560,443,38395,6930,31465,56,30,27,29,allow
2777,23,2777,23,130,66,64,2,4,1,1,allow
56602,443,24699,443,27035,4207,22828,43,31,21,22,allow
56799,443,31346,443,6496,1340,5156,31,506,10,21,allow
53682,20884,39828,20884,70,70,0,2,7,2,0,allow
60376,80,60376,80,180425,10839,169586,213,33,93,120,allow
53686,8999,46759,8999,70,70,0,2,7,2,0,allow
35751,80,35751,80,336615,15190,321425,383,31,159,224,allow
27005,27015,42995,27015,1758,252,1506,5,32,3,2,allow
49229,53,37715,53,243,110,133,2,29,1,1,allow
59222,53,30617,53,181,86,95,2,30,1,1,allow
53102,53,13819,53,70,70,0,1,30,1,0,allow
57388,53,31918,53,266,86,180,2,30,1,1,allow
42487,443,53584,443,4887,895,3992,16,29,9,7,allow
49940,443,49940,443,13342,2357,10985,25,18,14,11,allow
61040,443,61040,443,4886,1530,3356,17,17,10,7,allow
57373,443,61209,443,5620,927,4693,17,15,10,7,allow
56989,80,28425,80,526,304,222,8,35,5,3,allow
6881,6881,56925,6881,238,118,120,2,1200,1,1,allow
50494,80,52508,80,18059,13615,4444,29,27,16,13,allow
56658,53,56658,53,257,114,143,2,30,1,1,allow
59743,80,42514,80,815748,15896,799852,777,90,244,533,allow
50508,443,58389,443,7588,1850,5738,19,25,10,9,allow
51873,19311,58554,19311,70,70,0,2,7,2,0,allow
54961,443,58980,443,1015861,30762,985099,1147,257,421,726,allow
56659,443,54837,443,8058,2038,6020,20,15,11,9,allow
49523,53,19380,53,314,93,221,4,43,2,2,allow
7928,80,7928,80,25909,3016,22893,40,83,15,25,allow
37941,443,61204,443,69429,16478,52951,156,182,83,73,allow
50474,80,43879,80,19357,10244,9113,36,27,19,17,allow
56987,80,45961,80,214,140,74,4,35,3,1,allow
56986,80,18351,80,214,140,74,4,35,3,1,allow
56984,80,27269,80,214,140,74,4,35,3,1,allow
23023,80,23023,80,2270,1645,625,9,26,6,3,allow
8167,443,8167,443,1474,697,777,18,82,8,10,allow
40806,8000,49174,8000,1259,639,620,20,300,10,10,allow
51481,53,20508,53,168,78,90,2,30,1,1,allow
55952,443,28479,443,24272,12428,11844,70,213,32,38,allow
51073,80,13586,80,525373,237667,287706,1387,390,693,694,allow
50408,7000,50408,7000,3132,815,2317,14,18,7,7,allow
48105,53,48105,53,262,106,156,2,33,1,1,allow
51875,25072,31017,25072,70,70,0,2,7,2,0,allow
4956,53,4956,53,203,82,121,2,30,1,1,allow
60399,161,0,0,18789,5169,13620,54,30,27,27,allow
53125,10693,11015,10693,954,454,500,14,21,8,6,allow
51856,62841,45068,62841,136,136,0,3,13,3,0,allow
51855,23268,16577,23268,70,70,0,1,5,1,0,allow
62439,443,26291,443,16246,11056,5190,37,45,21,16,allow
32967,80,37431,80,21387,1482,19905,38,18,19,19,allow
22,15260,22,15260,130,70,60,2,15,1,1,allow
8024,80,8024,80,572,240,332,10,83,5,5,allow
64530,53,46090,53,211,102,109,2,30,1,1,allow
38260,443,50232,443,7173,1419,5754,32,383,11,21,allow
58847,443,24312,443,3143,1064,2079,18,82,8,10,allow
35915,443,57098,443,1786,172,1614,7,120,3,4,allow
60369,80,60369,80,266818,12375,254443,285,34,107,178,allow
57066,443,13444,443,556770,88286,468484,777,202,314,463,allow
27005,27016,56355,27016,1646,126,1520,4,31,2,2,allow
43087,443,6969,443,4909,1007,3902,14,35,8,6,allow
56660,443,63035,443,8006,1986,6020,20,15,11,9,allow
13743,80,13743,80,724,366,358,11,142,6,5,allow
27563,443,27563,443,1181,722,459,10,147,6,4,allow
53689,42719,61267,42719,70,70,0,2,7,2,0,allow
57790,443,8937,443,117653,21783,95870,251,556,93,158,allow
10038,443,58313,443,7481,2070,5411,25,315,12,13,allow
47120,443,47120,443,4604,1697,2907,19,29,11,8,allow
62441,443,36404,443,4651,3116,1535,19,44,10,9,allow
22592,443,22592,443,29021,6752,22269,48,30,29,19,allow
7934,443,7934,443,6593,3073,3520,27,82,14,13,allow
49502,53,35075,53,179,86,93,2,29,1,1,allow
59262,80,59262,80,94514,14468,80046,152,15,41,111,allow
23022,443,23022,443,10943,5186,5757,32,25,18,14,allow
56985,80,59526,80,214,140,74,4,35,3,1,allow
57184,53,36086,53,272,94,178,2,29,1,1,allow
22205,443,22205,443,10793,2049,8744,23,30,14,9,allow
43743,53,43743,53,240,98,142,2,29,1,1,allow
56981,80,19891,80,214,140,74,4,35,3,1,allow
43039,53,27551,53,168,78,90,2,29,1,1,allow
61217,53,50317,53,281,94,187,2,30,1,1,allow
55552,53,60195,53,211,102,109,2,30,1,1,allow
27005,28515,30330,28515,1660,126,1534,4,30,2,2,allow
27005,27017,47971,27017,1616,126,1490,4,30,2,2,allow
49182,53,44371,53,211,102,109,2,30,1,1,allow
55531,53,57594,53,370,126,244,2,30,1,1,allow
60121,161,0,0,8215,3237,4978,30,30,15,15,allow
50502,123,1103,123,184,94,90,2,30,1,1,allow
33027,161,0,0,15505,6180,9325,50,30,25,25,allow
53512,53,23746,53,168,78,90,2,30,1,1,allow
61567,53,3917,53,183,86,97,2,30,1,1,allow
34044,161,0,0,18549,5061,13488,54,30,27,27,allow
6881,48533,62658,48533,502,150,352,2,1199,1,1,allow
57791,443,18201,443,30057,13955,16102,146,556,65,81,allow
60276,80,60276,80,671,313,358,7,75,4,3,allow
56990,80,57120,80,214,140,74,4,35,3,1,allow
53471,161,0,0,5907,2302,3605,22,30,11,11,allow
64438,53,23542,53,211,102,109,2,30,1,1,allow
56852,6057,3356,6057,2499,2499,0,22,300,22,0,allow
48962,161,0,0,8507,3320,5187,28,30,14,14,allow
65166,53,40990,53,211,102,109,2,30,1,1,allow
49826,80,54409,80,6311,4340,1971,20,186,12,8,allow
64679,53,17226,53,211,102,109,2,31,1,1,allow
60921,443,60921,443,4886,1530,3356,17,17,10,7,allow
62295,443,30041,443,3538,2015,1523,28,325,14,14,allow
56983,80,30863,80,214,140,74,4,35,3,1,allow
56982,80,63526,80,214,140,74,4,35,3,1,allow
8583,443,8583,443,19994,4745,15249,47,82,21,26,allow
8168,443,8168,443,10130,4701,5429,34,82,18,16,allow
41486,443,65300,443,204,70,134,4,26,2,2,allow
65039,53,3857,53,302,102,200,2,30,1,1,allow
23769,53,45289,53,334,226,108,3,30,2,1,allow
64430,53,41812,53,493,91,402,4,31,2,2,allow
49565,53,54064,53,768,193,575,6,40,3,3,allow
22807,443,22807,443,4518,1665,2853,19,25,11,8,allow
22983,443,22983,443,205941,20753,185188,264,30,129,135,allow
56658,443,31194,443,8007,1987,6020,20,15,11,9,allow
49736,443,25787,443,8028,1787,6241,32,28,17,15,allow
64703,53,13570,53,214,102,112,2,30,1,1,allow
56529,53,10690,53,378,94,284,2,30,1,1,allow
46398,443,65303,443,12982,7168,5814,50,165,23,27,allow
27005,27022,35280,27022,1654,126,1528,4,31,2,2,allow
17750,12550,53024,12550,491,150,341,2,1200,1,1,allow
27005,27018,36101,27018,1634,126,1508,4,31,2,2,allow
27005,27019,51161,27019,1698,126,1572,4,31,2,2,allow
61766,443,43724,443,4326,2217,2109,14,120,7,7,allow
56648,443,37098,443,1327,918,409,10,26,6,4,allow
63853,10659,14752,10659,66,66,0,2,8,2,0,allow
48839,443,60350,443,111590,17663,93927,212,115,93,119,allow
49936,80,9467,80,1130,613,517,11,15,6,5,allow
64096,443,64096,443,5661,2415,3246,26,160,14,12,allow
61286,443,41653,443,248071,7320,240751,269,268,89,180,allow
65361,53,22669,53,249,94,155,2,30,1,1,allow
49615,53,9854,53,276,94,182,2,30,1,1,allow
56655,443,7969,443,1272,876,396,10,26,6,4,allow
49737,443,13001,443,37094,22774,14320,125,27,72,53,allow
64824,53,60323,53,94,94,0,1,30,1,0,allow
27005,27015,55058,27015,1666,126,1540,4,31,2,2,allow
56646,443,10246,443,1327,918,409,10,26,6,4,allow
59291,53,59291,53,197,90,107,2,30,1,1,allow
56660,445,0,0,66,66,0,1,0,1,0,drop
61256,445,0,0,70,70,0,1,0,1,0,drop
61252,445,0,0,70,70,0,1,0,1,0,drop
61248,445,0,0,70,70,0,1,0,1,0,drop
61247,445,0,0,70,70,0,1,0,1,0,drop
55459,50584,0,0,66,66,0,1,0,1,0,deny
56656,445,0,0,66,66,0,1,0,1,0,drop
33563,14037,0,0,78,78,0,1,0,1,0,deny
34247,48817,0,0,145,145,0,1,0,1,0,deny
56336,445,0,0,70,70,0,1,0,1,0,drop
54989,50265,0,0,66,66,0,1,0,1,0,deny
51313,64147,0,0,66,66,0,1,0,1,0,deny
50292,62413,0,0,62,62,0,1,0,1,0,deny
46518,44847,0,0,62,62,0,1,0,1,0,deny
60312,57470,0,0,74,74,0,1,0,1,0,deny
11136,15503,0,0,62,62,0,1,0,1,0,deny
61240,445,0,0,70,70,0,1,0,1,0,drop
61236,445,0,0,70,70,0,1,0,1,0,drop
61237,445,0,0,70,70,0,1,0,1,0,drop
38683,17,0,0,60,60,0,1,0,1,0,deny
56649,445,0,0,66,66,0,1,0,1,0,drop
56331,445,0,0,70,70,0,1,0,1,0,drop
56330,445,0,0,70,70,0,1,0,1,0,drop
56643,445,0,0,66,66,0,1,0,1,0,drop
56648,445,0,0,66,66,0,1,0,1,0,drop
56645,445,0,0,66,66,0,1,0,1,0,drop
34809,57470,0,0,66,66,0,1,0,1,0,deny
56328,445,0,0,70,70,0,1,0,1,0,drop
56640,445,0,0,66,66,0,1,0,1,0,drop
56641,445,0,0,66,66,0,1,0,1,0,drop
56638,445,0,0,66,66,0,1,0,1,0,drop
1026,30188,0,0,62,62,0,1,0,1,0,deny
45964,3111,0,0,60,60,0,1,0,1,0,deny
62625,37965,0,0,66,66,0,1,0,1,0,deny
17579,57470,0,0,62,62,0,1,0,1,0,deny
65388,55783,0,0,66,66,0,1,0,1,0,deny
24041,55783,0,0,62,62,0,1,0,1,0,deny
61235,445,0,0,70,70,0,1,0,1,0,drop
61230,445,0,0,70,70,0,1,0,1,0,drop
61229,445,0,0,70,70,0,1,0,1,0,drop
26921,57470,0,0,62,62,0,1,0,1,0,deny
56635,445,0,0,66,66,0,1,0,1,0,drop
61227,445,0,0,70,70,0,1,0,1,0,drop
56633,445,0,0,66,66,0,1,0,1,0,drop
54118,6004,0,0,66,66,0,1,0,1,0,deny
56321,445,0,0,70,70,0,1,0,1,0,drop
56631,445,0,0,66,66,0,1,0,1,0,drop
56630,445,0,0,66,66,0,1,0,1,0,drop
22399,22,0,0,60,60,0,1,0,1,0,deny
56627,445,0,0,66,66,0,1,0,1,0,drop
56319,445,0,0,70,70,0,1,0,1,0,drop
57174,57470,0,0,66,66,0,1,0,1,0,deny
10028,25604,0,0,62,62,0,1,0,1,0,deny
35461,44847,0,0,146,146,0,1,0,1,0,deny
61336,61689,0,0,66,66,0,1,0,1,0,deny
31021,35440,0,0,146,146,0,1,0,1,0,deny
61195,56205,0,0,66,66,0,1,0,1,0,deny
56318,445,0,0,70,70,0,1,0,1,0,drop
56944,35894,0,0,62,62,0,1,0,1,0,deny
46701,1433,0,0,60,60,0,1,0,1,0,deny
50991,443,38073,443,6448,2376,4072,22,2,10,12,allow
56317,445,0,0,70,70,0,1,0,1,0,drop
58743,35894,0,0,66,66,0,1,0,1,0,deny
48283,42873,0,0,66,66,0,1,0,1,0,deny
56316,445,0,0,70,70,0,1,0,1,0,drop
1024,29892,0,0,145,145,0,1,0,1,0,deny
56312,445,0,0,70,70,0,1,0,1,0,drop
56310,445,0,0,70,70,0,1,0,1,0,drop
61222,445,0,0,70,70,0,1,0,1,0,drop
4257,35440,0,0,62,62,0,1,0,1,0,deny
47037,1,0,0,62,62,0,1,0,1,0,deny
59889,30188,0,0,66,66,0,1,0,1,0,deny
61218,445,0,0,70,70,0,1,0,1,0,drop
61210,445,0,0,70,70,0,1,0,1,0,drop
57987,56125,0,0,90,90,0,1,0,1,0,deny
24949,47224,0,0,145,145,0,1,0,1,0,deny
52410,8604,0,0,66,66,0,1,0,1,0,deny
56298,445,0,0,70,70,0,1,0,1,0,drop
56297,445,0,0,70,70,0,1,0,1,0,drop
56616,445,0,0,66,66,0,1,0,1,0,drop
56291,445,0,0,70,70,0,1,0,1,0,drop
56288,445,0,0,70,70,0,1,0,1,0,drop
56287,445,0,0,70,70,0,1,0,1,0,drop
37420,44847,0,0,66,66,0,1,0,1,0,deny
44849,46478,0,0,74,74,0,1,0,1,0,deny
9529,26467,0,0,62,62,0,1,0,1,0,deny
52705,42873,0,0,66,66,0,1,0,1,0,deny
42465,57470,0,0,60,60,0,1,0,1,0,deny
56609,445,0,0,66,66,0,1,0,1,0,drop
61199,445,0,0,70,70,0,1,0,1,0,drop
49248,35993,0,0,66,66,0,1,0,1,0,deny
64681,35993,0,0,66,66,0,1,0,1,0,deny
56276,445,0,0,70,70,0,1,0,1,0,drop
56606,445,0,0,66,66,0,1,0,1,0,drop
59965,36237,0,0,66,66,0,1,0,1,0,deny
1972,57470,0,0,78,78,0,1,0,1,0,deny
28824,44847,0,0,66,66,0,1,0,1,0,deny
56376,44847,0,0,66,66,0,1,0,1,0,deny
56600,445,0,0,66,66,0,1,0,1,0,drop
48755,23,0,0,60,60,0,1,0,1,0,deny
57665,52700,0,0,66,66,0,1,0,1,0,deny
56595,445,0,0,66,66,0,1,0,1,0,drop
17561,52700,0,0,62,62,0,1,0,1,0,deny
0,0,0,0,124,64,60,2,0,1,1,allow
13285,29892,0,0,145,145,0,1,0,1,0,deny
1024,64147,0,0,62,62,0,1,0,1,0,deny
56272,445,0,0,70,70,0,1,0,1,0,drop
30783,51505,0,0,62,62,0,1,0,1,0,deny
10348,25604,0,0,66,66,0,1,0,1,0,deny
443,20087,0,0,83,83,0,1,0,1,0,deny
51093,57470,0,0,66,66,0,1,0,1,0,deny
54305,26467,0,0,66,66,0,1,0,1,0,deny
45964,7776,0,0,60,60,0,1,0,1,0,deny
56263,445,0,0,70,70,0,1,0,1,0,drop
56260,445,0,0,70,70,0,1,0,1,0,drop
56261,445,0,0,70,70,0,1,0,1,0,drop
56259,445,0,0,70,70,0,1,0,1,0,drop
51818,37965,0,0,66,66,0,1,0,1,0,deny
28364,23,0,0,60,60,0,1,0,1,0,deny
56256,445,0,0,70,70,0,1,0,1,0,drop
61192,445,0,0,70,70,0,1,0,1,0,drop
61189,445,0,0,70,70,0,1,0,1,0,drop
61187,445,0,0,70,70,0,1,0,1,0,drop
56579,445,0,0,66,66,0,1,0,1,0,drop
56580,445,0,0,66,66,0,1,0,1,0,drop
56582,445,0,0,66,66,0,1,0,1,0,drop
56584,445,0,0,66,66,0,1,0,1,0,drop
56583,445,0,0,66,66,0,1,0,1,0,drop
56581,445,0,0,66,66,0,1,0,1,0,drop
56577,445,0,0,66,66,0,1,0,1,0,drop
56576,445,0,0,66,66,0,1,0,1,0,drop
58131,30228,0,0,146,146,0,1,0,1,0,deny
6666,21,0,0,60,60,0,1,0,1,0,deny
40521,23117,0,0,66,66,0,1,0,1,0,deny
51183,56205,0,0,62,62,0,1,0,1,0,deny
27407,36237,0,0,146,146,0,1,0,1,0,deny
57234,21247,0,0,66,66,0,1,0,1,0,deny
1035,26467,0,0,62,62,0,1,0,1,0,deny
49976,5900,0,0,60,60,0,1,0,1,0,deny
56249,445,0,0,70,70,0,1,0,1,0,drop
48841,51221,0,0,62,62,0,1,0,1,0,deny
59008,51221,0,0,66,66,0,1,0,1,0,deny
62540,29892,0,0,145,145,0,1,0,1,0,deny
16944,50584,0,0,62,62,0,1,0,1,0,deny
61181,445,0,0,70,70,0,1,0,1,0,drop
61180,445,0,0,70,70,0,1,0,1,0,drop
61176,445,0,0,70,70,0,1,0,1,0,drop
62438,37807,0,0,62,62,0,1,0,1,0,deny
35849,30188,0,0,62,62,0,1,0,1,0,deny
56563,445,0,0,66,66,0,1,0,1,0,drop
56564,445,0,0,66,66,0,1,0,1,0,drop
56562,445,0,0,66,66,0,1,0,1,0,drop
56242,445,0,0,70,70,0,1,0,1,0,drop
54210,64097,0,0,66,66,0,1,0,1,0,deny
56241,445,0,0,70,70,0,1,0,1,0,drop
61170,445,0,0,70,70,0,1,0,1,0,drop
61167,445,0,0,70,70,0,1,0,1,0,drop
60222,22114,0,0,66,66,0,1,0,1,0,deny
54873,443,62397,443,9238,3472,5766,43,75,24,19,allow
46415,53,46415,53,211,80,131,2,30,1,1,allow
62408,3478,27920,3478,140,140,0,1,30,1,0,allow
63856,6881,6366,6881,66,66,0,2,8,2,0,allow
51434,53,0,0,202,93,109,2,30,1,1,allow
55773,53,49268,53,97,97,0,1,60,1,0,allow
27005,31010,2449,31010,1626,126,1500,4,31,2,2,allow
57329,443,20931,443,7472,2014,5458,29,16,16,13,allow
49651,443,6996,443,920003,731041,188962,2024,929,1212,812,allow
63855,29799,24538,29799,66,66,0,2,8,2,0,allow
51851,48605,8820,48605,136,136,0,3,14,3,0,allow
57332,443,64135,443,2687,1728,959,23,15,12,11,allow
57331,443,8045,443,7468,2225,5243,27,16,15,12,allow
53450,443,18001,443,5931,1750,4181,24,48,14,10,allow
64093,443,64093,443,5663,2416,3247,26,159,14,12,allow
64097,443,64097,443,13511,6811,6700,43,159,23,20,allow
46750,80,46750,80,27124,1455,25669,41,15,20,21,allow
62457,7000,62457,7000,3959,1738,2221,15,15,8,7,allow
57947,443,8723,443,2791,1800,991,26,185,15,11,allow
56666,443,31326,443,1299,730,569,13,25,7,6,allow
41842,443,41842,443,4707,1800,2907,19,28,11,8,allow
56665,443,57309,443,1299,730,569,13,25,7,6,allow
27005,27013,28763,27013,1628,126,1502,4,31,2,2,allow
48655,53,0,0,82,82,0,2,40,2,0,allow
46230,53,46230,53,257,101,156,2,33,1,1,allow
51853,30585,59624,30585,136,136,0,3,14,3,0,allow
33038,443,55545,443,7338,2419,4919,19,35,12,7,allow
37534,443,60202,443,6927,1883,5044,25,46,14,11,allow
59487,53,59487,53,211,80,131,2,30,1,1,allow
60108,443,32347,443,9091,2988,6103,47,19,22,25,allow
44467,53,44467,53,211,80,131,2,30,1,1,allow
37485,161,0,0,6435,2535,3900,22,30,11,11,allow
65408,53,49701,53,817,98,719,2,30,1,1,allow
62408,3478,24308,3478,140,140,0,1,30,1,0,allow
43749,443,15009,443,8900,2090,6810,26,80,14,12,allow
64095,443,64095,443,17046,2620,14426,42,159,19,23,allow
56662,443,60423,443,1233,730,503,12,25,7,5,allow
56663,443,26937,443,1299,730,569,13,25,7,6,allow
64573,443,63298,443,29112,2866,26246,53,31,28,25,allow
80,34539,80,34539,1468,1468,0,1,5,1,0,allow
64092,443,64092,443,5643,2397,3246,26,159,14,12,allow
62408,3478,62290,3478,140,140,0,1,30,1,0,allow
44949,443,55206,443,190,70,120,4,15,2,2,allow
27005,30004,43558,30004,1646,126,1520,4,30,2,2,allow
49300,443,31684,443,4364,2129,2235,12,121,6,6,allow
46505,443,50685,443,7072,1541,5531,27,271,12,15,allow
64538,443,60340,443,4658,1652,3006,10,121,5,5,allow
56543,443,22323,443,1323,616,707,18,120,9,9,allow
27200,34021,0,0,66,66,0,1,90,1,0,allow
50930,443,14420,443,1786,172,1614,7,121,3,4,allow
12060,37965,0,0,66,66,0,1,0,1,0,deny
10436,37965,0,0,62,62,0,1,0,1,0,deny
61165,445,0,0,70,70,0,1,0,1,0,drop
61160,445,0,0,70,70,0,1,0,1,0,drop
61156,445,0,0,70,70,0,1,0,1,0,drop
56236,445,0,0,70,70,0,1,0,1,0,drop
54423,21247,0,0,66,66,0,1,0,1,0,deny
56234,445,0,0,70,70,0,1,0,1,0,drop
53815,44847,0,0,66,66,0,1,0,1,0,deny
20508,57470,0,0,62,62,0,1,0,1,0,deny
18623,1,0,0,66,66,0,1,0,1,0,deny
56230,445,0,0,70,70,0,1,0,1,0,drop
60430,51413,63647,51413,70,70,0,2,8,2,0,allow
37865,123,17478,123,184,94,90,2,30,1,1,allow
53521,443,40751,443,130,70,60,2,14,1,1,allow
55637,27816,50457,27816,316,190,126,5,15,3,2,allow
56647,443,58814,443,1327,918,409,10,25,6,4,allow
56653,443,22218,443,1272,876,396,10,25,6,4,allow
49146,443,26817,443,47589,17003,30586,283,238,128,155,allow
63983,53,48725,53,447,94,353,4,54,2,2,allow
64374,53,21599,53,211,94,117,2,30,1,1,allow
56657,443,53403,443,8059,2039,6020,20,15,11,9,allow
49718,443,50184,443,7644833,215496,7429337,8664,135,2509,6155,allow
56656,443,24919,443,1342,918,424,10,25,6,4,allow
64094,443,64094,443,5647,2402,3245,26,159,14,12,allow
45531,53,30846,53,168,78,90,2,30,1,1,allow
38710,80,33174,80,190,70,120,4,17,2,2,allow
56657,443,37201,443,1342,918,424,10,25,6,4,allow
53934,443,47963,443,360,360,0,7,4,7,0,allow
49440,53,64789,53,415,88,327,4,52,2,2,allow
27005,27016,56293,27016,1640,126,1514,4,31,2,2,allow
56631,80,19501,80,234,234,0,4,12,4,0,allow
51854,13923,55002,13923,136,136,0,3,13,3,0,allow
63563,24096,6074,24096,70,70,0,1,5,1,0,allow
64685,53,19809,53,535,100,435,4,36,2,2,allow
65179,53,9786,53,289,102,187,2,30,1,1,allow
38772,53,26700,53,168,78,90,2,30,1,1,allow
62447,53,48844,53,296,94,202,2,30,1,1,allow
49934,80,37957,80,1130,613,517,11,15,6,5,allow
49652,80,41270,80,1854,945,909,13,106,7,6,allow
35023,53,0,0,82,82,0,2,40,2,0,allow
49933,80,49306,80,1130,613,517,11,15,6,5,allow
56651,443,36673,443,4628,1035,3593,19,25,11,8,allow
50293,443,30749,443,6697,1606,5091,23,36,13,10,allow
56655,443,40290,443,8058,2038,6020,20,15,11,9,allow
58689,123,57350,123,184,94,90,2,30,1,1,allow
60130,80,60130,80,23216,1806,21410,40,28,20,20,allow
57294,53,58964,53,387,134,253,2,30,1,1,allow
64914,53,14005,53,224,94,130,2,30,1,1,allow
37531,443,49565,443,17284,5197,12087,46,48,25,21,allow
64403,53,53109,53,387,134,253,2,30,1,1,allow
58688,53,58261,53,184,78,106,2,30,1,1,allow
57236,443,34862,443,2294,1126,1168,25,120,12,13,allow
51872,48108,5295,48108,70,70,0,2,8,2,0,allow
51852,18636,28064,18636,136,136,0,3,13,3,0,allow
56656,443,38705,443,8006,1986,6020,20,15,11,9,allow
57919,443,32808,443,21293,7315,13978,85,188,37,48,allow
63952,53,35871,53,289,102,187,2,30,1,1,allow
27005,27018,47150,27018,1898,378,1520,6,31,4,2,allow
27005,27015,40771,27015,1618,126,1492,4,31,2,2,allow
49663,443,52474,443,8161,1929,6232,26,46,15,11,allow
45657,443,4313,443,2553,1355,1198,22,77,13,9,allow
59261,80,59261,80,109128,4773,104355,197,15,68,129,allow
49730,443,62541,443,400810,14719,386091,506,39,164,342,allow
60379,443,42355,443,4162,2121,2041,25,95,14,11,allow
37313,443,31778,443,1364815,60410,1304405,1401,901,341,1060,allow
64574,443,40988,443,9151,2109,7042,27,30,15,12,allow
52815,80,10358,80,1152,712,440,10,15,5,5,allow
56654,443,1981,443,8007,1987,6020,20,15,11,9,allow
53279,443,22916,443,36459,6736,29723,54,29,24,30,allow
53648,80,65465,80,2162,1608,554,10,34,6,4,allow
55638,32765,61121,32765,564,318,246,9,15,5,4,allow
57946,443,19612,443,2791,1800,991,26,185,15,11,allow
49935,80,29909,80,1130,613,517,11,15,6,5,allow
56649,443,46574,443,4628,1035,3593,19,25,11,8,allow
45124,80,4219,80,1808,636,1172,16,16,8,8,allow
26923,443,40541,443,7362,1770,5592,31,87,16,15,allow
56652,443,14295,443,1272,876,396,10,25,6,4,allow
27005,27015,32807,27015,1622,126,1496,4,30,2,2,allow
46308,123,1425,123,184,94,90,2,30,1,1,allow
49892,53,17000,53,525,110,415,4,43,2,2,allow
63854,16437,39591,16437,66,66,0,2,7,2,0,allow
53128,29593,52824,29593,70,70,0,1,4,1,0,allow
53640,443,55622,443,3201,1057,2144,13,135,6,7,allow
56650,443,36450,443,4628,1035,3593,19,25,11,8,allow
51870,40490,10666,40490,70,70,0,2,8,2,0,allow
60429,46854,52028,46854,70,70,0,2,8,2,0,allow
54828,443,16065,443,572,572,0,5,11,5,0,allow
60760,20010,11977,20010,70,70,0,1,5,1,0,allow
63838,80,51652,80,314,192,122,6,15,4,2,allow
41857,443,32439,443,1633,1010,623,14,2424,7,7,allow
60422,62456,45228,62456,341,215,126,5,16,3,2,allow
45484,443,14429,443,5766,1575,4191,24,589,13,11,allow
33982,80,37305,80,1152,712,440,10,15,5,5,allow
55639,62954,47207,62954,504,318,186,8,15,5,3,allow
52831,3389,52831,3389,4145,1976,2169,22,18,13,9,allow
51971,80,13099,80,60753,2612,58141,76,46,34,42,allow
64908,53,50995,53,304,94,210,2,30,1,1,allow
49795,53,1877,53,211,102,109,2,30,1,1,allow
52070,443,55434,443,8971,4228,4743,20,95,12,8,allow
49651,80,48758,80,1854,945,909,13,106,7,6,allow
62408,3478,14278,3478,142,142,0,1,30,1,0,allow
50106,53,56744,53,296,94,202,2,30,1,1,allow
45475,161,0,0,41552,20621,20931,212,31,106,106,allow
35989,161,0,0,18741,9242,9499,96,31,48,48,allow
62482,443,44604,443,4427,2362,2065,11,119,6,5,allow
64090,443,49482,443,7360,2435,4925,19,135,9,10,allow
51951,443,35308,443,3854,1151,2703,20,135,10,10,allow
54520,443,49982,443,8152,4874,3278,22,138,11,11,allow
37965,8999,40313,8999,491,150,341,2,1199,1,1,allow
49924,53,63883,53,353,94,259,2,31,1,1,allow
57470,22838,37190,22838,481,150,331,2,1199,1,1,allow
6881,34746,2559,34746,484,150,334,2,1200,1,1,allow
47053,5228,30906,5228,11647,2439,9208,47,3724,21,26,allow
49661,443,46909,443,10553,2117,8436,24,46,12,12,allow
62766,443,26712,443,4911,3442,1469,29,322,16,13,allow
50484,80,53622,80,318,192,126,6,26,4,2,allow
50485,80,52438,80,318,192,126,6,26,4,2,allow
35412,443,65351,443,1251,749,502,11,68,6,5,allow
45152,80,61047,80,2865,2000,865,12,18,7,5,allow
56660,443,12588,443,1579,988,591,13,25,7,6,allow
63928,53,2140,53,376,126,250,2,30,1,1,allow
49318,53,58973,53,718,94,624,2,30,1,1,allow
57171,443,13487,443,13932,3673,10259,26,121,11,15,allow
53894,443,60349,443,6375,1019,5356,21,16,11,10,allow
39108,443,16198,443,330651,13398,317253,404,115,179,225,allow
39094,443,50838,443,828718,43410,785308,1071,347,479,592,allow
50528,80,29242,80,1658,1247,411,8,16,5,3,allow
60763,40010,33856,40010,316,136,180,6,6,3,3,allow
64503,53,37724,53,209,102,107,2,30,1,1,allow
64551,53,2637,53,354,94,260,2,30,1,1,allow
29989,26467,0,0,62,62,0,1,0,1,0,deny
51164,64147,0,0,66,66,0,1,0,1,0,deny
53147,37965,0,0,62,62,0,1,0,1,0,deny
63080,37965,0,0,66,66,0,1,0,1,0,deny
24260,50584,0,0,62,62,0,1,0,1,0,deny
42389,42873,0,0,74,74,0,1,0,1,0,deny
56229,445,0,0,70,70,0,1,0,1,0,drop
59509,64147,0,0,145,145,0,1,0,1,0,deny
48676,53395,0,0,60,60,0,1,0,1,0,deny
63271,52752,0,0,78,78,0,1,0,1,0,deny
31637,17348,0,0,60,60,0,1,0,1,0,deny
61145,445,0,0,70,70,0,1,0,1,0,drop
61147,445,0,0,70,70,0,1,0,1,0,drop
61144,445,0,0,70,70,0,1,0,1,0,drop
50828,123,0,0,234,234,0,1,0,1,0,deny
57878,55108,0,0,148,148,0,1,0,1,0,deny
48676,53392,0,0,60,60,0,1,0,1,0,deny
56222,445,0,0,70,70,0,1,0,1,0,drop
61314,23,0,0,60,60,0,1,0,1,0,deny
17781,50265,0,0,62,62,0,1,0,1,0,deny
56540,445,0,0,66,66,0,1,0,1,0,drop
47348,23,0,0,60,60,0,1,0,1,0,deny
61140,445,0,0,70,70,0,1,0,1,0,drop
61141,445,0,0,70,70,0,1,0,1,0,drop
9353,32761,0,0,110,110,0,1,0,1,0,deny
52569,30188,0,0,66,66,0,1,0,1,0,deny
16430,31573,0,0,62,62,0,1,0,1,0,deny
19204,56448,0,0,78,78,0,1,0,1,0,deny
18754,30188,0,0,66,66,0,1,0,1,0,deny
24882,50647,0,0,60,60,0,1,0,1,0,deny
56209,445,0,0,70,70,0,1,0,1,0,drop
52123,1433,0,0,60,60,0,1,0,1,0,deny
52123,1433,0,0,60,60,0,1,0,1,0,deny
56237,26467,0,0,66,66,0,1,0,1,0,deny
56536,445,0,0,66,66,0,1,0,1,0,drop
57987,56125,0,0,90,90,0,1,0,1,0,deny
56578,64147,0,0,62,62,0,1,0,1,0,deny
53156,35993,0,0,66,66,0,1,0,1,0,deny
23197,44847,0,0,62,62,0,1,0,1,0,deny
56532,445,0,0,66,66,0,1,0,1,0,drop
61127,445,0,0,70,70,0,1,0,1,0,drop
45964,2666,0,0,60,60,0,1,0,1,0,deny
49325,41615,0,0,157,157,0,1,0,1,0,deny
56206,445,0,0,70,70,0,1,0,1,0,drop
61126,445,0,0,70,70,0,1,0,1,0,drop
61124,445,0,0,70,70,0,1,0,1,0,drop
61121,445,0,0,70,70,0,1,0,1,0,drop
56529,445,0,0,66,66,0,1,0,1,0,drop
26183,22114,0,0,62,62,0,1,0,1,0,deny
16948,990,0,0,60,60,0,1,0,1,0,deny
1024,6881,0,0,62,62,0,1,0,1,0,deny
51222,35440,0,0,66,66,0,1,0,1,0,deny
61114,445,0,0,70,70,0,1,0,1,0,drop
56201,445,0,0,70,70,0,1,0,1,0,drop
45673,30188,0,0,146,146,0,1,0,1,0,deny
56200,445,0,0,70,70,0,1,0,1,0,drop
61111,445,0,0,70,70,0,1,0,1,0,drop
61109,445,0,0,70,70,0,1,0,1,0,drop
61108,445,0,0,70,70,0,1,0,1,0,drop
56523,445,0,0,66,66,0,1,0,1,0,drop
2440,37807,0,0,66,66,0,1,0,1,0,deny
56198,445,0,0,70,70,0,1,0,1,0,drop
56516,445,0,0,66,66,0,1,0,1,0,drop
56519,445,0,0,66,66,0,1,0,1,0,drop
56517,445,0,0,66,66,0,1,0,1,0,drop
19698,502,0,0,60,60,0,1,0,1,0,deny
59699,55783,0,0,62,62,0,1,0,1,0,deny
56512,445,0,0,66,66,0,1,0,1,0,drop
56513,445,0,0,66,66,0,1,0,1,0,drop
56511,445,0,0,66,66,0,1,0,1,0,drop
44059,23,0,0,60,60,0,1,0,1,0,deny
56127,35440,0,0,62,62,0,1,0,1,0,deny
19096,64147,0,0,62,62,0,1,0,1,0,deny
49367,51505,0,0,66,66,0,1,0,1,0,deny
51745,57470,0,0,62,62,0,1,0,1,0,deny
61107,445,0,0,70,70,0,1,0,1,0,drop
61104,445,0,0,70,70,0,1,0,1,0,drop
61102,445,0,0,70,70,0,1,0,1,0,drop
40936,5900,0,0,60,60,0,1,0,1,0,deny
56509,445,0,0,66,66,0,1,0,1,0,drop
56191,445,0,0,70,70,0,1,0,1,0,drop
61099,445,0,0,70,70,0,1,0,1,0,drop
56505,445,0,0,66,66,0,1,0,1,0,drop
56189,445,0,0,70,70,0,1,0,1,0,drop
56502,445,0,0,66,66,0,1,0,1,0,drop
56503,445,0,0,66,66,0,1,0,1,0,drop
443,20087,0,0,83,83,0,1,0,1,0,deny
9327,57470,0,0,62,62,0,1,0,1,0,deny
56499,445,0,0,66,66,0,1,0,1,0,drop
56188,445,0,0,70,70,0,1,0,1,0,drop
19004,51505,0,0,66,66,0,1,0,1,0,deny
56187,445,0,0,70,70,0,1,0,1,0,drop
56186,445,0,0,70,70,0,1,0,1,0,drop
50713,57470,0,0,66,66,0,1,0,1,0,deny
56181,445,0,0,70,70,0,1,0,1,0,drop
56183,445,0,0,70,70,0,1,0,1,0,drop
28194,32468,0,0,62,62,0,1,0,1,0,deny
42465,57470,0,0,60,60,0,1,0,1,0,deny
61093,445,0,0,70,70,0,1,0,1,0,drop
15701,37965,0,0,146,146,0,1,0,1,0,deny
60248,30188,0,0,66,66,0,1,0,1,0,deny
50470,61463,0,0,86,86,0,1,0,1,0,deny
61090,445,0,0,70,70,0,1,0,1,0,drop
61085,445,0,0,70,70,0,1,0,1,0,drop
59481,30975,0,0,146,146,0,1,0,1,0,deny
61002,37965,0,0,145,145,0,1,0,1,0,deny
56168,445,0,0,70,70,0,1,0,1,0,drop
56167,445,0,0,70,70,0,1,0,1,0,drop
56164,445,0,0,70,70,0,1,0,1,0,drop
54167,50584,0,0,66,66,0,1,0,1,0,deny
56158,445,0,0,70,70,0,1,0,1,0,drop
56157,445,0,0,70,70,0,1,0,1,0,drop
50066,30188,0,0,66,66,0,1,0,1,0,deny
47814,51505,0,0,62,62,0,1,0,1,0,deny
56489,445,0,0,66,66,0,1,0,1,0,drop
45682,37965,0,0,62,62,0,1,0,1,0,deny
56753,44847,0,0,146,146,0,1,0,1,0,deny
2828,35253,0,0,66,66,0,1,0,1,0,deny
1972,57470,0,0,78,78,0,1,0,1,0,deny
25297,11530,0,0,145,145,0,1,0,1,0,deny
0,0,0,0,164,164,0,2,0,2,0,deny
0,0,0,0,70,70,0,1,0,1,0,deny
56481,445,0,0,66,66,0,1,0,1,0,drop
61072,445,0,0,70,70,0,1,0,1,0,drop
5222,27389,0,0,66,66,0,1,0,1,0,deny
56146,445,0,0,70,70,0,1,0,1,0,drop
38852,37965,0,0,62,62,0,1,0,1,0,deny
56479,445,0,0,66,66,0,1,0,1,0,drop
48557,37965,0,0,62,62,0,1,0,1,0,deny
56472,445,0,0,66,66,0,1,0,1,0,drop
56142,445,0,0,70,70,0,1,0,1,0,drop
57820,32753,0,0,361,361,0,1,0,1,0,deny
56461,445,0,0,66,66,0,1,0,1,0,drop
17010,57470,0,0,62,62,0,1,0,1,0,deny
56133,445,0,0,70,70,0,1,0,1,0,drop
56131,445,0,0,70,70,0,1,0,1,0,drop
56130,445,0,0,70,70,0,1,0,1,0,drop
56129,445,0,0,70,70,0,1,0,1,0,drop
56126,445,0,0,70,70,0,1,0,1,0,drop
30015,36237,0,0,66,66,0,1,0,1,0,deny
61062,445,0,0,70,70,0,1,0,1,0,drop
61060,445,0,0,70,70,0,1,0,1,0,drop
61059,445,0,0,70,70,0,1,0,1,0,drop
56456,445,0,0,66,66,0,1,0,1,0,drop
56450,445,0,0,66,66,0,1,0,1,0,drop
56455,445,0,0,66,66,0,1,0,1,0,drop
56453,445,0,0,66,66,0,1,0,1,0,drop
56454,445,0,0,66,66,0,1,0,1,0,drop
56449,445,0,0,66,66,0,1,0,1,0,drop
56451,445,0,0,66,66,0,1,0,1,0,drop
56448,445,0,0,66,66,0,1,0,1,0,drop
1663,30188,0,0,62,62,0,1,0,1,0,deny
443,20087,0,0,83,83,0,1,0,1,0,deny
23277,53733,0,0,66,66,0,1,0,1,0,deny
50090,50265,0,0,66,66,0,1,0,1,0,deny
49186,53,49186,53,257,101,156,2,32,1,1,allow
53710,80,64568,80,2499,531,1968,11,75,6,5,allow
50504,443,62477,443,6051,1149,4902,16,25,9,7,allow
61335,443,41509,443,42437,8035,34402,79,247,30,49,allow
41973,443,27764,443,26109,3251,22858,60,256,31,29,allow
53711,80,6435,80,2391,532,1859,11,75,6,5,allow
50500,80,1291,80,318,192,126,6,25,4,2,allow
50499,80,43182,80,318,192,126,6,25,4,2,allow
59623,161,0,0,11212,5520,5692,58,30,29,29,allow
49488,443,58643,443,90030,13137,76893,92,47,29,63,allow
53713,80,58765,80,5778,661,5117,17,75,8,9,allow
50479,80,2241,80,312,192,120,6,25,4,2,allow
61304,443,62811,443,8594,1042,7552,16,120,7,9,allow
61496,443,4674,443,27232,3841,23391,42,38,17,25,allow
50125,443,44397,443,9798,3571,6227,43,143,23,20,allow
36520,3142,36520,3142,138,78,60,2,5,1,1,allow
61338,443,62752,443,39067,7713,31354,74,247,29,45,allow
48890,443,48166,443,79665,4371,75294,110,256,45,65,allow
27005,27016,41130,27016,1622,126,1496,4,31,2,2,allow
36601,443,32906,443,16455,11185,5270,37,271,22,15,allow
53712,80,11675,80,2424,529,1895,11,75,6,5,allow
39569,443,39569,443,4601,1694,2907,19,28,11,8,allow
46984,443,45323,443,416,210,206,7,35,4,3,allow
61337,443,54439,443,31111,6287,24824,62,247,25,37,allow
37533,443,8271,443,5516,1774,3742,21,46,13,8,allow
62900,993,6178,993,12900,4980,7920,91,117,51,40,allow
50501,80,58618,80,318,192,126,6,25,4,2,allow
50503,443,63118,443,5987,1085,4902,15,25,8,7,allow
50502,80,37094,80,318,192,126,6,25,4,2,allow
59684,443,44849,443,5173,860,4313,16,15,9,7,allow
50492,80,56917,80,318,192,126,6,25,4,2,allow
65025,443,1842,443,2227,1018,1209,17,16,8,9,allow
38476,161,0,0,3304,1560,1744,18,30,9,9,allow
52042,53,52042,53,81,81,0,1,30,1,0,allow
44032,161,0,0,4491,2143,2348,24,30,12,12,allow
27005,27050,14571,27050,1684,126,1558,4,31,2,2,allow
61339,443,59710,443,31648,6288,25360,62,247,25,37,allow
61336,443,63223,443,34919,6979,27940,68,247,27,41,allow
40811,80,13530,80,31286,2032,29254,50,30,26,24,allow
50491,80,59883,80,318,192,126,6,25,4,2,allow
27005,30003,56044,30003,1640,126,1514,4,30,2,2,allow
57161,53,1657,53,711,87,624,2,30,1,1,allow
51566,443,47460,443,9451,3719,5732,45,76,25,20,allow
52537,443,37723,443,132577,21019,111558,348,236,142,206,allow
8889,16991,8889,16991,124,60,64,2,31,1,1,allow
27005,27019,21783,27019,1648,126,1522,4,31,2,2,allow
55958,53,60321,53,170,87,83,2,31,1,1,allow
56351,53,13734,53,306,99,207,2,31,1,1,allow
49302,443,8225,443,3182,1568,1614,8,120,4,4,allow
65487,443,51445,443,3641,886,2755,13,136,6,7,allow
50701,443,1473,443,45394,5743,39651,133,233,49,84,allow
27005,27022,12480,27022,1882,378,1504,6,31,4,2,allow
50164,443,9375,443,3312,1098,2214,19,137,10,9,allow
5757,80,5757,80,104444,4047,100397,122,126,52,70,allow
53548,443,53548,443,1386,751,635,15,181,8,7,allow
62299,53,62299,53,259,108,151,2,31,1,1,allow
42870,443,3034,443,20248,1033,19215,28,3620,9,19,allow
63927,50265,0,0,62,62,0,1,0,1,0,deny
58574,21247,0,0,66,66,0,1,0,1,0,deny
63445,64631,0,0,66,66,0,1,0,1,0,deny
35460,35440,0,0,146,146,0,1,0,1,0,deny
56119,445,0,0,70,70,0,1,0,1,0,drop
27773,56205,0,0,146,146,0,1,0,1,0,deny
45908,33330,0,0,60,60,0,1,0,1,0,deny
22275,51505,0,0,62,62,0,1,0,1,0,deny
61057,445,0,0,70,70,0,1,0,1,0,drop
61055,445,0,0,70,70,0,1,0,1,0,drop
61051,445,0,0,70,70,0,1,0,1,0,drop
9283,57470,0,0,66,66,0,1,0,1,0,deny
63768,53,12206,53,298,102,196,2,30,1,1,allow
64133,53,32044,53,216,102,114,2,30,1,1,allow
16387,3655,0,0,60,60,0,1,0,1,0,deny
56112,445,0,0,70,70,0,1,0,1,0,drop
16387,22272,0,0,60,60,0,1,0,1,0,deny
16387,20045,0,0,60,60,0,1,0,1,0,deny
56111,445,0,0,70,70,0,1,0,1,0,drop
56436,445,0,0,66,66,0,1,0,1,0,drop
56434,445,0,0,66,66,0,1,0,1,0,drop
56435,445,0,0,66,66,0,1,0,1,0,drop
16387,44427,0,0,60,60,0,1,0,1,0,deny
16387,7205,0,0,60,60,0,1,0,1,0,deny
16387,63752,0,0,60,60,0,1,0,1,0,deny
16387,35583,0,0,60,60,0,1,0,1,0,deny
16387,16862,0,0,60,60,0,1,0,1,0,deny
16387,64075,0,0,60,60,0,1,0,1,0,deny
61041,445,0,0,70,70,0,1,0,1,0,drop
33193,50584,0,0,62,62,0,1,0,1,0,deny
13281,51050,0,0,66,66,0,1,0,1,0,deny
46839,51050,0,0,146,146,0,1,0,1,0,deny
51324,11392,0,0,66,66,0,1,0,1,0,deny
56106,445,0,0,70,70,0,1,0,1,0,drop
54210,36237,0,0,62,62,0,1,0,1,0,deny
61039,445,0,0,70,70,0,1,0,1,0,drop
56104,445,0,0,70,70,0,1,0,1,0,drop
2918,37965,0,0,62,62,0,1,0,1,0,deny
61033,445,0,0,70,70,0,1,0,1,0,drop
61031,445,0,0,70,70,0,1,0,1,0,drop
61029,445,0,0,70,70,0,1,0,1,0,drop
56256,62413,0,0,66,66,0,1,0,1,0,deny
35120,26467,0,0,62,62,0,1,0,1,0,deny
63447,44847,0,0,66,66,0,1,0,1,0,deny
13462,35440,0,0,66,66,0,1,0,1,0,deny
443,20087,0,0,83,83,0,1,0,1,0,deny
56653,22114,0,0,66,66,0,1,0,1,0,deny
56100,445,0,0,70,70,0,1,0,1,0,drop
52430,35440,0,0,62,62,0,1,0,1,0,deny
27785,37965,0,0,66,66,0,1,0,1,0,deny
56099,445,0,0,70,70,0,1,0,1,0,drop
39056,22114,0,0,62,62,0,1,0,1,0,deny
61020,445,0,0,70,70,0,1,0,1,0,drop
61017,445,0,0,70,70,0,1,0,1,0,drop
61016,445,0,0,70,70,0,1,0,1,0,drop
56094,445,0,0,70,70,0,1,0,1,0,drop
50496,80,19242,80,318,192,126,6,25,4,2,allow
50480,80,36021,80,318,192,126,6,25,4,2,allow
55496,80,55496,80,1099,578,521,10,15,6,4,allow
58556,80,23584,80,884,529,355,10,255,6,4,allow
53709,443,33210,443,7356,1014,6342,20,75,10,10,allow
49710,53,28433,53,480,93,387,4,50,2,2,allow
60796,53,56563,53,296,94,202,2,29,1,1,allow
56659,443,25934,443,1579,988,591,13,24,7,6,allow
56653,443,38474,443,8059,2039,6020,20,15,11,9,allow
50497,80,3021,80,19946,10573,9373,29,25,14,15,allow
40919,443,40161,443,12243,6818,5425,30,314,16,14,allow
62778,443,47503,443,6676,2316,4360,34,318,16,18,allow
39107,443,62182,443,692830,23263,669567,784,114,306,478,allow
57429,443,7406,443,15017,8283,6734,47,18,24,23,allow
27005,27016,13972,27016,1656,126,1530,4,30,2,2,allow
63938,53,63032,53,385,110,275,2,30,1,1,allow
49172,53,32719,53,227,102,125,2,29,1,1,allow
65352,53,63363,53,321,102,219,2,29,1,1,allow
52042,53,52042,53,478,292,186,5,30,3,2,allow
55640,54435,42654,54435,70,70,0,1,5,1,0,allow
50482,80,36252,80,314,192,122,6,25,4,2,allow
41911,443,53613,443,9499,3786,5713,31,315,16,15,allow
42767,443,1762,443,8995,2498,6497,40,256,19,21,allow
62139,53,5028,53,298,102,196,2,30,1,1,allow
64845,53,4147,53,289,110,179,2,30,1,1,allow
55234,443,6100,443,9176,2226,6950,28,31,16,12,allow
56336,53,52213,53,196,102,94,2,35,1,1,allow
64514,53,39075,53,437,88,349,4,41,2,2,allow
50498,80,12035,80,312,192,120,6,25,4,2,allow
50490,80,51282,80,318,192,126,6,25,4,2,allow
56630,443,17918,443,6156,918,5238,18,26,10,8,allow
57232,443,17235,443,51152,3321,47831,81,100,38,43,allow
27176,53,64798,53,396,257,139,3,30,2,1,allow
36008,443,16915,443,5378,1423,3955,19,56,11,8,allow
58851,443,28195,443,344,130,214,6,77,3,3,allow
21544,41599,31043,41599,70,70,0,1,5,1,0,allow
56651,443,21328,443,8058,2038,6020,20,15,11,9,allow
47640,443,10100,443,1058,571,487,10,38,6,4,allow
56724,53,0,0,86,86,0,1,30,1,0,allow
65207,53,42618,53,277,110,167,2,30,1,1,allow
57092,53,43166,53,270,102,168,2,30,1,1,allow
5588,5588,0,0,3562,1936,1626,48,195,24,24,allow
50489,80,24870,80,318,192,126,6,25,4,2,allow
57942,443,1661,443,2791,1800,991,26,185,15,11,allow
62894,993,44411,993,8840,4151,4689,80,190,41,39,allow
50505,80,62173,80,318,192,126,6,25,4,2,allow
57386,443,57835,443,1056,569,487,10,38,6,4,allow
47638,443,5364,443,1056,569,487,10,38,6,4,allow
49932,443,32840,443,8428,1889,6539,25,16,13,12,allow
46531,123,21322,123,184,94,90,2,30,1,1,allow
60379,443,13895,443,9593,3182,6411,19,23,8,11,allow
6881,6881,5588,6881,324,150,174,2,1203,1,1,allow
62765,443,43288,443,52223,3318,48905,75,321,30,45,allow
65428,53,65157,53,516,86,430,4,32,2,2,allow
50493,80,1565,80,318,192,126,6,25,4,2,allow
62899,993,51481,993,9385,3246,6139,53,118,31,22,allow
5588,5588,0,0,3562,1936,1626,48,194,24,24,allow
39101,443,49967,443,201217,15748,185469,327,207,163,164,allow
49159,53,48232,53,213,102,111,2,29,1,1,allow
52523,443,12913,443,4307,2005,2302,37,18,20,17,allow
58039,161,0,0,11672,5710,5962,60,29,30,30,allow
27005,27015,18996,27015,1618,126,1492,4,30,2,2,allow
53664,13701,26986,13701,70,70,0,1,4,1,0,allow
56395,443,25199,443,7018,2751,4267,24,39,11,13,allow
57470,32348,51610,32348,527,166,361,2,1199,1,1,allow
50481,80,4638,80,318,192,126,6,25,4,2,allow
55270,443,14179,443,6098,778,5320,17,15,8,9,allow
37855,443,39398,443,25928,15100,10828,59,39,37,22,allow
35098,161,0,0,15190,7454,7736,78,30,39,39,allow
56652,443,7084,443,8006,1986,6020,20,15,11,9,allow
57372,53,20962,53,177,94,83,2,30,1,1,allow
65481,443,11803,443,138507,5990,132517,156,16,60,96,allow
33882,80,63489,80,1454,866,588,11,58,7,4,allow
35716,53,38842,53,168,78,90,2,30,1,1,allow
55153,443,47094,443,5897,1982,3915,20,18,11,9,allow
49771,53,64611,53,272,110,162,2,30,1,1,allow
56341,53,28637,53,213,102,111,2,29,1,1,allow
51667,25826,12114,25826,9434,9434,0,11,30,11,0,allow
64791,53,19786,53,526,197,329,6,49,3,3,allow
55917,53,58501,53,371,109,262,4,59,2,2,allow
64209,53,40539,53,291,94,197,2,29,1,1,allow
57370,53,22264,53,347,110,237,2,30,1,1,allow
34891,53,37025,53,396,257,139,3,30,2,1,allow
54052,443,54052,443,1386,751,635,15,181,8,7,allow
57470,53756,4202,53756,132,132,0,3,1199,3,0,allow
48817,51413,48817,51413,460,150,310,2,1200,1,1,allow
55877,38597,28809,38597,481,150,331,2,1200,1,1,allow
53130,443,53130,443,3121,1764,1357,19,181,10,9,allow
54053,443,54053,443,1468,763,705,16,181,8,8,allow
53591,443,53591,443,1468,763,705,16,181,8,8,allow
57470,23848,47855,23848,545,166,379,2,1199,1,1,allow
51868,30305,49639,30305,70,70,0,2,8,2,0,allow
63981,53,39748,53,329,86,243,4,42,2,2,allow
54842,443,49660,443,5860,1151,4709,18,283,10,8,allow
57384,443,57610,443,1054,567,487,10,38,6,4,allow
62888,993,63963,993,8786,4118,4668,80,200,41,39,allow
14914,443,14914,443,16960,1347,15613,28,17,10,18,allow
57372,53,54871,53,177,94,83,2,30,1,1,allow
36765,443,20693,443,27557,20627,6930,89,5581,44,45,allow
37621,80,10654,80,350,210,140,6,15,4,2,allow
59863,443,54710,443,12809,7765,5044,95,84,55,40,allow
57729,443,45932,443,12689,5742,6947,26,43,14,12,allow
54966,53,44405,53,171,88,83,3,33,2,1,allow
51869,25355,58736,25355,70,70,0,2,8,2,0,allow
10035,443,49026,443,7915,1634,6281,25,315,11,14,allow
64268,53,45536,53,334,103,231,4,54,2,2,allow
50018,53,44491,53,270,102,168,2,30,1,1,allow
8282,39458,7982,39458,78,78,0,1,30,1,0,allow
56233,53,2635,53,399,97,302,4,59,2,2,allow
65073,53,40365,53,293,102,191,2,30,1,1,allow
55958,53,40832,53,177,94,83,2,30,1,1,allow
58869,443,38937,443,4657,2146,2511,14,135,7,7,allow
44847,17977,12872,17977,502,150,352,2,1200,1,1,allow
50506,80,64243,80,318,192,126,6,25,4,2,allow
50488,80,56611,80,318,192,126,6,25,4,2,allow
50495,80,9941,80,312,192,120,6,25,4,2,allow
50483,80,35746,80,374,192,182,7,25,4,3,allow
51641,443,64110,443,4692,2882,1810,32,80,14,18,allow
56198,443,56198,443,27729,5508,22221,60,18,31,29,allow
51867,48059,33998,48059,258,70,188,4,8,2,2,allow
39616,443,20055,443,60,60,0,2,5,2,0,allow
49761,53,36428,53,373,99,274,4,41,2,2,allow
50477,80,59736,80,648,256,392,8,25,5,3,allow
56654,443,53376,443,4972,2136,2836,21,24,12,9,allow
65482,443,24363,443,92212,4799,87413,107,16,43,64,allow
55004,53,63304,53,270,102,168,2,30,1,1,allow
44169,443,53615,443,12098,5328,6770,25,121,12,13,allow
35212,443,26645,443,4477,2350,2127,16,135,8,8,allow
5819,53,5819,53,197,90,107,2,30,1,1,allow
27005,27016,54268,27016,1642,126,1516,4,31,2,2,allow
25504,53,50116,53,311,86,225,2,30,1,1,allow
49818,53,37745,53,86,86,0,1,30,1,0,allow
49301,443,34200,443,7616,3064,4552,14,120,6,8,allow
36762,443,56086,443,13119,3359,9760,39,120,19,20,allow
64537,443,9854,443,3182,1568,1614,8,120,4,4,allow
6882,6999,21724,6999,228,118,110,2,1200,1,1,allow
30188,41184,4045,41184,509,150,359,2,1200,1,1,allow
56888,443,32016,443,15807,12220,3587,44,242,18,26,allow
52038,80,51825,80,70,70,0,1,5,1,0,allow
51846,41510,42814,41510,70,70,0,1,5,1,0,allow
64753,53,63867,53,94,94,0,1,30,1,0,allow
49622,53,58073,53,244,94,150,2,30,1,1,allow
50098,443,16798,443,12942,3659,9283,66,217,36,30,allow
62887,993,3389,993,8921,4675,4246,77,200,47,30,allow
51866,23431,38401,23431,70,70,0,2,8,2,0,allow
51467,443,51893,443,194,70,124,3,11,1,2,allow
49406,443,41618,443,7808,2879,4929,36,186,19,17,allow
64191,53,1179,53,212,102,110,2,30,1,1,allow
64164,53,32232,53,229,102,127,2,30,1,1,allow
55498,53,0,0,86,86,0,1,30,1,0,allow
443,20087,0,0,83,83,0,1,0,1,0,deny
10916,44847,0,0,62,62,0,1,0,1,0,deny
49717,57470,0,0,62,62,0,1,0,1,0,deny
52575,22114,0,0,62,62,0,1,0,1,0,deny
47256,37807,0,0,146,146,0,1,0,1,0,deny
52720,35894,0,0,62,62,0,1,0,1,0,deny
15341,23,0,0,60,60,0,1,0,1,0,deny
29000,48817,0,0,148,148,0,1,0,1,0,deny
28897,35440,0,0,66,66,0,1,0,1,0,deny
50637,44847,0,0,66,66,0,1,0,1,0,deny
56410,445,0,0,66,66,0,1,0,1,0,drop
56835,35894,0,0,66,66,0,1,0,1,0,deny
61013,445,0,0,70,70,0,1,0,1,0,drop
61012,445,0,0,70,70,0,1,0,1,0,drop
14059,21247,0,0,62,62,0,1,0,1,0,deny
43540,1433,0,0,60,60,0,1,0,1,0,deny
40474,23117,0,0,62,62,0,1,0,1,0,deny
50716,50584,0,0,74,74,0,1,0,1,0,deny
736,23,0,0,60,60,0,1,0,1,0,deny
7273,64147,0,0,66,66,0,1,0,1,0,deny
56081,445,0,0,70,70,0,1,0,1,0,drop
60646,11392,0,0,66,66,0,1,0,1,0,deny
58131,42416,0,0,146,146,0,1,0,1,0,deny
59739,35253,0,0,62,62,0,1,0,1,0,deny
60126,35440,0,0,66,66,0,1,0,1,0,deny
56406,445,0,0,66,66,0,1,0,1,0,drop
45964,3111,0,0,60,60,0,1,0,1,0,deny
56078,445,0,0,70,70,0,1,0,1,0,drop
27783,57470,0,0,62,62,0,1,0,1,0,deny
56404,445,0,0,66,66,0,1,0,1,0,drop
60999,445,0,0,70,70,0,1,0,1,0,drop
60997,445,0,0,70,70,0,1,0,1,0,drop
60994,445,0,0,70,70,0,1,0,1,0,drop
60993,445,0,0,70,70,0,1,0,1,0,drop
64903,51050,0,0,66,66,0,1,0,1,0,deny
23770,50584,0,0,66,66,0,1,0,1,0,deny
56400,445,0,0,66,66,0,1,0,1,0,drop
58382,50584,0,0,146,146,0,1,0,1,0,deny
59564,57470,0,0,66,66,0,1,0,1,0,deny
35163,30188,0,0,62,62,0,1,0,1,0,deny
443,20087,0,0,83,83,0,1,0,1,0,deny
56073,445,0,0,70,70,0,1,0,1,0,drop
59937,37965,0,0,66,66,0,1,0,1,0,deny
20400,64147,0,0,62,62,0,1,0,1,0,deny
1334,8497,0,0,148,148,0,1,0,1,0,deny
56072,445,0,0,70,70,0,1,0,1,0,drop
60987,445,0,0,70,70,0,1,0,1,0,drop
56070,445,0,0,70,70,0,1,0,1,0,drop
60984,445,0,0,70,70,0,1,0,1,0,drop
60982,445,0,0,70,70,0,1,0,1,0,drop
60980,445,0,0,70,70,0,1,0,1,0,drop
53090,59356,0,0,66,66,0,1,0,1,0,deny
41220,59356,0,0,62,62,0,1,0,1,0,deny
10775,35440,0,0,66,66,0,1,0,1,0,deny
56395,445,0,0,66,66,0,1,0,1,0,drop
56392,445,0,0,66,66,0,1,0,1,0,drop
6666,50070,0,0,60,60,0,1,0,1,0,deny
56391,445,0,0,66,66,0,1,0,1,0,drop
56386,445,0,0,66,66,0,1,0,1,0,drop
40185,64147,0,0,66,66,0,1,0,1,0,deny
44496,57470,0,0,66,66,0,1,0,1,0,deny
56384,445,0,0,66,66,0,1,0,1,0,drop
56385,445,0,0,66,66,0,1,0,1,0,drop
56383,445,0,0,66,66,0,1,0,1,0,drop
3996,57470,0,0,62,62,0,1,0,1,0,deny
65526,28793,0,0,66,66,0,1,0,1,0,deny
61902,22114,0,0,66,66,0,1,0,1,0,deny
17534,50584,0,0,146,146,0,1,0,1,0,deny
56063,445,0,0,70,70,0,1,0,1,0,drop
60978,445,0,0,70,70,0,1,0,1,0,drop
60977,445,0,0,70,70,0,1,0,1,0,drop
50052,65008,0,0,60,60,0,1,0,1,0,deny
60972,445,0,0,70,70,0,1,0,1,0,drop
56381,445,0,0,66,66,0,1,0,1,0,drop
56061,445,0,0,70,70,0,1,0,1,0,drop
60971,445,0,0,70,70,0,1,0,1,0,drop
56377,445,0,0,66,66,0,1,0,1,0,drop
58131,1,0,0,146,146,0,1,0,1,0,deny
56060,445,0,0,70,70,0,1,0,1,0,drop
56375,445,0,0,66,66,0,1,0,1,0,drop
56373,445,0,0,66,66,0,1,0,1,0,drop
56059,445,0,0,70,70,0,1,0,1,0,drop
56058,445,0,0,70,70,0,1,0,1,0,drop
56371,445,0,0,66,66,0,1,0,1,0,drop
56053,445,0,0,70,70,0,1,0,1,0,drop
56052,445,0,0,70,70,0,1,0,1,0,drop
55678,5618,0,0,145,145,0,1,0,1,0,reset-both
48258,37965,0,0,62,62,0,1,0,1,0,deny
43584,24748,0,0,156,156,0,1,0,1,0,deny
43584,24748,0,0,156,156,0,1,0,1,0,deny
0,0,0,0,480,244,236,4,0,2,2,allow
1972,57470,0,0,78,78,0,1,0,1,0,deny
60965,445,0,0,70,70,0,1,0,1,0,drop
57612,28793,0,0,66,66,0,1,0,1,0,deny
63621,30188,0,0,62,62,0,1,0,1,0,deny
56040,445,0,0,70,70,0,1,0,1,0,drop
56039,445,0,0,70,70,0,1,0,1,0,drop
59435,37807,0,0,66,66,0,1,0,1,0,deny
51032,30188,0,0,62,62,0,1,0,1,0,deny
56035,445,0,0,70,70,0,1,0,1,0,drop
60959,445,0,0,70,70,0,1,0,1,0,drop
60957,445,0,0,70,70,0,1,0,1,0,drop
45099,57470,0,0,62,62,0,1,0,1,0,deny
56030,445,0,0,70,70,0,1,0,1,0,drop
56029,445,0,0,70,70,0,1,0,1,0,drop
63867,64147,0,0,62,62,0,1,0,1,0,deny
24236,8055,0,0,148,148,0,1,0,1,0,deny
56360,445,0,0,66,66,0,1,0,1,0,drop
5285,64147,0,0,145,145,0,1,0,1,0,deny
15641,26467,0,0,62,62,0,1,0,1,0,deny
50901,26467,0,0,66,66,0,1,0,1,0,deny
55311,44847,0,0,62,62,0,1,0,1,0,deny
22835,51221,0,0,62,62,0,1,0,1,0,deny
58398,44847,0,0,62,62,0,1,0,1,0,deny
54028,37965,0,0,66,66,0,1,0,1,0,deny
56018,445,0,0,70,70,0,1,0,1,0,drop
56353,445,0,0,66,66,0,1,0,1,0,drop
60943,445,0,0,70,70,0,1,0,1,0,drop
1040,37965,0,0,62,62,0,1,0,1,0,deny
20608,28189,0,0,60,60,0,1,0,1,0,deny
36034,35440,0,0,62,62,0,1,0,1,0,deny
19875,30170,0,0,145,145,0,1,0,1,0,deny
56752,44847,0,0,66,66,0,1,0,1,0,deny
56350,445,0,0,66,66,0,1,0,1,0,drop
58381,57470,0,0,66,66,0,1,0,1,0,deny
60398,46776,0,0,74,74,0,1,0,1,0,deny
32968,43890,0,0,146,146,0,1,0,1,0,deny
33354,10387,0,0,148,148,0,1,0,1,0,deny
56014,445,0,0,70,70,0,1,0,1,0,drop
56343,445,0,0,66,66,0,1,0,1,0,drop
53625,64147,0,0,66,66,0,1,0,1,0,deny
56341,445,0,0,66,66,0,1,0,1,0,drop
65289,46776,0,0,66,66,0,1,0,1,0,deny
58369,443,14100,443,155345,11568,143777,195,195,73,122,allow
59112,443,3834,443,7174,1831,5343,31,110,17,14,allow
59117,443,59117,443,4659,1752,2907,19,30,11,8,allow
49653,443,56043,443,8915,2193,6722,22,46,13,9,allow
58999,53,58999,53,825,99,726,2,30,1,1,allow
8978,53,8978,53,1415,689,726,3,30,2,1,allow
59733,443,53510,443,7165,2077,5088,22,105,12,10,allow
55158,443,7666,443,7963,2657,5306,29,333,13,16,allow
52814,53,53198,53,578,286,292,9,15,5,4,allow
37390,80,51104,80,234,234,0,4,12,4,0,allow
53376,443,49944,443,4814,1207,3607,17,75,10,7,allow
27005,27015,26613,27015,1664,126,1538,4,30,2,2,allow
63015,53,58315,53,303,85,218,2,31,1,1,allow
63016,443,62521,443,303,85,218,2,31,1,1,allow
63024,53,42862,53,569,164,405,2,30,1,1,allow
27005,27020,51720,27020,1626,126,1500,4,30,2,2,allow
27005,27011,25017,27011,1622,126,1496,4,31,2,2,allow
27005,27024,9068,27024,1760,252,1508,5,31,3,2,allow
51631,443,52849,443,36602,1919,34683,58,80,19,39,allow
27005,27020,2257,27020,1622,126,1496,4,31,2,2,allow
43435,5228,26335,5228,6668,1369,5299,20,3600,10,10,allow
63023,443,14505,443,382,164,218,2,30,1,1,allow
38815,53,38815,53,230,99,131,2,30,1,1,allow
37132,443,37132,443,4381,1474,2907,19,27,11,8,allow
37836,443,46026,443,4647,1536,3111,25,40,12,13,allow
48238,443,41856,443,2227,1018,1209,17,15,8,9,allow
56627,443,41594,443,4499,947,3552,14,25,8,6,allow
63835,30794,25747,30794,66,66,0,1,5,1,0,allow
63849,16632,35962,16632,66,66,0,2,8,2,0,allow
60421,6882,25350,6882,70,70,0,1,5,1,0,allow
59259,80,59259,80,101244,15308,85936,165,15,53,112,allow
50324,443,9934,443,8725,2284,6441,17,120,8,9,allow
26050,22448,0,0,62,62,0,1,60,1,0,allow
53377,443,17654,443,4814,1207,3607,17,75,10,7,allow
49450,443,58155,443,8411,2042,6369,25,251,13,12,allow
57932,443,47126,443,29612,2205,27407,53,186,21,32,allow
64080,443,11837,443,75064,64938,10126,147,277,71,76,allow
27005,27015,57738,27015,1638,126,1512,4,30,2,2,allow
50119,443,44388,443,10557,2063,8494,40,144,22,18,allow
38436,5222,53562,5222,7338,3611,3727,74,616,37,37,allow
59128,443,26405,443,92207,5395,86812,130,88,58,72,allow
27005,27018,56521,27018,1672,126,1546,4,30,2,2,allow
57470,47191,13630,47191,528,528,0,9,1200,9,0,allow
27005,27019,64712,27019,1624,126,1498,4,31,2,2,allow
27005,27017,53801,27017,1634,126,1508,4,31,2,2,allow
47595,33437,0,0,106,106,0,1,61,1,0,allow
51221,51413,6783,51413,459,149,310,2,1201,1,1,allow
65160,443,49536,443,1786,172,1614,7,120,3,4,allow
56005,445,0,0,70,70,0,1,0,1,0,drop
56003,445,0,0,70,70,0,1,0,1,0,drop
54520,1433,0,0,60,60,0,1,0,1,0,deny
56001,445,0,0,70,70,0,1,0,1,0,drop
56000,445,0,0,70,70,0,1,0,1,0,drop
61085,37965,0,0,62,62,0,1,0,1,0,deny
55997,445,0,0,70,70,0,1,0,1,0,drop
64997,51221,0,0,66,66,0,1,0,1,0,deny
33801,62413,0,0,66,66,0,1,0,1,0,deny
26180,35440,0,0,66,66,0,1,0,1,0,deny
59352,37965,0,0,66,66,0,1,0,1,0,deny
34306,37965,0,0,62,62,0,1,0,1,0,deny
50481,443,29111,443,16160,13969,2191,42,80,23,19,allow
41981,443,19357,443,5164,2984,2180,42,1285,26,16,allow
64363,53,54171,53,212,102,110,2,30,1,1,allow
50127,80,7047,80,164773,6196,158577,200,135,83,117,allow
63785,55255,57684,55255,3706,2125,1581,18,33,10,8,allow
43223,443,31934,443,836939,25380,811559,864,64,302,562,allow
56838,35124,44520,35124,70,70,0,1,5,1,0,allow
43487,443,46134,443,10015,3476,6539,30,28,19,11,allow
60433,123,65242,123,184,94,90,2,29,1,1,allow
55624,53,62232,53,244,94,150,2,29,1,1,allow
62895,993,31409,993,10457,4879,5578,98,186,50,48,allow
62893,993,15179,993,8883,4621,4262,76,191,47,29,allow
56837,53,27740,53,195,102,93,2,32,1,1,allow
26783,443,21530,443,22489,15918,6571,39,26,21,18,allow
60287,80,62692,80,1052,612,440,10,15,5,5,allow
62889,993,15893,993,9608,4549,5059,88,199,45,43,allow
56650,443,37147,443,8008,1988,6020,20,15,11,9,allow
63848,48560,48756,48560,66,66,0,2,7,2,0,allow
63850,6881,54520,6881,66,66,0,2,7,2,0,allow
62892,993,17111,993,9588,4811,4777,85,193,49,36,allow
49931,443,45441,443,3278,1835,1443,22,16,13,9,allow
55193,53,55120,53,200,102,98,2,33,1,1,allow
56837,53,4890,53,195,102,93,2,29,1,1,allow
65106,53,17651,53,354,94,260,2,29,1,1,allow
57831,443,53060,443,1320606,47731,1272875,1454,294,552,902,allow
39978,443,51684,443,6834,2189,4645,40,29,26,14,allow
56649,443,38913,443,8060,2040,6020,20,15,11,9,allow
58679,53,27207,53,298,102,196,2,29,1,1,allow
55958,53,62913,53,177,94,83,2,29,1,1,allow
56346,53,56346,53,262,106,156,2,32,1,1,allow
54703,53,49581,53,168,78,90,2,30,1,1,allow
38771,443,39867,443,7407,3501,3906,18,15,10,8,allow
63021,443,34609,443,512,166,346,2,30,1,1,allow
63830,15847,65256,15847,1592,1044,548,15,15,9,6,allow
56648,443,26064,443,8007,1987,6020,20,15,11,9,allow
38871,80,51643,80,2057,1263,794,10,15,6,4,allow
50120,443,33702,443,23870,3485,20385,55,143,29,26,allow
56839,49949,49715,49949,70,70,0,1,5,1,0,allow
59258,80,59258,80,107904,4143,103761,179,15,59,120,allow
56658,443,12805,443,1560,988,572,13,23,7,6,allow
42522,443,26969,443,7352,1592,5760,25,16,15,10,allow
49408,443,47633,443,4728,2928,1800,28,95,15,13,allow
64047,53,55544,53,604,89,515,4,45,2,2,allow
58481,53,42506,53,290,110,180,2,30,1,1,allow
35722,123,29832,123,94,94,0,1,30,1,0,allow
63027,443,10834,443,384,166,218,2,30,1,1,allow
64338,53,41701,53,200,102,98,2,30,1,1,allow
65188,53,34848,53,213,102,111,2,30,1,1,allow
39615,443,17497,443,130,70,60,3,5,2,1,allow
49166,443,10443,443,70,70,0,1,5,1,0,allow
44034,80,44034,80,18510,706,17804,22,16,6,16,allow
49250,53,62470,53,298,87,211,4,48,2,2,allow
35321,443,13287,443,9675,2671,7004,36,262,18,18,allow
58558,53,58236,53,268,86,182,2,30,1,1,allow
51497,443,14907,443,8939,3462,5477,25,263,12,13,allow
56630,80,55230,80,234,234,0,4,12,4,0,allow
46460,443,35545,443,5117,3501,1616,29,80,15,14,allow
65282,53,57609,53,522,91,431,4,49,2,2,allow
37900,53,2466,53,78,78,0,1,30,1,0,allow
55958,53,14434,53,177,94,83,2,30,1,1,allow
55995,443,59419,443,7563,2253,5310,20,157,11,9,allow
53819,443,53819,443,1386,751,635,15,180,8,7,allow
63020,443,53282,443,512,166,346,2,30,1,1,allow
57476,443,16400,443,10068,3304,6764,28,36,17,11,allow
52069,443,58319,443,8593,2221,6372,31,232,17,14,allow
34083,443,2580,443,7510,2040,5470,24,210,13,11,allow
50222,443,19718,443,9582,2201,7381,28,99,14,14,allow
62886,993,19324,993,9557,4773,4784,84,199,48,36,allow
62890,993,29471,993,9624,4559,5065,88,196,45,43,allow
51871,23801,64442,23801,316,136,180,6,6,3,3,allow
63837,14023,26076,14023,70,70,0,1,4,1,0,allow
54966,53,59029,53,255,88,167,4,32,2,2,allow
63836,14791,37606,14791,70,70,0,1,4,1,0,allow
49995,53,53855,53,303,98,205,4,40,2,2,allow
51865,14732,26909,14732,70,70,0,2,7,2,0,allow
37356,443,58036,443,1842,1134,708,14,315,8,6,allow
65465,53,18720,53,293,102,191,2,29,1,1,allow
49684,53,21165,53,305,94,211,2,29,1,1,allow
50118,443,10177,443,125395,8711,116684,178,143,83,95,allow
50129,443,15530,443,9199,2329,6870,30,133,17,13,allow
52072,443,62613,443,7737,6531,1206,21,16,12,9,allow
49497,53,38810,53,297,102,195,2,29,1,1,allow
55600,53,56237,53,168,78,90,2,30,1,1,allow
55762,53,8136,53,196,86,110,2,29,1,1,allow
55762,53,54612,53,184,102,82,2,29,1,1,allow
65212,53,14498,53,273,118,155,2,30,1,1,allow
65093,53,16648,53,266,118,148,2,29,1,1,allow
57065,53,34013,53,272,110,162,2,29,1,1,allow
65389,53,51653,53,94,94,0,1,30,1,0,allow
39814,53,58386,53,168,78,90,2,30,1,1,allow
55193,53,45543,53,200,102,98,2,30,1,1,allow
49378,53,56071,53,268,94,174,2,30,1,1,allow
64512,53,55792,53,244,118,126,2,30,1,1,allow
34531,443,54332,443,135231,5033,130198,149,216,55,94,allow
57996,53,57996,53,265,114,151,2,30,1,1,allow
56663,443,26392,443,9691,2221,7470,16,120,8,8,allow
55308,443,1473,443,4981,943,4038,20,360,10,10,allow
42861,443,12903,443,2337,1394,943,17,275,9,8,allow
63013,443,17200,443,304,86,218,2,30,1,1,allow
58259,53,23484,53,168,78,90,2,30,1,1,allow
50503,443,44653,443,9295,3094,6201,24,82,12,12,allow
42115,53,42115,53,262,106,156,2,32,1,1,allow
10060,443,49510,443,293424,16379,277045,410,93,193,217,allow
38770,443,2311,443,7431,3525,3906,18,15,10,8,allow
63028,53,16966,53,384,166,218,2,30,1,1,allow
63025,443,40805,443,304,86,218,2,30,1,1,allow
11076,53,11076,53,832,106,726,2,30,1,1,allow
56129,53,60836,53,94,94,0,1,30,1,0,allow
53761,123,54980,123,184,94,90,2,30,1,1,allow
55484,443,11193,443,5039,2002,3037,14,120,7,7,allow
60874,443,51364,443,1706,169,1537,6,121,3,3,allow
61231,443,59948,443,1864,250,1614,8,121,4,4,allow
57586,443,39129,443,3724,1963,1761,24,95,13,11,allow
64069,443,44966,443,11223,3362,7861,62,280,27,35,allow
49187,80,38831,80,1213,471,742,10,111,6,4,allow
57827,443,29156,443,912754,34972,877782,1035,294,410,625,allow
49288,53,48281,53,322,102,220,2,30,1,1,allow
49273,53,17508,53,342,110,232,2,30,1,1,allow
64875,53,51837,53,211,102,109,2,30,1,1,allow
44976,53,45616,53,86,86,0,1,30,1,0,allow
49995,53,30507,53,197,102,95,2,33,1,1,allow
33852,443,7849,443,3419,2241,1178,16,16,8,8,allow
26869,53,19844,53,290,110,180,2,30,1,1,allow
55228,53,59087,53,212,102,110,2,30,1,1,allow
63980,53,48933,53,225,102,123,2,30,1,1,allow
63026,53,55076,53,304,86,218,2,30,1,1,allow
62329,53,9486,53,268,86,182,2,30,1,1,allow
60920,53,22139,53,268,86,182,2,30,1,1,allow
49161,53,1492,53,385,102,283,2,30,1,1,allow
51933,53,51933,53,253,106,147,2,30,1,1,allow
38334,53,4428,53,168,78,90,2,31,1,1,allow
64724,443,50877,443,8602,1050,7552,16,121,7,9,allow
15503,38120,41177,38120,481,150,331,2,1200,1,1,allow
57470,48622,44893,48622,166,166,0,1,1200,1,0,allow
57510,443,62415,443,16532,2229,14303,26,133,11,15,allow
53678,31592,2735,31592,70,70,0,2,8,2,0,allow
56802,80,23332,80,1559,762,797,14,30,7,7,allow
64467,80,64467,80,5570,699,4871,14,22,7,7,allow
64361,53,32766,53,228,110,118,2,30,1,1,allow
58875,53,56659,53,370,86,284,2,30,1,1,allow
49954,53,40035,53,211,102,109,2,31,1,1,allow
54827,443,62409,443,11291,2426,8865,21,121,10,11,allow
52401,443,47720,443,12402,3972,8430,46,138,26,20,allow
38768,443,45644,443,7380,3474,3906,18,16,10,8,allow
53677,10657,26875,10657,70,70,0,2,8,2,0,allow
52705,80,52705,80,7237,2578,4659,19,16,9,10,allow
57583,443,11570,443,6150,4180,1970,21,95,13,8,allow
53481,443,12218,443,5913,4482,1431,30,30,20,10,allow
19372,443,19372,443,10461,1417,9044,23,16,10,13,allow
56647,443,45722,443,8059,2039,6020,20,15,11,9,allow
38769,443,3016,443,7352,3452,3900,18,15,10,8,allow
34709,443,21963,443,2119,1310,809,21,27,12,9,allow
63012,53,5232,53,304,86,218,2,30,1,1,allow
63011,443,30939,443,304,86,218,2,30,1,1,allow
64076,53,18119,53,353,118,235,2,30,1,1,allow
61510,37965,0,0,66,66,0,1,0,1,0,deny
60936,445,0,0,70,70,0,1,0,1,0,drop
60932,445,0,0,70,70,0,1,0,1,0,drop
60931,445,0,0,70,70,0,1,0,1,0,drop
44208,26467,0,0,62,62,0,1,0,1,0,deny
56325,445,0,0,66,66,0,1,0,1,0,drop
56326,445,0,0,66,66,0,1,0,1,0,drop
56324,445,0,0,66,66,0,1,0,1,0,drop
56320,445,0,0,66,66,0,1,0,1,0,drop
56322,445,0,0,66,66,0,1,0,1,0,drop
56323,445,0,0,66,66,0,1,0,1,0,drop
56321,445,0,0,66,66,0,1,0,1,0,drop
56319,445,0,0,66,66,0,1,0,1,0,drop
15403,51505,0,0,66,66,0,1,0,1,0,deny
46945,64147,0,0,62,62,0,1,0,1,0,deny
57433,21247,0,0,66,66,0,1,0,1,0,deny
6889,45129,0,0,159,159,0,1,0,1,0,deny
55992,445,0,0,70,70,0,1,0,1,0,drop
53227,64097,0,0,62,62,0,1,0,1,0,deny
55459,50584,0,0,66,66,0,1,0,1,0,deny
27679,37965,0,0,62,62,0,1,0,1,0,deny
61002,37965,0,0,145,145,0,1,0,1,0,deny
55984,445,0,0,70,70,0,1,0,1,0,drop
60923,445,0,0,70,70,0,1,0,1,0,drop
60922,445,0,0,70,70,0,1,0,1,0,drop
60915,445,0,0,70,70,0,1,0,1,0,drop
55981,445,0,0,70,70,0,1,0,1,0,drop
50784,50584,0,0,62,62,0,1,0,1,0,deny
56369,22114,0,0,62,62,0,1,0,1,0,deny
56369,22114,0,0,146,146,0,1,0,1,0,deny
56307,445,0,0,66,66,0,1,0,1,0,drop
56306,445,0,0,66,66,0,1,0,1,0,drop
56304,445,0,0,66,66,0,1,0,1,0,drop
60913,445,0,0,70,70,0,1,0,1,0,drop
26699,35253,0,0,62,62,0,1,0,1,0,deny
52150,39109,0,0,66,66,0,1,0,1,0,deny
55978,445,0,0,70,70,0,1,0,1,0,drop
48980,11119,0,0,146,146,0,1,0,1,0,deny
16387,3655,0,0,60,60,0,1,0,1,0,deny
16387,22272,0,0,60,60,0,1,0,1,0,deny
49197,30188,0,0,62,62,0,1,0,1,0,deny
16387,20045,0,0,60,60,0,1,0,1,0,deny
55976,445,0,0,70,70,0,1,0,1,0,drop
12107,22114,0,0,66,66,0,1,0,1,0,deny
60911,445,0,0,70,70,0,1,0,1,0,drop
4427,50584,0,0,62,62,0,1,0,1,0,deny
16387,44427,0,0,60,60,0,1,0,1,0,deny
16387,7205,0,0,60,60,0,1,0,1,0,deny
16387,16862,0,0,60,60,0,1,0,1,0,deny
60909,445,0,0,70,70,0,1,0,1,0,drop
60908,445,0,0,70,70,0,1,0,1,0,drop
60900,445,0,0,70,70,0,1,0,1,0,drop
34146,51221,0,0,62,62,0,1,0,1,0,deny
51313,64147,0,0,66,66,0,1,0,1,0,deny
55972,445,0,0,70,70,0,1,0,1,0,drop
16387,63752,0,0,60,60,0,1,0,1,0,deny
16387,35583,0,0,60,60,0,1,0,1,0,deny
16387,64075,0,0,60,60,0,1,0,1,0,deny
2876,35440,0,0,62,62,0,1,0,1,0,deny
64283,37965,0,0,74,74,0,1,0,1,0,deny
55971,445,0,0,70,70,0,1,0,1,0,drop
28370,35440,0,0,66,66,0,1,0,1,0,deny
11344,42873,0,0,62,62,0,1,0,1,0,deny
1790,48817,0,0,62,62,0,1,0,1,0,deny
8080,37965,0,0,62,62,0,1,0,1,0,deny
53781,37965,0,0,66,66,0,1,0,1,0,deny
34809,57470,0,0,66,66,0,1,0,1,0,deny
59772,62413,0,0,66,66,0,1,0,1,0,deny
60892,445,0,0,70,70,0,1,0,1,0,drop
60891,445,0,0,70,70,0,1,0,1,0,drop
60888,445,0,0,70,70,0,1,0,1,0,drop
55966,445,0,0,70,70,0,1,0,1,0,drop
29787,37965,0,0,62,62,0,1,0,1,0,deny
62625,37965,0,0,66,66,0,1,0,1,0,deny
27443,23,0,0,60,60,0,1,0,1,0,deny
62725,51221,0,0,62,62,0,1,0,1,0,deny
64693,26467,0,0,62,62,0,1,0,1,0,deny
34499,8497,0,0,148,148,0,1,0,1,0,deny
61195,56205,0,0,66,66,0,1,0,1,0,deny
56281,445,0,0,66,66,0,1,0,1,0,drop
55238,21247,0,0,62,62,0,1,0,1,0,deny
60885,445,0,0,70,70,0,1,0,1,0,drop
60884,445,0,0,70,70,0,1,0,1,0,drop
13970,42873,0,0,62,62,0,1,0,1,0,deny
55953,445,0,0,70,70,0,1,0,1,0,drop
59724,64147,0,0,66,66,0,1,0,1,0,deny
55950,445,0,0,70,70,0,1,0,1,0,drop
58334,5223,0,0,148,148,0,1,0,1,0,deny
56277,445,0,0,66,66,0,1,0,1,0,drop
52410,8604,0,0,66,66,0,1,0,1,0,deny
56275,445,0,0,66,66,0,1,0,1,0,drop
60873,445,0,0,70,70,0,1,0,1,0,drop
65495,11392,0,0,66,66,0,1,0,1,0,deny
12087,59033,0,0,148,148,0,1,0,1,0,deny
60868,445,0,0,70,70,0,1,0,1,0,drop
60866,445,0,0,70,70,0,1,0,1,0,drop
60865,445,0,0,70,70,0,1,0,1,0,drop
7978,50584,0,0,66,66,0,1,0,1,0,deny
56274,445,0,0,66,66,0,1,0,1,0,drop
52870,22197,0,0,66,66,0,1,0,1,0,deny
55945,445,0,0,70,70,0,1,0,1,0,drop
55944,445,0,0,70,70,0,1,0,1,0,drop
59889,30188,0,0,66,66,0,1,0,1,0,deny
63740,64147,0,0,66,66,0,1,0,1,0,deny
14924,44847,0,0,62,62,0,1,0,1,0,deny
49248,35993,0,0,66,66,0,1,0,1,0,deny
55942,445,0,0,70,70,0,1,0,1,0,drop
60859,445,0,0,70,70,0,1,0,1,0,drop
42968,56205,0,0,146,146,0,1,0,1,0,deny
60856,445,0,0,70,70,0,1,0,1,0,drop
60855,445,0,0,70,70,0,1,0,1,0,drop
60852,445,0,0,70,70,0,1,0,1,0,drop
56265,445,0,0,66,66,0,1,0,1,0,drop
43584,24748,0,0,156,156,0,1,0,1,0,deny
43584,24748,0,0,156,156,0,1,0,1,0,deny
57131,35776,0,0,145,145,0,1,0,1,0,deny
43584,24748,0,0,156,156,0,1,0,1,0,deny
43584,24748,0,0,156,156,0,1,0,1,0,deny
59965,36237,0,0,66,66,0,1,0,1,0,deny
43584,24748,0,0,156,156,0,1,0,1,0,deny
56263,445,0,0,66,66,0,1,0,1,0,drop
56260,445,0,0,66,66,0,1,0,1,0,drop
56258,445,0,0,66,66,0,1,0,1,0,drop
443,2629,0,0,135,135,0,1,0,1,0,deny
443,46223,0,0,66,66,0,1,0,1,0,deny
56256,445,0,0,66,66,0,1,0,1,0,drop
56255,445,0,0,66,66,0,1,0,1,0,drop
56253,445,0,0,66,66,0,1,0,1,0,drop
54530,35440,0,0,66,66,0,1,0,1,0,deny
56376,44847,0,0,66,66,0,1,0,1,0,deny
52724,64147,0,0,62,62,0,1,0,1,0,deny
55935,445,0,0,70,70,0,1,0,1,0,drop
0,0,0,0,2000,1020,980,20,0,10,10,allow
57472,44847,0,0,66,66,0,1,0,1,0,deny
14255,2767,0,0,146,146,0,1,0,1,0,deny
55933,445,0,0,70,70,0,1,0,1,0,drop
60849,445,0,0,70,70,0,1,0,1,0,drop
60850,445,0,0,70,70,0,1,0,1,0,drop
60848,445,0,0,70,70,0,1,0,1,0,drop
10348,25604,0,0,66,66,0,1,0,1,0,deny
54636,26467,0,0,62,62,0,1,0,1,0,deny
26921,57470,0,0,62,62,0,1,0,1,0,deny
10028,25604,0,0,62,62,0,1,0,1,0,deny
23383,64147,0,0,62,62,0,1,0,1,0,deny
51093,57470,0,0,66,66,0,1,0,1,0,deny
38383,51221,0,0,62,62,0,1,0,1,0,deny
64387,37965,0,0,62,62,0,1,0,1,0,deny
56252,445,0,0,66,66,0,1,0,1,0,drop
60843,445,0,0,70,70,0,1,0,1,0,drop
55932,445,0,0,70,70,0,1,0,1,0,drop
56247,445,0,0,66,66,0,1,0,1,0,drop
57969,42873,0,0,66,66,0,1,0,1,0,deny
55931,445,0,0,70,70,0,1,0,1,0,drop
55930,445,0,0,70,70,0,1,0,1,0,drop
55926,445,0,0,70,70,0,1,0,1,0,drop
55927,445,0,0,70,70,0,1,0,1,0,drop
56246,445,0,0,66,66,0,1,0,1,0,drop
56244,445,0,0,66,66,0,1,0,1,0,drop
3117,37965,0,0,62,62,0,1,0,1,0,deny
6824,26467,0,0,66,66,0,1,0,1,0,deny
54854,19847,0,0,62,62,0,1,0,1,0,deny
43657,50011,0,0,62,62,0,1,0,1,0,deny
50095,30188,0,0,62,62,0,1,0,1,0,deny
57114,35440,0,0,62,62,0,1,0,1,0,deny
55912,445,0,0,70,70,0,1,0,1,0,drop
1972,57470,0,0,78,78,0,1,0,1,0,deny
55911,445,0,0,70,70,0,1,0,1,0,drop
55907,445,0,0,70,70,0,1,0,1,0,drop
55902,445,0,0,70,70,0,1,0,1,0,drop
52459,5555,0,0,60,60,0,1,0,1,0,deny
55901,445,0,0,70,70,0,1,0,1,0,drop
60838,445,0,0,70,70,0,1,0,1,0,drop
28124,37965,0,0,62,62,0,1,0,1,0,deny
16086,6881,0,0,146,146,0,1,0,1,0,deny
20608,28189,0,0,60,60,0,1,0,1,0,deny
6881,6881,0,0,146,146,0,1,0,1,0,deny
60830,445,0,0,70,70,0,1,0,1,0,drop
60825,445,0,0,70,70,0,1,0,1,0,drop
55600,22,0,0,60,60,0,1,0,1,0,deny
54047,50011,0,0,66,66,0,1,0,1,0,deny
55145,11392,0,0,66,66,0,1,0,1,0,deny
16944,50584,0,0,62,62,0,1,0,1,0,deny
16944,50584,0,0,146,146,0,1,0,1,0,deny
35849,30188,0,0,62,62,0,1,0,1,0,deny
56231,445,0,0,66,66,0,1,0,1,0,drop
55890,445,0,0,70,70,0,1,0,1,0,drop
29300,35440,0,0,62,62,0,1,0,1,0,deny
1821,64147,0,0,66,66,0,1,0,1,0,deny
56224,445,0,0,66,66,0,1,0,1,0,drop
60815,445,0,0,70,70,0,1,0,1,0,drop
443,62451,0,0,199,199,0,1,0,1,0,deny
51283,80,60981,80,1114,534,580,12,16,7,5,allow
60419,33709,17912,33709,504,318,186,8,16,5,3,allow
49487,443,25025,443,72073,12550,59523,78,45,25,53,allow
37098,443,22843,443,1835,1190,645,17,26,10,7,allow
55631,16191,24420,16191,504,318,186,8,16,5,3,allow
51842,27665,45700,27665,66,66,0,1,5,1,0,allow
54213,443,30339,443,7498,2799,4699,24,17,13,11,allow
49295,443,9529,443,4179,2599,1580,27,75,13,14,allow
27005,27025,48292,27025,1774,252,1522,5,31,3,2,allow
56677,443,37200,443,6313,2068,4245,21,20,12,9,allow
53645,62348,1333,62348,2395,1145,1250,13,16,6,7,allow
60347,80,6401,80,2018,1704,314,16,15,11,5,allow
48643,80,57942,80,1912,1464,448,14,16,7,7,allow
57470,1028,19810,1028,350,163,187,2,1200,1,1,allow
37095,443,45405,443,1835,1190,645,17,26,10,7,allow
37097,443,17597,443,1835,1190,645,17,26,10,7,allow
45132,443,57235,443,5398,3277,2121,30,80,16,14,allow
37096,443,33249,443,1753,1108,645,16,26,9,7,allow
38365,15000,43140,15000,130,70,60,2,6,1,1,allow
48710,22,48710,22,11002,3445,7557,60,42,26,34,allow
63214,53,63214,53,261,103,158,2,30,1,1,allow
27005,27023,4968,27023,1640,126,1514,4,30,2,2,allow
35123,443,15419,443,17656,4044,13612,30,122,13,17,allow
60875,443,10095,443,1786,172,1614,7,120,3,4,allow
52662,443,35849,443,5382,1353,4029,19,135,10,9,allow
33356,80,44491,80,1658,1344,314,10,15,5,5,allow
39328,80,54036,80,78,78,0,1,5,1,0,allow
53656,58624,54901,58624,70,70,0,1,5,1,0,allow
60417,443,24567,443,8590,1987,6603,23,86,12,11,allow
27005,27017,60411,27017,1644,126,1518,4,30,2,2,allow
55592,53,16143,53,817,98,719,2,30,1,1,allow
49396,53,24683,53,170,87,83,2,30,1,1,allow
55274,53,15789,53,711,87,624,2,30,1,1,allow
61232,443,38058,443,1786,172,1614,7,120,3,4,allow
61234,443,50660,443,1786,172,1614,7,120,3,4,allow
50584,6881,56597,6881,161,161,0,1,1201,1,0,allow
50584,44816,28229,44816,161,161,0,1,1201,1,0,allow
53765,443,24226,443,16482,9312,7170,39,141,19,20,allow
50265,21544,58613,21544,390,266,124,6,1200,4,2,allow
49224,53,6029,53,170,87,83,2,31,1,1,allow
30960,45718,62760,45718,330,330,0,6,3609,6,0,allow
57277,5223,45346,5223,4339,1521,2818,23,3002,14,9,allow
1024,21247,0,0,62,62,0,1,0,1,0,deny
40322,23,0,0,60,60,0,1,0,1,0,deny
7109,64147,0,0,62,62,0,1,0,1,0,deny
56221,445,0,0,66,66,0,1,0,1,0,drop
60222,22114,0,0,66,66,0,1,0,1,0,deny
30913,33876,0,0,145,145,0,1,0,1,0,deny
55886,445,0,0,70,70,0,1,0,1,0,drop
56214,445,0,0,66,66,0,1,0,1,0,drop
55877,445,0,0,70,70,0,1,0,1,0,drop
55876,445,0,0,70,70,0,1,0,1,0,drop
51164,64147,0,0,66,66,0,1,0,1,0,deny
1024,64147,0,0,62,62,0,1,0,1,0,deny
55872,445,0,0,70,70,0,1,0,1,0,drop
55874,445,0,0,70,70,0,1,0,1,0,drop
56211,445,0,0,66,66,0,1,0,1,0,drop
55869,445,0,0,70,70,0,1,0,1,0,drop
13663,23,0,0,60,60,0,1,0,1,0,deny
52754,26467,0,0,66,66,0,1,0,1,0,deny
57093,26467,0,0,66,66,0,1,0,1,0,deny
25565,20455,0,0,60,60,0,1,0,1,0,deny
4772,37965,0,0,66,66,0,1,0,1,0,deny
60803,445,0,0,70,70,0,1,0,1,0,drop
60805,445,0,0,70,70,0,1,0,1,0,drop
60804,445,0,0,70,70,0,1,0,1,0,drop
39452,123,25633,123,184,94,90,2,30,1,1,allow
37653,5223,9635,5223,417,417,0,4,13,4,0,allow
65352,443,3902,443,12690,1918,10772,39,195,19,20,allow
49396,53,21722,53,177,94,83,2,30,1,1,allow
46582,80,45383,80,540,540,0,10,194,10,0,allow
49989,53,42243,53,677,217,460,6,74,3,3,allow
9555,80,9555,80,6893,704,6189,14,15,6,8,allow
64202,53,3004,53,316,89,227,4,50,2,2,allow
63022,53,50452,53,384,166,218,2,29,1,1,allow
63014,53,26673,53,304,86,218,2,29,1,1,allow
61233,443,12202,443,1775,169,1606,7,120,3,4,allow
51825,80,15500,80,540,540,0,10,194,10,0,allow
49507,53,65329,53,177,94,83,2,30,1,1,allow
53674,31724,4834,31724,70,70,0,2,7,2,0,allow
60827,53,38613,53,224,86,138,2,29,1,1,allow
63018,53,50611,53,384,166,218,2,29,1,1,allow
63010,53,14322,53,304,86,218,2,29,1,1,allow
65442,53,44743,53,262,102,160,2,29,1,1,allow
49396,53,32920,53,177,94,83,2,29,1,1,allow
54044,53,15773,53,224,86,138,2,29,1,1,allow
51862,27758,32851,27758,70,70,0,2,7,2,0,allow
39807,443,25771,443,1684,1031,653,16,92,9,7,allow
34715,443,46649,443,584,370,214,9,26,6,3,allow
64765,53,50725,53,177,94,83,2,30,1,1,allow
34391,443,18031,443,80160,3527,76633,98,76,38,60,allow
53652,57503,44187,57503,492,306,186,8,15,5,3,allow
51861,23919,9665,23919,70,70,0,2,7,2,0,allow
53647,80,49783,80,1962,1287,675,13,27,7,6,allow
51841,21960,6708,21960,136,136,0,3,14,3,0,allow
56837,46790,59586,46790,70,70,0,1,5,1,0,allow
58870,443,45632,443,1411,921,490,12,15,7,5,allow
55245,443,9754,443,6799,1581,5218,27,25,14,13,allow
50086,80,23658,80,3148,687,2461,12,15,7,5,allow
49606,53,55555,53,328,94,234,4,43,2,2,allow
50084,80,12971,80,2173,616,1557,10,15,6,4,allow
49640,443,55755,443,2809,1729,1080,18,80,10,8,allow
26849,443,35279,443,20979,15982,4997,38,36,22,16,allow
26854,53,44108,53,222,86,136,2,30,1,1,allow
64608,53,19709,53,718,94,624,2,30,1,1,allow
8283,52443,24980,52443,70,70,0,1,30,1,0,allow
65081,443,33904,443,5291,339,4952,11,120,5,6,allow
64670,53,49938,53,228,94,134,2,30,1,1,allow
49507,53,33142,53,177,94,83,2,30,1,1,allow
51863,22038,18854,22038,70,70,0,2,7,2,0,allow
51486,4545,51486,4545,156,156,0,3,8,3,0,allow
49334,53,5617,53,300,99,201,4,38,2,2,allow
55327,443,55327,443,16304,2069,14235,39,17,19,20,allow
64828,53,23782,53,372,94,278,2,30,1,1,allow
64230,53,48297,53,193,94,99,2,30,1,1,allow
51844,12471,8982,12471,70,70,0,1,5,1,0,allow
51789,80,62386,80,28433,1668,26765,39,20,18,21,allow
51787,80,42388,80,26626,1555,25071,36,20,16,20,allow
34490,443,47026,443,584,370,214,9,26,6,3,allow
56644,443,57838,443,7862,1873,5989,20,15,11,9,allow
55217,443,42611,443,8690,4119,4571,26,31,14,12,allow
19962,53,19962,53,832,106,726,2,30,1,1,allow
10151,11809,51182,11809,481,150,331,2,1200,1,1,allow
48285,80,8478,80,6713,1736,4977,24,1130,8,16,allow
38010,443,65428,443,5474,2239,3235,31,80,14,17,allow
45359,443,22644,443,10480,4949,5531,22,15,12,10,allow
50085,80,7079,80,3326,684,2642,12,15,7,5,allow
56646,443,12579,443,7862,1873,5989,20,15,11,9,allow
48742,443,3234,443,4801,2138,2663,23,15,12,11,allow
45360,443,43206,443,10280,6167,4113,20,15,12,8,allow
52292,80,52292,80,1914,1302,612,11,14,5,6,allow
36532,6555,55068,6555,922,428,494,10,14,5,5,allow
52661,80,52661,80,1950,1338,612,11,14,5,6,allow
53676,3678,29317,3678,70,70,0,2,7,2,0,allow
34787,80,1192,80,2989,813,2176,15,166,8,7,allow
39570,443,62469,443,70,70,0,1,5,1,0,allow
41431,443,28233,443,1843,996,847,17,275,8,9,allow
19125,80,19125,80,12650,889,11761,20,16,9,11,allow
27005,27016,57250,27016,1784,252,1532,5,31,3,2,allow
33165,443,61975,443,7442,1260,6182,19,15,10,9,allow
55206,443,55206,443,18965,2061,16904,35,17,18,17,allow
63019,53,40745,53,512,166,346,2,29,1,1,allow
51791,80,21497,80,1934,1083,851,9,15,5,4,allow
64542,53,47604,53,234,94,140,2,29,1,1,allow
49474,53,54970,53,224,86,138,2,29,1,1,allow
63017,443,7644,443,571,166,405,2,29,1,1,allow
53290,443,5427,443,494,288,206,8,26,5,3,allow
63009,443,26712,443,304,86,218,2,29,1,1,allow
53649,26085,23135,26085,612,306,306,10,15,5,5,allow
49396,53,18429,53,177,94,83,2,29,1,1,allow
64966,53,26229,53,376,126,250,2,29,1,1,allow
65197,53,14120,53,177,86,91,2,30,1,1,allow
50059,53,45752,53,718,94,624,2,30,1,1,allow
27005,27015,22209,27015,1654,126,1528,4,30,2,2,allow
64722,443,16301,443,61890,2830,59060,73,120,27,46,allow
65167,53,20946,53,219,94,125,2,30,1,1,allow
49758,53,63769,53,243,102,141,2,30,1,1,allow
46671,53,46671,53,832,106,726,2,30,1,1,allow
64765,53,64580,53,177,94,83,2,30,1,1,allow
50265,37711,22022,37711,132,132,0,3,1200,3,0,allow
6881,55085,23823,55085,509,150,359,2,1199,1,1,allow
50584,13560,50803,13560,166,166,0,1,1200,1,0,allow
57470,24907,9136,24907,1386,1386,0,22,1544,22,0,allow
57470,6881,62721,6881,150,150,0,1,1200,1,0,allow
39820,443,15397,443,2642442,95056,2547386,2730,3629,999,1731,allow
33850,443,55796,443,6987,2005,4982,18,16,9,9,allow
51790,80,59266,80,1936,1085,851,9,15,5,4,allow
56645,443,46847,443,7914,1925,5989,20,15,11,9,allow
34392,443,49266,443,1820,1101,719,18,76,10,8,allow
55808,53,55808,53,257,106,151,2,30,1,1,allow
46887,443,50848,443,118,118,0,1,30,1,0,allow
49338,53,20545,53,368,94,274,2,30,1,1,allow
64561,53,17308,53,461,91,370,4,60,2,2,allow
49559,443,1739,443,3641,1047,2594,14,120,7,7,allow
47377,443,54637,443,2725,1153,1572,19,208,8,11,allow
45275,443,51304,443,9908271,123308,9784963,8531,359,1708,6823,allow
65105,80,65105,80,23382,3770,19612,48,45,24,24,allow
39762,123,46956,123,184,94,90,2,30,1,1,allow
64360,53,15501,53,350,88,262,4,31,2,2,allow
44353,443,12767,443,15234,2503,12731,45,135,20,25,allow
58004,443,48941,443,13206,7781,5425,29,253,15,14,allow
63832,6969,32926,6969,70,70,0,1,5,1,0,allow
56786,443,56786,443,4381,1474,2907,19,27,11,8,allow
51788,80,12159,80,35407,1784,33623,46,20,20,26,allow
50265,24387,44902,24387,330,330,0,6,1200,6,0,allow
50584,51651,64737,51651,166,166,0,1,1200,1,0,allow
41762,443,13178,443,2306249,52358,2253891,2041,239,447,1594,allow
50584,49001,15411,49001,889,161,728,3,1200,2,1,allow
33200,443,11701,443,67123,10708,56415,100,124,41,59,allow
47089,443,11846,443,172,172,0,2,5,2,0,allow
53654,8100,50250,8100,70,70,0,1,5,1,0,allow
35168,443,20668,443,7447,2133,5314,27,348,14,13,allow
49640,443,44264,443,12619,3258,9361,33,47,19,14,allow
58440,53,59026,53,305,102,203,2,31,1,1,allow
49746,53,24579,53,479,88,391,4,58,2,2,allow
49293,80,54518,80,75982,15645,60337,88,158,31,57,allow
53670,32016,15273,32016,70,70,0,2,8,2,0,allow
64157,53,49752,53,370,126,244,2,30,1,1,allow
64951,53,60545,53,230,102,128,2,30,1,1,allow
49948,53,19107,53,380,110,270,2,30,1,1,allow
56660,53,3127,53,338,110,228,2,30,1,1,allow
27005,27025,58786,27025,1634,126,1508,4,31,2,2,allow
56621,443,14784,443,1327,918,409,10,26,6,4,allow
58866,443,52755,443,2353,1453,900,16,15,8,8,allow
11324,443,11324,443,6981,948,6033,17,28,10,7,allow
27005,27052,57707,27052,1948,378,1570,6,33,4,2,allow
47528,8080,0,0,184,78,106,3,10,2,1,allow
49649,443,20901,443,10099,1721,8378,27,46,14,13,allow
57580,443,3612,443,4049,1992,2057,23,96,13,10,allow
27005,27015,32114,27015,1634,126,1508,4,31,2,2,allow
56197,445,0,0,66,66,0,1,0,1,0,drop
56193,445,0,0,66,66,0,1,0,1,0,drop
56192,445,0,0,66,66,0,1,0,1,0,drop
56198,445,0,0,66,66,0,1,0,1,0,drop
56194,445,0,0,66,66,0,1,0,1,0,drop
56196,445,0,0,66,66,0,1,0,1,0,drop
56195,445,0,0,66,66,0,1,0,1,0,drop
56190,445,0,0,66,66,0,1,0,1,0,drop
2370,23,0,0,60,60,0,1,0,1,0,deny
37343,21247,0,0,146,146,0,1,0,1,0,deny
55864,445,0,0,70,70,0,1,0,1,0,drop
44129,64147,0,0,145,145,0,1,0,1,0,deny
54868,1433,0,0,60,60,0,1,0,1,0,deny
65492,2323,0,0,60,60,0,1,0,1,0,deny
30783,51505,0,0,62,62,0,1,0,1,0,deny
10252,11392,0,0,62,62,0,1,0,1,0,deny
10331,6881,0,0,146,146,0,1,0,1,0,deny
55856,445,0,0,70,70,0,1,0,1,0,drop
6655,2323,0,0,60,60,0,1,0,1,0,deny
55855,445,0,0,70,70,0,1,0,1,0,drop
3436,46783,0,0,62,62,0,1,0,1,0,deny
60802,445,0,0,70,70,0,1,0,1,0,drop
60789,445,0,0,70,70,0,1,0,1,0,drop
60788,445,0,0,70,70,0,1,0,1,0,drop
25857,57354,0,0,145,145,0,1,0,1,0,deny
11030,37965,0,0,62,62,0,1,0,1,0,deny
56178,445,0,0,66,66,0,1,0,1,0,drop
56177,445,0,0,66,66,0,1,0,1,0,drop
56175,445,0,0,66,66,0,1,0,1,0,drop
55850,445,0,0,70,70,0,1,0,1,0,drop
52563,17235,0,0,70,70,0,1,0,1,0,deny
55848,445,0,0,70,70,0,1,0,1,0,drop
60786,445,0,0,70,70,0,1,0,1,0,drop
47803,64147,0,0,145,145,0,1,0,1,0,deny
63213,15503,0,0,66,66,0,1,0,1,0,deny
58550,21247,0,0,66,66,0,1,0,1,0,deny
60783,445,0,0,70,70,0,1,0,1,0,drop
56148,37965,0,0,66,66,0,1,0,1,0,deny
55844,445,0,0,70,70,0,1,0,1,0,drop
60776,445,0,0,70,70,0,1,0,1,0,drop
60779,445,0,0,70,70,0,1,0,1,0,drop
60778,445,0,0,70,70,0,1,0,1,0,drop
19632,37965,0,0,62,62,0,1,0,1,0,deny
16387,3655,0,0,60,60,0,1,0,1,0,deny
16387,22272,0,0,60,60,0,1,0,1,0,deny
16387,20045,0,0,60,60,0,1,0,1,0,deny
55981,31573,0,0,146,146,0,1,0,1,0,deny
53543,44847,0,0,62,62,0,1,0,1,0,deny
55843,445,0,0,70,70,0,1,0,1,0,drop
16387,44427,0,0,60,60,0,1,0,1,0,deny
16387,7205,0,0,60,60,0,1,0,1,0,deny
16387,16862,0,0,60,60,0,1,0,1,0,deny
16387,63752,0,0,60,60,0,1,0,1,0,deny
16387,35583,0,0,60,60,0,1,0,1,0,deny
16387,64075,0,0,60,60,0,1,0,1,0,deny
3980,63710,0,0,66,66,0,1,0,1,0,deny
20198,17372,0,0,62,62,0,1,0,1,0,deny
51910,37965,0,0,62,62,0,1,0,1,0,deny
56127,35440,0,0,62,62,0,1,0,1,0,deny
1117,37965,0,0,62,62,0,1,0,1,0,deny
55838,445,0,0,70,70,0,1,0,1,0,drop
19096,64147,0,0,62,62,0,1,0,1,0,deny
60766,445,0,0,70,70,0,1,0,1,0,drop
60765,445,0,0,70,70,0,1,0,1,0,drop
60764,445,0,0,70,70,0,1,0,1,0,drop
56380,36829,0,0,66,66,0,1,0,1,0,deny
38758,23,0,0,60,60,0,1,0,1,0,deny
58286,37965,0,0,66,66,0,1,0,1,0,deny
56153,445,0,0,66,66,0,1,0,1,0,drop
55825,445,0,0,70,70,0,1,0,1,0,drop
50713,57470,0,0,66,66,0,1,0,1,0,deny
51745,57470,0,0,62,62,0,1,0,1,0,deny
60758,445,0,0,70,70,0,1,0,1,0,drop
55968,56205,0,0,66,66,0,1,0,1,0,deny
57131,26296,0,0,145,145,0,1,0,1,0,deny
3730,37965,0,0,62,62,0,1,0,1,0,deny
60248,30188,0,0,66,66,0,1,0,1,0,deny
55822,445,0,0,70,70,0,1,0,1,0,drop
57499,80,58855,80,30979,1798,29181,46,14,23,23,allow
51172,44847,0,0,62,62,0,1,0,1,0,deny
51676,23718,0,0,66,66,0,1,0,1,0,deny
56148,445,0,0,66,66,0,1,0,1,0,drop
56146,445,0,0,66,66,0,1,0,1,0,drop
60745,445,0,0,70,70,0,1,0,1,0,drop
55817,445,0,0,70,70,0,1,0,1,0,drop
60741,445,0,0,70,70,0,1,0,1,0,drop
60740,445,0,0,70,70,0,1,0,1,0,drop
60735,445,0,0,70,70,0,1,0,1,0,drop
53003,11392,0,0,66,66,0,1,0,1,0,deny
55816,445,0,0,70,70,0,1,0,1,0,drop
56143,445,0,0,66,66,0,1,0,1,0,drop
0,0,0,0,320,320,0,5,0,5,0,allow
55814,445,0,0,70,70,0,1,0,1,0,drop
17781,50265,0,0,145,145,0,1,0,1,0,deny
52282,37965,0,0,66,66,0,1,0,1,0,deny
45832,51050,0,0,66,66,0,1,0,1,0,deny
50881,50584,0,0,66,66,0,1,0,1,0,deny
60730,445,0,0,70,70,0,1,0,1,0,drop
64294,64147,0,0,62,62,0,1,0,1,0,deny
60728,445,0,0,70,70,0,1,0,1,0,drop
60725,445,0,0,70,70,0,1,0,1,0,drop
60724,445,0,0,70,70,0,1,0,1,0,drop
56137,445,0,0,66,66,0,1,0,1,0,drop
56131,445,0,0,66,66,0,1,0,1,0,drop
56128,445,0,0,66,66,0,1,0,1,0,drop
56130,445,0,0,66,66,0,1,0,1,0,drop
55807,445,0,0,70,70,0,1,0,1,0,drop
56127,445,0,0,66,66,0,1,0,1,0,drop
56125,445,0,0,66,66,0,1,0,1,0,drop
56126,445,0,0,66,66,0,1,0,1,0,drop
2432,11392,0,0,146,146,0,1,0,1,0,deny
55805,445,0,0,70,70,0,1,0,1,0,drop
27300,36237,0,0,146,146,0,1,0,1,0,deny
55804,445,0,0,70,70,0,1,0,1,0,drop
20608,28189,0,0,60,60,0,1,0,1,0,deny
60723,445,0,0,70,70,0,1,0,1,0,drop
60720,445,0,0,70,70,0,1,0,1,0,drop
60717,445,0,0,70,70,0,1,0,1,0,drop
21641,51505,0,0,62,62,0,1,0,1,0,deny
55803,445,0,0,70,70,0,1,0,1,0,drop
55802,445,0,0,70,70,0,1,0,1,0,drop
56123,445,0,0,66,66,0,1,0,1,0,drop
26502,64147,0,0,62,62,0,1,0,1,0,deny
62688,32480,0,0,109,109,0,1,0,1,0,deny
55798,445,0,0,70,70,0,1,0,1,0,drop
55799,445,0,0,70,70,0,1,0,1,0,drop
60715,445,0,0,70,70,0,1,0,1,0,drop
56118,445,0,0,66,66,0,1,0,1,0,drop
48676,53395,0,0,60,60,0,1,0,1,0,deny
36566,37965,0,0,62,62,0,1,0,1,0,deny
60398,46776,0,0,74,74,0,1,0,1,0,deny
30015,36237,0,0,66,66,0,1,0,1,0,deny
56117,445,0,0,66,66,0,1,0,1,0,drop
56115,445,0,0,66,66,0,1,0,1,0,drop
56113,445,0,0,66,66,0,1,0,1,0,drop
55784,445,0,0,70,70,0,1,0,1,0,drop
55782,445,0,0,70,70,0,1,0,1,0,drop
55777,445,0,0,70,70,0,1,0,1,0,drop
59699,55783,0,0,62,62,0,1,0,1,0,deny
51858,44647,64567,44647,70,70,0,2,8,2,0,allow
53669,59056,24869,59056,70,70,0,2,7,2,0,allow
10167,80,10167,80,450,246,204,8,25,5,3,allow
59200,53,0,0,82,82,0,1,30,1,0,allow
53126,47035,20200,47035,70,70,0,1,5,1,0,allow
49639,443,59144,443,13604,1980,11624,33,46,18,15,allow
27005,27018,26444,27018,1634,126,1508,4,30,2,2,allow
61736,443,61172,443,148467,8298,140169,192,17,93,99,allow
5588,5588,0,0,3354,1792,1562,46,192,23,23,allow
58961,80,54182,80,1674,1360,314,11,15,6,5,allow
54966,53,23127,53,170,87,83,3,32,2,1,allow
55082,443,25259,443,8944,4006,4938,31,16,18,13,allow
48617,443,54481,443,10802,2841,7961,29,21,14,15,allow
64367,443,64367,443,4347,1440,2907,19,26,11,8,allow
47401,80,21233,80,3158,1159,1999,14,16,8,6,allow
11044,443,11044,443,6981,948,6033,17,27,10,7,allow
11139,443,11139,443,6981,948,6033,17,27,10,7,allow
55642,26872,53975,26872,70,70,0,2,8,2,0,allow
57670,80,41385,80,2274,1660,614,21,15,11,10,allow
53668,50678,24375,50678,70,70,0,2,7,2,0,allow
56612,443,14658,443,4378,1140,3238,14,26,9,5,allow
46669,80,58799,80,1802,1488,314,11,16,6,5,allow
49228,53,49228,53,825,99,726,2,30,1,1,allow
55859,53,0,0,82,82,0,1,30,1,0,allow
50584,49533,38774,49533,161,161,0,1,1200,1,0,allow
53129,38413,48065,38413,70,70,0,2,8,2,0,allow
53646,16561,53092,16561,422,140,282,6,15,3,3,allow
35078,443,8054,443,234,234,0,4,12,4,0,allow
56613,443,45386,443,4378,1140,3238,14,26,9,5,allow
27005,27021,13743,27021,1616,126,1490,4,30,2,2,allow
64915,53,33891,53,170,87,83,2,31,1,1,allow
49844,53,1140,53,762,98,664,2,31,1,1,allow
42971,3478,43871,3478,452,280,172,5,31,3,2,allow
56837,53,17666,53,190,97,93,2,31,1,1,allow
65483,53,14095,53,701,88,613,2,31,1,1,allow
54666,123,26890,123,184,94,90,2,31,1,1,allow
64968,53,11084,53,87,87,0,1,31,1,0,allow
53432,53,53432,53,197,76,121,2,31,1,1,allow
54712,8080,31768,8080,110,110,0,1,31,1,0,allow
29486,53,29486,53,825,99,726,2,31,1,1,allow
36749,443,54855,443,487330,18074,469256,508,122,148,360,allow
50584,39812,60344,39812,161,161,0,1,1200,1,0,allow
45562,5228,50425,5228,29298,3627,25671,67,5346,25,42,allow
55727,53,65316,53,711,87,624,2,31,1,1,allow
49707,53,6726,53,733,85,648,2,31,1,1,allow
57008,443,25539,443,10572,5109,5463,24,122,12,12,allow
6881,5903,6718,5903,501,150,351,2,1200,1,1,allow
53404,443,43178,443,4972,1547,3425,22,149,10,12,allow
51221,31285,26575,31285,2274,924,1350,30,3293,15,15,allow
42463,56205,0,0,62,62,0,1,0,1,0,deny
55773,445,0,0,70,70,0,1,0,1,0,drop
55774,445,0,0,70,70,0,1,0,1,0,drop
11988,48817,0,0,66,66,0,1,0,1,0,deny
60714,445,0,0,70,70,0,1,0,1,0,drop
60702,445,0,0,70,70,0,1,0,1,0,drop
60701,445,0,0,70,70,0,1,0,1,0,drop
45363,23,0,0,60,60,0,1,0,1,0,deny
62682,23,0,0,60,60,0,1,0,1,0,deny
1024,44847,0,0,146,146,0,1,0,1,0,deny
3818,37965,0,0,66,66,0,1,0,1,0,deny
48706,23393,0,0,60,60,0,1,0,1,0,deny
60363,443,34155,443,2962,796,2166,10,120,5,5,allow
56102,445,0,0,66,66,0,1,0,1,0,drop
9327,57470,0,0,62,62,0,1,0,1,0,deny
9283,57470,0,0,66,66,0,1,0,1,0,deny
28194,32468,0,0,62,62,0,1,0,1,0,deny
55762,445,0,0,70,70,0,1,0,1,0,drop
23296,23,0,0,60,60,0,1,0,1,0,deny
62872,50584,0,0,66,66,0,1,0,1,0,deny
25469,57470,0,0,62,62,0,1,0,1,0,deny
56094,445,0,0,66,66,0,1,0,1,0,drop
13281,51050,0,0,66,66,0,1,0,1,0,deny
22619,10214,0,0,66,66,0,1,0,1,0,deny
60688,445,0,0,70,70,0,1,0,1,0,drop
61053,44847,0,0,66,66,0,1,0,1,0,deny
51324,11392,0,0,66,66,0,1,0,1,0,deny
26408,64147,0,0,66,66,0,1,0,1,0,deny
10000,10214,0,0,62,62,0,1,0,1,0,deny
43725,54532,0,0,109,109,0,1,0,1,0,deny
56256,62413,0,0,66,66,0,1,0,1,0,deny
63447,44847,0,0,66,66,0,1,0,1,0,deny
55758,445,0,0,70,70,0,1,0,1,0,drop
13462,35440,0,0,66,66,0,1,0,1,0,deny
56092,445,0,0,66,66,0,1,0,1,0,drop
2422,50584,0,0,66,66,0,1,0,1,0,deny
27785,37965,0,0,66,66,0,1,0,1,0,deny
48557,37965,0,0,62,62,0,1,0,1,0,deny
1695,30349,0,0,148,148,0,1,0,1,0,deny
55747,445,0,0,70,70,0,1,0,1,0,drop
55748,445,0,0,70,70,0,1,0,1,0,drop
54210,36237,0,0,62,62,0,1,0,1,0,deny
50798,36237,0,0,62,62,0,1,0,1,0,deny
49635,443,49110,443,54634,6944,47690,99,47,47,52,allow
57504,443,39017,443,5238,695,4543,14,25,8,6,allow
51046,443,28730,443,17469,2444,15025,39,207,17,22,allow
57592,443,17732,443,2614,1689,925,18,19,10,8,allow
10168,80,10168,80,450,246,204,8,24,5,3,allow
57370,6969,42046,6969,70,70,0,2,8,2,0,allow
50644,5222,32859,5222,11661,4442,7219,87,71,41,46,allow
56301,443,56301,443,4378,1471,2907,19,30,11,8,allow
57236,443,10665,443,225524,59002,166522,402,78,192,210,allow
57441,53,16567,53,177,94,83,2,29,1,1,allow
50584,64027,41636,64027,166,166,0,1,1199,1,0,allow
8464,3389,8464,3389,3910,1805,2105,20,18,12,8,allow
50139,5228,61271,5228,7727,2172,5555,44,104,23,21,allow
56643,443,54840,443,7914,1925,5989,20,15,11,9,allow
53671,60416,42593,60416,70,70,0,2,7,2,0,allow
56620,443,2901,443,1327,918,409,10,25,6,4,allow
62737,443,7478,443,35936,2741,33195,62,15,30,32,allow
60762,40010,40997,40010,316,136,180,6,6,3,3,allow
60426,25988,19003,25988,70,70,0,2,8,2,0,allow
65110,53,12122,53,754,191,563,6,51,3,3,allow
64974,53,51198,53,493,111,382,4,57,2,2,allow
63930,53,2970,53,377,94,283,2,29,1,1,allow
63762,123,63358,123,184,94,90,2,29,1,1,allow
58440,53,26101,53,305,102,203,2,30,1,1,allow
27005,27017,8108,27017,1658,126,1532,4,30,2,2,allow
49469,443,43348,443,8779,3672,5107,17,119,8,9,allow
64429,53,41917,53,217,94,123,2,30,1,1,allow
58509,443,26840,443,13973721,436876,13536845,14039,1629,4929,9110,allow
51860,53854,28127,53854,70,70,0,2,7,2,0,allow
65175,53,18597,53,269,94,175,2,30,1,1,allow
56629,80,58427,80,234,234,0,4,12,4,0,allow
51839,27256,49193,27256,70,70,0,1,5,1,0,allow
56617,443,38005,443,5325,1074,4251,18,25,10,8,allow
56641,443,17125,443,7942,1953,5989,20,15,11,9,allow
38941,443,53715,443,4613,2811,1802,27,95,14,13,allow
45354,443,16907,443,81504,6111,75393,108,20,53,55,allow
55217,53,39301,53,210,102,108,2,30,1,1,allow
57238,443,50721,443,7549,2807,4742,42,78,22,20,allow
49325,443,64992,443,6141,949,5192,17,21,9,8,allow
34076,53,22329,53,168,78,90,2,30,1,1,allow
65268,53,12409,53,395,107,288,4,46,2,2,allow
52935,443,46702,443,1769338,65258,1704080,1935,1200,735,1200,allow
38295,443,36563,443,5247,3662,1585,21,310,11,10,allow
49224,53,17208,53,185,102,83,2,30,1,1,allow
49648,443,58904,443,11011,4522,6489,35,45,17,18,allow
27005,27015,55025,27015,1624,126,1498,4,31,2,2,allow
27005,50002,4449,50002,1642,126,1516,4,31,2,2,allow
60517,53,31898,53,198,86,112,2,30,1,1,allow
60427,61137,3652,61137,70,70,0,2,8,2,0,allow
55641,61762,32816,61762,70,70,0,2,8,2,0,allow
51834,30309,10825,30309,70,70,0,1,5,1,0,allow
54350,443,59930,443,15567,5964,9603,27,21,14,13,allow
34424,443,56503,443,773546,29906,743640,881,1166,350,531,allow
65211,53,49175,53,216,102,114,2,30,1,1,allow
64915,53,11027,53,177,94,83,2,30,1,1,allow
56336,53,12124,53,196,102,94,2,30,1,1,allow
46703,443,29330,443,4589,2090,2499,15,120,7,8,allow
51517,443,20075,443,590874,19818,571056,669,42,271,398,allow
51859,35365,47948,35365,70,70,0,2,7,2,0,allow
57245,443,39703,443,170452,9659,160793,224,68,97,127,allow
59841,80,53537,80,711697,18422,693275,716,50,253,463,allow
12656,53,33403,53,211,86,125,2,30,1,1,allow
56921,443,49898,443,8416,2142,6274,25,330,12,13,allow
62288,443,20087,443,1638,776,862,22,120,11,11,allow
58814,443,50784,443,1549485,41822,1507663,1612,179,520,1092,allow
27005,50001,15883,50001,1656,126,1530,4,31,2,2,allow
56642,443,62625,443,7890,1901,5989,20,15,11,9,allow
50584,16526,25996,16526,166,166,0,1,1199,1,0,allow
12011,443,12011,443,6981,948,6033,17,27,10,7,allow
51324,443,31259,443,2359,1283,1076,17,17,9,8,allow
10166,80,10166,80,450,246,204,8,24,5,3,allow
10169,80,10169,80,450,246,204,8,24,5,3,allow
53177,443,2633,443,6512167,186944,6325223,6347,1216,2089,4258,allow
49432,80,52783,80,2231,899,1332,15,92,8,7,allow
64930,443,64930,443,4596,1689,2907,19,27,11,8,allow
56336,53,53884,53,196,102,94,2,35,1,1,allow
12150,443,12150,443,6981,948,6033,17,27,10,7,allow
49444,53,42796,53,401,88,313,4,38,2,2,allow
53672,20380,35772,20380,70,70,0,2,7,2,0,allow
49756,53,16127,53,396,94,302,4,41,2,2,allow
52931,80,27397,80,78,78,0,1,4,1,0,allow
57247,443,40506,443,93673,74276,19397,194,67,111,83,allow
64575,443,61163,443,24686,1935,22751,36,16,17,19,allow
49633,53,1926,53,245,94,151,2,29,1,1,allow
57246,443,63215,443,360050,17258,342792,432,68,185,247,allow
64252,53,63103,53,350,94,256,2,29,1,1,allow
57244,443,45761,443,230914,10401,220513,290,76,121,169,allow
65377,443,4212,443,4864,2496,2368,33,121,17,16,allow
31574,53,31574,53,213,90,123,2,29,1,1,allow
5588,5588,0,0,3562,1936,1626,48,193,24,24,allow
27005,27017,62934,27017,1658,126,1532,4,30,2,2,allow
57441,53,9760,53,177,94,83,2,29,1,1,allow
63008,53,31909,53,183,86,97,2,30,1,1,allow
64873,53,26833,53,380,110,270,2,30,1,1,allow
27005,27016,51582,27016,1626,126,1500,4,30,2,2,allow
39624,53,30103,53,168,78,90,2,30,1,1,allow
55631,443,48681,443,17521,3850,13671,30,121,13,17,allow
31593,53,31593,53,832,106,726,2,30,1,1,allow
49369,53,33288,53,232,110,122,2,30,1,1,allow
49835,53,27246,53,214,94,120,2,30,1,1,allow
50584,56221,62822,56221,166,166,0,1,1199,1,0,allow
51835,29778,40587,29778,70,70,0,1,5,1,0,allow
57242,443,22643,443,291104,18601,272503,413,77,186,227,allow
65520,56330,49409,56330,558,318,240,9,143,5,4,allow
55773,53,28630,53,102,102,0,1,60,1,0,allow
50045,443,64654,443,4551,2388,2163,16,120,8,8,allow
10164,80,10164,80,7351,803,6548,16,24,7,9,allow
51857,40561,9754,40561,70,70,0,2,8,2,0,allow
56222,443,56222,443,4378,1471,2907,19,27,11,8,allow
56611,443,65034,443,1473,868,605,10,25,6,4,allow
43719,53,43719,53,295,90,205,2,30,1,1,allow
64367,53,24939,53,257,110,147,2,30,1,1,allow
55625,53,6982,53,94,94,0,1,30,1,0,allow
55633,54638,31495,54638,504,318,186,8,15,5,3,allow
51585,80,50569,80,3192,624,2568,10,155,5,5,allow
51840,34678,44195,34678,70,70,0,1,5,1,0,allow
35203,443,62498,443,232,172,60,3,5,2,1,allow
64482,53,36400,53,322,95,227,4,39,2,2,allow
57248,443,32420,443,1021056,38101,982955,1183,64,501,682,allow
36313,443,38446,443,55608,48375,7233,140,95,81,59,allow
64716,53,33097,53,385,134,251,2,30,1,1,allow
56777,53,34621,53,210,94,116,2,30,1,1,allow
64758,443,35347,443,5066,2558,2508,26,127,13,13,allow
49987,53,51873,53,253,86,167,2,30,1,1,allow
27005,27027,58259,27027,1654,126,1528,4,31,2,2,allow
27005,27019,28663,27019,1652,126,1526,4,31,2,2,allow
58809,443,38293,443,4055,1295,2760,11,121,6,5,allow
65453,53,50552,53,242,94,148,2,30,1,1,allow
49855,53,11171,53,290,102,188,2,30,1,1,allow
50584,26301,47178,26301,161,161,0,2,1199,2,0,allow
57470,1337,56441,1337,792,792,0,13,1199,13,0,allow
64915,53,41416,53,177,94,83,2,31,1,1,allow
19473,6881,30849,6881,491,150,341,2,1200,1,1,allow
57470,49001,13810,49001,166,166,0,1,1200,1,0,allow
50584,50901,9302,50901,166,166,0,1,1199,1,0,allow
46991,53,46991,53,262,106,156,2,31,1,1,allow
52354,443,50559,443,10417,5338,5079,22,135,11,11,allow
50584,32808,19666,32808,166,166,0,1,1199,1,0,allow
50584,1283,8544,1283,1617,161,1456,4,1199,2,2,allow
54145,443,52108,443,118,118,0,1,120,1,0,allow
53651,47758,11315,47758,70,70,0,1,5,1,0,allow
42971,3478,30951,3478,312,140,172,4,30,2,2,allow
60049,443,35659,443,10124,2145,7979,24,156,11,13,allow
56639,443,28147,443,7849,1860,5989,20,16,11,9,allow
55744,445,0,0,70,70,0,1,0,1,0,drop
55745,445,0,0,70,70,0,1,0,1,0,drop
56085,445,0,0,66,66,0,1,0,1,0,drop
55742,445,0,0,70,70,0,1,0,1,0,drop
60350,51505,0,0,66,66,0,1,0,1,0,deny
56082,445,0,0,66,66,0,1,0,1,0,drop
25565,62144,0,0,60,60,0,1,0,1,0,deny
57564,56205,0,0,62,62,0,1,0,1,0,deny
55736,445,0,0,70,70,0,1,0,1,0,drop
60678,445,0,0,70,70,0,1,0,1,0,drop
60677,445,0,0,70,70,0,1,0,1,0,drop
60675,445,0,0,70,70,0,1,0,1,0,drop
56067,445,0,0,66,66,0,1,0,1,0,drop
56069,445,0,0,66,66,0,1,0,1,0,drop
56066,445,0,0,66,66,0,1,0,1,0,drop
56063,445,0,0,66,66,0,1,0,1,0,drop
56065,445,0,0,66,66,0,1,0,1,0,drop
56061,445,0,0,66,66,0,1,0,1,0,drop
56062,445,0,0,66,66,0,1,0,1,0,drop
52720,35894,0,0,62,62,0,1,0,1,0,deny
56835,35894,0,0,66,66,0,1,0,1,0,deny
60168,35440,0,0,66,66,0,1,0,1,0,deny
14059,21247,0,0,62,62,0,1,0,1,0,deny
49616,30188,0,0,62,62,0,1,0,1,0,deny
50637,44847,0,0,66,66,0,1,0,1,0,deny
65064,30188,0,0,66,66,0,1,0,1,0,deny
6931,55108,0,0,139,139,0,1,0,1,0,deny
55728,445,0,0,70,70,0,1,0,1,0,drop
55727,445,0,0,70,70,0,1,0,1,0,drop
50716,50584,0,0,74,74,0,1,0,1,0,deny
17579,57470,0,0,62,62,0,1,0,1,0,deny
40474,23117,0,0,62,62,0,1,0,1,0,deny
60671,445,0,0,70,70,0,1,0,1,0,drop
60661,445,0,0,70,70,0,1,0,1,0,drop
60660,445,0,0,70,70,0,1,0,1,0,drop
55722,445,0,0,70,70,0,1,0,1,0,drop
55720,445,0,0,70,70,0,1,0,1,0,drop
56047,445,0,0,66,66,0,1,0,1,0,drop
56049,445,0,0,66,66,0,1,0,1,0,drop
56046,445,0,0,66,66,0,1,0,1,0,drop
3883,50265,0,0,66,66,0,1,0,1,0,deny
60657,445,0,0,70,70,0,1,0,1,0,drop
56582,37965,0,0,62,62,0,1,0,1,0,deny
23770,50584,0,0,66,66,0,1,0,1,0,deny
59564,57470,0,0,66,66,0,1,0,1,0,deny
27783,57470,0,0,62,62,0,1,0,1,0,deny
64903,51050,0,0,66,66,0,1,0,1,0,deny
55716,445,0,0,70,70,0,1,0,1,0,drop
60655,445,0,0,70,70,0,1,0,1,0,drop
19610,55839,0,0,137,137,0,1,0,1,0,deny
65518,5710,0,0,62,62,0,1,0,1,0,deny
55714,445,0,0,70,70,0,1,0,1,0,drop
60654,445,0,0,70,70,0,1,0,1,0,drop
60652,445,0,0,70,70,0,1,0,1,0,drop
60650,445,0,0,70,70,0,1,0,1,0,drop
20400,64147,0,0,62,62,0,1,0,1,0,deny
20400,64147,0,0,145,145,0,1,0,1,0,deny
11023,51505,0,0,62,62,0,1,0,1,0,deny
43916,21,0,0,60,60,0,1,0,1,0,deny
42252,33303,0,0,60,60,0,1,0,1,0,deny
16387,3655,0,0,60,60,0,1,0,1,0,deny
16387,22272,0,0,60,60,0,1,0,1,0,deny
16387,20045,0,0,60,60,0,1,0,1,0,deny
55710,445,0,0,70,70,0,1,0,1,0,drop
16387,44427,0,0,60,60,0,1,0,1,0,deny
20005,37965,0,0,62,62,0,1,0,1,0,deny
16387,7205,0,0,60,60,0,1,0,1,0,deny
16387,16862,0,0,60,60,0,1,0,1,0,deny
16387,35583,0,0,60,60,0,1,0,1,0,deny
16387,63752,0,0,60,60,0,1,0,1,0,deny
16387,64075,0,0,60,60,0,1,0,1,0,deny
13980,23,0,0,60,60,0,1,0,1,0,deny
60637,445,0,0,70,70,0,1,0,1,0,drop
60635,445,0,0,70,70,0,1,0,1,0,drop
60632,445,0,0,70,70,0,1,0,1,0,drop
3996,57470,0,0,62,62,0,1,0,1,0,deny
61002,37965,0,0,145,145,0,1,0,1,0,deny
63779,26467,0,0,66,66,0,1,0,1,0,deny
26536,53,62994,53,306,99,207,2,0,1,1,allow
55697,445,0,0,70,70,0,1,0,1,0,drop
56025,445,0,0,66,66,0,1,0,1,0,drop
60628,445,0,0,70,70,0,1,0,1,0,drop
60629,445,0,0,70,70,0,1,0,1,0,drop
52837,35440,0,0,66,66,0,1,0,1,0,deny
55694,445,0,0,70,70,0,1,0,1,0,drop
34808,22114,0,0,62,62,0,1,0,1,0,deny
63621,30188,0,0,62,62,0,1,0,1,0,deny
48016,57470,0,0,62,62,0,1,0,1,0,deny
1024,50265,0,0,62,62,0,1,0,1,0,deny
26391,44847,0,0,146,146,0,1,0,1,0,deny
56020,445,0,0,66,66,0,1,0,1,0,drop
45682,1,0,0,62,62,0,1,0,1,0,deny
55690,445,0,0,70,70,0,1,0,1,0,drop
56017,445,0,0,66,66,0,1,0,1,0,drop
55688,445,0,0,70,70,0,1,0,1,0,drop
60617,445,0,0,70,70,0,1,0,1,0,drop
8889,10794,0,0,60,60,0,1,0,1,0,deny
60614,445,0,0,70,70,0,1,0,1,0,drop
60612,445,0,0,70,70,0,1,0,1,0,drop
60607,445,0,0,70,70,0,1,0,1,0,drop
55686,445,0,0,70,70,0,1,0,1,0,drop
56013,445,0,0,66,66,0,1,0,1,0,drop
20608,28189,0,0,60,60,0,1,0,1,0,deny
45912,44847,0,0,146,146,0,1,0,1,0,deny
49160,57470,0,0,146,146,0,1,0,1,0,deny
1024,45129,0,0,145,145,0,1,0,1,0,deny
60603,445,0,0,70,70,0,1,0,1,0,drop
30114,65151,0,0,60,60,0,1,0,1,0,deny
60398,46776,0,0,74,74,0,1,0,1,0,deny
60600,445,0,0,70,70,0,1,0,1,0,drop
60599,445,0,0,70,70,0,1,0,1,0,drop
60598,445,0,0,70,70,0,1,0,1,0,drop
58381,57470,0,0,66,66,0,1,0,1,0,deny
56008,445,0,0,66,66,0,1,0,1,0,drop
55679,445,0,0,70,70,0,1,0,1,0,drop
56003,445,0,0,66,66,0,1,0,1,0,drop
56005,445,0,0,66,66,0,1,0,1,0,drop
56004,445,0,0,66,66,0,1,0,1,0,drop
55677,445,0,0,70,70,0,1,0,1,0,drop
55998,445,0,0,66,66,0,1,0,1,0,drop
55997,445,0,0,66,66,0,1,0,1,0,drop
1081,1970,0,0,146,146,0,1,0,1,0,deny
53625,64147,0,0,66,66,0,1,0,1,0,deny
63867,64147,0,0,62,62,0,1,0,1,0,deny
49915,35440,0,0,62,62,0,1,0,1,0,deny
55676,445,0,0,70,70,0,1,0,1,0,drop
63421,53,63421,53,223,86,137,2,30,1,1,allow
57289,443,13366,443,2693,1361,1332,17,19,10,7,allow
57285,443,38646,443,21198,9647,11551,97,20,52,45,allow
49181,2710,53031,2710,70,70,0,2,8,2,0,allow
60115,443,39754,443,268,120,148,5,10,3,2,allow
53776,53,0,0,82,82,0,2,40,2,0,allow
57251,443,64913,443,54515,20774,33741,167,36,88,79,allow
49499,443,5486,443,8848,4908,3940,23,42,12,11,allow
64411,443,21450,443,23357,2589,20768,33,120,13,20,allow
50949,443,50949,443,4453,1546,2907,19,29,11,8,allow
45340,443,58208,443,2504,1442,1062,22,29,12,10,allow
49632,443,35637,443,5598,1185,4413,24,80,13,11,allow
56552,53,56552,53,223,86,137,2,30,1,1,allow
62466,53,62466,53,194,87,107,2,30,1,1,allow
40334,53,40334,53,213,87,126,2,30,1,1,allow
55220,53,55080,53,758,96,662,2,30,1,1,allow
57996,53,57996,53,847,110,737,2,30,1,1,allow
55215,443,18070,443,3717,2233,1484,34,80,20,14,allow
60900,443,51308,443,7426,1877,5549,22,81,13,9,allow
57273,443,35041,443,10926,3915,7011,50,33,28,22,allow
49628,443,15510,443,5600,1187,4413,24,80,13,11,allow
56039,53,8952,53,762,98,664,2,30,1,1,allow
60109,443,54198,443,268,120,148,5,10,3,2,allow
56536,443,5996,443,6044,3444,2600,49,501,25,24,allow
49629,443,16590,443,5600,1187,4413,24,80,13,11,allow
42971,3478,56626,3478,452,280,172,5,30,3,2,allow
60944,443,23317,443,8264,4269,3995,17,31,9,8,allow
50382,80,4705,80,1369,799,570,13,77,7,6,allow
42971,3478,30766,3478,312,140,172,4,30,2,2,allow
46000,443,62571,443,2583,334,2249,7,90,3,4,allow
56664,443,31995,443,7561,2483,5078,26,20,13,13,allow
55193,53,9970,53,200,102,98,2,30,1,1,allow
56836,1,16144,1,130,70,60,2,5,1,1,allow
57892,443,5458,443,6845,1743,5102,22,81,13,9,allow
61589,443,61589,443,4672,1765,2907,19,28,11,8,allow
53653,17436,61017,17436,70,70,0,1,5,1,0,allow
57287,443,20277,443,8960,2778,6182,31,20,16,15,allow
57292,443,37855,443,18591,5839,12752,78,18,44,34,allow
57322,443,7352,443,8237,2784,5453,35,16,21,14,allow
57352,53,30931,53,711,87,624,2,31,1,1,allow
49622,443,43494,443,15336,2803,12533,47,202,24,23,allow
49615,443,24939,443,48705,7643,41062,146,256,77,69,allow
57252,443,17744,443,12683,4753,7930,59,36,33,26,allow
56828,53156,57681,53156,70,70,0,2,8,2,0,allow
57254,443,23704,443,6000,1578,4422,22,36,12,10,allow
51832,40607,33466,40607,66,66,0,1,5,1,0,allow
60365,443,2645,443,130,70,60,2,15,1,1,allow
59773,443,43322,443,165464,10322,155142,189,71,69,120,allow
57291,443,9776,443,2685,1353,1332,17,19,10,7,allow
57290,443,45371,443,2693,1361,1332,17,19,10,7,allow
53650,37096,27046,37096,70,70,0,1,5,1,0,allow
53647,16194,38859,16194,70,70,0,1,5,1,0,allow
51220,443,53814,443,7647,1917,5730,22,80,13,9,allow
49556,443,16559,443,8602,2308,6294,23,82,13,10,allow
33166,53,0,0,82,82,0,2,40,2,0,allow
65027,53,8113,53,758,96,662,2,30,1,1,allow
35747,443,32307,443,8676,3499,5177,31,373,17,14,allow
40127,53,0,0,82,82,0,1,31,1,0,allow
55104,53,12993,53,733,85,648,2,31,1,1,allow
55733,53,35309,53,170,87,83,2,31,1,1,allow
56720,53,21366,53,170,87,83,2,31,1,1,allow
56747,443,3267,443,19030,7323,11707,51,122,23,28,allow
56045,53,44616,53,754,94,660,2,31,1,1,allow
54654,443,37432,443,4869,1016,3853,18,121,9,9,allow
58278,443,36015,443,3581,1045,2536,10,122,5,5,allow
41164,443,62496,443,8582,4759,3823,29,135,14,15,allow
55675,445,0,0,70,70,0,1,0,1,0,drop
51412,51505,0,0,66,66,0,1,0,1,0,deny
35065,23,0,0,60,60,0,1,0,1,0,deny
55674,445,0,0,70,70,0,1,0,1,0,drop
55672,445,0,0,70,70,0,1,0,1,0,drop
55668,445,0,0,70,70,0,1,0,1,0,drop
60594,445,0,0,70,70,0,1,0,1,0,drop
60593,445,0,0,70,70,0,1,0,1,0,drop
60589,445,0,0,70,70,0,1,0,1,0,drop
50341,37965,0,0,66,66,0,1,0,1,0,deny
52144,49344,0,0,62,62,0,1,0,1,0,deny
55991,445,0,0,66,66,0,1,0,1,0,drop
60587,445,0,0,70,70,0,1,0,1,0,drop
33801,62413,0,0,66,66,0,1,0,1,0,deny
55988,445,0,0,66,66,0,1,0,1,0,drop
26180,35440,0,0,66,66,0,1,0,1,0,deny
49191,35440,0,0,66,66,0,1,0,1,0,deny
41794,41794,0,0,308,308,0,1,0,1,0,deny
57282,443,46130,443,11721,2230,9491,39,31,22,17,allow
53238,443,61389,443,13597,1371,12226,26,323,11,15,allow
42644,443,8391,443,8384,2161,6223,24,255,12,12,allow
50236,443,15469,443,5858,791,5067,19,22,10,9,allow
27005,28018,47944,28018,1640,126,1514,4,30,2,2,allow
27005,27017,53303,27017,1634,126,1508,4,30,2,2,allow
27005,32030,25176,32030,1796,252,1544,5,31,3,2,allow
35486,443,63942,443,4630,2803,1827,29,80,14,15,allow
50543,443,30180,443,38667,3344,35323,56,210,24,32,allow
50201,80,38325,80,5015,2123,2892,25,96,14,11,allow
50486,80,43523,80,378,192,186,7,21,4,3,allow
51457,443,1251,443,334,70,264,5,17,1,4,allow
60423,52001,49584,52001,260,140,120,5,9,3,2,allow
50116,22,50116,22,184,120,64,4,4,3,1,allow
64780,53,56336,53,203,86,117,2,29,1,1,allow
50002,53,23419,53,183,102,81,2,30,1,1,allow
64915,53,19337,53,177,94,83,2,29,1,1,allow
48151,123,24928,123,184,94,90,2,30,1,1,allow
52417,443,14213,443,8376,6877,1499,27,31,15,12,allow
37774,443,33221,443,282171,13444,268727,377,201,175,202,allow
41959,443,65186,443,5838,1840,3998,20,80,12,8,allow
51833,47388,62543,47388,70,70,0,1,5,1,0,allow
53248,443,27776,443,41125,3625,37500,62,323,25,37,allow
53242,443,60207,443,42135,4098,38037,64,323,25,39,allow
53256,443,59014,443,29039,3057,25982,46,323,19,27,allow
53252,443,27483,443,31843,2847,28996,50,323,20,30,allow
64745,3389,64745,3389,3413,1458,1955,16,18,8,8,allow
50020,53,1594,53,210,102,108,2,30,1,1,allow
56835,27582,44303,27582,130,70,60,2,5,1,1,allow
60719,443,32077,443,71523,19991,51532,112,41,59,53,allow
55193,53,3630,53,533,102,431,4,42,2,2,allow
42820,443,41684,443,8155,1999,6156,22,81,13,9,allow
52657,53,48551,53,302,210,92,3,30,2,1,allow
53258,443,42318,443,31919,3528,28391,49,323,19,30,allow
49619,443,17429,443,46202,8086,38116,131,243,69,62,allow
49623,443,29272,443,36302,2869,33433,67,180,32,35,allow
52217,80,27362,80,1074,565,509,11,16,6,5,allow
33257,443,43255,443,19341,4612,14729,38,21,19,19,allow
59403,443,58702,443,5853,2409,3444,35,80,16,19,allow
49623,443,17482,443,3972,2532,1440,18,80,10,8,allow
56637,443,26633,443,7907,1918,5989,20,15,11,9,allow
63826,80,41744,80,314,192,122,6,15,4,2,allow
53241,443,7784,443,24835,2671,22164,42,323,17,25,allow
59731,443,62257,443,7236,827,6409,17,25,8,9,allow
56670,443,55495,443,8308,3589,4719,25,19,15,10,allow
53251,443,22293,443,24116,2677,21439,42,323,17,25,allow
59732,443,8520,443,7310,967,6343,18,25,10,8,allow
47325,443,49234,443,130,70,60,2,15,1,1,allow
56593,443,58940,443,1165,662,503,11,25,6,5,allow
59844,80,25773,80,397391,8624,388767,380,49,118,262,allow
64153,53,31839,53,213,94,119,2,30,1,1,allow
50368,53,59190,53,70,70,0,1,30,1,0,allow
57829,443,7967,443,981499,39775,941724,1109,291,439,670,allow
49289,53,43256,53,177,94,83,2,30,1,1,allow
61015,443,14729,443,7863,1962,5901,29,270,16,13,allow
64656,53,38366,53,718,94,624,2,30,1,1,allow
49767,53,47243,53,185,102,83,2,30,1,1,allow
49817,53,12075,53,167,86,81,2,30,1,1,allow
65299,53,37280,53,177,94,83,2,30,1,1,allow
36287,443,35494,443,6419,2962,3457,25,148,12,13,allow
60163,443,56805,443,8929,3204,5725,25,80,14,11,allow
53369,80,53369,80,81339,4340,76999,84,57,22,62,allow
53268,443,17713,443,22541,2143,20398,38,322,16,22,allow
59733,443,63033,443,7310,967,6343,18,25,10,8,allow
64224,53,56405,53,280,94,186,2,30,1,1,allow
55275,53,25486,53,213,94,119,2,30,1,1,allow
50734,443,16701,443,1726,668,1058,13,2033,4,9,allow
50172,443,42288,443,152228,30166,122062,215,153,92,123,allow
53282,443,19856,443,13300,1695,11605,27,321,12,15,allow
53260,443,22555,443,23664,2213,21451,41,323,17,24,allow
56643,443,24007,443,1560,988,572,13,21,7,6,allow
57276,443,44097,443,14236,2699,11537,51,31,27,24,allow
63843,53603,44636,53603,312,132,180,6,6,3,3,allow
42618,443,18541,443,4694,2432,2262,34,81,16,18,allow
51169,443,30146,443,975832,29038,946794,991,51,341,650,allow
56572,443,48876,443,10325,2594,7731,28,27,16,12,allow
43920,443,54926,443,12666,4180,8486,37,504,20,17,allow
60228,443,13572,443,1058,641,417,10,50,6,4,allow
58692,53,28574,53,199,94,105,2,30,1,1,allow
64238,53,60413,53,213,102,111,2,30,1,1,allow
49767,53,2563,53,177,94,83,2,30,1,1,allow
65053,53,62092,53,197,94,103,2,30,1,1,allow
49620,443,27552,443,13241,2865,10376,60,242,26,34,allow
60848,443,33330,443,6513,1863,4650,28,255,15,13,allow
57283,443,46704,443,7792,2318,5474,38,27,22,16,allow
53246,443,34451,443,30174,2792,27382,47,323,19,28,allow
54966,53,31791,53,254,87,167,4,31,2,2,allow
53278,443,20618,443,12634,1635,10999,26,322,11,15,allow
49505,443,2441,443,35158,5065,30093,53,42,18,35,allow
57250,443,30751,443,345315,16365,328950,459,36,206,253,allow
50386,80,26554,80,6718,3126,3592,16,77,8,8,allow
42971,3478,49754,3478,312,140,172,4,29,2,2,allow
36435,443,62505,443,7046,3518,3528,66,612,35,31,allow
50475,80,52145,80,2669,1434,1235,11,21,6,5,allow
53270,443,48173,443,21684,2143,19541,38,322,16,22,allow
56640,443,64695,443,7797,1808,5989,20,14,11,9,allow
50487,80,25708,80,378,192,186,7,21,4,3,allow
53266,443,29507,443,30264,2794,27470,47,322,19,28,allow
64644,53,30010,53,364,89,275,4,33,2,2,allow
47002,53,47002,53,244,98,146,2,31,1,1,allow
53272,443,47485,443,20745,2083,18662,36,322,15,21,allow
56837,53,14391,53,195,102,93,2,33,1,1,allow
51831,26270,17546,26270,70,70,0,1,5,1,0,allow
51855,23268,62200,23268,70,70,0,2,7,2,0,allow
60114,443,25008,443,268,120,148,5,10,3,2,allow
53706,80,53481,80,1398,590,808,9,111,6,3,allow
49930,443,7030,443,7934,1836,6098,23,15,13,10,allow
50478,80,37121,80,2869,1173,1696,11,21,6,5,allow
50472,80,63342,80,12222,3865,8357,23,22,11,12,allow
60428,55172,58181,55172,320,140,180,6,7,3,3,allow
12064,53,12064,53,244,98,146,2,33,1,1,allow
56638,443,63919,443,7855,1866,5989,20,15,11,9,allow
51836,37753,57785,37753,70,70,0,1,4,1,0,allow
57299,443,9312,443,23282,4482,18800,67,17,35,32,allow
59735,443,11468,443,7310,967,6343,18,25,10,8,allow
57293,443,65420,443,7057,2815,4242,37,18,21,16,allow
55629,36190,12886,36190,504,318,186,8,16,5,3,allow
59134,443,19073,443,6857,1727,5130,23,316,13,10,allow
55634,58846,20945,58846,70,70,0,1,5,1,0,allow
43518,443,23490,443,10265,2118,8147,23,81,13,10,allow
5588,5588,0,0,3354,1792,1562,46,194,23,23,allow
52407,443,53495,443,100194,6406,93788,171,24,85,86,allow
64459,53,56371,53,251,94,157,2,29,1,1,allow
62736,80,60766,80,1516,481,1035,11,15,6,5,allow
54447,53,9967,53,199,94,105,2,29,1,1,allow
45701,80,26870,80,1579,1217,362,8,15,5,3,allow
39850,53,3565,53,199,94,105,2,29,1,1,allow
27005,27015,29834,27015,1634,126,1508,4,30,2,2,allow
46455,53,32632,53,168,78,90,2,30,1,1,allow
50659,53,45075,53,168,78,90,2,30,1,1,allow
49289,53,16244,53,177,94,83,2,30,1,1,allow
5588,5588,0,0,3354,1792,1562,46,192,23,23,allow
32742,53,46400,53,207,86,121,2,30,1,1,allow
56345,53,18764,53,199,94,105,2,30,1,1,allow
54147,443,52345,443,3334,331,3003,10,120,5,5,allow
50287,53,28262,53,781,94,687,2,30,1,1,allow
50239,53,31652,53,183,94,89,2,31,1,1,allow
27005,50003,20006,50003,887,126,761,2,31,1,1,allow
49562,443,59931,443,3380,346,3034,12,120,5,7,allow
38700,443,53165,443,40207,7892,32315,59,152,23,36,allow
57470,58753,38248,58753,166,166,0,1,1199,1,0,allow
57271,443,34428,443,7155,2151,5004,34,33,20,14,allow
57274,443,44033,443,11536,2572,8964,41,33,24,17,allow
55635,38649,44116,38649,70,70,0,1,5,1,0,allow
50721,443,49373,443,5828,1439,4389,16,75,9,7,allow
55628,13343,19881,13343,634,388,246,10,18,6,4,allow
46328,443,26248,443,446664,48034,398630,698,223,326,372,allow
37759,53,22729,53,164,78,86,2,30,1,1,allow
27005,50003,10902,50003,1636,126,1510,4,31,2,2,allow
57288,443,58142,443,116807,21042,95765,315,19,161,154,allow
64749,3389,64749,3389,3347,1458,1889,15,18,8,7,allow
57284,443,12442,443,1402,917,485,12,27,7,5,allow
51838,29448,59159,29448,70,70,0,1,5,1,0,allow
51830,32787,57258,32787,70,70,0,1,5,1,0,allow
54100,80,44998,80,78,78,0,1,5,1,0,allow
62952,38741,48558,38741,18963,9580,9383,211,348,109,102,allow
52218,80,8584,80,2373,614,1759,11,15,6,5,allow
50318,53,54870,53,94,94,0,1,30,1,0,allow
65299,53,60442,53,177,94,83,2,30,1,1,allow
59486,443,24695,443,9161,2202,6959,28,374,14,14,allow
53245,443,1855,443,28206,2737,25469,45,323,18,27,allow
57272,443,35317,443,6445,2145,4300,29,33,17,12,allow
57275,443,6369,443,22074,3005,19069,58,31,31,27,allow
54101,80,21675,80,78,78,0,1,5,1,0,allow
55632,45682,33177,45682,70,70,0,1,5,1,0,allow
56671,443,62348,443,8300,3581,4719,25,19,15,10,allow
43762,443,5128,443,7775,1963,5812,22,77,13,9,allow
57327,443,38850,443,5613,733,4880,16,15,9,7,allow
49943,53,18559,53,718,94,624,2,30,1,1,allow
43851,53,43851,53,227,90,137,2,30,1,1,allow
48737,53,48737,53,227,90,137,2,30,1,1,allow
49872,53,36268,53,331,126,205,2,30,1,1,allow
49995,53,57379,53,197,102,95,2,30,1,1,allow
56006,53,33224,53,183,102,81,2,30,1,1,allow
55261,53,37106,53,177,94,83,2,30,1,1,allow
64902,53,39715,53,231,110,121,2,30,1,1,allow
6881,6881,48403,6881,502,150,352,2,1200,1,1,allow
55619,53,59792,53,241,78,163,2,30,1,1,allow
57364,53,64164,53,177,94,83,2,30,1,1,allow
55757,53,48609,53,177,94,83,2,30,1,1,allow
35041,443,38147,443,16010,4754,11256,47,130,20,27,allow
21133,6889,63864,6889,481,150,331,2,1199,1,1,allow
57470,43836,52896,43836,402,132,270,6,1209,3,3,allow
42288,443,48757,443,16985,7850,9135,39,121,19,20,allow
52317,5223,5494,5223,6070,1779,4291,17,3600,8,9,allow
51860,443,38045,443,6577,1938,4639,14,121,7,7,allow
50265,13826,10952,13826,330,330,0,6,1200,6,0,allow
62704,443,4818,443,6805,3445,3360,31,121,15,16,allow
36732,443,61155,443,7449,2359,5090,15,120,7,8,allow
40183,443,34811,443,6065,2277,3788,17,135,8,9,allow
57470,49160,41673,49160,132,132,0,3,1199,3,0,allow
53667,49160,27701,49160,320,140,180,6,7,3,3,allow
57308,443,32709,443,8837,3033,5804,44,16,24,20,allow
64968,53,21697,53,250,102,148,2,31,1,1,allow
53128,29593,28307,29593,70,70,0,2,9,2,0,allow
38681,443,38681,443,3028,1828,1200,19,21,11,8,allow
65521,53,52937,53,167,86,81,2,30,1,1,allow
53643,8118,59357,8118,2104,1209,895,15,16,7,8,allow
49528,53,57566,53,177,94,83,2,30,1,1,allow
55009,53,51311,53,241,78,163,2,30,1,1,allow
55987,445,0,0,66,66,0,1,0,1,0,drop
55985,445,0,0,66,66,0,1,0,1,0,drop
55656,445,0,0,70,70,0,1,0,1,0,drop
55655,445,0,0,70,70,0,1,0,1,0,drop
22683,39210,0,0,60,60,0,1,0,1,0,deny
55651,445,0,0,70,70,0,1,0,1,0,drop
55984,445,0,0,66,66,0,1,0,1,0,drop
55645,445,0,0,70,70,0,1,0,1,0,drop
55646,445,0,0,70,70,0,1,0,1,0,drop
57433,21247,0,0,66,66,0,1,0,1,0,deny
60586,445,0,0,70,70,0,1,0,1,0,drop
54545,49344,0,0,66,66,0,1,0,1,0,deny
22275,51505,0,0,62,62,0,1,0,1,0,deny
60573,445,0,0,70,70,0,1,0,1,0,drop
60569,445,0,0,70,70,0,1,0,1,0,drop
55514,1604,0,0,84,84,0,1,0,1,0,deny
55632,445,0,0,70,70,0,1,0,1,0,drop
64990,55442,0,0,66,66,0,1,0,1,0,deny
55973,445,0,0,66,66,0,1,0,1,0,drop
55373,1,0,0,66,66,0,1,0,1,0,deny
63194,50265,0,0,62,62,0,1,0,1,0,deny
28370,35440,0,0,66,66,0,1,0,1,0,deny
50280,57470,0,0,78,78,0,1,0,1,0,deny
46362,35440,0,0,66,66,0,1,0,1,0,deny
45941,23386,0,0,60,60,0,1,0,1,0,deny
27641,39004,0,0,62,62,0,1,0,1,0,deny
55965,445,0,0,66,66,0,1,0,1,0,drop
54989,50265,0,0,66,66,0,1,0,1,0,deny
12107,22114,0,0,66,66,0,1,0,1,0,deny
60560,445,0,0,70,70,0,1,0,1,0,drop
49197,30188,0,0,62,62,0,1,0,1,0,deny
55628,445,0,0,70,70,0,1,0,1,0,drop
26699,35253,0,0,62,62,0,1,0,1,0,deny
55963,445,0,0,66,66,0,1,0,1,0,drop
55618,445,0,0,70,70,0,1,0,1,0,drop
55619,445,0,0,70,70,0,1,0,1,0,drop
55616,445,0,0,70,70,0,1,0,1,0,drop
55614,445,0,0,70,70,0,1,0,1,0,drop
11136,15503,0,0,62,62,0,1,0,1,0,deny
55611,445,0,0,70,70,0,1,0,1,0,drop
55955,445,0,0,66,66,0,1,0,1,0,drop
55952,445,0,0,66,66,0,1,0,1,0,drop
58497,39004,0,0,66,66,0,1,0,1,0,deny
59772,62413,0,0,66,66,0,1,0,1,0,deny
64693,26467,0,0,62,62,0,1,0,1,0,deny
36034,35440,0,0,62,62,0,1,0,1,0,deny
55605,445,0,0,70,70,0,1,0,1,0,drop
45908,33330,0,0,60,60,0,1,0,1,0,deny
60548,445,0,0,70,70,0,1,0,1,0,drop
60547,445,0,0,70,70,0,1,0,1,0,drop
60549,445,0,0,70,70,0,1,0,1,0,drop
4257,35440,0,0,62,62,0,1,0,1,0,deny
55937,445,0,0,66,66,0,1,0,1,0,drop
55940,445,0,0,66,66,0,1,0,1,0,drop
55934,445,0,0,66,66,0,1,0,1,0,drop
55935,445,0,0,66,66,0,1,0,1,0,drop
55939,445,0,0,66,66,0,1,0,1,0,drop
55933,445,0,0,66,66,0,1,0,1,0,drop
55938,445,0,0,66,66,0,1,0,1,0,drop
55932,445,0,0,66,66,0,1,0,1,0,drop
59312,22,59312,22,327,140,187,4,0,2,2,deny
57174,57470,0,0,66,66,0,1,0,1,0,deny
55598,445,0,0,70,70,0,1,0,1,0,drop
55596,445,0,0,70,70,0,1,0,1,0,drop
55238,21247,0,0,62,62,0,1,0,1,0,deny
48706,23394,0,0,60,60,0,1,0,1,0,deny
55591,445,0,0,70,70,0,1,0,1,0,drop
46292,42873,0,0,72,72,0,1,0,1,0,deny
55590,445,0,0,70,70,0,1,0,1,0,drop
59724,64147,0,0,66,66,0,1,0,1,0,deny
60544,445,0,0,70,70,0,1,0,1,0,drop
60540,445,0,0,70,70,0,1,0,1,0,drop
46945,64147,0,0,62,62,0,1,0,1,0,deny
60533,445,0,0,70,70,0,1,0,1,0,drop
443,52504,0,0,97,97,0,1,0,1,0,deny
55920,445,0,0,66,66,0,1,0,1,0,drop
55919,445,0,0,66,66,0,1,0,1,0,drop
55917,445,0,0,66,66,0,1,0,1,0,drop
65495,11392,0,0,66,66,0,1,0,1,0,deny
55586,445,0,0,70,70,0,1,0,1,0,drop
62740,44847,0,0,146,146,0,1,0,1,0,deny
60530,445,0,0,70,70,0,1,0,1,0,drop
7978,50584,0,0,66,66,0,1,0,1,0,deny
58213,37807,0,0,66,66,0,1,0,1,0,deny
55585,445,0,0,70,70,0,1,0,1,0,drop
60527,445,0,0,70,70,0,1,0,1,0,drop
32707,11392,0,0,62,62,0,1,0,1,0,deny
52870,22197,0,0,66,66,0,1,0,1,0,deny
60519,445,0,0,70,70,0,1,0,1,0,drop
60516,445,0,0,70,70,0,1,0,1,0,drop
60515,445,0,0,70,70,0,1,0,1,0,drop
47037,1,0,0,62,62,0,1,0,1,0,deny
51818,37965,0,0,66,66,0,1,0,1,0,deny
50784,50584,0,0,62,62,0,1,0,1,0,deny
55580,445,0,0,70,70,0,1,0,1,0,drop
50914,51505,0,0,66,66,0,1,0,1,0,deny
54530,35440,0,0,66,66,0,1,0,1,0,deny
60510,445,0,0,70,70,0,1,0,1,0,drop
60508,445,0,0,70,70,0,1,0,1,0,drop
60504,445,0,0,70,70,0,1,0,1,0,drop
57472,44847,0,0,66,66,0,1,0,1,0,deny
46495,4607,0,0,60,60,0,1,0,1,0,deny
57969,42873,0,0,66,66,0,1,0,1,0,deny
55567,445,0,0,70,70,0,1,0,1,0,drop
59994,11446,0,0,66,66,0,1,0,1,0,deny
57114,35440,0,0,62,62,0,1,0,1,0,deny
55564,445,0,0,70,70,0,1,0,1,0,drop
62438,37807,0,0,66,66,0,1,0,1,0,deny
55898,445,0,0,66,66,0,1,0,1,0,drop
51183,56205,0,0,66,66,0,1,0,1,0,deny
60501,445,0,0,70,70,0,1,0,1,0,drop
60498,445,0,0,70,70,0,1,0,1,0,drop
45472,8168,0,0,62,62,0,1,0,1,0,deny
58110,23,0,0,60,60,0,1,0,1,0,deny
19875,30170,0,0,145,145,0,1,0,1,0,deny
50438,50584,0,0,146,146,0,1,0,1,0,deny
55560,445,0,0,70,70,0,1,0,1,0,drop
54047,50011,0,0,66,66,0,1,0,1,0,deny
43657,50011,0,0,62,62,0,1,0,1,0,deny
55558,445,0,0,70,70,0,1,0,1,0,drop
55891,445,0,0,66,66,0,1,0,1,0,drop
60970,20541,0,0,66,66,0,1,0,1,0,deny
55888,445,0,0,66,66,0,1,0,1,0,drop
55556,445,0,0,70,70,0,1,0,1,0,drop
16285,23,0,0,60,60,0,1,0,1,0,deny
60489,445,0,0,70,70,0,1,0,1,0,drop
14252,35993,0,0,62,62,0,1,0,1,0,deny
60482,445,0,0,70,70,0,1,0,1,0,drop
60481,445,0,0,70,70,0,1,0,1,0,drop
60479,445,0,0,70,70,0,1,0,1,0,drop
54210,64097,0,0,66,66,0,1,0,1,0,deny
55884,445,0,0,66,66,0,1,0,1,0,drop
1821,64147,0,0,66,66,0,1,0,1,0,deny
52724,64147,0,0,62,62,0,1,0,1,0,deny
28124,37965,0,0,62,62,0,1,0,1,0,deny
64589,53,29733,53,742,88,654,2,30,1,1,allow
55547,53,56945,53,738,86,652,2,30,1,1,allow
38085,443,38085,443,1452,817,635,16,20,9,7,allow
38464,443,38464,443,33734,3007,30727,53,90,29,24,allow
41919,53,41919,53,223,86,137,2,30,1,1,allow
49528,53,46480,53,170,87,83,2,30,1,1,allow
65414,443,41456,443,2494,1643,851,17,25,9,8,allow
137,137,40295,137,114,114,0,2,32,2,0,allow
53479,80,7819,80,3307,937,2370,17,16,10,7,allow
61500,443,52553,443,14738,2175,12563,24,16,10,14,allow
44455,53,21066,53,221,75,146,2,30,1,1,allow
59403,443,14686,443,30995,9655,21340,65,121,27,38,allow
58649,443,35795,443,7701,2215,5486,28,373,14,14,allow
56834,46513,28288,46513,70,70,0,1,5,1,0,allow
38508,443,38508,443,279067,22871,256196,327,90,145,182,allow
38144,443,38144,443,14849,2263,12586,29,90,17,12,allow
46741,53,52840,53,221,75,146,2,30,1,1,allow
64614,53,3783,53,168,86,82,2,30,1,1,allow
50314,31652,0,0,66,66,0,1,90,1,0,allow
57424,53,20131,53,170,87,83,2,31,1,1,allow
38409,443,38409,443,1452,817,635,16,20,9,7,allow
45339,443,35795,443,2312,1382,930,19,34,11,8,allow
55940,53,24862,53,168,86,82,2,30,1,1,allow
56143,3389,56143,3389,4365,2581,1784,20,32,11,9,allow
45338,443,42439,443,2719,1454,1265,22,34,12,10,allow
48981,15000,58211,15000,130,70,60,2,5,1,1,allow
56717,53,9802,53,711,87,624,2,30,1,1,allow
58280,443,25550,443,1786,172,1614,7,121,3,4,allow
51690,443,24259,443,9320,4615,4705,25,120,12,13,allow
50178,53,43275,53,172,88,84,2,31,1,1,allow
9087,53,9087,53,215,80,135,2,33,1,1,allow
49450,443,32537,443,9704,2335,7369,20,26,10,10,allow
55782,53,3411,53,238,87,151,2,30,1,1,allow
44847,51365,14892,51365,509,150,359,2,1200,1,1,allow
50584,49647,42268,49647,523,161,362,2,1200,1,1,allow
54522,443,63026,443,4728282,133897,4594385,4756,80,1650,3106,allow
61719,80,27024,80,32457,1499,30958,42,50,16,26,allow
58701,80,43595,80,12499310,161518,12337792,10496,70,2325,8171,allow
50972,3544,16024,3544,258,107,151,2,30,1,1,allow
61734,443,59784,443,231110,14545,216565,307,18,154,153,allow
56336,53,18502,53,192,98,94,2,30,1,1,allow
56131,53,17639,53,238,87,151,2,30,1,1,allow
42959,443,5921,443,795,795,0,2,154,2,0,allow
50584,48493,7175,48493,161,161,0,1,1200,1,0,allow
50584,10312,63675,10312,161,161,0,2,1200,2,0,allow
57000,53,25419,53,188,96,92,2,31,1,1,allow
27005,30009,8020,30009,889,126,763,3,31,2,1,allow
53810,443,53810,443,7656,4622,3034,24,139,12,12,allow
56625,53,10109,53,711,87,624,2,31,1,1,allow
55664,53,52942,53,711,87,624,2,31,1,1,allow
57073,53,4074,53,99,99,0,1,31,1,0,allow
38770,443,52968,443,140155,6367,133788,173,145,62,111,allow
50584,63591,44593,63591,161,161,0,2,1200,2,0,allow
50203,443,50531,443,3792,871,2921,16,121,7,9,allow
50584,1070,63097,1070,161,161,0,2,1200,2,0,allow
37371,5228,12391,5228,3277,1954,1323,27,3600,14,13,allow
50584,16453,1503,16453,161,161,0,2,1200,2,0,allow
50584,6889,32589,6889,311,311,0,3,1200,3,0,allow
30960,45713,7044,45713,330,330,0,6,3610,6,0,allow
53043,51050,0,0,62,62,0,1,0,1,0,deny
21674,28189,0,0,60,60,0,1,0,1,0,deny
1035,26467,0,0,62,62,0,1,0,1,0,deny
5179,50265,0,0,62,62,0,1,0,1,0,deny
60476,445,0,0,70,70,0,1,0,1,0,drop
55549,445,0,0,70,70,0,1,0,1,0,drop
58455,80,58455,80,348,132,216,6,15,3,3,allow
60470,445,0,0,70,70,0,1,0,1,0,drop
60471,445,0,0,70,70,0,1,0,1,0,drop
60469,445,0,0,70,70,0,1,0,1,0,drop
55877,445,0,0,66,66,0,1,0,1,0,drop
55547,445,0,0,70,70,0,1,0,1,0,drop
22971,50584,0,0,62,62,0,1,0,1,0,deny
18623,1,0,0,66,66,0,1,0,1,0,deny
55869,445,0,0,66,66,0,1,0,1,0,drop
55875,445,0,0,66,66,0,1,0,1,0,drop
55872,445,0,0,66,66,0,1,0,1,0,drop
55866,445,0,0,66,66,0,1,0,1,0,drop
55868,445,0,0,66,66,0,1,0,1,0,drop
55865,445,0,0,66,66,0,1,0,1,0,drop
55546,445,0,0,70,70,0,1,0,1,0,drop
29989,26467,0,0,66,66,0,1,0,1,0,deny
55545,445,0,0,70,70,0,1,0,1,0,drop
55544,445,0,0,70,70,0,1,0,1,0,drop
55542,445,0,0,70,70,0,1,0,1,0,drop
55540,445,0,0,70,70,0,1,0,1,0,drop
57093,26467,0,0,66,66,0,1,0,1,0,deny
52526,30188,0,0,62,62,0,1,0,1,0,deny
52754,26467,0,0,66,66,0,1,0,1,0,deny
60466,445,0,0,70,70,0,1,0,1,0,drop
60465,445,0,0,70,70,0,1,0,1,0,drop
60464,445,0,0,70,70,0,1,0,1,0,drop
55864,445,0,0,66,66,0,1,0,1,0,drop
60459,445,0,0,70,70,0,1,0,1,0,drop
55526,445,0,0,70,70,0,1,0,1,0,drop
55525,445,0,0,70,70,0,1,0,1,0,drop
443,21717,0,0,97,97,0,1,0,1,0,deny
55859,445,0,0,66,66,0,1,0,1,0,drop
55519,445,0,0,70,70,0,1,0,1,0,drop
55515,445,0,0,70,70,0,1,0,1,0,drop
55516,445,0,0,70,70,0,1,0,1,0,drop
55858,445,0,0,66,66,0,1,0,1,0,drop
55856,445,0,0,66,66,0,1,0,1,0,drop
53661,34967,21536,34967,70,70,0,2,8,2,0,allow
57307,443,21158,443,8407,3013,5394,43,15,24,19,allow
33040,443,3946,443,118,118,0,1,30,1,0,allow
54087,443,2699,443,2637658,83234,2554424,2794,140,929,1865,allow
27005,30006,10243,30006,888,126,762,3,31,2,1,allow
37854,443,37854,443,1452,817,635,16,20,9,7,allow
57324,443,38455,443,5612,733,4879,16,14,9,7,allow
58706,80,52999,80,4175,3452,723,14,15,7,7,allow
55261,53,19096,53,177,94,83,2,29,1,1,allow
55010,53,1751,53,245,94,151,2,29,1,1,allow
55782,53,43309,53,245,94,151,2,29,1,1,allow
55757,53,56073,53,177,94,83,2,29,1,1,allow
49646,443,27491,443,12279,4202,8077,33,43,16,17,allow
57000,53,24193,53,194,102,92,2,30,1,1,allow
40025,443,22559,443,10012,3016,6996,40,133,19,21,allow
55844,443,40826,443,6881,2073,4808,37,255,18,19,allow
38534,443,44926,443,8918,730,8188,20,72,7,13,allow
38143,443,38143,443,36902,3203,33699,57,90,31,26,allow
51091,80,6090,80,3324,663,2661,12,15,7,5,allow
37628,443,37628,443,1452,817,635,16,20,9,7,allow
57326,443,4725,443,5613,733,4880,16,14,9,7,allow
57325,443,9317,443,5613,733,4880,16,14,9,7,allow
51025,443,40011,443,6999,2523,4476,22,80,13,9,allow
55195,53,34217,53,969,86,883,2,29,1,1,allow
38049,80,38049,80,2180,1555,625,9,86,6,3,allow
58554,443,5045,443,8626,2156,6470,24,81,14,10,allow
49349,53,12679,53,405,110,295,4,38,2,2,allow
50042,53,35274,53,738,86,652,2,29,1,1,allow
49929,443,23324,443,7298,2303,4995,22,16,12,10,allow
49912,53,4964,53,733,94,639,2,29,1,1,allow
55733,53,46336,53,177,94,83,2,29,1,1,allow
57364,53,42885,53,177,94,83,2,29,1,1,allow
52202,443,56757,443,3036,818,2218,12,119,6,6,allow
28010,443,22569,443,5515,1388,4127,18,15,9,9,allow
65521,53,38042,53,167,86,81,2,29,1,1,allow
55782,53,22320,53,245,94,151,2,29,1,1,allow
55734,53,29847,53,733,94,639,2,30,1,1,allow
57396,53,31064,53,183,94,89,2,30,1,1,allow
27005,33059,58962,33059,900,126,774,3,30,2,1,allow
27005,33052,31448,33052,873,126,747,2,30,1,1,allow
60769,443,60769,443,13423,1386,12037,33,17,14,19,allow
60373,443,19425,443,3875761,85491,3790270,3838,89,1315,2523,allow
52924,443,13021,443,5583,1390,4193,19,15,9,10,allow
56131,53,29991,53,245,94,151,2,30,1,1,allow
56720,53,20064,53,177,94,83,2,30,1,1,allow
57396,53,6439,53,183,94,89,2,30,1,1,allow
55940,53,15244,53,168,86,82,2,30,1,1,allow
50124,443,33361,443,24329,7675,16654,47,16,25,22,allow
52923,443,55900,443,5581,1388,4193,19,15,9,10,allow
56581,443,17747,443,4884,1015,3869,17,25,9,8,allow
57424,53,34088,53,177,94,83,2,30,1,1,allow
47971,443,21107,443,9021,1511,7510,21,121,11,10,allow
55223,53,34886,53,168,86,82,2,31,1,1,allow
12532,80,12532,80,6215,769,5446,14,16,7,7,allow
50273,53,27219,53,718,94,624,2,30,1,1,allow
59282,123,52231,123,184,94,90,2,30,1,1,allow
58132,80,58132,80,348,132,216,6,15,3,3,allow
56131,53,25151,53,245,94,151,2,30,1,1,allow
50239,53,39194,53,183,94,89,2,30,1,1,allow
50642,53,60676,53,173,94,79,2,30,1,1,allow
55122,53,24716,53,173,94,79,2,30,1,1,allow
64752,53,32902,53,186,102,84,2,30,1,1,allow
54930,443,22759,443,2349,258,2091,10,120,4,6,allow
49501,443,27772,443,1882,1108,774,17,135,10,7,allow
63064,443,24318,443,12008,2367,9641,32,151,18,14,allow
56134,53,19695,53,167,86,81,2,30,1,1,allow
57000,53,6517,53,194,102,92,2,30,1,1,allow
57396,53,65107,53,183,94,89,2,30,1,1,allow
60760,20010,54790,20010,70,70,0,2,8,2,0,allow
64879,53,23535,53,173,94,79,2,30,1,1,allow
65436,53,10665,53,102,102,0,1,30,1,0,allow
50972,3544,63114,3544,409,107,302,4,30,2,2,allow
52054,443,46268,443,9339,4411,4928,20,135,10,10,allow
57318,443,48526,443,5612,733,4879,16,15,9,7,allow
55112,53,21380,53,245,94,151,2,30,1,1,allow
64879,53,13290,53,165,86,79,2,30,1,1,allow
56720,53,7909,53,177,94,83,2,30,1,1,allow
57470,6969,29118,6969,528,528,0,9,1199,9,0,allow
42841,53,47596,53,168,78,90,2,30,1,1,allow
50584,62758,61935,62758,161,161,0,2,1199,2,0,allow
40107,53,34833,53,168,78,90,2,30,1,1,allow
57321,443,61348,443,5613,733,4880,16,14,9,7,allow
27005,32063,39805,32063,889,126,763,2,30,1,1,allow
37580,443,37580,443,1452,817,635,16,20,9,7,allow
53130,10168,25089,10168,320,140,180,6,5,3,3,allow
49277,53,3822,53,821,102,719,2,30,1,1,allow
57316,443,30855,443,5613,733,4880,16,15,9,7,allow
55730,8060,61259,8060,70,70,0,1,4,1,0,allow
57317,443,9547,443,5614,733,4881,16,15,9,7,allow
38095,443,38095,443,247172,58810,188362,325,90,174,151,allow
57323,443,4968,443,5613,733,4880,16,14,9,7,allow
57320,443,20383,443,5989,926,5063,19,14,10,9,allow
56394,443,3047,443,5019,946,4073,19,34,9,10,allow
33967,5222,10318,5222,74654,9673,64981,221,616,106,115,allow
55733,53,30284,53,177,94,83,2,30,1,1,allow
50239,53,26724,53,183,94,89,2,30,1,1,allow
56134,53,7161,53,167,86,81,2,30,1,1,allow
49216,53,26832,53,401,142,259,2,30,1,1,allow
56006,53,57116,53,183,102,81,2,29,1,1,allow
27005,32078,22538,32078,871,126,745,2,30,1,1,allow
55782,53,15555,53,245,94,151,2,29,1,1,allow
56759,53,4446,53,177,94,83,2,30,1,1,allow
49528,53,36226,53,177,94,83,2,29,1,1,allow
27005,33076,26025,33076,889,126,763,2,31,1,1,allow
63758,443,30040,443,3263,1643,1620,9,119,5,4,allow
57470,13244,33439,13244,166,166,0,1,1199,1,0,allow
50584,6881,19659,6881,161,161,0,2,1200,2,0,allow
50584,9301,1872,9301,498,150,348,4,2396,2,2,allow
56272,53,49117,53,235,86,149,2,30,1,1,allow
49594,53,57290,53,301,102,199,2,30,1,1,allow
56459,53,5237,53,177,94,83,2,30,1,1,allow
27005,32028,64745,32028,900,126,774,2,31,1,1,allow
49171,443,51614,443,7966,2735,5231,22,120,10,12,allow
50584,42504,10356,42504,161,161,0,2,1199,2,0,allow
57306,443,21388,443,8699,3391,5308,40,15,24,16,allow
65480,443,49360,443,310863,9840,301023,323,16,115,208,allow
65047,53,53893,53,196,86,110,2,30,1,1,allow
65530,53,42402,53,194,102,92,2,30,1,1,allow
49528,53,13440,53,177,94,83,2,30,1,1,allow
55770,53,54138,53,167,86,81,2,30,1,1,allow
51966,443,55026,443,35199,15909,19290,70,152,34,36,allow
62377,443,62377,443,4378,1471,2907,19,27,11,8,allow
53664,13701,27246,13701,70,70,0,2,8,2,0,allow
53665,29135,50493,29135,70,70,0,2,8,2,0,allow
49900,4500,63369,4500,78,78,0,1,5,1,0,allow
56759,53,10512,53,177,94,83,2,30,1,1,allow
57424,53,65254,53,177,94,83,2,30,1,1,allow
50584,6881,59238,6881,901,166,735,2,1200,1,1,allow
51850,11981,61118,11981,316,136,180,6,7,3,3,allow
45457,443,33286,443,11989,7908,4081,61,120,31,30,allow
49723,53,39151,53,427,90,337,4,41,2,2,allow
28011,443,11393,443,5577,1390,4187,19,15,9,10,allow
56429,80,57755,80,17188,1559,15629,25,25,10,15,allow
42156,80,50916,80,1323,335,988,10,15,5,5,allow
56131,53,31536,53,245,94,151,2,30,1,1,allow
64531,53,13391,53,754,94,660,2,30,1,1,allow
64614,53,55438,53,168,86,82,2,30,1,1,allow
65047,53,60656,53,184,102,82,2,30,1,1,allow
49431,53,38249,53,767,102,665,2,30,1,1,allow
50642,53,41798,53,165,86,79,2,30,1,1,allow
50584,50545,46451,50545,166,166,0,1,1199,1,0,allow
50265,51413,14137,51413,460,150,310,2,1200,1,1,allow
49557,53,33015,53,211,102,109,2,30,1,1,allow
64286,53,59300,53,274,94,180,2,30,1,1,allow
55910,53,42664,53,183,94,89,2,30,1,1,allow
33288,53,0,0,86,86,0,1,30,1,0,allow
55910,53,63749,53,183,94,89,2,31,1,1,allow
56893,53,20902,53,177,94,83,2,31,1,1,allow
27005,32055,61239,32055,878,126,752,2,31,1,1,allow
55479,53,50336,53,184,94,90,2,31,1,1,allow
64751,53,58884,53,178,94,84,2,31,1,1,allow
45742,443,8175,443,8471,3275,5196,21,120,11,10,allow
46641,443,43427,443,8471,3278,5193,21,120,11,10,allow
58281,443,12495,443,4039,805,3234,17,120,8,9,allow
27005,33035,34801,33035,864,126,738,2,31,1,1,allow
65206,443,20256,443,7525,3267,4258,36,120,17,19,allow
27005,33051,7331,33051,887,126,761,2,31,1,1,allow
27005,32066,2938,32066,881,126,755,2,31,1,1,allow
50584,8999,32902,8999,311,311,0,3,1199,3,0,allow
50584,17991,30598,17991,161,161,0,2,1199,2,0,allow
57470,13332,8538,13332,166,166,0,1,1199,1,0,allow
50584,61421,62887,61421,166,166,0,1,1199,1,0,allow
50584,8999,33361,8999,1237,369,868,6,1199,3,3,allow
50584,64368,19845,64368,161,161,0,2,1200,2,0,allow
50584,49001,14591,49001,166,166,0,1,1199,1,0,allow
50584,18066,56366,18066,1705,536,1169,5,1200,4,1,allow
57470,24451,64687,24451,166,166,0,1,1200,1,0,allow
50584,6882,59204,6882,371,311,60,4,1199,3,1,allow
6882,41923,41297,41923,492,150,342,2,1200,1,1,allow
50584,40926,15001,40926,166,166,0,1,1199,1,0,allow
30188,64511,50224,64511,854,150,704,4,1200,2,2,allow
50584,6881,41717,6881,1357,369,988,6,1200,3,3,allow
36488,443,36488,443,8448,2150,6298,39,98,21,18,allow
65479,443,61050,443,92397,4379,88018,102,16,37,65,allow
49495,443,44088,443,9037,3596,5441,36,321,19,17,allow
55037,443,6546,443,130,70,60,3,5,2,1,allow
50608,443,5976,443,5039,2265,2774,21,30,11,10,allow
36067,443,36067,443,228681,29484,199197,303,110,149,154,allow
56985,53,39491,53,165,86,79,2,30,1,1,allow
50589,53,3456,53,177,94,83,2,30,1,1,allow
35240,443,35240,443,24155,3115,21040,55,98,27,28,allow
61355,443,38386,443,17666,3045,14621,52,213,21,31,allow
52216,80,58055,80,15824,805,15019,25,18,9,16,allow
40547,443,6575,443,4916,2083,2833,24,43,13,11,allow
53208,80,52746,80,2953,785,2168,12,116,8,4,allow
55842,443,52718,443,8661,2036,6625,40,256,19,21,allow
56120,443,26246,443,551795,18805,532990,603,43,220,383,allow
55122,53,17738,53,173,94,79,2,30,1,1,allow
49647,443,38723,443,11011,4522,6489,35,43,17,18,allow
38450,443,40244,443,9299,2445,6854,25,81,14,11,allow
49451,443,61379,443,12802,1977,10825,32,25,14,18,allow
57188,443,33520,443,7162,1731,5431,29,32,14,15,allow
55854,445,0,0,66,66,0,1,0,1,0,drop
51620,56205,0,0,62,62,0,1,0,1,0,deny
60455,445,0,0,70,70,0,1,0,1,0,drop
60444,445,0,0,70,70,0,1,0,1,0,drop
60441,445,0,0,70,70,0,1,0,1,0,drop
55504,445,0,0,70,70,0,1,0,1,0,drop
24853,39828,0,0,60,60,0,1,0,1,0,deny
58550,21247,0,0,66,66,0,1,0,1,0,deny
55844,445,0,0,66,66,0,1,0,1,0,drop
45908,33330,0,0,60,60,0,1,0,1,0,deny
59210,8168,0,0,66,66,0,1,0,1,0,deny
56578,64147,0,0,66,66,0,1,0,1,0,deny
53156,35993,0,0,66,66,0,1,0,1,0,deny
63731,26467,0,0,62,62,0,1,0,1,0,deny
51244,57587,0,0,100,100,0,1,0,1,0,deny
13973,50584,0,0,146,146,0,1,0,1,0,deny
55500,445,0,0,70,70,0,1,0,1,0,drop
443,20550,0,0,97,97,0,1,0,1,0,deny
55836,445,0,0,66,66,0,1,0,1,0,drop
60432,445,0,0,70,70,0,1,0,1,0,drop
56148,37965,0,0,66,66,0,1,0,1,0,deny
55490,445,0,0,70,70,0,1,0,1,0,drop
55491,445,0,0,70,70,0,1,0,1,0,drop
11030,37965,0,0,62,62,0,1,0,1,0,deny
55488,445,0,0,70,70,0,1,0,1,0,drop
55487,445,0,0,70,70,0,1,0,1,0,drop
55834,445,0,0,66,66,0,1,0,1,0,drop
55483,445,0,0,70,70,0,1,0,1,0,drop
53543,44847,0,0,62,62,0,1,0,1,0,deny
1070,26467,0,0,62,62,0,1,0,1,0,deny
54858,51505,0,0,62,62,0,1,0,1,0,deny
55827,445,0,0,66,66,0,1,0,1,0,drop
2440,37807,0,0,66,66,0,1,0,1,0,deny
55820,445,0,0,66,66,0,1,0,1,0,drop
29300,35440,0,0,62,62,0,1,0,1,0,deny
57070,30170,0,0,146,146,0,1,0,1,0,deny
5664,36237,0,0,62,62,0,1,0,1,0,deny
55478,445,0,0,70,70,0,1,0,1,0,drop
17873,23117,0,0,62,62,0,1,0,1,0,deny
56380,36829,0,0,66,66,0,1,0,1,0,deny
55986,26467,0,0,62,62,0,1,0,1,0,deny
3980,63710,0,0,66,66,0,1,0,1,0,deny
60422,445,0,0,70,70,0,1,0,1,0,drop
60420,445,0,0,70,70,0,1,0,1,0,drop
60419,445,0,0,70,70,0,1,0,1,0,drop
43916,21,0,0,60,60,0,1,0,1,0,deny
55470,445,0,0,70,70,0,1,0,1,0,drop
55811,445,0,0,66,66,0,1,0,1,0,drop
55810,445,0,0,66,66,0,1,0,1,0,drop
55808,445,0,0,66,66,0,1,0,1,0,drop
55809,445,0,0,66,66,0,1,0,1,0,drop
55807,445,0,0,66,66,0,1,0,1,0,drop
55806,445,0,0,66,66,0,1,0,1,0,drop
55804,445,0,0,66,66,0,1,0,1,0,drop
55803,445,0,0,66,66,0,1,0,1,0,drop
55469,445,0,0,70,70,0,1,0,1,0,drop
15922,44847,0,0,66,66,0,1,0,1,0,deny
60129,55442,0,0,62,62,0,1,0,1,0,deny
55463,445,0,0,70,70,0,1,0,1,0,drop
55462,445,0,0,70,70,0,1,0,1,0,drop
53490,62413,0,0,62,62,0,1,0,1,0,deny
8889,16520,0,0,60,60,0,1,0,1,0,deny
50878,23,0,0,60,60,0,1,0,1,0,deny
56491,56205,0,0,146,146,0,1,0,1,0,deny
51676,23718,0,0,66,66,0,1,0,1,0,deny
60413,445,0,0,70,70,0,1,0,1,0,drop
60405,445,0,0,70,70,0,1,0,1,0,drop
60404,445,0,0,70,70,0,1,0,1,0,drop
55458,445,0,0,70,70,0,1,0,1,0,drop
47814,51505,0,0,66,66,0,1,0,1,0,deny
55791,445,0,0,66,66,0,1,0,1,0,drop
55790,445,0,0,66,66,0,1,0,1,0,drop
55789,445,0,0,66,66,0,1,0,1,0,drop
58966,30188,0,0,62,62,0,1,0,1,0,deny
60401,445,0,0,70,70,0,1,0,1,0,drop
55457,445,0,0,70,70,0,1,0,1,0,drop
53003,11392,0,0,66,66,0,1,0,1,0,deny
45832,51050,0,0,66,66,0,1,0,1,0,deny
0,0,0,0,98,98,0,1,0,1,0,deny
0,0,0,0,156,156,0,2,0,2,0,allow
0,0,0,0,98,98,0,1,0,1,0,deny
0,0,0,0,98,98,0,1,0,1,0,deny
0,0,0,0,244,244,0,2,0,2,0,allow
0,0,0,0,98,98,0,1,0,1,0,deny
60399,445,0,0,70,70,0,1,0,1,0,drop
60392,445,0,0,70,70,0,1,0,1,0,drop
60391,445,0,0,70,70,0,1,0,1,0,drop
60387,445,0,0,70,70,0,1,0,1,0,drop
50881,50584,0,0,66,66,0,1,0,1,0,deny
55452,445,0,0,70,70,0,1,0,1,0,drop
54742,50584,0,0,66,66,0,1,0,1,0,deny
20198,17372,0,0,62,62,0,1,0,1,0,deny
13907,57470,0,0,62,62,0,1,0,1,0,deny
3803,51505,0,0,62,62,0,1,0,1,0,deny
60382,445,0,0,70,70,0,1,0,1,0,drop
60380,445,0,0,70,70,0,1,0,1,0,drop
60376,445,0,0,70,70,0,1,0,1,0,drop
43104,26467,0,0,62,62,0,1,0,1,0,deny
55439,445,0,0,70,70,0,1,0,1,0,drop
55436,445,0,0,70,70,0,1,0,1,0,drop
23089,48817,0,0,62,62,0,1,0,1,0,deny
16221,50584,0,0,146,146,0,1,0,1,0,deny
1663,30188,0,0,66,66,0,1,0,1,0,deny
55769,445,0,0,66,66,0,1,0,1,0,drop
60374,445,0,0,70,70,0,1,0,1,0,drop
54219,443,4743,443,10323,2834,7489,44,256,21,23,allow
41114,53,0,0,82,82,0,1,30,1,0,allow
55897,53,59750,53,733,85,648,2,30,1,1,allow
55426,53,8033,53,181,98,83,2,30,1,1,allow
55910,53,5285,53,182,93,89,2,30,1,1,allow
56437,53,9819,53,749,94,655,2,30,1,1,allow
33399,443,27816,443,3603,2013,1590,21,42,12,9,allow
34873,80,34873,80,2148,918,1230,10,20,6,4,allow
61497,443,26455,443,15302,2355,12947,30,32,14,16,allow
41626,15000,7526,15000,130,70,60,2,5,1,1,allow
34365,443,34038,443,223826,45909,177917,356,44,176,180,allow
35271,443,35271,443,134405,6968,127437,187,97,85,102,allow
55841,443,33701,443,9333,2019,7314,41,255,19,22,allow
5588,5588,0,0,3562,1936,1626,48,194,24,24,allow
36622,443,36622,443,16116,3253,12863,52,97,29,23,allow
55131,53,48118,53,744,95,649,2,30,1,1,allow
55180,53,64280,53,780,93,687,2,31,1,1,allow
41524,443,23023,443,3976,2652,1324,20,312,11,9,allow
38017,7275,45146,7275,4615,664,3951,15,15,9,6,allow
55164,53,9551,53,170,87,83,2,31,1,1,allow
56141,53,2789,53,184,94,90,2,31,1,1,allow
50306,53,23964,53,814,110,704,2,30,1,1,allow
40768,443,17418,443,3287,2049,1238,12,32,7,5,allow
55630,43736,8013,43736,70,70,0,1,5,1,0,allow
33397,443,15065,443,1348,687,661,14,42,8,6,allow
46219,53,46219,53,237,91,146,2,33,1,1,allow
19698,502,19698,502,60,60,0,1,5,1,0,allow
55840,443,56226,443,9374,2150,7224,42,255,19,23,allow
51272,12210,15332,12210,70,70,0,1,5,1,0,allow
56504,443,16127,443,4467051,102279,4364772,4340,46,1452,2888,allow
55839,443,48499,443,13469,2007,11462,44,256,19,25,allow
57209,53,54053,53,764,99,665,2,30,1,1,allow
38056,443,15075,443,9528,2738,6790,27,81,15,12,allow
55148,53,64223,53,711,87,624,2,30,1,1,allow
55223,53,54493,53,168,86,82,2,31,1,1,allow
13868,53,13868,53,215,80,135,2,34,1,1,allow
55087,443,24413,443,101356,10743,90613,178,31,90,88,allow
55479,53,40449,53,184,94,90,2,31,1,1,allow
54975,443,15865,443,441892,86941,354951,716,73,343,373,allow
33404,443,64550,443,4152,2734,1418,24,40,14,10,allow
38057,443,24418,443,9486,2668,6818,26,81,14,12,allow
36053,443,36053,443,79562,17054,62508,111,109,54,57,allow
51829,46209,24768,46209,66,66,0,1,5,1,0,allow
50669,53,9177,53,578,286,292,9,16,5,4,allow
58886,15000,23434,15000,138,78,60,2,5,1,1,allow
55471,53,27819,53,256,93,163,2,30,1,1,allow
52385,53,0,0,138,69,69,2,30,1,1,allow
55770,53,35170,53,166,85,81,2,30,1,1,allow
56956,53,28771,53,182,93,89,2,30,1,1,allow
65021,53,29006,53,256,93,163,2,30,1,1,allow
49867,53,44107,53,170,87,83,2,30,1,1,allow
50313,53,2331,53,744,95,649,2,30,1,1,allow
57166,53,41004,53,170,87,83,2,30,1,1,allow
51594,53,51594,53,219,92,127,2,30,1,1,allow
58688,53,58688,53,235,92,143,2,30,1,1,allow
34240,53,34240,53,229,89,140,2,31,1,1,allow
55727,53,47747,53,701,88,613,2,31,1,1,allow
60781,443,56303,443,5964,3582,2382,17,136,8,9,allow
49160,40527,18392,40527,854,150,704,4,1201,2,2,allow
30960,45714,65388,45714,330,330,0,6,3609,6,0,allow
55253,53,63534,53,754,94,660,2,31,1,1,allow
27005,27023,64597,27023,875,126,749,2,31,1,1,allow
57020,53,49369,53,738,86,652,2,31,1,1,allow
49168,53,10918,53,192,98,94,2,31,1,1,allow
33571,443,51011,443,4281,1160,3121,12,122,6,6,allow
60701,443,27691,443,5166,1989,3177,15,122,7,8,allow
60373,445,0,0,70,70,0,1,0,1,0,drop
52633,30188,0,0,62,62,0,1,0,1,0,deny
11988,48817,0,0,66,66,0,1,0,1,0,deny
21674,28189,0,0,60,60,0,1,0,1,0,deny
3730,37965,0,0,62,62,0,1,0,1,0,deny
42252,33306,0,0,60,60,0,1,0,1,0,deny
55431,445,0,0,70,70,0,1,0,1,0,drop
55430,445,0,0,70,70,0,1,0,1,0,drop
3818,37965,0,0,66,66,0,1,0,1,0,deny
55428,445,0,0,70,70,0,1,0,1,0,drop
55760,445,0,0,66,66,0,1,0,1,0,drop
55759,445,0,0,66,66,0,1,0,1,0,drop
54619,80,53235,80,2269,1579,690,10,77,6,4,allow
56956,53,61460,53,183,94,89,2,30,1,1,allow
10701,11392,0,0,62,62,0,1,0,1,0,deny
60362,445,0,0,70,70,0,1,0,1,0,drop
62029,36237,0,0,62,62,0,1,0,1,0,deny
62872,50584,0,0,66,66,0,1,0,1,0,deny
60358,445,0,0,70,70,0,1,0,1,0,drop
60354,445,0,0,70,70,0,1,0,1,0,drop
60351,445,0,0,70,70,0,1,0,1,0,drop
22619,10214,0,0,66,66,0,1,0,1,0,deny
10000,10214,0,0,62,62,0,1,0,1,0,deny
7892,50584,0,0,62,62,0,1,0,1,0,deny
55755,445,0,0,66,66,0,1,0,1,0,drop
43260,41615,0,0,145,145,0,1,0,1,0,deny
61053,44847,0,0,66,66,0,1,0,1,0,deny
55421,445,0,0,70,70,0,1,0,1,0,drop
60347,445,0,0,70,70,0,1,0,1,0,drop
55419,445,0,0,70,70,0,1,0,1,0,drop
2422,50584,0,0,66,66,0,1,0,1,0,deny
60344,445,0,0,70,70,0,1,0,1,0,drop
56715,53,50292,53,807,94,713,2,30,1,1,allow
48521,53,27557,53,78,78,0,1,30,1,0,allow
64566,53,24742,53,194,102,92,2,30,1,1,allow
65000,53,35253,53,184,102,82,2,30,1,1,allow
55426,53,25381,53,177,94,83,2,30,1,1,allow
62546,443,43210,443,7740,2603,5137,13,120,7,6,allow
56113,443,21683,443,103486,7416,96070,161,42,82,79,allow
47330,443,38110,443,9297,2727,6570,27,80,15,12,allow
45414,443,2299,443,2215,1412,803,19,38,10,9,allow
44870,80,28005,80,1119,1045,74,7,14,6,1,allow
56635,443,56247,443,8654,2150,6504,20,15,11,9,allow
50589,53,31342,53,177,94,83,2,29,1,1,allow
57424,53,34696,53,177,94,83,2,30,1,1,allow
49867,53,10689,53,177,94,83,2,30,1,1,allow
49867,53,63133,53,177,94,83,2,30,1,1,allow
56119,443,4138,443,144290,9387,134903,217,42,110,107,allow
57470,51413,47712,51413,543,166,377,2,1199,1,1,allow
60927,443,47688,443,3642,606,3036,13,119,6,7,allow
57305,443,15646,443,1574,1089,485,13,15,8,5,allow
34257,7275,41230,7275,2845,419,2426,12,15,7,5,allow
59861,443,36199,443,2128,828,1300,19,40,8,11,allow
35292,443,36726,443,4866,3323,1543,25,94,14,11,allow
57300,443,65390,443,8979,3093,5886,43,15,24,19,allow
40549,443,43115,443,1352,691,661,14,42,8,6,allow
57298,443,20012,443,8313,2850,5463,42,15,24,18,allow
52437,443,30974,443,384,384,0,7,33,7,0,allow
36144,443,36144,443,170890,13800,157090,246,97,123,123,allow
63927,53,2248,53,374,101,273,4,33,2,2,allow
41230,443,4213,443,234,234,0,4,11,4,0,allow
35449,443,35449,443,157435,9243,148192,220,97,101,119,allow
56628,80,40894,80,234,234,0,4,11,4,0,allow
123,123,24489,123,184,94,90,2,29,1,1,allow
50159,53,16650,53,94,94,0,1,29,1,0,allow
53261,12348,58794,12348,552,306,246,9,142,5,4,allow
56985,53,40638,53,165,86,79,2,29,1,1,allow
50178,53,59652,53,178,94,84,2,29,1,1,allow
55244,53,54182,53,186,102,84,2,30,1,1,allow
57000,53,32346,53,194,102,92,2,30,1,1,allow
55770,53,28096,53,167,86,81,2,29,1,1,allow
49867,53,7070,53,177,94,83,2,29,1,1,allow
27005,33038,17485,33038,892,126,766,2,30,1,1,allow
65221,53,41318,53,199,102,97,2,30,1,1,allow
55479,53,22790,53,184,94,90,2,30,1,1,allow
43347,7275,22003,7275,3299,665,2634,18,16,10,8,allow
54985,443,28045,443,23913,3495,20418,50,48,24,26,allow
42117,80,40456,80,1056,682,374,10,15,6,4,allow
56893,53,7619,53,177,94,83,2,30,1,1,allow
49718,53,50641,53,184,94,90,2,30,1,1,allow
64016,53,54267,53,183,94,89,2,30,1,1,allow
56292,53,23956,53,197,102,95,2,30,1,1,allow
55164,53,14668,53,177,94,83,2,30,1,1,allow
35596,5228,54963,5228,3235,1448,1787,26,811,8,18,allow
53141,443,52504,443,37389,3972,33417,69,133,32,37,allow
54620,80,5302,80,14855,1611,13244,26,77,14,12,allow
56688,443,37544,443,32780,6864,25916,142,345,57,85,allow
56694,53,57041,53,196,102,94,2,30,1,1,allow
60892,443,56728,443,22772,8095,14677,46,54,24,22,allow
56634,443,30287,443,8654,2150,6504,20,15,11,9,allow
57073,53,22592,53,197,102,95,2,33,1,1,allow
64867,53,27823,53,765,102,663,2,30,1,1,allow
52793,443,27629,443,1942,1281,661,22,228,16,6,allow
54978,443,60259,443,225539,162879,62660,476,70,262,214,allow
56472,53,44784,53,177,94,83,2,30,1,1,allow
54986,443,39292,443,5684,3042,2642,32,46,18,14,allow
56991,443,56991,443,6305,1352,4953,19,16,10,9,allow
56715,53,19827,53,184,94,90,2,30,1,1,allow
56568,443,49242,443,1277,705,572,13,25,7,6,allow
64052,53,43180,53,211,102,109,2,30,1,1,allow
56141,53,19077,53,184,94,90,2,30,1,1,allow
56571,53,44608,53,211,102,109,2,30,1,1,allow
65221,53,47234,53,199,102,97,2,30,1,1,allow
55770,53,17489,53,167,86,81,2,30,1,1,allow
55820,53,26876,53,184,94,90,2,30,1,1,allow
55264,53,44429,53,177,94,83,2,30,1,1,allow
58744,80,31824,80,4635,1572,3063,12,15,7,5,allow
60894,443,20427,443,34862,6364,28498,64,54,31,33,allow
51500,443,57250,443,7211,823,6388,16,15,10,6,allow
57166,53,28476,53,177,94,83,2,30,1,1,allow
64710,53,46845,53,393,110,283,2,30,1,1,allow
53227,443,46822,443,5430,687,4743,15,73,6,9,allow
53210,80,7510,80,1726,940,786,8,51,5,3,allow
56956,53,13948,53,183,94,89,2,30,1,1,allow
60608,53,20949,53,199,94,105,2,30,1,1,allow
57155,53,11661,53,396,102,294,2,30,1,1,allow
39068,443,31079,443,10831,1381,9450,22,20,12,10,allow
56118,443,45922,443,187927,12115,175812,276,42,137,139,allow
54454,5222,49306,5222,9568,1982,7586,44,345,17,27,allow
46277,443,48047,443,15670,12575,3095,51,37,30,21,allow
41474,443,44338,443,190,70,120,4,15,2,2,allow
57606,443,40796,443,11986,3075,8911,60,4981,31,29,allow
57302,443,55784,443,5614,733,4881,16,15,9,7,allow
51984,80,5183,80,48285,2659,45626,65,15,32,33,allow
57303,443,1835,443,5612,733,4879,16,15,9,7,allow
59860,443,59422,443,2165,987,1178,17,40,8,9,allow
40333,80,15004,80,1049,975,74,6,15,5,1,allow
43274,443,35686,443,6645,1668,4977,21,31,12,9,allow
58600,443,58600,443,4398,1491,2907,19,28,11,8,allow
54981,443,51323,443,36008,2548,33460,55,69,26,29,allow
53209,8081,13912,8081,5349,1928,3421,17,114,10,7,allow
49173,80,62950,80,254,128,126,5,15,3,2,allow
55079,443,57713,443,7156,1187,5969,20,16,10,10,allow
64934,53,52297,53,197,102,95,2,33,1,1,allow
52035,80,61330,80,4185,3462,723,14,15,7,7,allow
35063,443,32697,443,7105,1924,5181,20,25,10,10,allow
58286,20,58286,20,100132,17467,82665,325,619,168,157,allow
53328,443,21893,443,4670,2814,1856,33,81,15,18,allow
53642,39344,30760,39344,612,306,306,10,15,5,5,allow
55244,53,5418,53,186,102,84,2,29,1,1,allow
64800,53,3701,53,343,92,251,4,50,2,2,allow
34305,80,22535,80,2443,1794,649,11,76,6,5,allow
36811,53,36811,53,227,90,137,2,29,1,1,allow
60632,53,3971,53,179,86,93,2,29,1,1,allow
65239,53,28035,53,757,102,655,2,29,1,1,allow
64046,53,35754,53,259,110,149,2,29,1,1,allow
39927,443,15384,443,7787,2370,5417,23,242,11,12,allow
64752,53,22741,53,178,94,84,2,29,1,1,allow
64935,53,42263,53,313,94,219,2,29,1,1,allow
56720,53,11601,53,177,94,83,2,29,1,1,allow
56459,53,48405,53,177,94,83,2,30,1,1,allow
56141,53,30553,53,184,94,90,2,30,1,1,allow
50000,53,56621,53,216,102,114,2,29,1,1,allow
38936,53,29060,53,215,86,129,2,30,1,1,allow
49718,53,42238,53,807,94,713,2,30,1,1,allow
49793,53,43171,53,718,94,624,2,30,1,1,allow
65325,53,48288,53,216,110,106,2,30,1,1,allow
56717,53,10005,53,183,94,89,2,30,1,1,allow
54179,443,27953,443,5037,2002,3035,14,120,7,7,allow
56736,443,56736,443,120441,7846,112595,167,61,76,91,allow
59099,443,44771,443,7066,1861,5205,32,1262,17,15,allow
21544,41599,59404,41599,70,70,0,2,8,2,0,allow
51848,28960,25741,28960,70,70,0,2,9,2,0,allow
39543,7276,23316,7276,1142,558,584,16,16,8,8,allow
65324,53,6556,53,749,94,655,2,30,1,1,allow
65221,53,62850,53,199,102,97,2,30,1,1,allow
64016,53,50450,53,183,94,89,2,30,1,1,allow
49913,53,16997,53,216,110,106,2,31,1,1,allow
55919,53,44823,53,177,94,83,2,30,1,1,allow
57301,443,1829,443,5614,733,4881,16,15,9,7,allow
55640,54435,47783,54435,70,70,0,2,8,2,0,allow
53478,443,15802,443,7692,2183,5509,24,224,14,10,allow
53211,80,10536,80,194,128,66,4,51,3,1,allow
34219,53,25349,53,199,94,105,2,30,1,1,allow
65000,53,40784,53,168,86,82,2,30,1,1,allow
56956,53,49926,53,183,94,89,2,30,1,1,allow
55164,53,64984,53,177,94,83,2,30,1,1,allow
64493,53,11797,53,199,102,97,2,30,1,1,allow
55223,53,62144,53,168,86,82,2,30,1,1,allow
59214,443,59214,443,27659,5508,22151,59,47,31,28,allow
54976,443,13251,443,8156,3281,4875,43,71,21,22,allow
51847,32112,38487,32112,70,70,0,2,9,2,0,allow
56832,23900,53161,23900,130,70,60,2,5,1,1,allow
56831,10434,25973,10434,70,70,0,1,5,1,0,allow
60893,443,5461,443,46690,9390,37300,77,54,36,41,allow
56563,443,19548,443,4528,884,3644,15,26,9,6,allow
56472,53,22766,53,177,94,83,2,30,1,1,allow
49642,443,30931,443,17163,6197,10966,44,43,22,22,allow
53588,8999,41805,8999,1268,960,308,9,32,5,4,allow
57166,53,13391,53,177,94,83,2,30,1,1,allow
55910,53,26815,53,183,94,89,2,30,1,1,allow
46965,443,48357,443,1786,172,1614,7,120,3,4,allow
36857,80,4468,80,11216,2684,8532,28,163,11,17,allow
57470,49160,27757,49160,402,132,270,6,1209,3,3,allow
55479,53,23646,53,184,94,90,2,31,1,1,allow
27005,33026,18106,33026,879,126,753,2,31,1,1,allow
27005,32065,28721,32065,877,126,751,2,31,1,1,allow
57342,53,55197,53,167,86,81,2,31,1,1,allow
27005,33055,54134,33055,888,126,762,2,31,1,1,allow
27005,32039,29232,32039,883,126,757,2,31,1,1,allow
51821,443,38521,443,3002,258,2744,9,119,4,5,allow
57470,9273,56118,9273,491,150,341,2,1199,1,1,allow
55919,53,46329,53,177,94,83,2,31,1,1,allow
27005,33060,25157,33060,928,126,802,2,31,1,1,allow
49923,443,47836,443,7759,2264,5495,19,120,9,10,allow
53863,443,64176,443,13492,3615,9877,42,120,20,22,allow
57470,6881,22501,6881,353,166,187,2,1199,1,1,allow
53350,443,13931,443,5987,2780,3207,21,140,10,11,allow
37965,21859,39298,21859,481,150,331,2,1199,1,1,allow
26467,6969,46826,6969,192,192,0,4,1200,4,0,allow
56550,53,64220,53,183,94,89,2,31,1,1,allow
60761,40010,63900,40010,316,136,180,6,6,3,3,allow
64555,53,10175,53,469,97,372,4,49,2,2,allow
60424,6881,10732,6881,320,140,180,6,7,3,3,allow
64751,53,57978,53,178,94,84,2,30,1,1,allow
57166,53,52593,53,177,94,83,2,30,1,1,allow
50718,80,3998,80,620,320,300,11,166,6,5,allow
61718,443,31970,443,21125,2413,18712,42,49,20,22,allow
61703,80,42538,80,1494,954,540,13,51,8,5,allow
63837,14023,10553,14023,66,66,0,2,8,2,0,allow
54987,443,13107,443,7502,2299,5203,37,18,21,16,allow
55264,53,25192,53,177,94,83,2,30,1,1,allow
46726,53,27470,53,168,78,90,2,30,1,1,allow
49903,53,65277,53,231,110,121,2,30,1,1,allow
55043,53,37629,53,167,86,81,2,30,1,1,allow
55164,53,26323,53,177,94,83,2,30,1,1,allow
56785,443,18418,443,288525,15601,272924,383,33,193,190,allow
56586,53,63496,53,177,94,83,2,31,1,1,allow
64588,53,41773,53,173,94,79,2,31,1,1,allow
27005,27999,21376,27999,913,126,787,2,31,1,1,allow
60341,445,0,0,70,70,0,1,0,1,0,drop
60340,445,0,0,70,70,0,1,0,1,0,drop
55749,445,0,0,66,66,0,1,0,1,0,drop
55418,445,0,0,70,70,0,1,0,1,0,drop
55745,445,0,0,66,66,0,1,0,1,0,drop
55744,445,0,0,66,66,0,1,0,1,0,drop
55741,445,0,0,66,66,0,1,0,1,0,drop
55417,445,0,0,70,70,0,1,0,1,0,drop
50798,36237,0,0,62,62,0,1,0,1,0,deny
55416,445,0,0,70,70,0,1,0,1,0,drop
55411,445,0,0,70,70,0,1,0,1,0,drop
55412,445,0,0,70,70,0,1,0,1,0,drop
55739,445,0,0,66,66,0,1,0,1,0,drop
55738,445,0,0,66,66,0,1,0,1,0,drop
55736,445,0,0,66,66,0,1,0,1,0,drop
23936,35440,0,0,62,62,0,1,0,1,0,deny
39119,44847,0,0,62,62,0,1,0,1,0,deny
60338,445,0,0,70,70,0,1,0,1,0,drop
55398,445,0,0,70,70,0,1,0,1,0,drop
60337,445,0,0,70,70,0,1,0,1,0,drop
60335,445,0,0,70,70,0,1,0,1,0,drop
55397,445,0,0,70,70,0,1,0,1,0,drop
55392,445,0,0,70,70,0,1,0,1,0,drop
55733,445,0,0,66,66,0,1,0,1,0,drop
2918,37965,0,0,62,62,0,1,0,1,0,deny
48676,53393,0,0,60,60,0,1,0,1,0,deny
55388,445,0,0,70,70,0,1,0,1,0,drop
55387,445,0,0,70,70,0,1,0,1,0,drop
60331,445,0,0,70,70,0,1,0,1,0,drop
64294,64147,0,0,62,62,0,1,0,1,0,deny
55730,445,0,0,66,66,0,1,0,1,0,drop
55728,445,0,0,66,66,0,1,0,1,0,drop
55727,445,0,0,66,66,0,1,0,1,0,drop
55725,445,0,0,66,66,0,1,0,1,0,drop
10916,44847,0,0,66,66,0,1,0,1,0,deny
52575,22114,0,0,66,66,0,1,0,1,0,deny
60312,57470,0,0,74,74,0,1,0,1,0,deny
60168,35440,0,0,66,66,0,1,0,1,0,deny
63791,48817,0,0,145,145,0,1,0,1,0,deny
65064,30188,0,0,66,66,0,1,0,1,0,deny
11402,11119,0,0,145,145,0,1,0,1,0,deny
60328,445,0,0,70,70,0,1,0,1,0,drop
55376,445,0,0,70,70,0,1,0,1,0,drop
49717,57470,0,0,62,62,0,1,0,1,0,deny
60313,445,0,0,70,70,0,1,0,1,0,drop
14059,21247,0,0,146,146,0,1,0,1,0,deny
59739,35253,0,0,62,62,0,1,0,1,0,deny
55713,445,0,0,66,66,0,1,0,1,0,drop
55372,445,0,0,70,70,0,1,0,1,0,drop
42463,56205,0,0,62,62,0,1,0,1,0,deny
6882,64147,0,0,146,146,0,1,0,1,0,deny
30306,23,0,0,60,60,0,1,0,1,0,deny
55706,445,0,0,66,66,0,1,0,1,0,drop
35163,30188,0,0,66,66,0,1,0,1,0,deny
60303,445,0,0,70,70,0,1,0,1,0,drop
55363,445,0,0,70,70,0,1,0,1,0,drop
55361,445,0,0,70,70,0,1,0,1,0,drop
55360,445,0,0,70,70,0,1,0,1,0,drop
55358,445,0,0,70,70,0,1,0,1,0,drop
55355,445,0,0,70,70,0,1,0,1,0,drop
59937,37965,0,0,66,66,0,1,0,1,0,deny
23006,48817,0,0,62,62,0,1,0,1,0,deny
55704,445,0,0,66,66,0,1,0,1,0,drop
58398,44847,0,0,66,66,0,1,0,1,0,deny
20168,81,0,0,60,60,0,1,0,1,0,deny
55695,445,0,0,66,66,0,1,0,1,0,drop
55691,445,0,0,66,66,0,1,0,1,0,drop
55349,445,0,0,70,70,0,1,0,1,0,drop
61902,22114,0,0,66,66,0,1,0,1,0,deny
44849,46478,0,0,74,74,0,1,0,1,0,deny
44981,57470,0,0,66,66,0,1,0,1,0,deny
63779,26467,0,0,66,66,0,1,0,1,0,deny
52282,37965,0,0,66,66,0,1,0,1,0,deny
51910,37965,0,0,62,62,0,1,0,1,0,deny
53774,51505,0,0,62,62,0,1,0,1,0,deny
55342,445,0,0,70,70,0,1,0,1,0,drop
55339,445,0,0,70,70,0,1,0,1,0,drop
60292,445,0,0,70,70,0,1,0,1,0,drop
60293,445,0,0,70,70,0,1,0,1,0,drop
60291,445,0,0,70,70,0,1,0,1,0,drop
13285,29892,0,0,145,145,0,1,0,1,0,deny
55674,445,0,0,66,66,0,1,0,1,0,drop
55677,445,0,0,66,66,0,1,0,1,0,drop
55679,445,0,0,66,66,0,1,0,1,0,drop
55680,445,0,0,66,66,0,1,0,1,0,drop
55681,445,0,0,66,66,0,1,0,1,0,drop
55678,445,0,0,66,66,0,1,0,1,0,drop
55675,445,0,0,66,66,0,1,0,1,0,drop
55673,445,0,0,66,66,0,1,0,1,0,drop
45941,23386,0,0,60,60,0,1,0,1,0,deny
44203,8055,0,0,159,159,0,1,0,1,0,deny
64898,35993,0,0,74,74,0,1,0,1,0,deny
55335,445,0,0,70,70,0,1,0,1,0,drop
30879,35440,0,0,146,146,0,1,0,1,0,deny
55334,445,0,0,70,70,0,1,0,1,0,drop
13285,29892,0,0,145,145,0,1,0,1,0,deny
0,0,0,0,70,70,0,1,0,1,0,deny
51032,30188,0,0,66,66,0,1,0,1,0,deny
11937,35440,0,0,146,146,0,1,0,1,0,deny
55330,445,0,0,70,70,0,1,0,1,0,drop
61257,56448,0,0,146,146,0,1,0,1,0,deny
60288,445,0,0,70,70,0,1,0,1,0,drop
60282,445,0,0,70,70,0,1,0,1,0,drop
60276,445,0,0,70,70,0,1,0,1,0,drop
54196,11392,0,0,66,66,0,1,0,1,0,deny
43129,15503,0,0,62,62,0,1,0,1,0,deny
443,62451,0,0,199,199,0,1,0,1,0,deny
55329,445,0,0,70,70,0,1,0,1,0,drop
55311,44847,0,0,66,66,0,1,0,1,0,deny
55658,445,0,0,66,66,0,1,0,1,0,drop
55661,445,0,0,66,66,0,1,0,1,0,drop
60273,445,0,0,70,70,0,1,0,1,0,drop
52696,21247,0,0,62,62,0,1,0,1,0,deny
22835,51221,0,0,62,62,0,1,0,1,0,deny
443,5705,0,0,60,60,0,1,0,1,0,deny
60271,445,0,0,70,70,0,1,0,1,0,drop
38653,21247,0,0,62,62,0,1,0,1,0,deny
60267,445,0,0,70,70,0,1,0,1,0,drop
60266,445,0,0,70,70,0,1,0,1,0,drop
60263,445,0,0,70,70,0,1,0,1,0,drop
55324,445,0,0,70,70,0,1,0,1,0,drop
59563,56205,0,0,66,66,0,1,0,1,0,deny
17579,57470,0,0,62,62,0,1,0,1,0,deny
24174,57470,0,0,62,62,0,1,0,1,0,deny
62549,53733,0,0,66,66,0,1,0,1,0,deny
49915,35440,0,0,62,62,0,1,0,1,0,deny
30246,51050,0,0,146,146,0,1,0,1,0,deny
17453,35440,0,0,62,62,0,1,0,1,0,deny
59845,44847,0,0,66,66,0,1,0,1,0,deny
60254,445,0,0,70,70,0,1,0,1,0,drop
60251,445,0,0,70,70,0,1,0,1,0,drop
64021,53,21293,53,190,97,93,2,30,1,1,allow
55985,53,10494,53,711,87,624,2,30,1,1,allow
49517,80,14591,80,6123,3105,3018,16,38,8,8,allow
61700,443,65174,443,12613,2946,9667,38,50,18,20,allow
59769,443,37962,443,8432,1967,6465,35,68,17,18,allow
50574,443,59952,443,5870,1785,4085,21,80,12,9,allow
49144,443,40050,443,130,70,60,3,5,2,1,allow
44129,53,44129,53,182,81,101,2,30,1,1,allow
33842,53,33842,53,1415,689,726,3,31,2,1,allow
61698,80,14302,80,7712,4248,3464,23,51,12,11,allow
59857,443,40076,443,2118,1093,1025,22,44,9,13,allow
36357,443,35351,443,14614,1935,12679,36,16,20,16,allow
56445,53,12217,53,711,87,624,2,30,1,1,allow
56292,53,41121,53,194,99,95,2,30,1,1,allow
49845,53,6637,53,188,96,92,2,31,1,1,allow
55912,53,3506,53,184,94,90,2,30,1,1,allow
55620,53,14188,53,170,87,83,2,30,1,1,allow
50572,443,24489,443,5867,1782,4085,21,80,12,9,allow
59843,443,50473,443,1427,726,701,17,46,8,9,allow
65251,53,48559,53,198,101,97,2,30,1,1,allow
56968,80,44242,80,53181,50384,2797,75,20,39,36,allow
49515,80,17973,80,5101,2867,2234,15,38,8,7,allow
57342,53,37406,53,166,85,81,2,31,1,1,allow
50569,443,18328,443,5941,1856,4085,22,81,13,9,allow
50567,443,16036,443,5866,1781,4085,21,81,12,9,allow
49106,53,49106,53,1415,689,726,3,30,2,1,allow
61733,443,10616,443,168812,5693,163119,186,21,68,118,allow
63815,11372,42999,11372,504,382,122,8,16,6,2,allow
59858,443,47016,443,2069,1044,1025,22,44,9,13,allow
59848,443,53182,443,2431,1164,1267,27,46,11,16,allow
55820,53,49464,53,184,94,90,2,30,1,1,allow
56472,53,12167,53,711,87,624,2,30,1,1,allow
55851,53,15581,53,749,94,655,2,30,1,1,allow
45663,53,45663,53,507,129,378,2,30,1,1,allow
55264,53,35896,53,170,87,83,2,30,1,1,allow
64566,53,1628,53,188,96,92,2,30,1,1,allow
49825,53,46479,53,793,101,692,2,30,1,1,allow
64535,53,14565,53,763,101,662,2,30,1,1,allow
62230,443,57839,443,3709,1176,2533,14,135,7,7,allow
55267,53,18171,53,168,86,82,2,31,1,1,allow
27328,443,23617,443,3751,1007,2744,35,473,11,24,allow
49913,53,50642,53,216,110,106,2,31,1,1,allow
55640,53,50783,53,742,88,654,2,31,1,1,allow
57009,53,27487,53,1435,98,1337,4,34,2,2,allow
50568,443,35404,443,5877,1792,4085,21,81,12,9,allow
59842,443,63853,443,1307,666,641,15,46,7,8,allow
53663,17904,16406,17904,320,140,180,6,7,3,3,allow
63835,30794,60469,30794,66,66,0,2,8,2,0,allow
65107,53,44757,53,266,87,179,4,33,2,2,allow
51825,25501,31893,25501,66,66,0,1,5,1,0,allow
59826,443,57652,443,7284,1079,6205,29,53,13,16,allow
60421,6882,64164,6882,70,70,0,2,8,2,0,allow
52658,80,12733,80,214,140,74,4,15,3,1,allow
55208,80,41287,80,1638,1324,314,10,15,5,5,allow
56694,53,29552,53,192,98,94,2,30,1,1,allow
49483,80,60356,80,318,192,126,6,40,4,2,allow
64751,53,29777,53,172,88,84,2,30,1,1,allow
55838,443,19179,443,7034,2039,4995,37,255,18,19,allow
56100,53,43759,53,701,88,613,2,30,1,1,allow
50134,53,12196,53,768,99,669,2,30,1,1,allow
64493,53,45305,53,198,101,97,2,30,1,1,allow
56850,53,62960,53,763,101,662,2,31,1,1,allow
56889,53,34055,53,170,87,83,2,31,1,1,allow
50233,53,55519,53,756,95,661,2,31,1,1,allow
56550,53,60039,53,182,93,89,2,31,1,1,allow
55142,53,21559,53,770,101,669,2,31,1,1,allow
54973,53,47397,53,731,91,640,2,31,1,1,allow
56374,53,38425,53,770,102,668,2,31,1,1,allow
55368,53,50855,53,760,97,663,2,31,1,1,allow
49459,443,42939,443,2572,330,2242,12,135,5,7,allow
57470,47004,40280,47004,152,152,0,2,1200,2,0,allow
49166,53,45421,53,770,101,669,2,31,1,1,allow
27005,27027,32399,27027,880,126,754,2,31,1,1,allow
56757,53,3651,53,783,96,687,2,31,1,1,allow
64791,53,42823,53,184,94,90,2,31,1,1,allow
57100,53,41347,53,192,90,102,2,31,1,1,allow
56612,53,36295,53,184,94,90,2,31,1,1,allow
55105,53,18912,53,747,93,654,2,31,1,1,allow
64766,53,59121,53,212,108,104,2,31,1,1,allow
47493,53,47493,53,227,92,135,2,31,1,1,allow
50196,53,48778,53,756,95,661,2,31,1,1,allow
56484,443,15925,443,2948,782,2166,10,121,5,5,allow
59651,60038,0,0,66,66,0,1,90,1,0,allow
37587,5228,8359,5228,5509,2203,3306,22,3600,10,12,allow
56623,443,24976,443,8963,2190,6773,18,138,8,10,allow
56308,53,54603,53,184,94,90,2,31,1,1,allow
35713,443,23137,443,5315,2861,2454,16,135,8,8,allow
30960,45705,10345,45705,396,396,0,7,3617,7,0,allow
60247,445,0,0,70,70,0,1,0,1,0,drop
51412,51505,0,0,66,66,0,1,0,1,0,deny
55539,57470,0,0,66,66,0,1,0,1,0,deny
55311,445,0,0,70,70,0,1,0,1,0,drop
21674,28189,0,0,60,60,0,1,0,1,0,deny
20005,37965,0,0,62,62,0,1,0,1,0,deny
64997,51221,0,0,66,66,0,1,0,1,0,deny
50341,37965,0,0,66,66,0,1,0,1,0,deny
6713,2222,0,0,60,60,0,1,0,1,0,deny
49191,35440,0,0,66,66,0,1,0,1,0,deny
55308,445,0,0,70,70,0,1,0,1,0,deny
2541,51505,0,0,62,62,0,1,0,1,0,deny
42110,80,55658,80,1056,682,374,10,15,6,4,allow
55743,53,57939,53,165,86,79,2,30,1,1,allow
50281,53,4430,53,767,102,665,2,30,1,1,allow
55937,443,21508,443,3363,797,2566,14,135,7,7,allow
55636,445,0,0,66,66,0,1,0,1,0,drop
60243,445,0,0,70,70,0,1,0,1,0,drop
60241,445,0,0,70,70,0,1,0,1,0,drop
55303,445,0,0,70,70,0,1,0,1,0,drop
54545,49344,0,0,66,66,0,1,0,1,0,deny
32388,26467,0,0,66,66,0,1,0,1,0,deny
55302,445,0,0,70,70,0,1,0,1,0,drop
52144,49344,0,0,62,62,0,1,0,1,0,deny
53227,64097,0,0,66,66,0,1,0,1,0,deny
50577,23,0,0,60,60,0,1,0,1,0,deny
55300,445,0,0,70,70,0,1,0,1,0,drop
19885,64147,0,0,145,145,0,1,0,1,0,deny
55267,53,21533,53,168,86,82,2,30,1,1,allow
51827,48432,31400,48432,160,70,90,2,4,1,1,allow
57372,443,37935,443,4612,700,3912,12,15,8,4,allow
64021,53,18880,53,195,102,93,2,29,1,1,allow
64188,53,49847,53,216,94,122,2,29,1,1,allow
65325,53,33633,53,216,110,106,2,29,1,1,allow
55264,53,48968,53,177,94,83,2,30,1,1,allow
27005,26258,35412,26258,886,126,760,2,30,1,1,allow
56141,53,40551,53,713,94,619,4,54,2,2,allow
50019,80,29484,80,814,674,140,6,28,4,2,allow
50717,80,38874,80,3317,2376,941,17,165,9,8,allow
61711,80,55600,80,4448,2223,2225,18,49,10,8,allow
65107,53,56824,53,266,87,179,4,32,2,2,allow
51846,41510,18249,41510,70,70,0,2,8,2,0,allow
53644,58085,53471,58085,70,70,0,1,4,1,0,allow
56829,33418,63291,33418,316,136,180,6,5,3,3,allow
56292,443,38026,443,162,102,60,2,5,1,1,allow
64554,53,30164,53,94,94,0,1,29,1,0,allow
55820,53,22468,53,184,94,90,2,29,1,1,allow
64493,53,42355,53,199,102,97,2,29,1,1,allow
49771,53,57877,53,177,94,83,2,29,1,1,allow
56717,53,4326,53,183,94,89,2,29,1,1,allow
50320,53,19368,53,754,94,660,2,29,1,1,allow
64566,53,26350,53,194,102,92,2,29,1,1,allow
56717,53,57782,53,183,94,89,2,29,1,1,allow
56694,53,47429,53,196,102,94,2,29,1,1,allow
39444,53,0,0,86,86,0,1,29,1,0,allow
64021,53,54662,53,195,102,93,2,30,1,1,allow
46176,53,12412,53,168,78,90,2,30,1,1,allow
53124,52917,26989,52917,70,70,0,1,5,1,0,allow
50232,443,24591,443,7292,950,6342,19,75,9,10,allow
60786,3389,60786,3389,4226,2201,2025,19,18,10,9,allow
49406,80,24541,80,32206,1049,31157,37,89,11,26,allow
49235,80,47953,80,1783342,58977,1724365,1613,162,445,1168,allow
49523,80,32458,80,1399,826,573,11,38,6,5,allow
52223,443,45658,443,6710,4371,2339,33,109,18,15,allow
56506,53,39583,53,807,94,713,2,30,1,1,allow
55912,53,46949,53,184,94,90,2,30,1,1,allow
59325,53,7735,53,211,78,133,2,30,1,1,allow
55223,53,31444,53,168,86,82,2,30,1,1,allow
55738,53,4750,53,309,94,215,2,30,1,1,allow
49913,53,47185,53,216,110,106,2,30,1,1,allow
49168,53,14343,53,196,102,94,2,30,1,1,allow
55912,53,61558,53,184,94,90,2,30,1,1,allow
64722,53,58551,53,214,110,104,2,30,1,1,allow
56308,53,37236,53,184,94,90,2,31,1,1,allow
49713,53,55679,53,734,94,640,2,30,1,1,allow
64751,53,33597,53,178,94,84,2,30,1,1,allow
49925,80,49556,80,1126,609,517,11,15,6,5,allow
65201,53,45437,53,334,94,240,2,30,1,1,allow
60398,443,27669,443,2847,1797,1050,24,85,13,11,allow
65439,53,54009,53,168,86,82,2,30,1,1,allow
56586,53,7181,53,177,94,83,2,30,1,1,allow
57342,53,19842,53,167,86,81,2,30,1,1,allow
49891,53,62229,53,822,102,720,2,30,1,1,allow
35266,53,50904,53,164,78,86,2,30,1,1,allow
49525,80,7498,80,454,262,192,8,38,5,3,allow
55625,10480,18268,10480,564,318,246,9,15,5,4,allow
53639,15079,39945,15079,546,306,240,9,15,5,4,allow
49701,53,61542,53,197,102,95,2,30,1,1,allow
59714,3389,59714,3389,4134,2109,2025,18,17,9,9,allow
49236,80,22987,80,1904818,59945,1844873,1747,162,498,1249,allow
55620,53,23313,53,177,94,83,2,30,1,1,allow
60544,53,63580,53,211,78,133,2,30,1,1,allow
65251,53,53427,53,199,102,97,2,30,1,1,allow
64588,53,47202,53,165,86,79,2,30,1,1,allow
49202,53,58969,53,295,86,209,2,30,1,1,allow
64722,53,36705,53,214,110,104,2,30,1,1,allow
65473,53,40939,53,309,94,215,2,30,1,1,allow
56292,53,4815,53,197,102,95,2,30,1,1,allow
57294,443,36134,443,5614,733,4881,16,15,9,7,allow
49478,80,36631,80,28629,4862,23767,33,39,13,20,allow
56786,443,61415,443,238132,13988,224144,317,32,161,156,allow
55896,53,29667,53,733,94,639,2,30,1,1,allow
49168,53,25368,53,196,102,94,2,30,1,1,allow
49971,53,19251,53,779,110,669,2,30,1,1,allow
56966,53,53823,53,177,94,83,2,30,1,1,allow
65251,53,42946,53,199,102,97,2,30,1,1,allow
49269,53,8382,53,198,110,88,2,30,1,1,allow
59977,53,61405,53,168,78,90,2,30,1,1,allow
50430,53,3410,53,789,102,687,2,30,1,1,allow
57297,443,9892,443,5614,733,4881,16,15,9,7,allow
49260,80,56058,80,2013987,64000,1949987,1818,160,504,1314,allow
49891,53,46766,53,199,102,97,2,30,1,1,allow
51490,5223,60793,5223,9801,5352,4449,28,473,16,12,allow
55743,53,47802,53,165,86,79,2,30,1,1,allow
55620,53,48166,53,177,94,83,2,30,1,1,allow
56889,53,24379,53,177,94,83,2,30,1,1,allow
49179,443,25006,443,686176,17574,668602,702,18,252,450,allow
53332,443,6381,443,23215,18990,4225,44,405,24,20,allow
48354,5222,3961,5222,7786,1403,6383,44,434,15,29,allow
49446,443,57880,443,1280822,27768,1253054,1241,40,365,876,allow
40452,1488,40452,1488,156,156,0,3,8,3,0,allow
57295,443,4265,443,5614,733,4881,16,15,9,7,allow
42166,443,46667,443,162,102,60,2,5,1,1,allow
21017,3389,21017,3389,4085,1916,2169,21,18,12,9,allow
46360,443,51396,443,1053,566,487,10,16,6,4,allow
65107,53,20258,53,266,87,179,4,32,2,2,allow
50335,80,17897,80,3855,828,3027,11,15,5,6,allow
49471,80,33120,80,10175,1359,8816,18,78,7,11,allow
49519,80,21026,80,2981,1514,1467,12,38,7,5,allow
61687,80,48451,80,11437,2775,8662,32,53,15,17,allow
64638,53,33072,53,215,102,113,2,29,1,1,allow
63836,14791,9109,14791,66,66,0,2,7,2,0,allow
57161,53,42229,53,224,102,122,2,29,1,1,allow
53692,53,53692,53,262,82,180,2,29,1,1,allow
49379,80,26229,80,6307,2851,3456,18,150,9,9,allow
49524,80,21220,80,1401,828,573,11,38,6,5,allow
64493,53,5722,53,353,101,252,4,54,2,2,allow
49771,53,28192,53,177,94,83,2,29,1,1,allow
56292,53,5398,53,197,102,95,2,29,1,1,allow
49484,80,60761,80,318,192,126,6,39,4,2,allow
65325,53,57020,53,216,110,106,2,29,1,1,allow
49237,80,10310,80,1934086,60476,1873610,1754,162,493,1261,allow
27005,33070,2152,33070,883,126,757,2,30,1,1,allow
49051,443,25390,443,7683,1817,5866,42,3089,15,27,allow
55043,53,56883,53,167,86,81,2,29,1,1,allow
60792,53,38025,53,168,78,90,2,29,1,1,allow
49168,53,56952,53,196,102,94,2,30,1,1,allow
64733,53,63976,53,889,404,485,10,30,5,5,allow
55820,53,12238,53,184,94,90,2,30,1,1,allow
64650,53,46019,53,193,94,99,2,30,1,1,allow
49432,53,34624,53,812,110,702,2,30,1,1,allow
50545,53,44269,53,765,102,663,2,30,1,1,allow
55123,53,24178,53,295,86,209,2,30,1,1,allow
49797,53,57522,53,306,94,212,2,30,1,1,allow
50289,53,1310,53,189,102,87,2,30,1,1,allow
64791,53,7738,53,184,94,90,2,30,1,1,allow
64722,53,55455,53,214,110,104,2,30,1,1,allow
55235,53,63921,53,178,94,84,2,30,1,1,allow
64592,53,65035,53,209,110,99,2,31,1,1,allow
57362,53,9411,53,346,102,244,2,31,1,1,allow
56612,53,64503,53,184,94,90,2,31,1,1,allow
57188,443,9507,443,20317684,620294,19697390,20965,186,6716,14249,allow
56986,53,21320,53,177,94,83,2,31,1,1,allow
64021,53,7172,53,402,97,305,4,31,2,2,allow
52998,443,2559,443,190,70,120,4,15,2,2,allow
56624,443,23164,443,8536,3817,4719,25,20,15,10,allow
57296,443,59127,443,5613,733,4880,16,15,9,7,allow
56548,443,12998,443,4145,1069,3076,14,25,8,6,allow
49482,80,62281,80,378,192,186,7,39,4,3,allow
37004,80,37004,80,13825,1203,12622,22,29,9,13,allow
49514,80,16033,80,1352,832,520,12,38,7,5,allow
56966,53,65099,53,177,94,83,2,30,1,1,allow
52266,53,15275,53,168,78,90,2,30,1,1,allow
56139,53,55354,53,306,94,212,2,30,1,1,allow
55229,53,33453,53,173,94,79,2,30,1,1,allow
50072,53,22723,53,779,86,693,2,30,1,1,allow
51849,21091,51027,21091,316,136,180,6,7,3,3,allow
49927,80,35490,80,1126,609,517,11,15,6,5,allow
49926,80,8028,80,1126,609,517,11,15,6,5,allow
60767,443,60767,443,2406,1218,1188,21,16,11,10,allow
49234,80,29641,80,1103248,36317,1066931,1001,162,276,725,allow
49701,53,61488,53,197,102,95,2,30,1,1,allow
56986,53,63697,53,177,94,83,2,30,1,1,allow
55229,53,8520,53,173,94,79,2,30,1,1,allow
53662,55043,16806,55043,320,140,180,6,6,3,3,allow
50116,22,50116,22,152,66,86,2,9,1,1,allow
49928,80,49356,80,1270,679,591,13,15,7,6,allow
59715,3389,59715,3389,3331,1442,1889,15,17,8,7,allow
52215,80,59875,80,1009,506,503,10,16,5,5,allow
49512,80,18348,80,2225,1649,576,10,38,6,4,allow
65355,53,46648,53,592,105,487,4,50,2,2,allow
56506,53,3362,53,184,94,90,2,30,1,1,allow
65129,53,27603,53,213,102,111,2,30,1,1,allow
56618,443,44259,443,22938,14436,8502,43,41,23,20,allow
56889,53,34075,53,177,94,83,2,30,1,1,allow
64389,53,21920,53,244,94,150,2,30,1,1,allow
65218,443,1874,443,2767,681,2086,10,120,5,5,allow
49663,53,27941,53,168,86,82,2,31,1,1,allow
49936,53,50715,53,152,78,74,2,31,1,1,allow
27005,33111,35417,33111,895,126,769,2,31,1,1,allow
6881,37232,47143,37232,502,150,352,2,1199,1,1,allow
55877,22374,2922,22374,150,150,0,1,1200,1,0,allow
64766,53,62502,53,214,110,104,2,31,1,1,allow
42989,443,61280,443,9878,1936,7942,36,121,18,18,allow
64766,53,32517,53,214,110,104,2,30,1,1,allow
56667,53,18172,53,199,102,97,2,30,1,1,allow
64686,53,28216,53,811,94,717,2,30,1,1,allow
55912,53,21691,53,184,94,90,2,31,1,1,allow
55431,53,2541,53,196,102,94,2,31,1,1,allow
50017,53,58091,53,195,102,93,2,31,1,1,allow
42764,53,15953,53,164,78,86,2,31,1,1,allow
27005,32073,48886,32073,884,126,758,2,31,1,1,allow
57342,53,16666,53,167,86,81,2,31,1,1,allow
27005,27057,3516,27057,917,126,791,2,31,1,1,allow
27005,27091,19292,27091,883,126,757,2,31,1,1,allow
38566,443,54032,443,4108,1272,2836,11,121,5,6,allow
48817,30201,48817,30201,469,150,319,2,1200,1,1,allow
65077,443,2224,443,6118,5698,420,12,123,6,6,allow
42225,443,6040,443,8962,1601,7361,26,186,14,12,allow
51982,443,54748,443,9010,2779,6231,30,361,15,15,allow
33059,58962,0,0,774,774,0,1,0,1,0,deny
55631,445,0,0,66,66,0,1,0,1,0,drop
5227,50584,0,0,146,146,0,1,0,1,0,deny
34936,30188,0,0,62,62,0,1,0,1,0,deny
45682,1,0,0,62,62,0,1,0,1,0,deny
55373,1,0,0,66,66,0,1,0,1,0,deny
49687,53,60160,53,197,102,95,2,31,1,1,allow
58074,443,57514,443,2974,408,2566,13,135,6,7,allow
64364,53,21283,53,193,94,99,2,31,1,1,allow
27005,32025,48806,32025,887,126,761,2,31,1,1,allow
49480,53,38554,53,428,96,332,4,52,2,2,allow
60718,443,23092,443,71105,20647,50458,107,38,53,54,allow
56626,80,44276,80,234,234,0,4,12,4,0,allow
64658,53,8151,53,195,102,93,2,30,1,1,allow
56889,53,35698,53,177,94,83,2,30,1,1,allow
27005,27111,16900,27111,913,126,787,2,31,1,1,allow
51767,80,59527,80,2169,1263,906,13,75,8,5,allow
56067,53,11884,53,189,102,87,2,31,1,1,allow
49206,53,42939,53,179,94,85,2,31,1,1,allow
50413,123,48114,123,184,94,90,2,31,1,1,allow
57100,53,28423,53,180,94,86,2,31,1,1,allow
49996,53,3311,53,458,188,270,6,31,3,3,allow
51690,80,52942,80,21064,2772,18292,38,175,18,20,allow
65107,53,22367,53,266,87,179,4,35,2,2,allow
57030,53,7649,53,283,101,182,4,39,2,2,allow
32787,80,54491,80,1412,848,564,14,316,8,6,allow
39423,443,60458,443,121145,3578,117567,128,77,39,89,allow
57283,53,15261,53,185,102,83,2,30,1,1,allow
55482,53,16639,53,822,102,720,2,30,1,1,allow
50500,53,25369,53,166,86,80,2,30,1,1,allow
55628,445,0,0,66,66,0,1,0,1,0,drop
18650,23718,0,0,62,62,0,1,0,1,0,deny
60233,445,0,0,70,70,0,1,0,1,0,drop
1025,46232,0,0,145,145,0,1,0,1,0,deny
60230,445,0,0,70,70,0,1,0,1,0,drop
60228,445,0,0,70,70,0,1,0,1,0,drop
60222,445,0,0,70,70,0,1,0,1,0,drop
49479,56205,0,0,62,62,0,1,0,1,0,deny
55625,445,0,0,66,66,0,1,0,1,0,drop
52150,39109,0,0,66,66,0,1,0,1,0,deny
55293,445,0,0,70,70,0,1,0,1,0,drop
55291,445,0,0,70,70,0,1,0,1,0,drop
54989,50265,0,0,66,66,0,1,0,1,0,deny
60218,445,0,0,70,70,0,1,0,1,0,drop
64283,37965,0,0,74,74,0,1,0,1,0,deny
57633,50584,0,0,62,62,0,1,0,1,0,deny
55290,445,0,0,70,70,0,1,0,1,0,drop
60216,445,0,0,70,70,0,1,0,1,0,drop
60212,445,0,0,70,70,0,1,0,1,0,drop
60213,445,0,0,70,70,0,1,0,1,0,drop
4427,50584,0,0,62,62,0,1,0,1,0,deny
55289,445,0,0,70,70,0,1,0,1,0,drop
44208,26467,0,0,62,62,0,1,0,1,0,deny
55617,445,0,0,66,66,0,1,0,1,0,drop
55288,445,0,0,70,70,0,1,0,1,0,drop
55286,445,0,0,70,70,0,1,0,1,0,drop
55282,445,0,0,70,70,0,1,0,1,0,drop
34146,51221,0,0,62,62,0,1,0,1,0,deny
55614,445,0,0,66,66,0,1,0,1,0,drop
55616,445,0,0,66,66,0,1,0,1,0,drop
55610,445,0,0,66,66,0,1,0,1,0,drop
13985,34159,0,0,62,62,0,1,0,1,0,deny
2876,35440,0,0,62,62,0,1,0,1,0,deny
55609,445,0,0,66,66,0,1,0,1,0,drop
55608,445,0,0,66,66,0,1,0,1,0,drop
55606,445,0,0,66,66,0,1,0,1,0,drop
55270,445,0,0,70,70,0,1,0,1,0,drop
55268,445,0,0,70,70,0,1,0,1,0,drop
55267,445,0,0,70,70,0,1,0,1,0,drop
55259,445,0,0,70,70,0,1,0,1,0,drop
55260,445,0,0,70,70,0,1,0,1,0,drop
60210,445,0,0,70,70,0,1,0,1,0,drop
60209,445,0,0,70,70,0,1,0,1,0,drop
60206,445,0,0,70,70,0,1,0,1,0,drop
62725,51221,0,0,66,66,0,1,0,1,0,deny
55604,445,0,0,66,66,0,1,0,1,0,drop
1790,48817,0,0,66,66,0,1,0,1,0,deny
60203,445,0,0,70,70,0,1,0,1,0,drop
4257,35440,0,0,62,62,0,1,0,1,0,deny
55600,445,0,0,66,66,0,1,0,1,0,drop
80,57411,0,0,1514,1514,0,1,0,1,0,deny
46518,44847,0,0,146,146,0,1,0,1,0,deny
55598,445,0,0,66,66,0,1,0,1,0,drop
55594,445,0,0,66,66,0,1,0,1,0,drop
80,36466,0,0,1514,1514,0,1,0,1,0,deny
57174,57470,0,0,66,66,0,1,0,1,0,deny
11344,42873,0,0,62,62,0,1,0,1,0,deny
55248,445,0,0,70,70,0,1,0,1,0,drop
48706,23393,0,0,60,60,0,1,0,1,0,deny
60198,445,0,0,70,70,0,1,0,1,0,drop
13970,42873,0,0,66,66,0,1,0,1,0,deny
60191,445,0,0,70,70,0,1,0,1,0,drop
60186,445,0,0,70,70,0,1,0,1,0,drop
55583,445,0,0,66,66,0,1,0,1,0,drop
46292,42873,0,0,72,72,0,1,0,1,0,deny
55244,445,0,0,70,70,0,1,0,1,0,drop
443,24425,0,0,151,151,0,1,0,1,0,deny
55235,445,0,0,70,70,0,1,0,1,0,drop
55233,445,0,0,70,70,0,1,0,1,0,drop
64387,37965,0,0,66,66,0,1,0,1,0,deny
14924,44847,0,0,66,66,0,1,0,1,0,deny
55232,445,0,0,70,70,0,1,0,1,0,drop
55230,445,0,0,70,70,0,1,0,1,0,drop
55576,445,0,0,66,66,0,1,0,1,0,drop
55228,445,0,0,70,70,0,1,0,1,0,drop
60175,445,0,0,70,70,0,1,0,1,0,drop
55573,445,0,0,66,66,0,1,0,1,0,drop
11136,15503,0,0,62,62,0,1,0,1,0,deny
1162,57470,0,0,62,62,0,1,0,1,0,deny
20108,64147,0,0,62,62,0,1,0,1,0,deny
57410,37965,0,0,66,66,0,1,0,1,0,deny
55221,445,0,0,70,70,0,1,0,1,0,drop
55567,445,0,0,66,66,0,1,0,1,0,drop
55561,445,0,0,66,66,0,1,0,1,0,drop
55214,445,0,0,70,70,0,1,0,1,0,drop
38383,51221,0,0,66,66,0,1,0,1,0,deny
54636,26467,0,0,66,66,0,1,0,1,0,deny
55211,445,0,0,70,70,0,1,0,1,0,drop
60165,445,0,0,70,70,0,1,0,1,0,drop
60164,445,0,0,70,70,0,1,0,1,0,drop
60163,445,0,0,70,70,0,1,0,1,0,drop
55550,445,0,0,66,66,0,1,0,1,0,drop
55546,445,0,0,66,66,0,1,0,1,0,drop
55545,445,0,0,66,66,0,1,0,1,0,drop
55548,445,0,0,66,66,0,1,0,1,0,drop
55551,445,0,0,66,66,0,1,0,1,0,drop
55544,445,0,0,66,66,0,1,0,1,0,drop
55549,445,0,0,66,66,0,1,0,1,0,drop
55543,445,0,0,66,66,0,1,0,1,0,drop
55207,445,0,0,70,70,0,1,0,1,0,drop
54898,36237,0,0,66,66,0,1,0,1,0,deny
55206,445,0,0,70,70,0,1,0,1,0,drop
54854,19847,0,0,66,66,0,1,0,1,0,deny
51183,56205,0,0,66,66,0,1,0,1,0,deny
3117,37965,0,0,62,62,0,1,0,1,0,deny
50095,30188,0,0,66,66,0,1,0,1,0,deny
55202,445,0,0,70,70,0,1,0,1,0,drop
60161,445,0,0,70,70,0,1,0,1,0,drop
60158,445,0,0,70,70,0,1,0,1,0,drop
60148,445,0,0,70,70,0,1,0,1,0,drop
55201,445,0,0,70,70,0,1,0,1,0,drop
55145,11392,0,0,66,66,0,1,0,1,0,deny
50116,22,0,0,60,60,0,1,0,1,0,deny
55531,445,0,0,66,66,0,1,0,1,0,drop
55529,445,0,0,66,66,0,1,0,1,0,drop
55528,445,0,0,66,66,0,1,0,1,0,drop
33370,22,0,0,60,60,0,1,0,1,0,deny
62438,37807,0,0,66,66,0,1,0,1,0,deny
60145,445,0,0,70,70,0,1,0,1,0,drop
54210,64097,0,0,66,66,0,1,0,1,0,deny
45908,33330,0,0,60,60,0,1,0,1,0,deny
1081,64910,0,0,146,146,0,1,0,1,0,deny
55196,445,0,0,70,70,0,1,0,1,0,drop
41801,53,41801,53,213,87,126,2,30,1,1,allow
55651,53,6764,53,760,97,663,2,30,1,1,allow
48972,443,48972,443,4657,1750,2907,19,31,11,8,allow
56120,53,56120,53,237,91,146,2,33,1,1,allow
50734,80,51242,80,1114,534,580,12,16,7,5,allow
51807,443,51807,443,1466,856,610,13,27,6,7,allow
51076,80,51076,80,8170,844,7326,17,42,7,10,allow
57746,15000,19364,15000,130,70,60,2,6,1,1,allow
53972,443,53972,443,4380,1473,2907,19,29,11,8,allow
50951,80,50951,80,514,246,268,9,42,5,4,allow
65378,53,28736,53,770,102,668,2,30,1,1,allow
49983,53,51189,53,749,89,660,2,30,1,1,allow
56227,53,8068,53,188,96,92,2,30,1,1,allow
56526,443,53927,443,1560,988,572,13,25,7,6,allow
53656,58624,15076,58624,70,70,0,2,8,2,0,allow
50883,80,50883,80,514,246,268,9,42,5,4,allow
55871,53,11606,53,711,87,624,2,30,1,1,allow
49762,53,23081,53,760,97,663,2,30,1,1,allow
49837,53,39920,53,212,108,104,2,30,1,1,allow
53575,53,50120,53,198,93,105,2,30,1,1,allow
60945,443,60945,443,4680,1773,2907,19,29,11,8,allow
62738,443,30177,443,126,60,66,3,10,2,1,allow
38386,80,38386,80,6261,833,5428,15,20,8,7,allow
44258,443,15237,443,14478,1815,12663,30,170,14,16,allow
54990,80,38273,80,9054746,285623,8769123,10474,214,4673,5801,allow
53880,443,53880,443,4686,1779,2907,19,30,11,8,allow
57030,53,58226,53,283,101,182,4,38,2,2,allow
56541,443,2047,443,1560,988,572,13,25,7,6,allow
50757,80,50757,80,514,246,268,9,42,5,4,allow
51140,80,51140,80,514,246,268,9,42,5,4,allow
51810,443,51810,443,1536,856,680,14,27,6,8,allow
53835,7000,53835,7000,2099,676,1423,13,15,7,6,allow
56242,53,42071,53,711,87,624,2,30,1,1,allow
49192,53,18280,53,747,93,654,2,30,1,1,allow
64592,53,37714,53,202,103,99,2,31,1,1,allow
55129,53,28774,53,754,94,660,2,31,1,1,allow
51798,443,51798,443,14904,6448,8456,33,30,18,15,allow
10099,80,20785,80,130,70,60,2,15,1,1,allow
55237,53,13670,53,259,87,172,4,56,2,2,allow
53354,80,22791,80,2722,1530,1192,12,316,7,5,allow
50500,53,52272,53,164,84,80,2,30,1,1,allow
57067,53,64624,53,172,88,84,2,30,1,1,allow
56765,53,52854,53,711,87,624,2,30,1,1,allow
27005,27019,17502,27019,873,126,747,2,30,1,1,allow
64949,53,27237,53,744,89,655,2,30,1,1,allow
56986,53,24262,53,170,87,83,2,30,1,1,allow
55141,53,48144,53,744,89,655,2,30,1,1,allow
65328,53,16469,53,174,89,85,2,30,1,1,allow
56589,53,53742,53,711,87,624,2,30,1,1,allow
55759,53,54947,53,756,95,661,2,30,1,1,allow
27005,27017,50516,27017,873,126,747,2,30,1,1,allow
55877,53,16386,53,164,84,80,2,30,1,1,allow
56553,53,14002,53,198,101,97,2,30,1,1,allow
49206,53,61280,53,174,89,85,2,31,1,1,allow
65370,53,4186,53,778,103,675,2,31,1,1,allow
56334,53,41390,53,767,102,665,2,31,1,1,allow
39703,443,48474,443,4719,2313,2406,15,132,7,8,allow
15503,6881,37170,6881,490,149,341,2,1200,1,1,allow
52028,53,52028,53,194,87,107,2,31,1,1,allow
50017,53,55318,53,190,97,93,2,31,1,1,allow
59893,53,45221,53,198,93,105,2,30,1,1,allow
64560,53,23612,53,802,104,698,2,30,1,1,allow
49513,53,13327,53,200,102,98,2,31,1,1,allow
55533,53,30263,53,816,97,719,2,31,1,1,allow
27005,30005,39246,30005,890,126,764,2,31,1,1,allow
56342,53,27382,53,733,93,640,2,31,1,1,allow
57470,40870,29859,40870,535,163,372,2,1200,1,1,allow
56633,53,17988,53,194,99,95,2,31,1,1,allow
56250,53,20280,53,802,104,698,2,31,1,1,allow
64790,53,49419,53,182,93,89,2,31,1,1,allow
64934,53,46124,53,194,99,95,2,31,1,1,allow
47595,33436,0,0,106,106,0,1,60,1,0,allow
36228,80,25190,80,1114,540,574,17,191,10,7,allow
56076,443,18045,443,1786,172,1614,7,120,3,4,allow
56000,53,40530,53,170,87,83,2,31,1,1,allow
53635,22383,54338,22383,492,306,186,8,17,5,3,allow
49687,53,12525,53,194,99,95,2,31,1,1,allow
56380,53,55619,53,170,87,83,2,31,1,1,allow
56693,53,6310,53,756,95,661,2,31,1,1,allow
65516,53,45586,53,749,94,655,2,31,1,1,allow
64053,53,7121,53,186,95,91,2,31,1,1,allow
64257,53,54453,53,168,86,82,2,31,1,1,allow
65171,53,47372,53,760,97,663,2,31,1,1,allow
55680,53,52561,53,749,94,655,2,31,1,1,allow
55027,53,18379,53,168,86,82,2,31,1,1,allow
27005,30008,53621,30008,890,126,764,2,31,1,1,allow
49157,53,58041,53,184,94,90,2,31,1,1,allow
33949,80,17456,80,1360,540,820,20,191,10,10,allow
56511,53,19992,53,200,102,98,2,31,1,1,allow
41284,443,45151,443,7252,2147,5105,18,136,8,10,allow
57256,53,42871,53,771,101,670,2,31,1,1,allow
57470,59216,60669,59216,594,594,0,10,1200,10,0,allow
55994,53,19158,53,182,93,89,2,31,1,1,allow
41694,443,48276,443,16107,3200,12907,35,362,17,18,allow
64983,53,38581,53,777,87,690,2,31,1,1,allow
55179,53,42268,53,172,88,84,2,31,1,1,allow
55902,53,9062,53,178,91,87,2,31,1,1,allow
49936,53,59450,53,216,110,106,2,31,1,1,allow
57106,53,8204,53,760,97,663,2,31,1,1,allow
64825,53,5593,53,728,96,632,2,31,1,1,allow
55031,443,25745,443,3625,1378,2247,14,135,7,7,allow
52170,443,36243,443,7228,1589,5639,22,362,11,11,allow
6881,6881,43192,6881,150,150,0,1,1200,1,0,allow
60143,445,0,0,70,70,0,1,0,1,0,drop
8239,37965,0,0,146,146,0,1,0,1,0,deny
52323,44847,0,0,146,146,0,1,0,1,0,deny
1081,59353,0,0,146,146,0,1,0,1,0,deny
60142,445,0,0,70,70,0,1,0,1,0,drop
60138,445,0,0,70,70,0,1,0,1,0,drop
60135,445,0,0,70,70,0,1,0,1,0,drop
21674,28189,0,0,60,60,0,1,0,1,0,deny
29263,50939,0,0,148,148,0,1,0,1,0,deny
51446,57587,0,0,100,100,0,1,0,1,0,deny
1081,21162,0,0,146,146,0,1,0,1,0,deny
443,64347,0,0,131,131,0,1,0,1,0,deny
53652,1900,0,0,139,139,0,1,0,1,0,deny
23383,64147,0,0,62,62,0,1,0,1,0,deny
7109,64147,0,0,66,66,0,1,0,1,0,deny
5179,50265,0,0,62,62,0,1,0,1,0,deny
1081,43109,0,0,146,146,0,1,0,1,0,deny
1081,14984,0,0,146,146,0,1,0,1,0,deny
56550,53,61639,53,183,94,89,2,30,1,1,allow
44246,80,45320,80,5584,2543,3041,20,27,11,9,allow
47037,1,0,0,62,62,0,1,0,1,0,deny
13795,2323,0,0,60,60,0,1,0,1,0,deny
18623,1,0,0,66,66,0,1,0,1,0,deny
51197,57470,0,0,62,62,0,1,0,1,0,deny
29989,26467,0,0,66,66,0,1,0,1,0,deny
55183,445,0,0,70,70,0,1,0,1,0,drop
43260,41615,0,0,145,145,0,1,0,1,0,deny
60126,445,0,0,70,70,0,1,0,1,0,drop
60123,445,0,0,70,70,0,1,0,1,0,drop
60119,445,0,0,70,70,0,1,0,1,0,drop
32707,11392,0,0,62,62,0,1,0,1,0,deny
51446,3033,0,0,100,100,0,1,0,1,0,deny
31035,23,0,0,60,60,0,1,0,1,0,deny
51446,3855,0,0,100,100,0,1,0,1,0,deny
51446,17500,0,0,100,100,0,1,0,1,0,deny
55180,445,0,0,70,70,0,1,0,1,0,drop
51742,30317,0,0,66,66,0,1,0,1,0,deny
39920,22114,0,0,146,146,0,1,0,1,0,deny
27005,27018,61508,27018,252,252,0,3,2,3,0,allow
4772,37965,0,0,66,66,0,1,0,1,0,deny
62888,23,0,0,60,60,0,1,0,1,0,deny
39548,8696,0,0,60,60,0,1,0,1,0,deny
55176,445,0,0,70,70,0,1,0,1,0,drop
22971,50584,0,0,62,62,0,1,0,1,0,deny
55504,445,0,0,66,66,0,1,0,1,0,drop
55992,53,33542,53,194,94,100,2,30,1,1,allow
50091,53,37575,53,183,94,89,2,30,1,1,allow
56000,53,49191,53,177,94,83,2,30,1,1,allow
38111,443,61640,443,566856,28278,538578,737,37,351,386,allow
39416,443,22181,443,621104,12188,608916,575,78,149,426,allow
50076,443,58457,443,9920,5013,4907,41,15,25,16,allow
56353,53,32385,53,216,102,114,2,29,1,1,allow
65439,53,5065,53,198,94,104,2,30,1,1,allow
65414,53,56360,53,216,102,114,2,30,1,1,allow
64541,53,6698,53,363,94,269,2,30,1,1,allow
56380,53,5120,53,177,94,83,2,30,1,1,allow
39422,443,26393,443,557795,16003,541792,528,76,139,389,allow
57429,80,55023,80,1056,682,374,10,15,6,4,allow
51765,80,50481,80,5569,3270,2299,21,74,13,8,allow
51691,80,8687,80,19384,2720,16664,36,174,18,18,allow
51763,80,41535,80,3830,2255,1575,16,74,10,6,allow
51764,80,40729,80,5605,3306,2299,21,74,13,8,allow
55627,26192,18323,26192,70,70,0,1,5,1,0,allow
50929,443,35060,443,9571,2966,6605,52,35,29,23,allow
57422,80,40149,80,10454,4931,5523,21,30,10,11,allow
57117,53,45575,53,366,102,264,4,46,2,2,allow
55837,443,59967,443,39628,2279,37349,63,255,23,40,allow
55475,53,28600,53,757,102,655,2,29,1,1,allow
59368,53,55998,53,241,118,123,2,29,1,1,allow
56550,53,48765,53,183,94,89,2,29,1,1,allow
64658,53,60447,53,195,102,93,2,29,1,1,allow
56369,53,50667,53,168,86,82,2,29,1,1,allow
65439,53,2036,53,168,86,82,2,29,1,1,allow
56667,53,55956,53,199,102,97,2,29,1,1,allow
55235,53,18331,53,178,94,84,2,29,1,1,allow
64332,53,12232,53,195,102,93,2,30,1,1,allow
49646,53,5301,53,199,102,97,2,30,1,1,allow
49687,53,16473,53,197,102,95,2,29,1,1,allow
57258,53,4190,53,177,94,83,2,29,1,1,allow
55027,53,13864,53,168,86,82,2,30,1,1,allow
55933,53,32005,53,177,94,83,2,30,1,1,allow
56612,53,46131,53,184,94,90,2,29,1,1,allow
50289,53,8502,53,189,102,87,2,30,1,1,allow
57258,53,16585,53,177,94,83,2,30,1,1,allow
60638,53,31002,53,337,86,251,2,29,1,1,allow
22013,53,22013,53,198,90,108,2,30,1,1,allow
64792,53,34890,53,338,110,228,2,30,1,1,allow
56626,443,50553,443,8240,3521,4719,25,18,15,10,allow
49211,80,44277,80,8971,1094,7877,17,15,7,10,allow
36172,443,19620,443,6295,1324,4971,22,983,10,12,allow
54348,443,26587,443,12594,5098,7496,32,35,17,15,allow
40273,53,38821,53,164,78,86,2,30,1,1,allow
49837,53,42825,53,214,110,104,2,30,1,1,allow
56242,53,30808,53,231,86,145,2,30,1,1,allow
64882,53,8935,53,246,94,152,2,30,1,1,allow
57135,53,40947,53,443,182,261,6,30,3,3,allow
50819,443,23164,443,1663508,63528,1599980,1853,251,692,1161,allow
60420,2924,28301,2924,320,140,180,6,7,3,3,allow
53633,443,6086,443,8473,1099,7374,20,18,9,11,allow
50200,53,14002,53,758,102,656,2,30,1,1,allow
55295,53,52273,53,779,86,693,2,30,1,1,allow
10001,443,23014,443,8370,2798,5572,31,315,15,16,allow
55439,53,44673,53,177,94,83,2,30,1,1,allow
56825,16648,32548,16648,164,70,94,2,7,1,1,allow
64620,53,50964,53,166,86,80,2,30,1,1,allow
45157,7,33504,7,138,78,60,2,5,1,1,allow
56628,443,13354,443,8240,3521,4719,25,18,15,10,allow
56000,53,42944,53,177,94,83,2,30,1,1,allow
54989,80,38298,80,8159037,271621,7887416,9644,214,4424,5220,allow
56553,53,56242,53,199,102,97,2,30,1,1,allow
46872,80,56165,80,29218,27458,1760,36,22,24,12,allow
51510,7000,51510,7000,3490,1923,1567,14,16,7,7,allow
55675,53,10351,53,195,102,93,2,30,1,1,allow
49329,53,8761,53,258,102,156,2,30,1,1,allow
49646,53,18495,53,199,102,97,2,30,1,1,allow
49837,53,47456,53,214,110,104,2,30,1,1,allow
64591,53,55985,53,179,86,93,2,30,1,1,allow
53868,53,38630,53,164,78,86,2,30,1,1,allow
44409,53,42084,53,199,94,105,2,30,1,1,allow
43770,53,60550,53,199,94,105,2,30,1,1,allow
49889,53,4477,53,338,110,228,2,30,1,1,allow
47483,53,19312,53,164,78,86,2,30,1,1,allow
38732,443,56897,443,9217,1548,7669,25,50,13,12,allow
33846,443,41735,443,7760,2646,5114,24,16,13,11,allow
61455,443,28409,443,8947,1130,7817,28,124,13,15,allow
60432,80,60432,80,19915,764,19151,23,16,7,16,allow
10090,443,45576,443,20612,7872,12740,57,643,21,36,allow
55933,53,58575,53,177,94,83,2,30,1,1,allow
50456,53,42563,53,754,94,660,2,30,1,1,allow
64332,53,56016,53,195,102,93,2,30,1,1,allow
56928,53,57142,53,178,94,84,2,30,1,1,allow
56421,53,5669,53,350,94,256,2,30,1,1,allow
49708,53,14475,53,185,102,83,2,30,1,1,allow
56668,53,12015,53,199,94,105,2,30,1,1,allow
56989,53,25786,53,168,94,74,2,30,1,1,allow
51806,443,51806,443,1466,856,610,13,27,6,7,allow
38733,443,28389,443,9058,1542,7516,25,50,13,12,allow
63964,53,22176,53,323,85,238,4,34,2,2,allow
55237,53,6417,53,259,87,172,4,56,2,2,allow
56553,53,8293,53,199,102,97,2,30,1,1,allow
49936,53,17708,53,168,94,74,2,30,1,1,allow
57288,53,1558,53,354,94,260,2,30,1,1,allow
56950,53,2496,53,183,94,89,2,30,1,1,allow
50236,443,16316,443,4954,1768,3186,18,143,9,9,allow
55237,53,24870,53,259,87,172,4,56,2,2,allow
63832,6969,23907,6969,66,66,0,2,8,2,0,allow
37991,49152,57920,49152,156,156,0,3,7,3,0,allow
51762,80,41389,80,3945,2315,1630,18,74,11,7,allow
56826,31310,8679,31310,70,70,0,1,5,1,0,allow
44545,443,4712,443,546,280,266,9,26,5,4,allow
51809,443,51809,443,1466,856,610,13,27,6,7,allow
57368,443,57368,443,4401,1494,2907,19,28,11,8,allow
51844,12471,17127,12471,70,70,0,2,8,2,0,allow
50331,80,36568,80,1677,862,815,10,15,5,5,allow
37992,49152,18454,49152,156,156,0,3,7,3,0,allow
51766,80,8995,80,2190,1284,906,13,74,8,5,allow
55626,63805,23725,63805,70,70,0,1,5,1,0,allow
51826,58925,47237,58925,70,70,0,1,4,1,0,allow
49891,80,30734,80,1694,666,1028,10,75,6,4,allow
56602,53,56281,53,423,102,321,4,38,2,2,allow
63822,14382,38807,14382,70,70,0,1,4,1,0,allow
53284,80,44514,80,6995,783,6212,14,317,7,7,allow
49212,80,10274,80,912,410,502,10,15,5,5,allow
50330,80,61342,80,736,670,66,6,15,5,1,allow
64791,53,16107,53,184,94,90,2,29,1,1,allow
27450,443,32260,443,10099,1635,8464,31,83,14,17,allow
61453,443,29702,443,8052,1307,6745,27,125,16,11,allow
65251,53,12989,53,199,102,97,2,29,1,1,allow
56986,53,31308,53,177,94,83,2,29,1,1,allow
49269,53,5251,53,198,110,88,2,29,1,1,allow
55620,53,11702,53,177,94,83,2,29,1,1,allow
57089,53,22992,53,239,94,145,2,29,1,1,allow
56633,53,19316,53,197,102,95,2,30,1,1,allow
56667,53,35653,53,199,102,97,2,29,1,1,allow
56996,53,30047,53,177,94,83,2,29,1,1,allow
57283,53,20762,53,185,102,83,2,29,1,1,allow
55482,53,39470,53,199,102,97,2,30,1,1,allow
56996,53,54322,53,177,94,83,2,30,1,1,allow
56574,53,4025,53,198,94,104,2,30,1,1,allow
57067,53,26997,53,178,94,84,2,30,1,1,allow
49845,53,33096,53,194,102,92,2,30,1,1,allow
64168,53,53054,53,306,94,212,2,30,1,1,allow
65359,53,4725,53,443,182,261,6,30,3,3,allow
56369,53,3400,53,168,86,82,2,30,1,1,allow
65067,53,58003,53,214,110,104,2,30,1,1,allow
16403,16385,35308,16385,308,128,180,6,30,3,3,allow
65067,53,2919,53,214,110,104,2,30,1,1,allow
65328,53,23014,53,179,94,85,2,30,1,1,allow
50827,443,7368,443,388366,15919,372447,435,219,158,277,allow
56821,53,11694,53,235,94,141,2,30,1,1,allow
49913,53,6290,53,216,110,106,2,30,1,1,allow
58087,123,31892,123,184,94,90,2,30,1,1,allow
55877,53,52511,53,166,86,80,2,30,1,1,allow
50017,53,60474,53,195,102,93,2,30,1,1,allow
56067,53,20488,53,189,102,87,2,30,1,1,allow
64804,53,31085,53,182,102,80,2,30,1,1,allow
56612,53,50823,53,184,94,90,2,30,1,1,allow
64257,53,1307,53,168,86,82,2,30,1,1,allow
64257,53,50451,53,168,86,82,2,31,1,1,allow
57394,53,17167,53,193,102,91,2,31,1,1,allow
65007,53,7048,53,165,86,79,2,30,1,1,allow
49744,53,33458,53,193,102,91,2,30,1,1,allow
49157,53,4191,53,184,94,90,2,30,1,1,allow
56155,53,9599,53,199,102,97,2,30,1,1,allow
49206,53,44411,53,179,94,85,2,30,1,1,allow
60613,443,54092,443,154465,11473,142992,244,212,101,143,allow
56928,53,51278,53,178,94,84,2,30,1,1,allow
53532,53,52838,53,329,102,227,2,30,1,1,allow
56196,53,38043,53,214,110,104,2,30,1,1,allow
49964,53,63838,53,380,110,270,2,31,1,1,allow
64959,53,63198,53,245,102,143,2,31,1,1,allow
55199,53,53506,53,214,110,104,2,31,1,1,allow
49936,53,6002,53,216,110,106,2,31,1,1,allow
56548,53,54465,53,199,102,97,2,31,1,1,allow
56553,53,46585,53,199,102,97,2,30,1,1,allow
56827,18318,42346,18318,70,70,0,1,5,1,0,allow
47147,443,62760,443,70,70,0,1,5,1,0,allow
63940,3389,63940,3389,3347,1458,1889,15,17,8,7,allow
50072,443,58353,443,827,484,343,8,15,5,3,allow
37248,80,37248,80,7850,1208,6642,16,20,8,8,allow
49882,53,52287,53,441,104,337,4,48,2,2,allow
50091,53,60727,53,183,94,89,2,30,1,1,allow
49845,53,47352,53,194,102,92,2,30,1,1,allow
56219,53,21871,53,211,102,109,2,30,1,1,allow
57018,53,10253,53,177,94,83,2,30,1,1,allow
55983,53,48141,53,255,102,153,2,30,1,1,allow
56041,53,6902,53,185,102,83,2,30,1,1,allow
61456,443,24877,443,9577,1475,8102,30,124,14,16,allow
50818,80,50818,80,514,246,268,9,42,5,4,allow
53634,443,2193,443,2005,1100,905,16,17,9,7,allow
47982,443,20773,443,83558,8567,74991,180,171,92,88,allow
63939,3389,63939,3389,4134,2109,2025,18,17,9,9,allow
51997,53,57972,53,164,78,86,2,30,1,1,allow
56308,53,13825,53,184,94,90,2,30,1,1,allow
55439,53,11568,53,177,94,83,2,30,1,1,allow
64592,53,31524,53,209,110,99,2,30,1,1,allow
56155,53,9723,53,199,102,97,2,30,1,1,allow
45394,53,64814,53,199,94,105,2,30,1,1,allow
55497,53,48989,53,168,86,82,2,30,1,1,allow
65419,53,59811,53,200,102,98,2,30,1,1,allow
49744,53,14742,53,816,102,714,2,30,1,1,allow
49687,53,13204,53,197,102,95,2,31,1,1,allow
60612,443,17628,443,117190,11380,105810,171,212,67,104,allow
56812,49600,3950,49600,3060,1569,1491,12,16,7,5,allow
61454,443,53913,443,8673,1722,6951,30,125,18,12,allow
35372,443,41929,443,269750,10062,259688,285,152,92,193,allow
51808,443,51808,443,1466,856,610,13,27,6,7,allow
57030,53,12910,53,283,101,182,4,38,2,2,allow
56644,443,53305,443,3079,1895,1184,18,16,10,8,allow
49636,53,5352,53,790,110,680,2,30,1,1,allow
49663,53,41171,53,184,102,82,2,30,1,1,allow
50829,443,2487,443,1445207,43930,1401277,1562,219,556,1006,allow
56190,53,16437,53,196,94,102,2,30,1,1,allow
49603,53,17814,53,766,102,664,2,30,1,1,allow
64620,53,58577,53,166,86,80,2,30,1,1,allow
57319,53,46855,53,353,94,259,2,30,1,1,allow
56799,53,3973,53,353,94,259,2,30,1,1,allow
56633,53,60296,53,197,102,95,2,30,1,1,allow
56380,53,35466,53,177,94,83,2,30,1,1,allow
65007,53,25899,53,165,86,79,2,30,1,1,allow
16403,16386,26193,16386,308,128,180,6,30,3,3,allow
47463,53,25330,53,167,78,89,2,30,1,1,allow
51150,53,51368,53,167,78,89,2,30,1,1,allow
55336,53,18020,53,308,94,214,2,30,1,1,allow
49708,53,2580,53,177,94,83,2,30,1,1,allow
55027,53,18719,53,168,86,82,2,30,1,1,allow
49837,53,16345,53,214,110,104,2,30,1,1,allow
50082,53,51299,53,199,94,105,2,30,1,1,allow
58852,443,26155,443,3723,1793,1930,21,69,10,11,allow
57617,53,32772,53,164,78,86,2,30,1,1,allow
45103,80,17939,80,1748,716,1032,19,409,6,13,allow
49513,53,36009,53,200,102,98,2,30,1,1,allow
27005,32036,64099,32036,876,126,750,2,31,1,1,allow
27005,33086,32717,33086,877,126,751,2,31,1,1,allow
6881,32056,50769,32056,509,150,359,2,1199,1,1,allow
56989,53,15263,53,152,78,74,2,30,1,1,allow
39094,443,9909,443,350650,19028,331622,494,83,251,243,allow
57018,53,57758,53,177,94,83,2,30,1,1,allow
49714,53,21823,53,767,102,665,2,30,1,1,allow
56227,53,19451,53,194,102,92,2,30,1,1,allow
55534,53,6633,53,86,86,0,1,30,1,0,allow
56950,53,53864,53,183,94,89,2,30,1,1,allow
50108,53,30433,53,969,86,883,2,30,1,1,allow
55675,53,24009,53,195,102,93,2,30,1,1,allow
64804,53,26105,53,182,102,80,2,30,1,1,allow
56512,53,17535,53,166,86,80,2,30,1,1,allow
65143,53,18193,53,184,94,90,2,30,1,1,allow
56728,53,16534,53,166,86,80,2,30,1,1,allow
64257,53,2954,53,168,86,82,2,30,1,1,allow
49316,53,24928,53,184,94,90,2,31,1,1,allow
57157,53,38785,53,173,94,79,2,30,1,1,allow
50213,53,31929,53,774,102,672,2,30,1,1,allow
56266,53,40991,53,166,86,80,2,31,1,1,allow
56183,53,29912,53,179,94,85,2,31,1,1,allow
55902,53,8610,53,181,94,87,2,31,1,1,allow
49825,53,30889,53,336,110,226,2,31,1,1,allow
56041,53,39211,53,185,102,83,2,31,1,1,allow
27005,32038,32589,32038,868,126,742,2,31,1,1,allow
57018,53,23896,53,177,94,83,2,31,1,1,allow
65143,53,4098,53,184,94,90,2,31,1,1,allow
27005,50019,8990,50019,877,126,751,2,31,1,1,allow
60813,443,34578,443,658,140,518,10,3632,3,7,allow
60027,443,59128,443,25215,5119,20096,55,144,26,29,allow
65122,443,26133,443,5500,1277,4223,17,180,8,9,allow
56710,53,40167,53,195,102,93,2,31,1,1,allow
65235,53,33492,53,209,110,99,2,31,1,1,allow
64332,53,56454,53,195,102,93,2,31,1,1,allow
56728,53,8699,53,166,86,80,2,31,1,1,allow
55325,53,11184,53,210,110,100,2,31,1,1,allow
43560,443,3098,443,8964,2125,6839,34,120,18,16,allow
57470,49294,38558,49294,132,132,0,3,1199,3,0,allow
57470,44046,49985,44046,166,166,0,1,1199,1,0,allow
57470,44172,25895,44172,353,166,187,2,1199,1,1,allow
52936,5228,12223,5228,9201,2130,7071,41,5528,21,20,allow
27005,33084,40774,33084,906,126,780,2,31,1,1,allow
55237,53,51535,53,259,87,172,4,56,2,2,allow
56633,53,46953,53,342,99,243,4,32,2,2,allow
63814,12906,14738,12906,70,70,0,1,5,1,0,allow
56308,53,53406,53,700,282,418,8,81,4,4,allow
27005,32056,54567,32056,886,126,760,2,31,1,1,allow
63813,53455,10491,53455,70,70,0,1,5,1,0,allow
49225,443,49225,443,854266,56622,797644,969,98,420,549,allow
54706,443,10559,443,5612,1051,4561,20,16,11,9,allow
56928,53,11160,53,178,94,84,2,31,1,1,allow
55431,53,1200,53,196,102,94,2,31,1,1,allow
55179,53,2667,53,178,94,84,2,31,1,1,allow
64381,53,50743,53,198,102,96,2,31,1,1,allow
60292,8630,2625,8630,324,250,74,5,3605,4,1,allow
48941,443,29294,443,7437,2128,5309,22,33,13,9,allow
53654,8100,3351,8100,70,70,0,2,8,2,0,allow
53641,16605,52302,16605,70,70,0,1,5,1,0,allow
50017,53,24863,53,300,97,203,4,36,2,2,allow
56391,443,8649,443,13706,5958,7748,78,202,42,36,allow
55174,445,0,0,70,70,0,1,0,1,0,drop
60117,445,0,0,70,70,0,1,0,1,0,drop
60115,445,0,0,70,70,0,1,0,1,0,drop
10216,11392,0,0,66,66,0,1,0,1,0,deny
41447,64147,0,0,62,62,0,1,0,1,0,deny
55172,445,0,0,70,70,0,1,0,1,0,drop
24838,39828,0,0,60,60,0,1,0,1,0,deny
14309,56205,0,0,146,146,0,1,0,1,0,deny
55502,445,0,0,66,66,0,1,0,1,0,drop
55498,445,0,0,66,66,0,1,0,1,0,drop
60106,445,0,0,70,70,0,1,0,1,0,drop
56578,64147,0,0,66,66,0,1,0,1,0,deny
53156,35993,0,0,66,66,0,1,0,1,0,deny
52563,17235,0,0,74,74,0,1,0,1,0,deny
60102,445,0,0,70,70,0,1,0,1,0,drop
60099,445,0,0,70,70,0,1,0,1,0,drop
60096,445,0,0,70,70,0,1,0,1,0,drop
55165,445,0,0,70,70,0,1,0,1,0,drop
55497,445,0,0,66,66,0,1,0,1,0,drop
53020,61903,0,0,159,159,0,1,0,1,0,deny
55163,445,0,0,70,70,0,1,0,1,0,drop
3436,46783,0,0,62,62,0,1,0,1,0,deny
64240,50584,0,0,62,62,0,1,0,1,0,deny
55162,445,0,0,70,70,0,1,0,1,0,drop
55161,445,0,0,70,70,0,1,0,1,0,drop
60093,445,0,0,70,70,0,1,0,1,0,drop
55160,445,0,0,70,70,0,1,0,1,0,drop
55158,445,0,0,70,70,0,1,0,1,0,drop
55156,445,0,0,70,70,0,1,0,1,0,drop
19632,37965,0,0,62,62,0,1,0,1,0,deny
1035,26467,0,0,62,62,0,1,0,1,0,deny
60084,445,0,0,70,70,0,1,0,1,0,drop
60086,445,0,0,70,70,0,1,0,1,0,drop
51424,30188,0,0,62,62,0,1,0,1,0,deny
55489,445,0,0,66,66,0,1,0,1,0,drop
55485,445,0,0,66,66,0,1,0,1,0,drop
55484,445,0,0,66,66,0,1,0,1,0,drop
55481,445,0,0,66,66,0,1,0,1,0,drop
542,46783,0,0,62,62,0,1,0,1,0,deny
63814,81,0,0,60,60,0,1,0,1,0,deny
6881,6881,0,0,146,146,0,1,0,1,0,deny
55478,445,0,0,66,66,0,1,0,1,0,drop
38338,443,60739,443,499,425,74,4,0,3,1,allow
53853,443,38658,443,499,425,74,4,0,3,1,allow
53852,443,26865,443,499,425,74,4,0,3,1,allow
38337,443,4269,443,499,425,74,4,1,3,1,allow
55479,445,0,0,66,66,0,1,0,1,0,drop
55476,445,0,0,66,66,0,1,0,1,0,drop
55142,445,0,0,70,70,0,1,0,1,0,drop
55141,445,0,0,70,70,0,1,0,1,0,drop
55137,445,0,0,70,70,0,1,0,1,0,drop
2440,37807,0,0,66,66,0,1,0,1,0,deny
64940,26467,0,0,62,62,0,1,0,1,0,deny
55132,445,0,0,70,70,0,1,0,1,0,drop
55131,445,0,0,70,70,0,1,0,1,0,drop
58687,12883,0,0,143,143,0,1,0,1,0,deny
60079,445,0,0,70,70,0,1,0,1,0,drop
60077,445,0,0,70,70,0,1,0,1,0,drop
60076,445,0,0,70,70,0,1,0,1,0,drop
21844,50584,0,0,146,146,0,1,0,1,0,deny
55473,445,0,0,66,66,0,1,0,1,0,drop
60075,445,0,0,70,70,0,1,0,1,0,drop
32424,50584,0,0,146,146,0,1,0,1,0,deny
58286,37965,0,0,66,66,0,1,0,1,0,deny
55470,445,0,0,66,66,0,1,0,1,0,drop
52699,26467,0,0,62,62,0,1,0,1,0,deny
55469,445,0,0,66,66,0,1,0,1,0,drop
43916,21,0,0,60,60,0,1,0,1,0,deny
55466,445,0,0,66,66,0,1,0,1,0,drop
55120,445,0,0,70,70,0,1,0,1,0,drop
45964,5333,0,0,60,60,0,1,0,1,0,deny
26851,59858,0,0,146,146,0,1,0,1,0,deny
57853,64147,0,0,62,62,0,1,0,1,0,deny
23531,31573,0,0,146,146,0,1,0,1,0,deny
55968,56205,0,0,66,66,0,1,0,1,0,deny
60074,445,0,0,70,70,0,1,0,1,0,drop
60064,445,0,0,70,70,0,1,0,1,0,drop
60059,445,0,0,70,70,0,1,0,1,0,drop
443,10010,0,0,60,60,0,1,0,1,0,deny
44098,1433,0,0,60,60,0,1,0,1,0,deny
55116,445,0,0,70,70,0,1,0,1,0,drop
51172,44847,0,0,66,66,0,1,0,1,0,deny
55454,445,0,0,66,66,0,1,0,1,0,drop
47814,51505,0,0,66,66,0,1,0,1,0,deny
55106,445,0,0,70,70,0,1,0,1,0,drop
55107,445,0,0,70,70,0,1,0,1,0,drop
55102,445,0,0,70,70,0,1,0,1,0,drop
55101,445,0,0,70,70,0,1,0,1,0,drop
59459,37807,0,0,66,66,0,1,0,1,0,deny
55099,445,0,0,70,70,0,1,0,1,0,drop
6666,2222,0,0,60,60,0,1,0,1,0,deny
55447,445,0,0,66,66,0,1,0,1,0,drop
60048,445,0,0,70,70,0,1,0,1,0,drop
17027,1,0,0,62,62,0,1,0,1,0,deny
0,0,0,0,320,320,0,5,0,5,0,allow
0,0,0,0,70,70,0,1,0,1,0,deny
57131,7774,0,0,145,145,0,1,0,1,0,deny
50624,26467,0,0,66,66,0,1,0,1,0,deny
55445,445,0,0,66,66,0,1,0,1,0,drop
60133,1,0,0,62,62,0,1,0,1,0,deny
55093,445,0,0,70,70,0,1,0,1,0,drop
63956,44512,0,0,145,145,0,1,0,1,0,deny
55437,445,0,0,66,66,0,1,0,1,0,drop
56966,35440,0,0,62,62,0,1,0,1,0,deny
55427,445,0,0,66,66,0,1,0,1,0,drop
57943,1433,0,0,60,60,0,1,0,1,0,deny
55086,445,0,0,70,70,0,1,0,1,0,drop
55084,445,0,0,70,70,0,1,0,1,0,drop
1025,35447,0,0,62,62,0,1,0,1,0,deny
19875,30170,0,0,145,145,0,1,0,1,0,deny
52618,23718,0,0,146,146,0,1,0,1,0,deny
42034,28189,0,0,145,145,0,1,0,1,0,deny
55079,445,0,0,70,70,0,1,0,1,0,drop
26048,21,0,0,60,60,0,1,0,1,0,deny
60038,445,0,0,70,70,0,1,0,1,0,drop
60036,445,0,0,70,70,0,1,0,1,0,drop
60035,445,0,0,70,70,0,1,0,1,0,drop
55078,445,0,0,70,70,0,1,0,1,0,drop
55422,445,0,0,66,66,0,1,0,1,0,drop
55419,445,0,0,66,66,0,1,0,1,0,drop
55417,445,0,0,66,66,0,1,0,1,0,drop
55416,445,0,0,66,66,0,1,0,1,0,drop
55420,445,0,0,66,66,0,1,0,1,0,drop
55421,445,0,0,66,66,0,1,0,1,0,drop
55418,445,0,0,66,66,0,1,0,1,0,drop
55415,445,0,0,66,66,0,1,0,1,0,drop
50419,26467,0,0,62,62,0,1,0,1,0,deny
59833,48817,0,0,107,107,0,1,0,1,0,deny
62649,48817,0,0,148,148,0,1,0,1,0,deny
20894,51505,0,0,62,62,0,1,0,1,0,deny
45941,23386,0,0,60,60,0,1,0,1,0,deny
1663,30188,0,0,66,66,0,1,0,1,0,deny
51823,15843,53132,15843,66,66,0,2,9,2,0,allow
51822,12637,54729,12637,136,136,0,3,14,3,0,allow
50409,53,47032,53,731,85,646,2,30,1,1,allow
55771,80,55771,80,3538,701,2837,11,20,6,5,allow
55002,80,41422,80,10872190,337459,10534731,12500,208,5532,6968,allow
59985,443,16838,443,25649,1485,24164,36,144,14,22,allow
34628,443,42980,443,6392,1025,5367,18,27,9,9,allow
45119,15000,61352,15000,130,70,60,2,5,1,1,allow
53640,28937,28393,28937,70,70,0,1,5,1,0,allow
43972,80,64832,80,1894,1520,374,15,15,9,6,allow
49420,443,13090,443,5241,1194,4047,19,40,9,10,allow
48272,15000,32471,15000,130,70,60,2,5,1,1,allow
61412,443,58094,443,4934,771,4163,18,28,8,10,allow
34625,443,10799,443,6393,1025,5368,18,27,9,9,allow
60039,80,53912,80,3431,2292,1139,17,142,10,7,allow
60053,443,33088,443,3190,1599,1591,17,142,9,8,allow
60023,443,8218,443,9660,4678,4982,30,144,15,15,allow
56710,53,43417,53,190,97,93,2,31,1,1,allow
65143,53,7897,53,184,94,90,2,30,1,1,allow
56811,44008,31634,44008,3034,1547,1487,12,16,7,5,allow
53126,47035,16520,47035,70,70,0,2,8,2,0,allow
61413,443,10754,443,4933,771,4162,18,28,8,10,allow
49921,53,38148,53,212,108,104,2,31,1,1,allow
10077,443,21308,443,10940,4625,6315,36,347,19,17,allow
57394,53,16872,53,186,95,91,2,31,1,1,allow
54962,53,32571,53,188,96,92,2,30,1,1,allow
50311,80,32414,80,366,180,186,7,57,4,3,allow
55656,53,20503,53,760,96,664,2,30,1,1,allow
64381,53,47350,53,196,100,96,2,30,1,1,allow
51615,15000,33004,15000,130,70,60,2,5,1,1,allow
58172,443,58172,443,4526,1619,2907,19,26,11,8,allow
47165,15000,50664,15000,130,70,60,2,5,1,1,allow
61423,443,8022,443,1113,589,524,12,28,6,6,allow
60051,80,25182,80,1327,839,488,10,142,6,4,allow
60418,39537,10622,39537,70,70,0,1,5,1,0,allow
50403,8080,50403,8080,2203,575,1628,10,15,6,4,allow
53835,15000,42611,15000,130,70,60,2,5,1,1,allow
52544,443,52544,443,4487,1580,2907,19,26,11,8,allow
59983,80,41468,80,1745,779,966,12,144,7,5,allow
55484,53,28906,53,711,87,624,2,30,1,1,allow
59997,443,62198,443,3063,1395,1668,16,144,8,8,allow
60022,443,54871,443,4962,2551,2411,19,144,10,9,allow
56548,53,6954,53,198,101,97,2,31,1,1,allow
56728,53,35265,53,164,84,80,2,31,1,1,allow
56183,53,46991,53,174,89,85,2,31,1,1,allow
61431,443,2753,443,1401,940,461,11,28,7,4,allow
47088,15000,21651,15000,138,78,60,2,6,1,1,allow
41543,443,50786,443,78,78,0,1,5,1,0,allow
61424,443,36108,443,1119,589,530,12,28,6,6,allow
60049,443,36353,443,23967,5983,17984,40,142,17,23,allow
59999,443,56048,443,3047,1277,1770,16,144,8,8,allow
52028,53,0,0,354,81,273,2,30,1,1,allow
55580,53,22194,53,788,108,680,2,30,1,1,allow
60012,443,29771,443,6438,2599,3839,21,144,10,11,allow
57005,53,24332,53,762,98,664,2,30,1,1,allow
56262,53,49362,53,701,88,613,2,30,1,1,allow
60000,443,1189,443,34450,1943,32507,47,144,16,31,allow
49995,53,4642,53,99,99,0,1,30,1,0,allow
36453,443,24873,443,7298,2661,4637,21,18,11,10,allow
50310,80,55858,80,7979,802,7177,17,57,8,9,allow
52606,53,0,0,223,91,132,2,30,1,1,allow
55431,53,28791,53,192,98,94,2,30,1,1,allow
56928,53,33620,53,172,88,84,2,30,1,1,allow
57018,53,1950,53,170,87,83,2,30,1,1,allow
64790,53,30667,53,182,93,89,2,30,1,1,allow
57281,53,42469,53,172,88,84,2,30,1,1,allow
55534,53,23781,53,168,86,82,2,30,1,1,allow
57246,53,53043,53,182,93,89,2,31,1,1,allow
56767,53,17852,53,170,87,83,2,31,1,1,allow
59093,53,0,0,215,77,138,2,31,1,1,allow
65304,53,2754,53,202,103,99,2,31,1,1,allow
51909,443,57663,443,8801,2032,6769,28,361,14,14,allow
56562,53,8442,53,726,85,641,2,30,1,1,allow
56914,53,41623,53,731,85,646,2,30,1,1,allow
55666,53,48851,53,728,96,632,2,30,1,1,allow
64582,53,25024,53,202,103,99,2,30,1,1,allow
55994,53,14780,53,182,93,89,2,30,1,1,allow
57263,53,62100,53,166,85,81,2,30,1,1,allow
55205,53,36429,53,166,85,81,2,31,1,1,allow
49547,53,1649,53,186,95,91,2,31,1,1,allow
49242,53,7199,53,166,85,81,2,31,1,1,allow
28176,34021,0,0,66,66,0,1,90,1,0,allow
57470,6881,10120,6881,163,163,0,1,1200,1,0,allow
60814,443,39150,443,740,222,518,11,3631,4,7,allow
55199,53,58104,53,212,108,104,2,30,1,1,allow
59352,53,59352,53,283,114,169,2,31,1,1,allow
49707,53,0,0,82,82,0,1,31,1,0,allow
44967,53,51774,53,198,93,105,2,31,1,1,allow
49806,53,49806,53,229,89,140,2,31,1,1,allow
38910,53,21140,53,198,93,105,2,31,1,1,allow
64016,53,9177,53,93,93,0,1,31,1,0,allow
27005,30007,41112,30007,890,126,764,2,31,1,1,allow
55440,53,49182,53,752,93,659,2,31,1,1,allow
64074,53,3754,53,202,103,99,2,31,1,1,allow
64678,53,7690,53,758,93,665,2,31,1,1,allow
56729,53,56729,53,229,89,140,2,31,1,1,allow
50201,53,18513,53,751,95,656,2,31,1,1,allow
55937,53,44427,53,758,93,665,2,31,1,1,allow
55489,53,54406,53,186,95,91,2,31,1,1,allow
64761,53,64761,53,220,100,120,2,31,1,1,allow
55271,53,61756,53,751,95,656,2,31,1,1,allow
47787,53,24914,53,198,93,105,2,31,1,1,allow
56396,53,44233,53,182,93,89,2,31,1,1,allow
52377,53,52377,53,229,89,140,2,31,1,1,allow
41713,443,59804,443,61983,10061,51922,85,130,35,50,allow
20624,53,20624,53,229,89,140,2,31,1,1,allow
43927,443,42119,443,3410,1249,2161,16,136,8,8,allow
57470,16721,16664,16721,163,163,0,1,1200,1,0,allow
57146,53,31700,53,198,101,97,2,31,1,1,allow
64820,53,13245,53,190,97,93,2,31,1,1,allow
57346,53,4986,53,204,104,100,2,31,1,1,allow
27005,30006,32139,30006,890,126,764,3,31,2,1,allow
49157,53,49157,53,229,89,140,2,31,1,1,allow
39029,53,55192,53,198,93,105,2,31,1,1,allow
56487,53,29660,53,778,103,675,2,31,1,1,allow
59583,53,59583,53,229,89,140,2,31,1,1,allow
50298,443,51193,443,11984,6772,5212,52,222,30,22,allow
49334,53,23056,53,184,94,90,2,31,1,1,allow
57470,42329,52817,42329,1782,1782,0,28,1559,28,0,allow
59444,53,35195,53,489,114,375,2,31,1,1,allow
40159,53,40159,53,229,89,140,2,31,1,1,allow
55855,53,55855,53,221,89,132,2,31,1,1,allow
54786,30188,0,0,66,66,0,1,0,1,0,deny
46573,50584,0,0,62,62,0,1,0,1,0,deny
55074,445,0,0,70,70,0,1,0,1,0,drop
26502,64147,0,0,62,62,0,1,0,1,0,deny
443,3846,0,0,100,100,0,1,0,1,0,deny
47457,41615,0,0,145,145,0,1,0,1,0,deny
39313,37965,0,0,62,62,0,1,0,1,0,deny
26408,64147,0,0,66,66,0,1,0,1,0,deny
25536,50584,0,0,146,146,0,1,0,1,0,deny
36080,26467,0,0,62,62,0,1,0,1,0,deny
55072,445,0,0,70,70,0,1,0,1,0,drop
60026,445,0,0,70,70,0,1,0,1,0,drop
60021,445,0,0,70,70,0,1,0,1,0,drop
60019,445,0,0,70,70,0,1,0,1,0,drop
55401,445,0,0,66,66,0,1,0,1,0,drop
55402,445,0,0,66,66,0,1,0,1,0,drop
55400,445,0,0,66,66,0,1,0,1,0,drop
60018,445,0,0,70,70,0,1,0,1,0,drop
60073,80,45095,80,10676,6719,3957,23,141,12,11,allow
49767,53,52894,53,727,86,641,2,30,1,1,allow
38591,53,55685,53,391,102,289,2,30,1,1,allow
55325,53,50233,53,210,110,100,2,30,1,1,allow
57263,53,12000,53,167,86,81,2,30,1,1,allow
55489,53,32012,53,193,102,91,2,30,1,1,allow
60611,443,2263,443,478331,21023,457308,573,211,201,372,allow
61419,443,15902,443,6661,862,5799,18,28,9,9,allow
50324,80,23988,80,1083,653,430,8,15,5,3,allow
59982,80,63868,80,207418,4580,202838,194,143,50,144,allow
55600,53,57524,53,184,94,90,2,30,1,1,allow
50820,443,64516,443,2760048,78471,2681577,2863,250,962,1901,allow
60610,443,53274,443,187258,9720,177538,225,211,86,139,allow
55485,53,64726,53,212,102,110,2,30,1,1,allow
59324,53,10357,53,211,78,133,2,30,1,1,allow
54962,53,15807,53,194,102,92,2,30,1,1,allow
49226,443,49226,443,118943,24432,94511,156,96,79,77,allow
50688,5222,17560,5222,622,284,338,10,29,5,5,allow
63819,18445,34551,18445,70,70,0,1,4,1,0,allow
63820,27441,46760,27441,70,70,0,1,4,1,0,allow
44792,80,52125,80,1295,781,514,12,16,6,6,allow
56767,53,58838,53,177,94,83,2,30,1,1,allow
63817,50808,64390,50808,70,70,0,1,4,1,0,allow
63816,2073,59297,2073,70,70,0,1,4,1,0,allow
59944,80,15920,80,1052,612,440,10,15,5,5,allow
50826,443,44270,443,820870,30523,790347,918,218,337,581,allow
54705,443,23468,443,5411,851,4560,17,15,8,9,allow
60417,55100,62868,55100,164,70,94,2,5,1,1,allow
49513,53,63183,53,200,102,98,2,29,1,1,allow
55431,53,52036,53,196,102,94,2,29,1,1,allow
59878,53,26296,53,391,102,289,2,29,1,1,allow
65037,53,26531,53,210,110,100,2,29,1,1,allow
62330,443,31152,443,21361086,218978,21142108,16512,170,2203,14309,allow
49498,53,63118,53,734,94,640,2,29,1,1,allow
59010,53,59010,53,832,106,726,2,29,1,1,allow
39095,443,56882,443,310402,12194,298208,374,82,157,217,allow
56227,53,39156,53,194,102,92,2,30,1,1,allow
64592,53,58811,53,209,110,99,2,30,1,1,allow
56512,53,8579,53,166,86,80,2,29,1,1,allow
61420,443,13668,443,6327,1143,5184,18,28,9,9,allow
36785,443,22172,443,1799,1224,575,13,26,8,5,allow
57362,53,38084,53,177,94,83,2,30,1,1,allow
65304,53,18529,53,209,110,99,2,30,1,1,allow
56183,53,22164,53,179,94,85,2,30,1,1,allow
56710,53,13287,53,195,102,93,2,30,1,1,allow
57394,53,63615,53,193,102,91,2,30,1,1,allow
55199,53,63151,53,214,110,104,2,30,1,1,allow
50226,80,43900,80,9659,1454,8205,28,278,13,15,allow
51840,34678,2661,34678,70,70,0,2,8,2,0,allow
51824,53021,25345,53021,66,66,0,2,8,2,0,allow
61417,443,31390,443,4890,1219,3671,17,28,10,7,allow
61414,443,14574,443,5020,860,4160,18,28,9,9,allow
60033,443,16938,443,2845,1765,1080,15,142,8,7,allow
60045,80,49980,80,1455,965,490,10,142,6,4,allow
55410,53,52970,53,212,102,110,2,30,1,1,allow
54962,53,25167,53,194,102,92,2,30,1,1,allow
60095,443,60308,443,2357,1467,890,15,140,8,7,allow
56606,443,53334,443,9679,1633,8046,25,20,14,11,allow
59991,443,45209,443,5108,2834,2274,21,143,10,11,allow
60543,53,6634,53,211,78,133,2,30,1,1,allow
38639,80,55224,80,1013,504,509,10,15,6,4,allow
36786,443,50412,443,1798,1223,575,13,26,8,5,allow
60091,443,19389,443,2531,1288,1243,17,140,9,8,allow
55655,53,4325,53,524,214,310,6,57,3,3,allow
60061,443,58385,443,3195,1426,1769,15,141,8,7,allow
60011,443,19677,443,8413,3768,4645,25,143,12,13,allow
60063,443,64614,443,432803,9264,423539,427,141,135,292,allow
49991,53,12205,53,198,102,96,2,30,1,1,allow
60007,443,50307,443,2798,1652,1146,15,143,8,7,allow
64854,53,12372,53,1431,101,1330,4,50,2,2,allow
63811,80,47846,80,314,192,122,6,15,4,2,allow
55772,53,24055,53,269,110,159,2,30,1,1,allow
55771,53,21538,53,283,98,185,4,52,2,2,allow
49316,53,61603,53,184,94,90,2,30,1,1,allow
65446,53,11171,53,168,86,82,2,30,1,1,allow
57362,53,3531,53,177,94,83,2,30,1,1,allow
55027,53,65292,53,343,86,257,4,58,2,2,allow
65206,53,46359,53,167,86,81,2,30,1,1,allow
57281,53,14335,53,178,94,84,2,30,1,1,allow
57685,53,47518,53,275,86,189,2,30,1,1,allow
56767,53,32268,53,177,94,83,2,30,1,1,allow
56511,53,32498,53,200,102,98,2,30,1,1,allow
61700,53,0,0,202,86,116,2,30,1,1,allow
50067,53,31624,53,177,94,83,2,30,1,1,allow
64381,53,26257,53,198,102,96,2,30,1,1,allow
64582,53,17757,53,209,110,99,2,30,1,1,allow
55450,53,2536,53,102,102,0,1,30,1,0,allow
55475,53,23006,53,784,94,690,2,30,1,1,allow
47370,443,20985,443,350,210,140,6,75,4,2,allow
50315,80,20802,80,1030,310,720,11,56,6,5,allow
34331,443,8773,443,1717,1153,564,13,26,7,6,allow
34330,443,44282,443,1717,1153,564,13,26,7,6,allow
60055,443,24328,443,2314,1232,1082,15,141,8,7,allow
60065,443,12163,443,6395,2524,3871,18,141,10,8,allow
60367,443,45021,443,4847,963,3884,22,63,11,11,allow
60605,53,5384,53,275,86,189,2,30,1,1,allow
56533,53,11547,53,498,204,294,6,30,3,3,allow
56266,53,53849,53,182,102,80,2,30,1,1,allow
55199,53,8107,53,214,110,104,2,30,1,1,allow
56809,53,37625,53,167,86,81,2,30,1,1,allow
61411,443,46300,443,4775,894,3881,18,28,10,8,allow
60085,443,22950,443,1000,557,443,11,141,6,5,allow
60047,80,39100,80,2634,1780,854,14,142,8,6,allow
60067,443,11544,443,14085,1879,12206,27,141,12,15,allow
60003,443,18889,443,32538,7037,25501,49,143,20,29,allow
60060,443,7904,443,4648,1505,3143,17,141,9,8,allow
57281,53,55108,53,178,94,84,2,30,1,1,allow
49601,53,30637,53,178,94,84,2,30,1,1,allow
65235,53,42179,53,209,110,99,2,30,1,1,allow
16225,443,41335,443,13126,5105,8021,37,31,21,16,allow
64381,53,3642,53,198,102,96,2,30,1,1,allow
64934,53,64886,53,197,102,95,2,30,1,1,allow
64790,53,41786,53,183,94,89,2,30,1,1,allow
65087,53,12187,53,413,170,243,6,30,3,3,allow
65206,53,7977,53,167,86,81,2,30,1,1,allow
57246,53,12592,53,183,94,89,2,30,1,1,allow
65073,53,7816,53,195,102,93,2,30,1,1,allow
61433,443,18649,443,7796,766,7030,16,27,8,8,allow
55076,80,31296,80,1129,580,549,11,74,6,5,allow
61407,443,5972,443,6248,829,5419,17,29,9,8,allow
40432,443,35104,443,12022,2731,9291,53,20,26,27,allow
50928,443,1946,443,3347,2025,1322,31,34,18,13,allow
57030,53,42325,53,283,101,182,4,37,2,2,allow
39096,443,59336,443,1268772,32833,1235939,1288,81,409,879,allow
60019,443,11836,443,76774,9184,67590,104,143,41,63,allow
53234,443,19776,443,21571,8604,12967,38,34,19,19,allow
60088,443,5059,443,1000,557,443,11,141,6,5,allow
60727,443,60727,443,2169,1158,1011,20,15,11,9,allow
34332,443,1542,443,1717,1153,564,13,26,7,6,allow
60089,443,5576,443,1000,557,443,11,141,6,5,allow
63818,19291,22268,19291,70,70,0,1,4,1,0,allow
60093,443,46965,443,2090,1218,872,15,140,8,7,allow
60043,443,26610,443,1015,572,443,11,142,6,5,allow
60014,443,60627,443,4275,1488,2787,17,143,9,8,allow
55050,80,49586,80,246,120,126,5,15,3,2,allow
50309,80,22924,80,2481,723,1758,12,57,6,6,allow
50307,80,42606,80,3179,863,2316,13,57,7,6,allow
38640,80,6468,80,1013,504,509,10,15,6,4,allow
60069,443,38195,443,3045,1340,1705,16,141,8,8,allow
63808,40608,41042,40608,504,382,122,8,15,6,2,allow
60006,80,32015,80,1836,816,1020,12,143,7,5,allow
60890,443,40246,443,15081,6817,8264,31,34,14,17,allow
56196,53,30280,53,214,110,104,2,29,1,1,allow
60075,443,54321,443,6300,1427,4873,20,141,9,11,allow
55534,53,10719,53,168,86,82,2,29,1,1,allow
56380,53,36495,53,177,94,83,2,30,1,1,allow
49991,53,8139,53,198,102,96,2,30,1,1,allow
49936,53,39032,53,216,110,106,2,29,1,1,allow
56000,53,18353,53,177,94,83,2,29,1,1,allow
57157,53,8214,53,165,86,79,2,30,1,1,allow
49206,53,41774,53,301,89,212,4,48,2,2,allow
64598,53,18969,53,222,94,128,2,29,1,1,allow
55497,53,23337,53,184,102,82,2,29,1,1,allow
64053,53,35360,53,193,102,91,2,29,1,1,allow
64766,53,47744,53,214,110,104,2,29,1,1,allow
64053,53,10506,53,193,102,91,2,30,1,1,allow
65037,53,16035,53,210,110,100,2,29,1,1,allow
49601,53,44219,53,178,94,84,2,30,1,1,allow
64484,53,57722,53,168,86,82,2,30,1,1,allow
65037,53,41367,53,210,110,100,2,29,1,1,allow
57246,53,9725,53,183,94,89,2,30,1,1,allow
49157,53,42050,53,184,94,90,2,29,1,1,allow
55179,53,31015,53,178,94,84,2,30,1,1,allow
56548,53,18583,53,199,102,97,2,30,1,1,allow
64053,53,26364,53,193,102,91,2,30,1,1,allow
55994,53,14095,53,183,94,89,2,30,1,1,allow
65446,53,2812,53,184,102,82,2,30,1,1,allow
49730,53,34658,53,194,102,92,2,30,1,1,allow
57281,53,33051,53,178,94,84,2,30,1,1,allow
64582,53,29517,53,209,110,99,2,30,1,1,allow
49157,53,54699,53,184,94,90,2,30,1,1,allow
56629,53,37533,53,177,94,83,2,30,1,1,allow
49547,53,49951,53,193,102,91,2,30,1,1,allow
55205,53,50575,53,167,86,81,2,30,1,1,allow
64587,53,36595,53,167,86,81,2,31,1,1,allow
41085,443,36619,443,5553,1055,4498,19,121,9,10,allow
57470,44919,55339,44919,166,166,0,1,1199,1,0,allow
49921,53,27368,53,214,110,104,2,30,1,1,allow
57193,53,40448,53,229,110,119,2,30,1,1,allow
49730,53,40205,53,194,102,92,2,30,1,1,allow
49921,53,58309,53,214,110,104,2,30,1,1,allow
57263,53,19540,53,167,86,81,2,30,1,1,allow
55205,53,56363,53,167,86,81,2,30,1,1,allow
50034,53,15680,53,179,94,85,2,30,1,1,allow
55889,53,7976,53,168,86,82,2,30,1,1,allow
60542,53,46573,53,260,86,174,2,30,1,1,allow
10151,6881,7271,6881,490,150,340,2,1200,1,1,allow
61434,443,24839,443,8005,830,7175,19,27,9,10,allow
58600,53,58600,53,217,82,135,2,32,1,1,allow
60083,443,30237,443,490571,27526,463045,511,141,170,341,allow
60015,443,28429,443,6340,3788,2552,21,143,10,11,allow
60029,443,40871,443,1057,590,467,11,142,6,5,allow
60010,443,42426,443,4795,2875,1920,19,143,10,9,allow
55001,80,28763,80,9249354,297929,8951425,10789,208,4872,5917,allow
60898,443,32262,443,10104,1643,8461,28,46,15,13,allow
56609,443,13546,443,11061,1566,9495,25,19,13,12,allow
55250,443,44147,443,1271,918,353,9,15,6,3,allow
56511,53,50821,53,200,102,98,2,30,1,1,allow
55325,53,2560,53,210,110,100,2,30,1,1,allow
50067,53,8496,53,177,94,83,2,30,1,1,allow
57346,53,32731,53,210,110,100,2,30,1,1,allow
56548,53,28244,53,199,102,97,2,31,1,1,allow
56343,53,58460,53,194,102,92,2,31,1,1,allow
35888,443,35888,443,4481,1574,2907,19,26,11,8,allow
60416,55998,54141,55998,70,70,0,1,5,1,0,allow
60037,443,65363,443,4722,2945,1777,18,142,10,8,allow
50299,80,31739,80,2316,1206,1110,16,81,9,7,allow
33252,443,7874,443,89817,21083,68734,148,36,77,71,allow
55902,53,58638,53,181,94,87,2,30,1,1,allow
64582,53,64118,53,209,110,99,2,30,1,1,allow
55600,53,36294,53,184,94,90,2,30,1,1,allow
50034,53,21368,53,179,94,85,2,30,1,1,allow
55165,53,15099,53,199,102,97,2,30,1,1,allow
56090,53,62587,53,195,94,101,2,30,1,1,allow
56809,53,9821,53,167,86,81,2,30,1,1,allow
56511,53,55404,53,200,102,98,2,30,1,1,allow
55165,53,30043,53,199,102,97,2,30,1,1,allow
57246,53,49639,53,183,94,89,2,31,1,1,allow
50828,443,8189,443,178483,7778,170705,219,218,90,129,allow
60018,443,59209,443,117023,8825,108198,138,143,49,89,allow
60098,443,41490,443,1011,568,443,11,139,6,5,allow
36781,443,37104,443,1798,1223,575,13,26,8,5,allow
64934,53,51307,53,197,102,95,2,33,1,1,allow
60105,443,39991,443,4856,1587,3269,17,138,9,8,allow
60041,443,53446,443,1015,572,443,11,142,6,5,allow
55623,62853,62347,62853,504,318,186,8,15,5,3,allow
50314,80,10727,80,1030,310,720,11,56,6,5,allow
50317,80,30399,80,5438,2832,2606,18,56,10,8,allow
56608,443,21691,443,10062,1631,8431,25,19,14,11,allow
56413,53,29873,53,233,94,139,2,30,1,1,allow
56710,53,54162,53,355,97,258,4,60,2,2,allow
59925,443,55867,443,10302,3853,6449,27,61,16,11,allow
64820,53,3092,53,195,102,93,2,30,1,1,allow
57029,53,54997,53,413,170,243,6,30,3,3,allow
55266,53,20409,53,365,102,263,2,30,1,1,allow
55662,53,45972,53,212,102,110,2,30,1,1,allow
65304,53,46271,53,209,110,99,2,30,1,1,allow
55889,53,65516,53,168,86,82,2,30,1,1,allow
55179,53,47200,53,178,94,84,2,30,1,1,allow
65096,53,51459,53,216,94,122,2,30,1,1,allow
56629,53,33066,53,177,94,83,2,30,1,1,allow
65143,53,45277,53,184,94,90,2,30,1,1,allow
59323,53,1369,53,260,86,174,2,30,1,1,allow
65229,53,45181,53,195,102,93,2,31,1,1,allow
27005,27056,45270,27056,908,126,782,2,31,1,1,allow
57146,53,33353,53,199,102,97,2,31,1,1,allow
56704,53,8695,53,194,102,92,2,31,1,1,allow
49921,53,21465,53,214,110,104,2,31,1,1,allow
50438,53,15254,53,296,101,195,4,31,2,2,allow
50438,53,44786,53,296,101,195,4,31,2,2,allow
60811,443,53507,443,740,222,518,11,3631,4,7,allow
56767,53,44423,53,177,94,83,2,30,1,1,allow
56183,53,23444,53,179,94,85,2,30,1,1,allow
49513,53,20128,53,391,102,289,4,31,2,2,allow
65241,53,34581,53,198,102,96,2,30,1,1,allow
55955,53,56880,53,184,94,90,2,30,1,1,allow
49334,53,14859,53,184,94,90,2,30,1,1,allow
49265,53,12727,53,181,94,87,2,31,1,1,allow
65437,53,61379,53,195,102,93,2,31,1,1,allow
57394,53,39709,53,193,102,91,2,31,1,1,allow
55955,53,35067,53,184,94,90,2,31,1,1,allow
27005,27055,64070,27055,915,126,789,2,31,1,1,allow
65165,53,21302,53,200,102,98,2,31,1,1,allow
27005,28002,27297,28002,918,126,792,2,31,1,1,allow
65482,53,46055,53,179,94,85,2,31,1,1,allow
27005,27058,26884,27058,908,126,782,2,31,1,1,allow
49334,53,54606,53,184,94,90,2,31,1,1,allow
6881,6881,34489,6881,253,118,135,2,1199,1,1,allow
54644,443,43384,443,4679,3387,1292,18,304,10,8,allow
51835,443,19929,443,48635,5346,43289,83,151,38,45,allow
55902,53,57612,53,181,94,87,2,30,1,1,allow
56396,53,37010,53,183,94,89,2,30,1,1,allow
64074,53,54669,53,209,110,99,2,30,1,1,allow
55071,53,33464,53,177,94,83,2,31,1,1,allow
51221,57522,58823,57522,481,150,331,2,1200,1,1,allow
60759,40010,60253,40010,316,136,180,6,7,3,3,allow
2037,23,2037,23,152,66,86,2,10,1,1,allow
49843,80,51294,80,2901,1805,1096,17,108,13,4,allow
27005,27054,8800,27054,921,126,795,2,31,1,1,allow
27005,26259,57804,26259,889,126,763,2,31,1,1,allow
53534,443,20648,443,7639,1831,5808,29,76,15,14,allow
43314,443,48162,443,6102,782,5320,17,67,8,9,allow
14434,443,32675,443,2556,1470,1086,17,16,8,9,allow
40845,53,40845,53,210,98,112,2,31,1,1,allow
62311,443,60007,443,4778,1121,3657,15,280,8,7,allow
51845,11201,33761,11201,316,136,180,6,6,3,3,allow
49162,53,30620,53,401,94,307,4,32,2,2,allow
55068,445,0,0,70,70,0,1,0,1,0,drop
10701,11392,0,0,62,62,0,1,0,1,0,deny
7892,50584,0,0,62,62,0,1,0,1,0,deny
60015,445,0,0,70,70,0,1,0,1,0,drop
60013,445,0,0,70,70,0,1,0,1,0,drop
60009,445,0,0,70,70,0,1,0,1,0,drop
60004,445,0,0,70,70,0,1,0,1,0,drop
16948,990,0,0,60,60,0,1,0,1,0,deny
50631,23,0,0,60,60,0,1,0,1,0,deny
39548,8696,0,0,60,60,0,1,0,1,0,deny
55053,445,0,0,70,70,0,1,0,1,0,drop
39540,37965,0,0,66,66,0,1,0,1,0,deny
57768,37965,0,0,62,62,0,1,0,1,0,deny
443,62451,0,0,199,199,0,1,0,1,0,deny
63586,46824,0,0,62,62,0,1,0,1,0,deny
59995,445,0,0,70,70,0,1,0,1,0,drop
59998,445,0,0,70,70,0,1,0,1,0,drop
59993,445,0,0,70,70,0,1,0,1,0,drop
55050,445,0,0,70,70,0,1,0,1,0,drop
57564,56205,0,0,66,66,0,1,0,1,0,deny
55045,445,0,0,70,70,0,1,0,1,0,drop
10916,44847,0,0,66,66,0,1,0,1,0,deny
55044,445,0,0,70,70,0,1,0,1,0,drop
60350,51505,0,0,66,66,0,1,0,1,0,deny
52575,22114,0,0,66,66,0,1,0,1,0,deny
49616,30188,0,0,66,66,0,1,0,1,0,deny
55378,445,0,0,66,66,0,1,0,1,0,drop
58264,44847,0,0,66,66,0,1,0,1,0,deny
55042,445,0,0,70,70,0,1,0,1,0,drop
59989,445,0,0,70,70,0,1,0,1,0,drop
59988,445,0,0,70,70,0,1,0,1,0,drop
25469,57470,0,0,62,62,0,1,0,1,0,deny
55374,445,0,0,66,66,0,1,0,1,0,drop
59739,35253,0,0,62,62,0,1,0,1,0,deny
55035,445,0,0,70,70,0,1,0,1,0,drop
55370,445,0,0,66,66,0,1,0,1,0,drop
59977,445,0,0,70,70,0,1,0,1,0,drop
55033,445,0,0,70,70,0,1,0,1,0,drop
53459,37807,0,0,62,62,0,1,0,1,0,deny
59971,445,0,0,70,70,0,1,0,1,0,drop
59968,445,0,0,70,70,0,1,0,1,0,drop
59967,445,0,0,70,70,0,1,0,1,0,drop
55367,445,0,0,66,66,0,1,0,1,0,drop
4300,37838,0,0,146,146,0,1,0,1,0,deny
56582,37965,0,0,66,66,0,1,0,1,0,deny
55032,445,0,0,70,70,0,1,0,1,0,drop
3559,30188,0,0,62,62,0,1,0,1,0,deny
18246,64097,0,0,62,62,0,1,0,1,0,deny
55031,445,0,0,70,70,0,1,0,1,0,drop
55030,445,0,0,70,70,0,1,0,1,0,drop
35163,30188,0,0,66,66,0,1,0,1,0,deny
55921,43890,0,0,62,62,0,1,0,1,0,deny
55027,445,0,0,70,70,0,1,0,1,0,drop
55024,445,0,0,70,70,0,1,0,1,0,drop
59964,445,0,0,70,70,0,1,0,1,0,drop
59937,37965,0,0,66,66,0,1,0,1,0,deny
2918,37965,0,0,62,62,0,1,0,1,0,deny
59960,445,0,0,70,70,0,1,0,1,0,drop
59959,445,0,0,70,70,0,1,0,1,0,drop
59956,445,0,0,70,70,0,1,0,1,0,drop
55361,445,0,0,66,66,0,1,0,1,0,drop
65518,5710,0,0,62,62,0,1,0,1,0,deny
443,45940,0,0,85,85,0,1,0,1,0,deny
55012,445,0,0,70,70,0,1,0,1,0,drop
55011,445,0,0,70,70,0,1,0,1,0,drop
55358,445,0,0,66,66,0,1,0,1,0,drop
55355,445,0,0,66,66,0,1,0,1,0,drop
55352,445,0,0,66,66,0,1,0,1,0,drop
43916,21,0,0,60,60,0,1,0,1,0,deny
58481,37838,0,0,146,146,0,1,0,1,0,deny
55009,445,0,0,70,70,0,1,0,1,0,drop
58338,3369,0,0,60,60,0,1,0,1,0,deny
55001,445,0,0,70,70,0,1,0,1,0,drop
55002,445,0,0,70,70,0,1,0,1,0,drop
55351,445,0,0,66,66,0,1,0,1,0,drop
55350,445,0,0,66,66,0,1,0,1,0,drop
55349,445,0,0,66,66,0,1,0,1,0,drop
11023,51505,0,0,66,66,0,1,0,1,0,deny
61902,22114,0,0,66,66,0,1,0,1,0,deny
35421,30188,0,0,146,146,0,1,0,1,0,deny
33287,57354,0,0,145,145,0,1,0,1,0,deny
49717,57470,0,0,62,62,0,1,0,1,0,deny
59954,445,0,0,70,70,0,1,0,1,0,drop
59952,445,0,0,70,70,0,1,0,1,0,drop
59951,445,0,0,70,70,0,1,0,1,0,drop
44981,57470,0,0,66,66,0,1,0,1,0,deny
55346,445,0,0,66,66,0,1,0,1,0,drop
59947,445,0,0,70,70,0,1,0,1,0,drop
33948,15503,0,0,146,146,0,1,0,1,0,deny
55343,445,0,0,66,66,0,1,0,1,0,drop
49255,44847,0,0,62,62,0,1,0,1,0,deny
55341,445,0,0,66,66,0,1,0,1,0,drop
55339,445,0,0,66,66,0,1,0,1,0,drop
54990,445,0,0,70,70,0,1,0,1,0,drop
48629,63131,0,0,74,74,0,1,0,1,0,deny
55338,445,0,0,66,66,0,1,0,1,0,drop
46670,51505,0,0,146,146,0,1,0,1,0,deny
23936,35440,0,0,62,62,0,1,0,1,0,deny
52837,35440,0,0,66,66,0,1,0,1,0,deny
59941,445,0,0,70,70,0,1,0,1,0,drop
34808,22114,0,0,66,66,0,1,0,1,0,deny
56202,15503,0,0,146,146,0,1,0,1,0,deny
39119,44847,0,0,62,62,0,1,0,1,0,deny
59938,445,0,0,70,70,0,1,0,1,0,drop
59929,445,0,0,70,70,0,1,0,1,0,drop
54986,445,0,0,70,70,0,1,0,1,0,drop
51032,30188,0,0,66,66,0,1,0,1,0,deny
48016,57470,0,0,62,62,0,1,0,1,0,deny
58481,15503,0,0,146,146,0,1,0,1,0,deny
61838,37965,0,0,62,62,0,1,0,1,0,deny
54975,445,0,0,70,70,0,1,0,1,0,drop
54977,445,0,0,70,70,0,1,0,1,0,drop
55327,445,0,0,66,66,0,1,0,1,0,drop
1024,50265,0,0,62,62,0,1,0,1,0,deny
54971,445,0,0,70,70,0,1,0,1,0,drop
54974,445,0,0,70,70,0,1,0,1,0,drop
6666,50070,0,0,60,60,0,1,0,1,0,deny
54970,445,0,0,70,70,0,1,0,1,0,drop
55311,44847,0,0,66,66,0,1,0,1,0,deny
55319,445,0,0,66,66,0,1,0,1,0,drop
45964,3111,0,0,60,60,0,1,0,1,0,deny
59919,445,0,0,70,70,0,1,0,1,0,drop
38653,21247,0,0,62,62,0,1,0,1,0,deny
58398,44847,0,0,66,66,0,1,0,1,0,deny
55316,445,0,0,66,66,0,1,0,1,0,drop
54963,445,0,0,70,70,0,1,0,1,0,drop
30114,65151,0,0,60,60,0,1,0,1,0,deny
17579,57470,0,0,62,62,0,1,0,1,0,deny
55310,445,0,0,66,66,0,1,0,1,0,drop
54956,445,0,0,70,70,0,1,0,1,0,drop
55300,445,0,0,66,66,0,1,0,1,0,drop
25010,30188,0,0,146,146,0,1,0,1,0,deny
4515,37807,0,0,62,62,0,1,0,1,0,deny
54954,445,0,0,70,70,0,1,0,1,0,drop
36061,53,36061,53,220,100,120,2,30,1,1,allow
30478,53,30478,53,229,89,140,2,30,1,1,allow
63831,31539,8065,31539,312,132,180,6,7,3,3,allow
55771,53,58272,53,283,98,185,4,51,2,2,allow
15523,53,15523,53,227,88,139,2,30,1,1,allow
60373,80,60373,80,116680,5773,110907,126,21,46,80,allow
46633,53,46633,53,237,91,146,2,32,1,1,allow
53647,16194,65302,16194,70,70,0,2,8,2,0,allow
65497,53,35507,53,194,99,95,2,31,1,1,allow
64335,53,18778,53,186,95,91,2,30,1,1,allow
15239,53,15239,53,229,89,140,2,30,1,1,allow
56625,443,54912,443,6734,2065,4669,21,16,11,10,allow
49227,443,49227,443,155471,20626,134845,193,95,92,101,allow
57174,53,65010,53,755,94,661,2,30,1,1,allow
51230,80,8702,80,1594,1280,314,10,15,5,5,allow
56656,443,8282,443,7743,3072,4671,18,125,10,8,allow
49162,53,60010,53,182,93,89,2,31,1,1,allow
55955,53,59557,53,184,94,90,2,30,1,1,allow
61697,443,10867,443,9963,2631,7332,37,48,20,17,allow
53560,443,34440,443,10823,1626,9197,27,28,15,12,allow
61678,80,36347,80,79505,3799,75706,105,53,43,62,allow
55071,53,10472,53,170,87,83,2,31,1,1,allow
49265,53,7053,53,178,91,87,2,31,1,1,allow
53653,17436,48182,17436,70,70,0,2,8,2,0,allow
56695,53,57441,53,776,102,674,2,30,1,1,allow
57406,53,28886,53,761,100,661,2,30,1,1,allow
38678,443,31559,443,484,210,274,8,26,4,4,allow
65437,53,50016,53,190,97,93,2,30,1,1,allow
55450,53,15433,53,186,95,91,2,30,1,1,allow
53650,37096,53395,37096,70,70,0,2,8,2,0,allow
65241,53,65497,53,196,100,96,2,30,1,1,allow
51928,443,37238,443,18581,9681,8900,62,103,33,29,allow
59828,53,0,0,275,75,200,2,30,1,1,allow
65229,53,65354,53,190,97,93,2,31,1,1,allow
56704,53,19637,53,188,96,92,2,31,1,1,allow
65165,53,54019,53,200,102,98,2,31,1,1,allow
57072,53,1078,53,190,97,93,2,31,1,1,allow
53561,443,46196,443,4586,1216,3370,17,28,10,7,allow
48422,53,48422,53,229,89,140,2,30,1,1,allow
51819,59208,18687,59208,66,66,0,2,8,2,0,allow
50034,53,9396,53,174,89,85,2,30,1,1,allow
60796,80,60796,80,13869,3749,10120,28,26,15,13,allow
64587,53,28928,53,166,85,81,2,30,1,1,allow
40905,443,30832,443,6982,1535,5447,30,26,15,15,allow
27005,27021,33565,27021,879,126,753,2,30,1,1,allow
50584,6881,48204,6881,161,161,0,1,1200,1,0,allow
57470,6889,39885,6889,507,163,344,2,1200,1,1,allow
30960,45708,10232,45708,330,330,0,6,3609,6,0,allow
32390,53,32390,53,229,89,140,2,30,1,1,allow
38791,53,38791,53,229,89,140,2,30,1,1,allow
55032,53,0,0,288,79,209,2,31,1,1,allow
57275,53,1884,53,186,95,91,2,31,1,1,allow
55871,53,0,0,82,82,0,1,31,1,0,allow
49843,53,31745,53,186,95,91,2,31,1,1,allow
53546,443,23696,443,7268,3166,4102,19,136,10,9,allow
36306,53,36306,53,229,89,140,2,30,1,1,allow
5881,53,5881,53,231,90,141,2,31,1,1,allow
64999,53,11642,53,757,98,659,2,31,1,1,allow
50054,53,65410,53,775,103,672,2,31,1,1,allow
57266,53,10699,53,753,96,657,2,31,1,1,allow
48627,443,55025,443,638,70,568,10,207,2,8,allow
52280,5228,18366,5228,2147,1315,832,14,3601,7,7,allow
47163,53,47163,53,825,99,726,2,31,1,1,allow
42153,443,25509,443,12306,2097,10209,31,360,15,16,allow
50584,58516,43586,58516,161,161,0,1,1200,1,0,allow
57470,6881,14174,6881,490,163,327,2,1200,1,1,allow
57096,53,22814,53,196,100,96,2,31,1,1,allow
57296,53,12062,53,200,102,98,2,31,1,1,allow
64904,53,60868,53,198,101,97,2,31,1,1,allow
49654,53,58330,53,184,94,90,2,31,1,1,allow
50584,6881,21374,6881,161,161,0,1,1200,1,0,allow
57470,51413,13214,51413,490,163,327,2,1200,1,1,allow
49522,53,15202,53,753,96,657,2,31,1,1,allow
65439,53,55852,53,751,95,656,2,31,1,1,allow
64946,53,40387,53,202,95,107,2,31,1,1,allow
55481,53,52263,53,793,101,692,2,31,1,1,allow
26352,53,26352,53,231,90,141,2,31,1,1,allow
27005,37579,27251,37579,886,126,760,2,31,1,1,allow
49812,53,21383,53,164,84,80,2,31,1,1,allow
49159,53,33263,53,733,86,647,2,31,1,1,allow
65482,53,40607,53,174,89,85,2,31,1,1,allow
49761,53,10383,53,182,93,89,2,31,1,1,allow
56536,53,9836,53,202,103,99,2,31,1,1,allow
64559,53,44867,53,168,86,82,2,31,1,1,allow
56387,53,8885,53,757,98,659,2,31,1,1,allow
57470,51413,34257,51413,508,163,345,2,1200,1,1,allow
56783,53,31906,53,751,95,656,2,31,1,1,allow
56855,53,37174,53,775,103,672,2,31,1,1,allow
57109,53,37634,53,168,86,82,2,31,1,1,allow
65345,53,26359,53,782,105,677,2,31,1,1,allow
55062,53,13920,53,733,86,647,2,31,1,1,allow
48114,443,5239,443,4515,2193,2322,14,135,7,7,allow
50584,18047,33742,18047,851,369,482,5,1200,3,2,allow
19473,28109,14230,28109,468,149,319,2,1200,1,1,allow
50584,8999,10076,8999,161,161,0,1,1200,1,0,allow
57470,43259,40741,43259,517,163,354,2,1200,1,1,allow
19983,18242,0,0,146,146,0,1,0,1,0,reset-both
64997,51221,0,0,66,66,0,1,0,1,0,deny
22835,51221,0,0,62,62,0,1,0,1,0,deny
54950,445,0,0,70,70,0,1,0,1,0,drop
54948,445,0,0,70,70,0,1,0,1,0,drop
59909,445,0,0,70,70,0,1,0,1,0,drop
55489,53,26827,53,193,102,91,2,30,1,1,allow
55208,53,14602,53,177,94,83,2,30,1,1,allow
64587,53,13030,53,167,86,81,2,30,1,1,allow
49568,53,17593,53,214,102,112,2,30,1,1,allow
55771,53,45760,53,283,98,185,4,51,2,2,allow
59908,445,0,0,70,70,0,1,0,1,0,drop
59907,445,0,0,70,70,0,1,0,1,0,drop
55294,445,0,0,66,66,0,1,0,1,0,drop
55293,445,0,0,66,66,0,1,0,1,0,drop
55292,445,0,0,66,66,0,1,0,1,0,drop
55291,445,0,0,66,66,0,1,0,1,0,drop
55290,445,0,0,66,66,0,1,0,1,0,drop
55289,445,0,0,66,66,0,1,0,1,0,drop
55288,445,0,0,66,66,0,1,0,1,0,drop
55287,445,0,0,66,66,0,1,0,1,0,drop
19678,36237,0,0,146,146,0,1,0,1,0,deny
54944,445,0,0,70,70,0,1,0,1,0,drop
19361,37965,0,0,66,66,0,1,0,1,0,deny
54943,445,0,0,70,70,0,1,0,1,0,drop
43260,41615,0,0,145,145,0,1,0,1,0,deny
52643,15941,0,0,62,62,0,1,0,1,0,deny
22683,39210,0,0,60,60,0,1,0,1,0,deny
53227,64097,0,0,66,66,0,1,0,1,0,deny
53140,80,7682,80,9602,814,8788,19,129,10,9,allow
53648,31637,17348,31637,70,70,0,2,7,2,0,allow
51835,29778,4690,29778,70,70,0,2,7,2,0,allow
64820,53,5211,53,195,102,93,2,29,1,1,allow
56343,53,26376,53,194,102,92,2,29,1,1,allow
49242,53,1581,53,167,86,81,2,29,1,1,allow
56106,53,61650,53,816,102,714,2,30,1,1,allow
61702,80,48411,80,1553,953,600,14,47,8,6,allow
41420,443,4151,443,4858,855,4003,16,64,9,7,allow
43875,443,31372,443,18367,3429,14938,41,500,23,18,allow
56655,53,21531,53,209,110,99,2,30,1,1,allow
65482,53,50244,53,179,94,85,2,30,1,1,allow
65360,53,6269,53,763,102,661,2,30,1,1,allow
49186,53,28433,53,821,102,719,2,30,1,1,allow
56704,53,43778,53,194,102,92,2,29,1,1,allow
61701,80,22637,80,1495,954,541,13,47,8,5,allow
65437,53,38141,53,195,102,93,2,29,1,1,allow
54670,443,29364,443,18487,3434,15053,37,80,20,17,allow
37179,443,24898,443,7440,3165,4275,31,358,17,14,allow
57146,53,5349,53,199,102,97,2,29,1,1,allow
36541,443,3197,443,4322,797,3525,14,64,8,6,allow
50209,1688,16419,1688,70,70,0,1,4,1,0,allow
49547,53,33121,53,193,102,91,2,29,1,1,allow
49242,53,38872,53,167,86,81,2,29,1,1,allow
55450,53,40761,53,193,102,91,2,29,1,1,allow
57146,53,13566,53,199,102,97,2,29,1,1,allow
64335,53,30399,53,193,102,91,2,29,1,1,allow
56396,53,60964,53,183,94,89,2,30,1,1,allow
65073,53,50486,53,195,102,93,2,29,1,1,allow
57263,53,2666,53,167,86,81,2,29,1,1,allow
55571,53,22113,53,70,70,0,1,29,1,0,allow
54962,53,60392,53,194,102,92,2,29,1,1,allow
55205,53,45357,53,167,86,81,2,29,1,1,allow
64074,53,30034,53,209,110,99,2,29,1,1,allow
55858,53,14376,53,214,102,112,2,30,1,1,allow
61704,80,4261,80,1555,954,601,14,47,8,6,allow
60335,7010,60335,7010,6127,4018,2109,19,17,11,8,allow
49441,443,28685,443,2921276,89544,2831732,3090,63,1086,2004,allow
49242,53,5506,53,167,86,81,2,30,1,1,allow
49769,53,30329,53,785,110,675,2,30,1,1,allow
49169,53,65143,53,184,94,90,2,30,1,1,allow
49162,53,28701,53,183,94,89,2,30,1,1,allow
56010,53,24880,53,184,94,90,2,30,1,1,allow
64587,53,63035,53,167,86,81,2,30,1,1,allow
17752,53,17752,53,230,90,140,2,30,1,1,allow
56935,53,51699,53,821,102,719,2,30,1,1,allow
49337,53,44481,53,199,102,97,2,30,1,1,allow
51839,27256,26214,27256,70,70,0,2,7,2,0,allow
65229,53,47918,53,195,102,93,2,30,1,1,allow
49186,53,38504,53,198,102,96,2,30,1,1,allow
57162,443,26306,443,1798,1223,575,13,25,8,5,allow
39296,80,42810,80,740,452,288,11,17,7,4,allow
40705,443,7502,443,5721,3240,2481,35,147,14,21,allow
64922,53,63289,53,431,95,336,4,55,2,2,allow
57536,53,46039,53,199,94,105,2,30,1,1,allow
50179,80,50179,80,1473,920,553,9,137,6,3,allow
51424,53,58777,53,269,94,175,2,30,1,1,allow
50377,53,24974,53,753,94,659,2,30,1,1,allow
65478,443,30120,443,92279,4799,87480,107,16,43,64,allow
49773,53,17034,53,199,94,105,2,30,1,1,allow
49850,53,46784,53,166,86,80,2,30,1,1,allow
60211,443,55686,443,126490514,2726981,123763533,123275,553,41466,81809,allow
55095,53,28399,53,194,102,92,2,30,1,1,allow
49812,53,5502,53,166,86,80,2,30,1,1,allow
56441,80,22718,80,1272,389,883,16,394,4,12,allow
55972,53,29588,53,262,126,136,2,30,1,1,allow
64904,53,43718,53,199,102,97,2,30,1,1,allow
60732,443,1345,443,193520,11019,182501,280,276,140,140,allow
51820,53738,51101,53738,66,66,0,2,8,2,0,allow
53144,443,6960,443,7121,2564,4557,26,127,15,11,allow
50033,53,63649,53,533,184,349,6,76,3,3,allow
55771,53,49572,53,283,98,185,4,51,2,2,allow
65530,53,2612,53,102,102,0,1,30,1,0,allow
65443,53,19494,53,215,102,113,2,30,1,1,allow
49242,53,51879,53,183,94,89,2,30,1,1,allow
65005,53,27346,53,776,102,674,2,30,1,1,allow
64016,53,48329,53,183,94,89,2,30,1,1,allow
49518,443,56139,443,7834,1758,6076,26,171,13,13,allow
55635,38649,60618,38649,70,70,0,2,8,2,0,allow
51836,37753,15245,37753,70,70,0,2,7,2,0,allow
65477,443,34529,443,409770,12150,397620,421,16,148,273,allow
49327,53,15373,53,396,102,294,2,30,1,1,allow
49337,53,52249,53,199,102,97,2,30,1,1,allow
49242,53,36950,53,183,94,89,2,30,1,1,allow
64789,53,40256,53,193,102,91,2,30,1,1,allow
50354,53,23392,53,209,110,99,2,30,1,1,allow
56665,53,14967,53,223,86,137,2,30,1,1,allow
33473,443,49097,443,146684,25233,121451,183,189,75,108,allow
49730,443,40154,443,3233,1141,2092,14,135,7,7,allow
40488,443,48919,443,3635,2114,1521,22,515,13,9,allow
49936,53,34115,53,318,110,208,4,50,2,2,allow
35637,443,59473,443,5611,1559,4052,22,648,13,9,allow
60350,443,44026,443,5242,861,4381,17,16,9,8,allow
38405,443,30504,443,9876,1976,7900,27,27,13,14,allow
41322,443,26107,443,6332,944,5388,19,66,10,9,allow
51834,30309,65352,30309,70,70,0,2,7,2,0,allow
56625,80,20338,80,234,234,0,4,11,4,0,allow
56823,50291,65479,50291,316,136,180,6,6,3,3,allow
52585,53,6341,53,265,91,174,4,40,2,2,allow
64397,53,47942,53,658,186,472,6,51,3,3,allow
57188,8525,57188,8525,138,78,60,2,6,1,1,allow
50518,443,27027,443,1352,691,661,14,47,8,6,allow
55534,53,27868,53,168,86,82,2,29,1,1,allow
54835,443,59753,443,678,280,398,11,26,5,6,allow
38031,80,38031,80,37629,3025,34604,51,24,22,29,allow
55489,53,32876,53,193,102,91,2,29,1,1,allow
56344,443,64957,443,8111,1413,6698,21,28,12,9,allow
46596,443,51995,443,4146,2690,1456,31,37,16,15,allow
65497,53,55657,53,197,102,95,2,29,1,1,allow
56343,443,34805,443,350,210,140,6,27,4,2,allow
65241,53,47217,53,198,102,96,2,29,1,1,allow
56728,53,11841,53,166,86,80,2,30,1,1,allow
53651,47758,20351,47758,70,70,0,2,7,2,0,allow
55450,53,10732,53,193,102,91,2,29,1,1,allow
57072,53,9949,53,195,102,93,2,30,1,1,allow
56824,55829,39772,55829,70,70,0,1,5,1,0,allow
55208,53,2198,53,177,94,83,2,30,1,1,allow
49547,53,39009,53,193,102,91,2,30,1,1,allow
52405,443,45940,443,227267,18022,209245,424,38,239,185,allow
23997,53,23997,53,230,90,140,2,30,1,1,allow
60047,443,35596,443,1350,689,661,14,44,8,6,allow
60045,443,3000,443,1573,769,804,16,47,9,7,allow
48734,443,7322,443,256887,11565,245322,293,56,112,181,allow
60372,80,60372,80,186272,9792,176480,216,21,93,123,allow
50072,53,48106,53,172,94,78,2,30,1,1,allow
65497,53,26978,53,197,102,95,2,30,1,1,allow
55071,53,59621,53,177,94,83,2,30,1,1,allow
49928,53,49928,53,229,90,139,2,30,1,1,allow
57072,53,19221,53,195,102,93,2,30,1,1,allow
57346,53,23622,53,210,110,100,2,29,1,1,allow
57470,18531,64727,18531,166,166,0,1,1200,1,0,allow
50584,38496,45984,38496,166,166,0,1,1200,1,0,allow
57470,60560,62247,60560,527,166,361,2,1200,1,1,allow
64789,53,62569,53,816,102,714,2,30,1,1,allow
49843,53,13877,53,193,102,91,2,30,1,1,allow
50354,53,24829,53,209,110,99,2,30,1,1,allow
64335,53,25261,53,193,102,91,2,30,1,1,allow
49630,53,20567,53,374,126,248,2,30,1,1,allow
49812,53,4769,53,166,86,80,2,30,1,1,allow
57096,53,45247,53,198,102,96,2,30,1,1,allow
56322,53,19434,53,166,86,80,2,30,1,1,allow
50234,53,30924,53,775,102,673,2,30,1,1,allow
55810,53,5823,53,183,94,89,2,31,1,1,allow
6882,64287,36114,64287,228,118,110,2,1200,1,1,allow
55342,53,57972,53,994,86,908,2,30,1,1,allow
56616,53,31793,53,183,94,89,2,30,1,1,allow
64837,53,23710,53,196,94,102,2,30,1,1,allow
65012,53,58709,53,775,102,673,2,30,1,1,allow
56935,53,62999,53,198,102,96,2,30,1,1,allow
64719,53,54824,53,196,102,94,2,30,1,1,allow
56396,53,42377,53,183,94,89,2,30,1,1,allow
55071,53,51447,53,177,94,83,2,30,1,1,allow
55192,53,5787,53,178,94,84,2,31,1,1,allow
49162,53,41472,53,183,94,89,2,30,1,1,allow
49220,53,32308,53,755,94,661,2,30,1,1,allow
50072,53,26115,53,164,86,78,2,30,1,1,allow
44511,53,15897,53,199,94,105,2,30,1,1,allow
45872,53,25002,53,199,94,105,2,30,1,1,allow
65165,53,53498,53,200,102,98,2,30,1,1,allow
64414,53,3637,53,193,102,91,2,30,1,1,allow
57978,80,62070,80,4402,2878,1524,29,105,15,14,allow
39802,443,21011,443,3025,1958,1067,26,49,14,12,allow
23824,80,23824,80,24232,4550,19682,59,17,34,25,allow
55632,45682,28003,45682,70,70,0,2,8,2,0,allow
50516,443,44017,443,1575,771,804,16,47,9,7,allow
56622,443,50835,443,8302,3583,4719,24,17,14,10,allow
42446,123,14987,123,184,94,90,2,30,1,1,allow
63765,3389,63765,3389,3444,1730,1714,16,33,8,8,allow
47180,443,38596,443,6007,1727,4280,27,1128,15,12,allow
65304,53,61262,53,209,110,99,2,30,1,1,allow
7003,53,7003,53,229,90,139,2,30,1,1,allow
49265,53,37179,53,181,94,87,2,30,1,1,allow
56616,53,21461,53,183,94,89,2,30,1,1,allow
49850,53,15104,53,166,86,80,2,30,1,1,allow
49156,53,27997,53,304,118,186,2,30,1,1,allow
56106,53,18399,53,193,102,91,2,30,1,1,allow
4025,53,4025,53,230,90,140,2,30,1,1,allow
57275,53,22434,53,193,102,91,2,30,1,1,allow
53122,29070,40660,29070,758,320,438,11,16,6,5,allow
51838,29448,55370,29448,70,70,0,2,7,2,0,allow
55634,58846,18331,58846,70,70,0,2,8,2,0,allow
55624,80,56586,80,70,70,0,1,5,1,0,allow
51459,443,53569,443,202,70,132,3,11,1,2,allow
60897,443,29377,443,10706,1679,9027,27,46,15,12,allow
64074,53,19017,53,209,110,99,2,30,1,1,allow
65241,53,1849,53,198,102,96,2,30,1,1,allow
65216,53,15859,53,994,86,908,2,30,1,1,allow
50034,53,20576,53,179,94,85,2,30,1,1,allow
49337,53,49651,53,199,102,97,2,30,1,1,allow
64820,53,31810,53,195,102,93,2,30,1,1,allow
5773,53,5773,53,229,90,139,2,30,1,1,allow
49840,53,48921,53,277,102,175,2,30,1,1,allow
64137,53,61015,53,216,102,114,2,30,1,1,allow
49676,53,9085,53,200,94,106,2,30,1,1,allow
55786,53,42852,53,200,102,98,2,30,1,1,allow
14694,53,14694,53,230,90,140,2,30,1,1,allow
50257,53,13525,53,199,102,97,2,30,1,1,allow
49843,53,43292,53,193,102,91,2,30,1,1,allow
55955,53,53026,53,184,94,90,2,30,1,1,allow
56536,53,49265,53,209,110,99,2,30,1,1,allow
27005,33058,7981,33058,884,126,758,2,31,1,1,allow
57470,51413,27069,51413,807,275,532,4,1200,2,2,allow
50584,9045,4330,9045,166,166,0,1,1200,1,0,allow
57470,8999,29205,8999,863,363,500,4,1200,2,2,allow
57470,45340,41159,45340,527,166,361,2,1200,1,1,allow
57202,53,28601,53,184,94,90,2,30,1,1,allow
56409,53,35272,53,199,102,97,2,30,1,1,allow
56536,53,3128,53,209,110,99,2,31,1,1,allow
64719,53,44200,53,196,102,94,2,31,1,1,allow
65165,53,58294,53,200,102,98,2,31,1,1,allow
57275,53,13596,53,193,102,91,2,31,1,1,allow
27005,30008,41191,30008,881,126,755,2,31,1,1,allow
57494,443,51749,443,2435128,54736,2380392,2151,346,331,1820,allow
57470,6887,18117,6887,471,269,202,4,1199,2,2,allow
57470,44573,53035,44573,883,288,595,4,1200,2,2,allow
57470,65534,12773,65534,773,271,502,4,1200,2,2,allow
64461,53,47213,53,177,94,83,2,31,1,1,allow
57296,53,45722,53,200,102,98,2,30,1,1,allow
56086,53,3627,53,172,94,78,2,30,1,1,allow
57275,53,15169,53,193,102,91,2,30,1,1,allow
64917,53,1366,53,243,94,149,2,30,1,1,allow
56409,53,61903,53,199,102,97,2,31,1,1,allow
55192,53,55863,53,178,94,84,2,30,1,1,allow
64414,53,29559,53,193,102,91,2,31,1,1,allow
57150,53,61382,53,166,86,80,2,31,1,1,allow
64390,53,22708,53,225,110,115,2,30,1,1,allow
65487,53,64939,53,184,94,90,2,31,1,1,allow
32897,443,57512,443,3166,936,2230,18,120,9,9,allow
65074,443,20920,443,7584,7094,490,14,124,7,7,allow
50584,63015,51175,63015,166,166,0,1,1200,1,0,allow
57470,32517,51554,32517,166,166,0,1,1199,1,0,allow
50584,12899,63307,12899,166,166,0,1,1200,1,0,allow
50584,6889,59579,6889,161,161,0,2,1200,2,0,allow
57470,51413,6363,51413,493,166,327,2,1200,1,1,allow
50584,61867,27152,61867,166,166,0,1,1200,1,0,allow
57470,6881,5972,6881,755,275,480,4,1200,2,2,allow
57470,34590,16143,34590,527,166,361,2,1200,1,1,allow
57470,46487,30671,46487,527,166,361,2,1200,1,1,allow
27005,27015,8192,27015,912,126,786,2,31,1,1,allow
27005,33056,59284,33056,885,126,759,2,31,1,1,allow
54680,443,15778,443,1786,172,1614,7,120,3,4,allow
57470,46941,64707,46941,899,288,611,4,1199,2,2,allow
57470,11696,14471,11696,353,166,187,2,1199,1,1,allow
57470,51413,16094,51413,700,275,425,4,1200,2,2,allow
50584,28387,54140,28387,161,161,0,2,1200,2,0,allow
44847,51572,8318,51572,509,150,359,2,1200,1,1,allow
57470,6881,62748,6881,525,166,359,2,1200,1,1,allow
57470,43576,31912,43576,545,166,379,2,1200,1,1,allow
39338,443,58557,443,4362,1145,3217,17,26,9,8,allow
54830,443,23517,443,4478,1133,3345,13,26,8,5,allow
50384,443,12155,443,6147,911,5236,18,16,10,8,allow
27005,27015,19164,27015,871,126,745,2,31,1,1,allow
56308,443,13053,443,1622,1137,485,11,26,7,4,allow
56352,80,27612,80,1258,752,506,13,16,7,6,allow
56704,53,10036,53,194,102,92,2,31,1,1,allow
41439,443,30443,443,4370,1148,3222,17,26,9,8,allow
39337,443,52807,443,4362,1145,3217,17,26,9,8,allow
56342,443,42448,443,1463,988,475,12,27,7,5,allow
18767,35440,0,0,146,146,0,1,0,1,0,deny
59896,445,0,0,70,70,0,1,0,1,0,drop
59892,445,0,0,70,70,0,1,0,1,0,drop
59891,445,0,0,70,70,0,1,0,1,0,drop
64990,55442,0,0,66,66,0,1,0,1,0,deny
48640,47993,0,0,145,145,0,1,0,1,0,deny
39548,8696,0,0,60,60,0,1,0,1,0,deny
54938,445,0,0,70,70,0,1,0,1,0,drop
55272,445,0,0,66,66,0,1,0,1,0,drop
55274,445,0,0,66,66,0,1,0,1,0,drop
55271,445,0,0,66,66,0,1,0,1,0,drop
63194,50265,0,0,66,66,0,1,0,1,0,deny
48676,53392,0,0,60,60,0,1,0,1,0,deny
46670,51505,0,0,62,62,0,1,0,1,0,deny
52860,9694,0,0,146,146,0,1,0,1,0,deny
59890,445,0,0,70,70,0,1,0,1,0,drop
46362,35440,0,0,66,66,0,1,0,1,0,deny
52150,39109,0,0,66,66,0,1,0,1,0,deny
59887,445,0,0,70,70,0,1,0,1,0,drop
51525,35440,0,0,66,66,0,1,0,1,0,deny
38723,37838,0,0,146,146,0,1,0,1,0,deny
2876,35440,0,0,62,62,0,1,0,1,0,deny
2394,43890,0,0,62,62,0,1,0,1,0,deny
59883,445,0,0,70,70,0,1,0,1,0,drop
59882,445,0,0,70,70,0,1,0,1,0,drop
59884,445,0,0,70,70,0,1,0,1,0,drop
49197,30188,0,0,146,146,0,1,0,1,0,deny
61223,37965,0,0,62,62,0,1,0,1,0,deny
4427,50584,0,0,62,62,0,1,0,1,0,deny
46740,55108,0,0,148,148,0,1,0,1,0,deny
27679,37965,0,0,62,62,0,1,0,1,0,deny
64283,37965,0,0,74,74,0,1,0,1,0,deny
54925,445,0,0,70,70,0,1,0,1,0,drop
27641,39004,0,0,62,62,0,1,0,1,0,deny
59430,50584,0,0,66,66,0,1,0,1,0,deny
54922,445,0,0,70,70,0,1,0,1,0,drop
60312,57470,0,0,74,74,0,1,0,1,0,deny
58497,39004,0,0,66,66,0,1,0,1,0,deny
59868,445,0,0,70,70,0,1,0,1,0,drop
59867,445,0,0,70,70,0,1,0,1,0,drop
59864,445,0,0,70,70,0,1,0,1,0,drop
62725,51221,0,0,66,66,0,1,0,1,0,deny
30610,41615,0,0,145,145,0,1,0,1,0,deny
54918,445,0,0,70,70,0,1,0,1,0,drop
443,62451,0,0,199,199,0,1,0,1,0,deny
54916,445,0,0,70,70,0,1,0,1,0,drop
42798,26467,0,0,62,62,0,1,0,1,0,deny
6881,6881,0,0,62,62,0,1,0,1,0,deny
54914,445,0,0,70,70,0,1,0,1,0,drop
55249,445,0,0,66,66,0,1,0,1,0,drop
59861,445,0,0,70,70,0,1,0,1,0,drop
59862,445,0,0,70,70,0,1,0,1,0,drop
1790,48817,0,0,66,66,0,1,0,1,0,deny
13970,42873,0,0,66,66,0,1,0,1,0,deny
53840,443,34687,443,499,425,74,4,0,3,1,allow
53847,443,28382,443,499,425,74,4,0,3,1,allow
53841,443,33528,443,499,425,74,4,0,3,1,allow
11344,42873,0,0,62,62,0,1,0,1,0,deny
18713,40108,0,0,146,146,0,1,0,1,0,deny
6060,15503,0,0,146,146,0,1,0,1,0,deny
54907,445,0,0,70,70,0,1,0,1,0,drop
55246,445,0,0,66,66,0,1,0,1,0,drop
55396,26467,0,0,62,62,0,1,0,1,0,deny
53843,443,32315,443,499,425,74,4,0,3,1,allow
53844,443,56188,443,499,425,74,4,0,3,1,allow
53845,443,42345,443,499,425,74,4,0,3,1,allow
53846,443,62098,443,499,425,74,4,0,3,1,allow
53842,443,26608,443,499,425,74,4,0,3,1,allow
53839,443,31646,443,499,425,74,4,0,3,1,allow
53837,443,2999,443,499,425,74,4,0,3,1,allow
53836,443,61812,443,499,425,74,4,0,3,1,allow
53834,443,62616,443,499,425,74,4,0,3,1,allow
53838,443,50005,443,499,425,74,4,0,3,1,allow
53831,443,39132,443,499,425,74,4,0,3,1,allow
53832,443,1159,443,499,425,74,4,0,3,1,allow
54905,445,0,0,70,70,0,1,0,1,0,drop
55242,445,0,0,66,66,0,1,0,1,0,drop
43916,21,0,0,60,60,0,1,0,1,0,deny
59847,445,0,0,70,70,0,1,0,1,0,drop
42459,22114,0,0,62,62,0,1,0,1,0,deny
59844,445,0,0,70,70,0,1,0,1,0,drop
53829,443,25937,443,499,425,74,4,0,3,1,allow
53835,443,32854,443,499,425,74,4,0,3,1,allow
53823,443,24155,443,499,425,74,4,0,3,1,allow
53827,443,32061,443,499,425,74,4,0,3,1,allow
53830,443,40467,443,499,425,74,4,0,3,1,allow
53826,443,31854,443,499,425,74,4,0,3,1,allow
53825,443,49613,443,499,425,74,4,0,3,1,allow
53833,443,61114,443,499,425,74,4,0,3,1,allow
53822,443,12016,443,499,425,74,4,0,3,1,allow
53828,443,58283,443,499,425,74,4,0,3,1,allow
53824,443,33513,443,499,425,74,4,0,3,1,allow
53821,443,22487,443,499,425,74,4,0,3,1,allow
59845,445,0,0,70,70,0,1,0,1,0,drop
59843,445,0,0,70,70,0,1,0,1,0,drop
34129,19410,0,0,60,60,0,1,0,1,0,deny
54904,445,0,0,70,70,0,1,0,1,0,drop
55238,445,0,0,66,66,0,1,0,1,0,drop
9865,15503,0,0,146,146,0,1,0,1,0,deny
54903,445,0,0,70,70,0,1,0,1,0,drop
54902,445,0,0,70,70,0,1,0,1,0,drop
2077,45850,0,0,145,145,0,1,0,1,0,reset-both
58213,37807,0,0,66,66,0,1,0,1,0,deny
54897,445,0,0,70,70,0,1,0,1,0,drop
54896,445,0,0,70,70,0,1,0,1,0,drop
60152,26467,0,0,62,62,0,1,0,1,0,deny
44849,46478,0,0,74,74,0,1,0,1,0,deny
59834,445,0,0,70,70,0,1,0,1,0,drop
59832,445,0,0,70,70,0,1,0,1,0,drop
59828,445,0,0,70,70,0,1,0,1,0,drop
59830,445,0,0,70,70,0,1,0,1,0,drop
54884,445,0,0,70,70,0,1,0,1,0,drop
54883,445,0,0,70,70,0,1,0,1,0,drop
54880,445,0,0,70,70,0,1,0,1,0,drop
55233,445,0,0,66,66,0,1,0,1,0,drop
54874,445,0,0,70,70,0,1,0,1,0,drop
54873,445,0,0,70,70,0,1,0,1,0,drop
55675,53,17939,53,190,97,93,2,0,1,1,allow
48629,63131,0,0,74,74,0,1,0,1,0,deny
18650,23718,0,0,62,62,0,1,0,1,0,deny
55225,445,0,0,66,66,0,1,0,1,0,drop
55228,445,0,0,66,66,0,1,0,1,0,drop
55229,445,0,0,66,66,0,1,0,1,0,drop
50914,51505,0,0,66,66,0,1,0,1,0,deny
55222,445,0,0,66,66,0,1,0,1,0,drop
55223,445,0,0,66,66,0,1,0,1,0,drop
55221,445,0,0,66,66,0,1,0,1,0,drop
48388,44847,0,0,146,146,0,1,0,1,0,deny
64880,9694,0,0,66,66,0,1,0,1,0,deny
14924,44847,0,0,66,66,0,1,0,1,0,deny
0,0,0,0,110,110,0,1,0,1,0,deny
0,0,0,0,98,98,0,1,0,1,0,deny
0,0,0,0,480,244,236,4,0,2,2,allow
18203,23,0,0,60,60,0,1,0,1,0,deny
13285,29892,0,0,145,145,0,1,0,1,0,deny
38723,15503,0,0,146,146,0,1,0,1,0,deny
59824,445,0,0,70,70,0,1,0,1,0,drop
59822,445,0,0,70,70,0,1,0,1,0,drop
59820,445,0,0,70,70,0,1,0,1,0,drop
54636,26467,0,0,66,66,0,1,0,1,0,deny
44208,26467,0,0,62,62,0,1,0,1,0,deny
55217,445,0,0,66,66,0,1,0,1,0,drop
38383,51221,0,0,66,66,0,1,0,1,0,deny
19204,41864,0,0,159,159,0,1,0,1,0,deny
34146,51221,0,0,62,62,0,1,0,1,0,deny
59819,445,0,0,70,70,0,1,0,1,0,drop
54862,445,0,0,70,70,0,1,0,1,0,drop
57633,50584,0,0,62,62,0,1,0,1,0,deny
55215,445,0,0,66,66,0,1,0,1,0,drop
55213,445,0,0,66,66,0,1,0,1,0,drop
55211,445,0,0,66,66,0,1,0,1,0,drop
64387,37965,0,0,66,66,0,1,0,1,0,deny
55210,445,0,0,66,66,0,1,0,1,0,drop
59994,11446,0,0,66,66,0,1,0,1,0,deny
50095,30188,0,0,66,66,0,1,0,1,0,deny
46495,4607,0,0,60,60,0,1,0,1,0,deny
10354,81,0,0,60,60,0,1,0,1,0,deny
53833,26467,0,0,62,62,0,1,0,1,0,deny
54854,19847,0,0,66,66,0,1,0,1,0,deny
54858,445,0,0,70,70,0,1,0,1,0,drop
45941,23388,0,0,60,60,0,1,0,1,0,deny
48706,23393,0,0,60,60,0,1,0,1,0,deny
3911,50584,0,0,62,62,0,1,0,1,0,deny
59813,445,0,0,70,70,0,1,0,1,0,drop
22367,50584,0,0,146,146,0,1,0,1,0,deny
59807,445,0,0,70,70,0,1,0,1,0,drop
59802,445,0,0,70,70,0,1,0,1,0,drop
50052,65008,0,0,60,60,0,1,0,1,0,deny
54849,445,0,0,70,70,0,1,0,1,0,drop
54848,445,0,0,70,70,0,1,0,1,0,drop
54844,445,0,0,70,70,0,1,0,1,0,drop
54846,445,0,0,70,70,0,1,0,1,0,drop
49229,6921,0,0,145,145,0,1,0,1,0,deny
54841,445,0,0,70,70,0,1,0,1,0,drop
55199,445,0,0,66,66,0,1,0,1,0,drop
55145,11392,0,0,66,66,0,1,0,1,0,deny
11859,64147,0,0,62,62,0,1,0,1,0,deny
14252,35993,0,0,66,66,0,1,0,1,0,deny
27005,12345,54236,12345,898,126,772,2,30,1,1,allow
55192,53,45038,53,172,88,84,2,30,1,1,allow
11295,40033,39520,40033,213,89,124,4,49,2,2,allow
39983,80,29072,80,1614,1300,314,10,16,5,5,allow
50329,443,35211,443,12026,3494,8532,28,82,14,14,allow
51818,43942,60184,43942,156,66,90,2,5,1,1,allow
5588,5588,0,0,3354,1792,1562,46,192,23,23,allow
50759,53,62224,53,578,286,292,9,16,5,4,allow
37842,443,37842,443,109189,6692,102497,151,80,69,82,allow
55311,53,55274,53,298,101,197,4,31,2,2,allow
46404,53,46404,53,237,91,146,2,32,1,1,allow
65446,53,45033,53,204,104,100,2,30,1,1,allow
64461,53,10856,53,170,87,83,2,30,1,1,allow
64414,53,6612,53,186,95,91,2,30,1,1,allow
56788,53,36118,53,198,101,97,2,30,1,1,allow
38160,443,38160,443,11290,5394,5896,37,80,21,16,allow
45939,443,45939,443,4504,1597,2907,19,27,11,8,allow
37234,443,63563,443,1622,1137,485,11,26,7,4,allow
63807,38976,41497,38976,66,66,0,1,5,1,0,allow
49296,443,51414,443,7419,2173,5246,17,16,9,8,allow
51832,40607,46819,40607,70,70,0,2,7,2,0,allow
39582,80,57536,80,1614,1300,314,10,15,5,5,allow
33960,22,33960,22,5468,1991,3477,27,34,15,12,allow
64882,53,2357,53,176,90,86,2,30,1,1,allow
17018,53,17018,53,217,87,130,2,30,1,1,allow
50277,80,19151,80,12764,7749,5015,28,84,14,14,allow
54371,443,18994,443,11828,2811,9017,31,76,16,15,allow
50317,80,56458,80,3800,2776,1024,16,83,9,7,allow
49962,53,19275,53,184,94,90,2,31,1,1,allow
36236,443,36236,443,4625,1718,2907,19,31,11,8,allow
63809,45193,55077,45193,66,66,0,1,5,1,0,allow
49749,53,61513,53,200,102,98,2,30,1,1,allow
54370,443,2250,443,11876,2769,9107,30,76,15,15,allow
37977,443,37977,443,5763,2553,3210,24,80,14,10,allow
54124,80,4965,80,1594,1280,314,10,15,5,5,allow
51842,27665,50059,27665,70,70,0,1,5,1,0,allow
55810,53,12633,53,182,93,89,2,30,1,1,allow
59134,80,59134,80,104133,2163,101970,103,15,32,71,allow
38888,22,38888,22,5130,2103,3027,28,25,16,12,allow
56978,53,58165,53,774,101,673,2,30,1,1,allow
57202,53,47171,53,184,94,90,2,30,1,1,allow
55171,53,21824,53,198,101,97,2,31,1,1,allow
55788,53,13740,53,755,93,662,2,31,1,1,allow
64128,53,11418,53,186,95,91,2,31,1,1,allow
54356,80,42803,80,9608,746,8862,19,82,9,10,allow
54372,443,7862,443,11828,2811,9017,31,76,16,15,allow
32846,80,52606,80,1644,1324,320,10,15,5,5,allow
50316,80,40877,80,2062,872,1190,13,83,7,6,allow
18907,53,18907,53,237,91,146,2,32,1,1,allow
59298,443,18109,443,20971,2840,18131,52,89,24,28,allow
58077,36653,53473,36653,204,64,140,4,11,2,2,allow
50330,443,24584,443,9585,2138,7447,26,82,13,13,allow
53625,39198,33493,39198,552,306,246,9,16,5,4,allow
55095,53,24827,53,188,96,92,2,30,1,1,allow
27005,37569,49792,37569,892,126,766,2,30,1,1,allow
55042,53,54765,53,782,105,677,2,30,1,1,allow
65117,53,5041,53,196,100,96,2,31,1,1,allow
13257,53,13257,53,227,88,139,2,31,1,1,allow
27005,23333,15007,23333,890,126,764,2,30,1,1,allow
64719,53,59437,53,192,98,94,2,30,1,1,allow
65487,53,21256,53,184,94,90,2,30,1,1,allow
57150,53,55226,53,164,84,80,2,30,1,1,allow
55997,53,30863,53,716,95,621,2,30,1,1,allow
49263,53,22784,53,172,88,84,2,31,1,1,allow
60914,53,60914,53,220,100,120,2,31,1,1,allow
64266,53,49573,53,168,86,82,2,31,1,1,allow
57470,22070,58715,22070,559,198,361,5,1200,4,1,allow
56455,53,48314,53,182,93,89,2,31,1,1,allow
64538,53,28152,53,188,96,92,2,31,1,1,allow
57406,53,60835,53,188,96,92,2,30,1,1,allow
64169,53,10688,53,202,103,99,2,30,1,1,allow
56846,53,23614,53,192,98,94,2,31,1,1,allow
56837,53,43966,53,176,90,86,2,31,1,1,allow
55271,53,11109,53,168,86,82,2,31,1,1,allow
63964,53,46604,53,190,97,93,2,31,1,1,allow
64482,53,10257,53,192,98,94,2,31,1,1,allow
54976,443,15305,443,10335,2317,8018,24,188,13,11,allow
33967,80,35208,80,1836,662,1174,15,3826,6,9,allow
49317,53,61249,53,164,84,80,2,31,1,1,allow
27005,30010,6041,30010,887,126,761,2,31,1,1,allow
55066,53,18793,53,176,90,86,2,31,1,1,allow
39392,80,20430,80,1325,442,883,16,414,4,12,allow
56945,53,27105,53,176,90,86,2,31,1,1,allow
64695,53,9580,53,186,95,91,2,31,1,1,allow
54800,443,18015,443,18814,10011,8803,42,129,21,21,allow
57470,34879,21991,34879,1914,1914,0,30,1766,30,0,allow
35461,5228,26150,5228,8648,2111,6537,40,7038,21,19,allow
55191,445,0,0,66,66,0,1,0,1,0,drop
59792,445,0,0,70,70,0,1,0,1,0,drop
19698,502,0,0,60,60,0,1,0,1,0,deny
53043,51050,0,0,66,66,0,1,0,1,0,deny
46576,23718,0,0,62,62,0,1,0,1,0,deny
32768,22,0,0,60,60,0,1,0,1,0,deny
54836,445,0,0,70,70,0,1,0,1,0,drop
58343,23718,0,0,66,66,0,1,0,1,0,deny
55188,445,0,0,66,66,0,1,0,1,0,drop
58564,50432,0,0,66,66,0,1,0,1,0,deny
443,62451,0,0,199,199,0,1,0,1,0,deny
60970,20541,0,0,66,66,0,1,0,1,0,deny
37428,53,37182,53,168,78,90,2,30,1,1,allow
64169,53,8733,53,209,110,99,2,30,1,1,allow
49431,53,43013,53,194,102,92,2,30,1,1,allow
65331,53,36726,53,193,102,91,2,30,1,1,allow
45472,8168,0,0,62,62,0,1,0,1,0,deny
54828,445,0,0,70,70,0,1,0,1,0,drop
55182,445,0,0,66,66,0,1,0,1,0,drop
54827,445,0,0,70,70,0,1,0,1,0,drop
55174,445,0,0,66,66,0,1,0,1,0,drop
34731,22114,0,0,62,62,0,1,0,1,0,deny
52526,30188,0,0,66,66,0,1,0,1,0,deny
55075,8080,0,0,60,60,0,1,0,1,0,deny
43111,8080,0,0,60,60,0,1,0,1,0,deny
54822,445,0,0,70,70,0,1,0,1,0,drop
48929,62609,0,0,148,148,0,1,0,1,0,deny
54820,445,0,0,70,70,0,1,0,1,0,drop
4772,37965,0,0,66,66,0,1,0,1,0,deny
59782,445,0,0,70,70,0,1,0,1,0,drop
59779,445,0,0,70,70,0,1,0,1,0,drop
59780,445,0,0,70,70,0,1,0,1,0,drop
3117,37965,0,0,62,62,0,1,0,1,0,deny
59505,53733,0,0,62,62,0,1,0,1,0,deny
55163,445,0,0,66,66,0,1,0,1,0,drop
55164,445,0,0,66,66,0,1,0,1,0,drop
55162,445,0,0,66,66,0,1,0,1,0,drop
55166,445,0,0,66,66,0,1,0,1,0,drop
55165,445,0,0,66,66,0,1,0,1,0,drop
55159,445,0,0,66,66,0,1,0,1,0,drop
55158,445,0,0,66,66,0,1,0,1,0,drop
55161,445,0,0,66,66,0,1,0,1,0,drop
39548,8696,0,0,60,60,0,1,0,1,0,deny
54816,445,0,0,70,70,0,1,0,1,0,drop
52887,37807,0,0,62,62,0,1,0,1,0,deny
54815,445,0,0,70,70,0,1,0,1,0,drop
62566,35993,0,0,62,62,0,1,0,1,0,deny
6889,25975,0,0,143,143,0,1,0,1,0,deny
10216,11392,0,0,66,66,0,1,0,1,0,deny
51620,56205,0,0,66,66,0,1,0,1,0,deny
53453,2767,0,0,62,62,0,1,0,1,0,deny
1694,30188,0,0,62,62,0,1,0,1,0,deny
59770,445,0,0,70,70,0,1,0,1,0,drop
59765,445,0,0,70,70,0,1,0,1,0,drop
59763,445,0,0,70,70,0,1,0,1,0,drop
54810,445,0,0,70,70,0,1,0,1,0,drop
36943,10387,0,0,159,159,0,1,0,1,0,deny
55146,445,0,0,66,66,0,1,0,1,0,drop
50140,53,17472,53,209,110,99,2,30,1,1,allow
56536,53,64182,53,209,110,99,2,30,1,1,allow
49812,53,11228,53,166,86,80,2,30,1,1,allow
47866,53,1378,53,199,94,105,2,30,1,1,allow
65085,53,47896,53,196,94,102,2,30,1,1,allow
49843,53,21434,53,193,102,91,2,30,1,1,allow
65100,53,65386,53,720,94,626,2,30,1,1,allow
52319,443,62232,443,569666,25343,544323,721,46,320,401,allow
38701,443,3001,443,4478,1133,3345,13,27,8,5,allow
56312,443,54503,443,564,292,272,9,25,5,4,allow
52406,443,12118,443,11463,850,10613,23,25,7,16,allow
49662,443,52708,443,4353,1145,3208,17,25,9,8,allow
51439,443,29374,443,396,66,330,7,17,2,5,allow
54361,443,48340,443,12268,2979,9289,35,81,18,17,allow
52501,80,52501,80,79714,5592,74122,102,23,45,57,allow
54369,443,44287,443,11876,2769,9107,30,77,15,15,allow
49663,443,36491,443,4271,1075,3196,16,25,8,8,allow
52931,80,5991,80,234,234,0,4,11,4,0,allow
53123,59228,59037,59228,70,70,0,1,4,1,0,allow
50278,443,46463,443,6466,2862,3604,21,163,11,10,allow
50473,80,6625,80,1658,1247,411,8,15,5,3,allow
41440,443,30380,443,4370,1148,3222,17,25,9,8,allow
42557,443,48761,443,123082,8734,114348,200,84,101,99,allow
38700,443,59895,443,4478,1133,3345,13,27,8,5,allow
38406,443,5076,443,564,292,272,9,26,5,4,allow
50277,443,12688,443,3937,1191,2746,20,163,9,11,allow
56086,53,3323,53,172,94,78,2,29,1,1,allow
57202,53,54278,53,293,94,199,4,43,2,2,allow
55095,53,63653,53,194,102,92,2,29,1,1,allow
65487,53,58054,53,184,94,90,2,29,1,1,allow
55810,53,35208,53,183,94,89,2,29,1,1,allow
64559,53,60231,53,258,110,148,2,29,1,1,allow
58850,53,58850,53,231,90,141,2,29,1,1,allow
57150,53,42037,53,166,86,80,2,29,1,1,allow
49667,443,61228,443,334,140,194,6,25,3,3,allow
65446,53,26325,53,210,110,100,2,30,1,1,allow
56322,53,21211,53,166,86,80,2,29,1,1,allow
55786,53,41972,53,200,102,98,2,29,1,1,allow
49379,53,28766,53,199,102,97,2,30,1,1,allow
55627,53,60150,53,193,102,91,2,30,1,1,allow
57109,53,6255,53,168,86,82,2,30,1,1,allow
57120,443,27868,443,23906,9380,14526,40,16,24,16,allow
53631,43562,1567,43562,492,306,186,8,15,5,3,allow
51830,32787,47434,32787,70,70,0,2,6,2,0,allow
64942,53,20482,53,215,94,121,2,30,1,1,allow
57406,53,49515,53,194,102,92,2,30,1,1,allow
49749,53,60642,53,200,102,98,2,30,1,1,allow
54995,53,57538,53,199,102,97,2,30,1,1,allow
64461,53,2582,53,177,94,83,2,30,1,1,allow
39872,53,48299,53,78,78,0,1,30,1,0,allow
49962,53,48309,53,184,94,90,2,30,1,1,allow
57292,53,58837,53,395,102,293,2,30,1,1,allow
47136,53,53463,53,222,78,144,2,30,1,1,allow
56619,443,13998,443,6895,2273,4622,21,17,12,9,allow
55171,53,40871,53,199,102,97,2,30,1,1,allow
46848,80,53629,80,25162,23336,1826,34,19,21,13,allow
55271,53,6211,53,168,86,82,2,30,1,1,allow
46509,53,4834,53,168,78,90,2,30,1,1,allow
50468,80,2157,80,314,192,122,6,28,4,2,allow
57406,53,10288,53,194,102,92,2,30,1,1,allow
36042,53,8305,53,168,78,90,2,30,1,1,allow
51918,443,34743,443,28031,11553,16478,122,108,61,61,allow
51954,443,51642,443,2995,1894,1101,20,46,11,9,allow
49761,53,14047,53,183,94,89,2,30,1,1,allow
60340,80,29761,80,9406,1913,7493,14,16,7,7,allow
49006,443,37569,443,119425284,929428,118495856,93687,498,9675,84012,allow
65446,53,21925,53,210,110,100,2,30,1,1,allow
38576,443,38576,443,225915,9896,216019,283,80,128,155,allow
64719,53,8538,53,381,98,283,4,51,2,2,allow
64169,53,20022,53,209,110,99,2,30,1,1,allow
21082,53,21082,53,226,90,136,2,30,1,1,allow
54427,53,16738,53,199,94,105,2,30,1,1,allow
64559,53,43720,53,168,86,82,2,30,1,1,allow
54429,443,55314,443,9970,3706,6264,44,272,21,23,allow
49171,53,3246,53,199,102,97,2,30,1,1,allow
49654,53,49736,53,184,94,90,2,30,1,1,allow
56455,53,58599,53,183,94,89,2,30,1,1,allow
50290,53,2460,53,211,110,101,2,30,1,1,allow
55627,53,4823,53,193,102,91,2,30,1,1,allow
50321,443,43498,443,8156,1586,6570,24,82,11,13,allow
51833,47388,26582,47388,70,70,0,2,6,2,0,allow
49761,53,31558,53,183,94,89,2,30,1,1,allow
49654,53,26382,53,184,94,90,2,30,1,1,allow
46734,53,39721,53,168,78,90,2,30,1,1,allow
55849,53,3530,53,889,404,485,10,30,5,5,allow
56788,53,30869,53,199,102,97,2,30,1,1,allow
55935,53,36129,53,819,102,717,2,30,1,1,allow
55967,53,30635,53,209,110,99,2,30,1,1,allow
49787,53,35169,53,193,102,91,2,30,1,1,allow
56822,39352,35185,39352,70,70,0,1,5,1,0,allow
49475,53,56421,53,196,102,94,2,30,1,1,allow
56113,53,57844,53,194,102,92,2,30,1,1,allow
55935,53,44322,53,196,102,94,2,30,1,1,allow
65482,53,43448,53,179,94,85,2,30,1,1,allow
63964,53,35341,53,195,102,93,2,30,1,1,allow
56788,53,1582,53,199,102,97,2,30,1,1,allow
55192,53,17598,53,178,94,84,2,30,1,1,allow
65122,53,25897,53,410,110,300,2,30,1,1,allow
64904,53,63887,53,199,102,97,2,30,1,1,allow
64396,53,1161,53,211,102,109,2,30,1,1,allow
52320,443,52845,443,65770,4466,61304,94,46,44,50,allow
51691,993,8747,993,17462,4583,12879,93,19,47,46,allow
14433,443,47619,443,2589,1443,1146,18,15,8,10,allow
51689,993,61833,993,11580,4032,7548,79,19,40,39,allow
52191,443,40696,443,7018,1766,5252,23,19,13,10,allow
35610,80,8611,80,1970,977,993,12,61,7,5,allow
32729,3389,32729,3389,4021,1916,2105,20,18,12,8,allow
60720,443,36383,443,41921,15385,26536,69,34,37,32,allow
34613,80,39992,80,1013,504,509,10,17,6,4,allow
61694,443,25571,443,8696,3245,5451,36,47,16,20,allow
38672,443,23620,443,4478,1133,3345,13,35,8,5,allow
56614,443,7546,443,20451,1899,18552,33,17,14,19,allow
53621,443,63130,443,2005,1100,905,16,17,9,7,allow
61689,443,8639,443,8036,3293,4743,32,48,18,14,allow
22,37469,22,37469,178,118,60,2,4,1,1,allow
39336,443,13653,443,4362,1145,3217,17,25,9,8,allow
51828,11916,54336,11916,316,136,180,6,6,3,3,allow
53590,8999,22601,8999,1207,605,602,10,25,5,5,allow
55730,8060,62180,8060,70,70,0,2,7,2,0,allow
39340,443,15093,443,334,140,194,6,25,3,3,allow
38807,443,38807,443,5741,2532,3209,24,80,14,10,allow
28007,443,65025,443,10168,968,9200,19,15,9,10,allow
50319,443,50669,443,9933,2306,7627,27,82,13,14,allow
38573,443,38573,443,5744,2534,3210,24,80,14,10,allow
54959,53,54959,53,230,90,140,2,29,1,1,allow
50337,443,21907,443,9653,1740,7913,23,81,12,11,allow
64904,53,57832,53,199,102,97,2,29,1,1,allow
60761,53,45233,53,198,86,112,2,29,1,1,allow
56677,53,50989,53,286,103,183,4,49,2,2,allow
57202,53,37225,53,184,94,90,2,29,1,1,allow
55810,53,11576,53,183,94,89,2,29,1,1,allow
56655,53,57319,53,209,110,99,2,29,1,1,allow
49171,53,6707,53,199,102,97,2,30,1,1,allow
57346,53,18432,53,210,110,100,2,29,1,1,allow
50257,53,50801,53,199,102,97,2,29,1,1,allow
57096,53,11827,53,198,102,96,2,30,1,1,allow
123,123,8340,123,184,94,90,2,29,1,1,allow
49962,53,28111,53,184,94,90,2,30,1,1,allow
57072,53,14779,53,195,102,93,2,30,1,1,allow
57296,53,58059,53,200,102,98,2,29,1,1,allow
49265,53,28768,53,181,94,87,2,29,1,1,allow
56455,53,12391,53,183,94,89,2,30,1,1,allow
65229,53,24708,53,195,102,93,2,30,1,1,allow
50140,53,26490,53,209,110,99,2,30,1,1,allow
57296,53,48552,53,200,102,98,2,30,1,1,allow
65331,53,63156,53,816,102,714,2,30,1,1,allow
57096,53,39504,53,198,102,96,2,30,1,1,allow
55967,53,41577,53,209,110,99,2,30,1,1,allow
50629,53,6662,53,756,94,662,2,30,1,1,allow
64882,53,14352,53,180,94,86,2,30,1,1,allow
65342,53,59254,53,183,94,89,2,30,1,1,allow
56846,53,43478,53,196,102,94,2,30,1,1,allow
57095,53,22428,53,211,110,101,2,30,1,1,allow
63964,53,34726,53,195,102,93,2,30,1,1,allow
55066,53,62750,53,180,94,86,2,30,1,1,allow
56846,53,22209,53,196,102,94,2,31,1,1,allow
56907,53,11065,53,193,102,91,2,31,1,1,allow
57470,6890,10619,6890,520,166,354,2,1199,1,1,allow
32768,53,4546,53,86,86,0,1,30,1,0,allow
55095,53,40942,53,194,102,92,2,30,1,1,allow
64256,53,29163,53,244,94,150,2,30,1,1,allow
64634,53,16629,53,786,110,676,2,30,1,1,allow
41764,443,65468,443,9028,5092,3936,36,257,12,24,allow
64071,53,55557,53,194,102,92,2,31,1,1,allow
49317,53,16697,53,166,86,80,2,31,1,1,allow
49379,53,24029,53,199,102,97,2,30,1,1,allow
55025,443,34661,443,7654,2110,5544,21,46,13,8,allow
53620,443,60649,443,15422,1623,13799,34,18,14,20,allow
56583,443,5338,443,9416,2366,7050,25,19,14,11,allow
51831,26270,32908,26270,70,70,0,2,6,2,0,allow
8432,23,8432,23,130,66,64,2,5,1,1,allow
34896,53,34896,53,231,90,141,2,30,1,1,allow
65385,53,9523,53,227,110,117,2,30,1,1,allow
57352,53,35059,53,816,102,714,2,30,1,1,allow
56952,53,60759,53,193,102,91,2,30,1,1,allow
64260,53,40725,53,230,86,144,2,30,1,1,allow
49236,53,40534,53,723,102,621,2,30,1,1,allow
49544,53,31008,53,226,86,140,2,30,1,1,allow
64112,53,32226,53,281,94,187,2,30,1,1,allow
55311,53,15716,53,298,101,197,4,31,2,2,allow
55311,53,38927,53,298,101,197,4,31,2,2,allow
64439,53,35218,53,199,102,97,2,31,1,1,allow
55618,53,59211,53,255,102,153,2,30,1,1,allow
50899,80,61517,80,130,70,60,2,15,1,1,allow
51665,443,64553,443,8783,4321,4462,39,94,19,20,allow
49654,53,5508,53,184,94,90,2,30,1,1,allow
56113,53,19299,53,817,102,715,2,30,1,1,allow
57352,53,28583,53,193,102,91,2,30,1,1,allow
56846,53,45229,53,196,102,94,2,30,1,1,allow
23414,53,23414,53,197,90,107,2,30,1,1,allow
49749,53,2042,53,200,102,98,2,30,1,1,allow
49787,53,19694,53,193,102,91,2,30,1,1,allow
55171,53,44438,53,199,102,97,2,30,1,1,allow
56788,53,32214,53,199,102,97,2,30,1,1,allow
55050,443,45507,443,1480,1029,451,11,151,6,5,allow
55311,53,61632,53,298,101,197,4,31,2,2,allow
50326,443,7479,443,7819,2474,5345,25,82,13,12,allow
49431,53,39469,53,817,102,715,2,30,1,1,allow
49475,53,30283,53,819,102,717,2,30,1,1,allow
54995,53,9641,53,199,102,97,2,30,1,1,allow
59979,443,21635,443,30171,25514,4657,77,37,42,35,allow
54211,53,7944,53,339,94,245,2,30,1,1,allow
50290,53,11389,53,211,110,101,2,30,1,1,allow
65342,53,40557,53,183,94,89,2,30,1,1,allow
64128,53,37051,53,193,102,91,2,30,1,1,allow
65487,53,62444,53,184,94,90,2,30,1,1,allow
64169,53,31527,53,209,110,99,2,30,1,1,allow
56952,53,29584,53,193,102,91,2,30,1,1,allow
49263,53,43703,53,178,94,84,2,30,1,1,allow
56773,53,31138,53,183,94,89,2,30,1,1,allow
65117,53,17216,53,198,102,96,2,30,1,1,allow
56200,53,10019,53,211,110,101,2,30,1,1,allow
64565,53,48582,53,226,110,116,2,30,1,1,allow
57406,53,8433,53,194,102,92,2,31,1,1,allow
56769,53,51571,53,183,94,89,2,31,1,1,allow
55049,443,4491,443,1600,1089,511,13,151,7,6,allow
36262,53,36262,53,216,90,126,2,30,1,1,allow
64414,53,43076,53,193,102,91,2,30,1,1,allow
49472,53,42476,53,210,110,100,2,31,1,1,allow
56200,53,31034,53,211,110,101,2,31,1,1,allow
49962,53,58375,53,184,94,90,2,31,1,1,allow
27005,27015,60094,27015,876,126,750,2,31,1,1,allow
64128,53,2686,53,193,102,91,2,30,1,1,allow
55023,53,43972,53,216,102,114,2,30,1,1,allow
56907,53,52225,53,193,102,91,2,30,1,1,allow
49263,53,17752,53,178,94,84,2,30,1,1,allow
49749,53,47748,53,200,102,98,2,30,1,1,allow
65117,53,1871,53,198,102,96,2,30,1,1,allow
63981,53,11790,53,199,102,97,2,30,1,1,allow
48822,53,49162,53,168,78,90,2,30,1,1,allow
35218,53,23519,53,168,78,90,2,30,1,1,allow
56907,53,55203,53,193,102,91,2,30,1,1,allow
49472,53,37751,53,210,110,100,2,30,1,1,allow
56837,53,12687,53,180,94,86,2,30,1,1,allow
16857,53,16857,53,832,106,726,2,30,1,1,allow
55066,53,23255,53,180,94,86,2,31,1,1,allow
65446,53,24128,53,210,110,100,2,30,1,1,allow
56455,53,54287,53,183,94,89,2,31,1,1,allow
27005,27080,13244,27080,926,126,800,2,31,1,1,allow
27005,29999,13147,29999,876,126,750,2,31,1,1,allow
61745,443,5419,443,8123,5308,2815,18,134,9,9,allow
46129,443,13770,443,6255,1125,5130,26,413,9,17,allow
55048,443,61386,443,1600,1089,511,13,151,7,6,allow
49379,53,35998,53,199,102,97,2,31,1,1,allow
1100,27540,2700,27540,132,70,62,2,31,1,1,allow
21133,63622,33830,63622,150,150,0,1,1199,1,0,allow
57470,51413,18747,51413,604,275,329,4,1199,2,2,allow
27005,27001,28063,27001,887,126,761,2,31,1,1,allow
50470,80,36047,80,8593,2011,6582,17,23,8,9,allow
49354,443,56660,443,4379,2565,1814,24,81,11,13,allow
60371,443,40685,443,7202,2596,4606,24,83,12,12,allow
40103,443,5740,443,416,210,206,7,34,4,3,allow
60079,80,9698,80,31418,1784,29634,37,126,14,23,allow
41233,443,15671,443,1807,1048,759,16,26,8,8,allow
27005,29999,60743,29999,887,126,761,2,31,1,1,allow
50313,80,19871,80,3450,1386,2064,15,83,8,7,allow
54676,443,17245,443,5747,1892,3855,19,17,11,8,allow
60395,443,53609,443,10672,1729,8943,24,81,12,12,allow
41235,443,2013,443,1807,1048,759,16,26,8,8,allow
49349,53,37003,53,183,94,89,2,31,1,1,allow
27005,27015,35363,27015,884,126,758,2,31,1,1,allow
49735,443,60036,443,378,256,122,7,18,5,2,allow
39065,443,4463,443,3589,1251,2338,15,20,9,6,allow
50310,80,45251,80,2958,1116,1842,15,83,8,7,allow
56624,80,12583,80,234,234,0,4,12,4,0,allow
55143,445,0,0,66,66,0,1,0,1,0,drop
55145,445,0,0,66,66,0,1,0,1,0,drop
59210,8168,0,0,66,66,0,1,0,1,0,deny
52563,17235,0,0,74,74,0,1,0,1,0,deny
1070,26467,0,0,62,62,0,1,0,1,0,deny
55986,26467,0,0,66,66,0,1,0,1,0,deny
59761,445,0,0,70,70,0,1,0,1,0,drop
63731,26467,0,0,66,66,0,1,0,1,0,deny
35944,23,0,0,60,60,0,1,0,1,0,deny
28878,51505,0,0,146,146,0,1,0,1,0,deny
443,62451,0,0,199,199,0,1,0,1,0,deny
48692,57470,0,0,62,62,0,1,0,1,0,deny
59759,445,0,0,70,70,0,1,0,1,0,drop
59756,445,0,0,70,70,0,1,0,1,0,drop
59750,445,0,0,70,70,0,1,0,1,0,drop
59749,445,0,0,70,70,0,1,0,1,0,drop
33324,42873,0,0,62,62,0,1,0,1,0,deny
15296,37965,0,0,62,62,0,1,0,1,0,deny
10166,44847,0,0,62,62,0,1,0,1,0,deny
54797,445,0,0,70,70,0,1,0,1,0,drop
54790,1433,0,0,60,60,0,1,0,1,0,deny
63221,53436,0,0,62,62,0,1,0,1,0,deny
54794,445,0,0,70,70,0,1,0,1,0,drop
54858,51505,0,0,66,66,0,1,0,1,0,deny
49992,5900,0,0,60,60,0,1,0,1,0,deny
59740,445,0,0,70,70,0,1,0,1,0,drop
59736,445,0,0,70,70,0,1,0,1,0,drop
59737,445,0,0,70,70,0,1,0,1,0,drop
54789,445,0,0,70,70,0,1,0,1,0,drop
17873,23117,0,0,66,66,0,1,0,1,0,deny
54788,445,0,0,70,70,0,1,0,1,0,drop
58286,37965,0,0,66,66,0,1,0,1,0,deny
19632,37965,0,0,62,62,0,1,0,1,0,deny
4545,1900,0,0,136,136,0,1,0,1,0,deny
64066,23718,0,0,62,62,0,1,0,1,0,deny
5664,36237,0,0,66,66,0,1,0,1,0,deny
54786,445,0,0,70,70,0,1,0,1,0,drop
3504,23,0,0,60,60,0,1,0,1,0,deny
43916,21,0,0,60,60,0,1,0,1,0,deny
42532,22114,0,0,146,146,0,1,0,1,0,deny
57899,34317,0,0,145,145,0,1,0,1,0,deny
15922,44847,0,0,66,66,0,1,0,1,0,deny
55123,445,0,0,66,66,0,1,0,1,0,drop
59734,445,0,0,70,70,0,1,0,1,0,drop
59733,445,0,0,70,70,0,1,0,1,0,drop
60129,55442,0,0,66,66,0,1,0,1,0,deny
55968,56205,0,0,66,66,0,1,0,1,0,deny
60162,53436,0,0,66,66,0,1,0,1,0,deny
54779,445,0,0,70,70,0,1,0,1,0,drop
53490,62413,0,0,66,66,0,1,0,1,0,deny
55933,64097,0,0,62,62,0,1,0,1,0,deny
443,62451,0,0,199,199,0,1,0,1,0,deny
54777,445,0,0,70,70,0,1,0,1,0,drop
34083,22,0,0,60,60,0,1,0,1,0,deny
51172,44847,0,0,66,66,0,1,0,1,0,deny
55116,445,0,0,66,66,0,1,0,1,0,drop
57500,37965,0,0,62,62,0,1,0,1,0,deny
2021,44847,0,0,66,66,0,1,0,1,0,deny
55114,445,0,0,66,66,0,1,0,1,0,drop
54776,445,0,0,70,70,0,1,0,1,0,drop
59724,445,0,0,70,70,0,1,0,1,0,drop
54775,445,0,0,70,70,0,1,0,1,0,drop
54774,445,0,0,70,70,0,1,0,1,0,drop
59718,445,0,0,70,70,0,1,0,1,0,drop
59711,445,0,0,70,70,0,1,0,1,0,drop
59712,445,0,0,70,70,0,1,0,1,0,drop
54770,445,0,0,70,70,0,1,0,1,0,drop
54772,445,0,0,70,70,0,1,0,1,0,drop
63778,50584,0,0,146,146,0,1,0,1,0,deny
58966,30188,0,0,66,66,0,1,0,1,0,deny
55110,445,0,0,66,66,0,1,0,1,0,drop
3377,50584,0,0,62,62,0,1,0,1,0,deny
54756,445,0,0,70,70,0,1,0,1,0,deny
54755,445,0,0,70,70,0,1,0,1,0,drop
54749,445,0,0,70,70,0,1,0,1,0,drop
59709,445,0,0,70,70,0,1,0,1,0,drop
57325,37965,0,0,62,62,0,1,0,1,0,deny
54745,445,0,0,70,70,0,1,0,1,0,drop
54746,445,0,0,70,70,0,1,0,1,0,drop
59703,445,0,0,70,70,0,1,0,1,0,drop
59704,445,0,0,70,70,0,1,0,1,0,drop
59700,445,0,0,70,70,0,1,0,1,0,drop
55105,445,0,0,66,66,0,1,0,1,0,drop
54742,50584,0,0,66,66,0,1,0,1,0,deny
50727,57470,0,0,78,78,0,1,0,1,0,deny
55102,445,0,0,66,66,0,1,0,1,0,drop
55099,445,0,0,66,66,0,1,0,1,0,drop
55097,445,0,0,66,66,0,1,0,1,0,drop
55095,445,0,0,66,66,0,1,0,1,0,drop
55094,445,0,0,66,66,0,1,0,1,0,drop
55093,445,0,0,66,66,0,1,0,1,0,drop
53779,51505,0,0,66,66,0,1,0,1,0,deny
17226,35440,0,0,62,62,0,1,0,1,0,deny
43363,26467,0,0,66,66,0,1,0,1,0,deny
13907,57470,0,0,66,66,0,1,0,1,0,deny
3803,51505,0,0,66,66,0,1,0,1,0,deny
10319,42707,0,0,62,62,0,1,0,1,0,deny
54734,445,0,0,70,70,0,1,0,1,0,drop
59697,445,0,0,70,70,0,1,0,1,0,drop
59696,445,0,0,70,70,0,1,0,1,0,drop
55090,445,0,0,66,66,0,1,0,1,0,drop
59691,445,0,0,70,70,0,1,0,1,0,drop
46901,26672,0,0,60,60,0,1,0,1,0,deny
55087,445,0,0,66,66,0,1,0,1,0,drop
44822,40108,0,0,145,145,0,1,0,1,0,deny
55085,445,0,0,66,66,0,1,0,1,0,drop
55083,445,0,0,66,66,0,1,0,1,0,drop
45941,23388,0,0,60,60,0,1,0,1,0,deny
51026,37450,0,0,62,62,0,1,0,1,0,deny
60750,42707,0,0,62,62,0,1,0,1,0,deny
55082,445,0,0,66,66,0,1,0,1,0,drop
54730,445,0,0,70,70,0,1,0,1,0,drop
56078,22,0,0,60,60,0,1,0,1,0,deny
60772,36829,0,0,62,62,0,1,0,1,0,deny
11677,44847,0,0,146,146,0,1,0,1,0,deny
59685,445,0,0,70,70,0,1,0,1,0,drop
57038,53,13307,53,735,88,647,2,30,1,1,allow
64017,53,51575,53,202,103,99,2,30,1,1,allow
57452,53,64588,53,774,101,673,2,30,1,1,allow
56677,53,25915,53,286,103,183,4,48,2,2,allow
55630,43736,23766,43736,70,70,0,2,8,2,0,allow
60435,80,6093,80,1155,781,374,10,15,6,4,allow
27005,27015,44800,27015,858,126,732,2,30,1,1,allow
37138,80,13348,80,1658,1344,314,10,16,5,5,allow
60413,43555,1703,43555,70,70,0,1,5,1,0,allow
57614,80,57614,80,470276,8994,461282,388,25,75,313,allow
60407,443,16001,443,7298,1737,5561,21,79,11,10,allow
60408,443,33443,443,7282,1596,5686,21,79,11,10,allow
49754,80,3257,80,1793,634,1159,11,15,6,5,allow
51920,443,50819,443,98155,20830,77325,151,103,70,81,allow
56820,19562,44411,19562,316,136,180,6,6,3,3,allow
57617,80,57617,80,542818,11392,531426,466,25,106,360,allow
65477,53,60369,53,182,93,89,2,31,1,1,allow
51921,443,16602,443,7970,4154,3816,39,102,23,16,allow
64711,53,44473,53,206,105,101,2,31,1,1,allow
48064,443,60858,443,7358,2661,4697,22,17,11,11,allow
56952,53,7156,53,186,95,91,2,30,1,1,allow
49733,443,55919,443,7673,1637,6036,31,23,16,15,allow
49379,53,1311,53,198,101,97,2,30,1,1,allow
50166,80,59884,80,2181,849,1332,14,97,7,7,allow
51111,80,36793,80,1614,1300,314,10,15,5,5,allow
56200,53,9546,53,206,105,101,2,30,1,1,allow
53979,80,42117,80,64091,62467,1624,61,16,48,13,allow
56769,53,28212,53,182,93,89,2,30,1,1,allow
39039,443,4727,443,572,292,280,9,32,5,4,allow
6881,34190,52438,34190,509,150,359,2,1200,1,1,allow
50774,443,8773,443,6074,4349,1725,22,361,11,11,allow
54996,80,15340,80,1979,826,1153,13,17,9,4,allow
58996,443,63733,443,4979,1505,3474,21,40,11,10,allow
60400,443,24179,443,7073,1556,5517,21,80,11,10,allow
45409,80,10508,80,1155,781,374,10,15,6,4,allow
36404,443,36404,443,4651,1744,2907,19,28,11,8,allow
63981,53,63404,53,198,101,97,2,30,1,1,allow
51829,46209,37314,46209,70,70,0,2,6,2,0,allow
51272,12210,19987,12210,70,70,0,2,8,2,0,allow
56340,53,20646,53,780,104,676,2,30,1,1,allow
57615,80,57615,80,126266,7980,118286,126,25,37,89,allow
47193,443,47193,443,4555,1648,2907,19,30,11,8,allow
54994,53,46934,53,747,90,657,2,30,1,1,allow
49750,80,55648,80,1788,628,1160,11,15,6,5,allow
64439,53,21739,53,198,101,97,2,30,1,1,allow
56907,53,30481,53,186,95,91,2,30,1,1,allow
16994,53,0,0,300,90,210,2,30,1,1,allow
49270,53,41673,53,735,88,647,2,30,1,1,allow
45232,53,0,0,82,82,0,1,31,1,0,allow
50428,443,32117,443,9844,4554,5290,24,92,13,11,allow
34366,53,0,0,82,82,0,1,31,1,0,allow
50265,48982,51729,48982,480,149,331,2,1200,1,1,allow
49601,53,30079,53,88,88,0,1,31,1,0,allow
49323,53,32529,53,204,104,100,2,31,1,1,allow
64071,53,30972,53,188,96,92,2,31,1,1,allow
64756,53,52664,53,190,97,93,2,31,1,1,allow
52254,443,36907,443,13640,2316,11324,24,136,10,14,allow
49905,53,43598,53,176,90,86,2,31,1,1,allow
49926,53,49666,53,176,90,86,2,31,1,1,allow
55487,53,20467,53,198,101,97,2,31,1,1,allow
63962,53,53078,53,188,96,92,2,31,1,1,allow
27005,27016,39937,27016,914,126,788,2,31,1,1,allow
49349,53,29426,53,182,93,89,2,31,1,1,allow
49282,53,46163,53,172,88,84,2,31,1,1,allow
27005,27022,10825,27022,890,126,764,2,31,1,1,allow
64484,53,55455,53,168,86,82,2,31,1,1,allow
49365,443,8370,443,3598,1145,2453,15,120,7,8,allow
50265,65535,43978,65535,222,132,90,4,1210,3,1,allow
1046,48817,0,0,62,62,0,1,0,1,0,deny
52633,30188,0,0,66,66,0,1,0,1,0,deny
54720,445,0,0,70,70,0,1,0,1,0,drop
54719,445,0,0,70,70,0,1,0,1,0,drop
59679,445,0,0,70,70,0,1,0,1,0,drop
59676,445,0,0,70,70,0,1,0,1,0,drop
54716,445,0,0,70,70,0,1,0,1,0,drop
54717,445,0,0,70,70,0,1,0,1,0,drop
20894,51505,0,0,62,62,0,1,0,1,0,deny
54713,445,0,0,70,70,0,1,0,1,0,drop
50316,37965,0,0,66,66,0,1,0,1,0,deny
55070,445,0,0,66,66,0,1,0,1,0,drop
56834,53,25406,53,178,94,84,2,30,1,1,allow
26795,443,14434,443,21804,16558,5246,43,21,24,19,allow
60891,443,59680,443,4895,3822,1073,24,49,13,11,allow
23089,48817,0,0,62,62,0,1,0,1,0,deny
1024,6881,0,0,146,146,0,1,0,1,0,deny
62029,36237,0,0,66,66,0,1,0,1,0,deny
55063,445,0,0,66,66,0,1,0,1,0,drop
54707,445,0,0,70,70,0,1,0,1,0,drop
43260,41615,0,0,145,145,0,1,0,1,0,deny
59663,445,0,0,70,70,0,1,0,1,0,drop
26408,64147,0,0,66,66,0,1,0,1,0,deny
26502,64147,0,0,62,62,0,1,0,1,0,deny
63456,37965,0,0,62,62,0,1,0,1,0,deny
43104,26467,0,0,62,62,0,1,0,1,0,deny
58811,53976,0,0,62,62,0,1,0,1,0,deny
55061,445,0,0,66,66,0,1,0,1,0,drop
54700,445,0,0,70,70,0,1,0,1,0,drop
58562,57587,0,0,66,66,0,1,0,1,0,deny
54698,445,0,0,70,70,0,1,0,1,0,drop
52095,56079,0,0,62,62,0,1,0,1,0,deny
55054,445,0,0,66,66,0,1,0,1,0,drop
26494,26467,0,0,62,62,0,1,0,1,0,deny
55043,445,0,0,66,66,0,1,0,1,0,drop
8239,37965,0,0,146,146,0,1,0,1,0,deny
50280,57470,0,0,78,78,0,1,0,1,0,deny
54693,445,0,0,70,70,0,1,0,1,0,drop
54692,445,0,0,70,70,0,1,0,1,0,drop
5774,37965,0,0,66,66,0,1,0,1,0,deny
54688,445,0,0,70,70,0,1,0,1,0,drop
63030,2222,0,0,66,66,0,1,0,1,0,deny
59651,445,0,0,70,70,0,1,0,1,0,drop
59653,445,0,0,70,70,0,1,0,1,0,drop
59652,445,0,0,70,70,0,1,0,1,0,drop
64266,53,27142,53,168,86,82,2,30,1,1,allow
49555,53,21166,53,199,102,97,2,30,1,1,allow
57290,53,54259,53,178,94,84,2,30,1,1,allow
41232,443,32307,443,1807,1048,759,16,25,8,8,allow
49732,443,42008,443,27125,14251,12874,99,23,57,42,allow
60397,443,49717,443,7643,1678,5965,21,80,11,10,allow
60403,443,3192,443,5567,1589,3978,20,80,11,9,allow
15930,53,15930,53,244,98,146,2,31,1,1,allow
55636,25569,50876,25569,320,140,180,6,6,3,3,allow
49731,443,14153,443,13155,3815,9340,29,24,13,16,allow
60413,443,19866,443,9398,2320,7078,24,77,13,11,allow
60396,443,5888,443,5964,1586,4378,19,80,10,9,allow
50152,80,46738,80,731402,17622,713780,600,97,116,484,allow
64439,53,36450,53,199,102,97,2,30,1,1,allow
55927,53,41588,53,720,94,626,2,29,1,1,allow
54431,443,24894,443,9398,2027,7371,33,270,14,19,allow
41234,443,28858,443,1741,1048,693,15,25,8,7,allow
60368,443,34243,443,6041,1830,4211,21,82,10,11,allow
57095,53,1337,53,211,110,101,2,29,1,1,allow
60393,443,31011,443,8049,1805,6244,23,81,12,11,allow
49734,443,18197,443,7548,1543,6005,22,18,12,10,allow
60369,443,26606,443,6052,1841,4211,21,82,10,11,allow
60370,443,62763,443,6045,1834,4211,21,82,10,11,allow
60389,443,56749,443,8166,1734,6432,23,81,12,11,allow
51837,37610,19513,37610,316,136,180,6,5,3,3,allow
55271,53,23423,53,168,86,82,2,30,1,1,allow
46403,443,21158,443,6035,1758,4277,27,1169,15,12,allow
54518,7000,54518,7000,3518,1951,1567,15,15,8,7,allow
51443,443,35232,443,322,66,256,6,16,2,4,allow
63129,47117,14419,47117,574,448,126,10,25,8,2,allow
51919,443,36228,443,17595,8241,9354,80,106,43,37,allow
36692,443,41344,443,996,526,470,15,30,8,7,allow
54653,6881,28676,6881,658,412,246,9,15,5,4,allow
65300,53,17594,53,329,88,241,4,50,2,2,allow
49175,443,3024,443,4429,2593,1836,34,1126,18,16,allow
27005,27015,14590,27015,901,126,775,2,30,1,1,allow
64695,53,52435,53,193,102,91,2,30,1,1,allow
64711,53,17611,53,211,110,101,2,30,1,1,allow
55773,53,34274,53,199,102,97,2,30,1,1,allow
49905,53,29720,53,180,94,86,2,30,1,1,allow
51816,27721,15774,27721,70,70,0,1,5,1,0,allow
57613,80,57613,80,349583,9149,340434,298,25,62,236,allow
45239,443,9489,443,11147,3412,7735,36,458,20,16,allow
33409,53,6047,53,241272,234761,6511,2872,89,2833,39,allow
6437,53,6437,53,229,90,139,2,30,1,1,allow
65477,53,61765,53,183,94,89,2,30,1,1,allow
55487,53,40739,53,199,102,97,2,30,1,1,allow
49747,53,62194,53,355,102,253,2,30,1,1,allow
57207,53,1251,53,195,102,93,2,30,1,1,allow
64105,53,18897,53,182,86,96,2,30,1,1,allow
64017,53,3169,53,209,110,99,2,30,1,1,allow
60415,40829,46260,40829,70,70,0,1,5,1,0,allow
51441,443,28224,443,322,66,256,6,16,2,4,allow
64266,53,43619,53,168,86,82,2,30,1,1,allow
49751,80,48363,80,1876,998,878,12,15,7,5,allow
2437,53,2437,53,229,90,139,2,30,1,1,allow
49602,53,63187,53,178,94,84,2,30,1,1,allow
9708,53,0,0,304,94,210,2,30,1,1,allow
49981,53,37329,53,438,180,258,6,30,3,3,allow
56769,53,53195,53,183,94,89,2,30,1,1,allow
64439,53,3142,53,199,102,97,2,30,1,1,allow
49555,53,37709,53,199,102,97,2,30,1,1,allow
57290,53,13860,53,178,94,84,2,30,1,1,allow
49602,53,1592,53,178,94,84,2,30,1,1,allow
56945,53,62206,53,180,94,86,2,30,1,1,allow
43937,123,21193,123,184,94,90,2,30,1,1,allow
64538,53,37074,53,194,102,92,2,30,1,1,allow
64482,53,15277,53,196,102,94,2,30,1,1,allow
55538,53,48787,53,195,102,93,2,30,1,1,allow
55773,53,61209,53,199,102,97,2,30,1,1,allow
47905,443,5382,443,172,172,0,2,5,2,0,allow
52143,443,25458,443,712,452,260,8,25,4,4,allow
64017,53,64345,53,325,103,222,4,45,2,2,allow
65213,53,54852,53,298,94,204,2,30,1,1,allow
55859,53,59697,53,210,110,100,2,30,1,1,allow
64695,53,11927,53,193,102,91,2,30,1,1,allow
56677,53,32244,53,286,103,183,4,48,2,2,allow
60414,52559,6876,52559,70,70,0,1,5,1,0,allow
57616,80,57616,80,266789,7684,259105,234,25,54,180,allow
56677,53,36331,53,286,103,183,4,48,2,2,allow
63981,53,13175,53,199,102,97,2,29,1,1,allow
60502,443,31971,443,416,210,206,7,28,4,3,allow
23725,80,23725,80,1100980,31101,1069879,1210,19,462,748,allow
50307,80,5299,80,2840,1750,1090,13,82,7,6,allow
55171,53,9139,53,199,102,97,2,29,1,1,allow
65460,53,21678,53,387,102,285,2,29,1,1,allow
65117,53,55253,53,542,100,442,4,51,2,2,allow
41236,443,52117,443,1807,1048,759,16,25,8,8,allow
56769,53,31740,53,183,94,89,2,30,1,1,allow
50059,443,43913,443,8205,2989,5216,42,115,21,21,allow
60412,443,58640,443,7353,1573,5780,21,78,11,10,allow
64128,53,50271,53,606,182,424,6,71,3,3,allow
34733,80,35506,80,1056,682,374,10,15,6,4,allow
60353,80,51111,80,1679,1269,410,8,15,5,3,allow
65159,53,58481,53,500,204,296,6,75,3,3,allow
55271,53,59088,53,168,86,82,2,29,1,1,allow
27005,37569,24512,37569,880,126,754,2,30,1,1,allow
64482,53,47729,53,196,102,94,2,30,1,1,allow
56773,53,53330,53,183,94,89,2,29,1,1,allow
49263,53,54586,53,178,94,84,2,30,1,1,allow
45863,53,45863,53,229,90,139,2,30,1,1,allow
49464,53,1533,53,213,102,111,2,30,1,1,allow
65477,53,57278,53,183,94,89,2,30,1,1,allow
56945,53,11659,53,180,94,86,2,30,1,1,allow
64711,53,46738,53,211,110,101,2,30,1,1,allow
49198,443,22902,443,533813,25885,507928,678,50,308,370,allow
57207,53,55086,53,195,102,93,2,30,1,1,allow
49926,53,63439,53,180,94,86,2,30,1,1,allow
64484,53,23929,53,86,86,0,1,30,1,0,allow
48155,443,36559,443,7395,1514,5881,26,225,11,15,allow
35796,443,15213,443,664348,23858,640490,757,119,292,465,allow
36834,80,37812,80,12993,6920,6073,22,20,13,9,allow
5588,5588,0,0,3354,1792,1562,46,194,23,23,allow
49268,53,5165,53,353,118,235,2,30,1,1,allow
55859,53,29640,53,210,110,100,2,30,1,1,allow
50006,53,55896,53,378,94,284,2,30,1,1,allow
65187,53,19736,53,392,86,306,2,30,1,1,allow
56200,53,42161,53,211,110,101,2,30,1,1,allow
65477,53,48091,53,183,94,89,2,30,1,1,allow
56618,443,31063,443,3096,1882,1214,19,16,10,9,allow
57618,80,57618,80,265909,7294,258615,235,25,55,180,allow
50116,22,50116,22,152,66,86,2,10,1,1,allow
57384,443,63051,443,546,280,266,9,28,5,4,allow
57591,443,27521,443,2614,1689,925,18,20,10,8,allow
55312,53,35283,53,438,180,258,6,30,3,3,allow
55066,53,27707,53,180,94,86,2,30,1,1,allow
64538,53,57273,53,194,102,92,2,30,1,1,allow
56945,53,12864,53,180,94,86,2,30,1,1,allow
54973,53,3418,53,308,102,206,2,30,1,1,allow
64642,53,54204,53,751,94,657,2,30,1,1,allow
50642,53,37858,53,775,102,673,2,30,1,1,allow
64017,53,52336,53,209,110,99,2,30,1,1,allow
49317,53,48476,53,166,86,80,2,30,1,1,allow
49905,53,25136,53,180,94,86,2,30,1,1,allow
55093,53,0,0,318,86,232,2,30,1,1,allow
55538,53,14832,53,195,102,93,2,30,1,1,allow
49349,53,14349,53,183,94,89,2,30,1,1,allow
64711,53,26786,53,211,110,101,2,30,1,1,allow
20388,53,20388,53,203,82,121,2,30,1,1,allow
49323,53,60402,53,210,110,100,2,31,1,1,allow
64808,53,34038,53,239,94,145,2,30,1,1,allow
55487,53,60324,53,199,102,97,2,31,1,1,allow
16403,16384,56995,16384,556,256,300,10,31,5,5,allow
64071,53,28084,53,424,104,320,4,31,2,2,allow
53654,53,13764,53,523,85,438,4,31,2,2,allow
64347,53,32269,53,193,102,91,2,30,1,1,allow
49160,12176,2844,12176,852,150,702,4,1200,2,2,allow
56834,53,6671,53,178,94,84,2,31,1,1,allow
27005,27014,60254,27014,879,126,753,2,31,1,1,allow
17750,27517,53975,27517,491,150,341,2,1200,1,1,allow
50182,443,50182,443,12509,1447,11062,28,122,16,12,allow
51238,443,29233,443,8034,2584,5450,39,16,23,16,allow
52776,80,21861,80,432,240,192,8,101,5,3,allow
48009,443,46874,443,4015,1813,2202,17,256,9,8,allow
35672,443,33861,443,938,576,362,14,27,9,5,allow
47450,443,22297,443,162,102,60,2,5,1,1,allow
51239,443,46781,443,9649,4615,5034,42,16,24,18,allow
50018,80,3941,80,825,685,140,6,33,4,2,allow
56806,46903,25071,46903,3060,1569,1491,12,17,7,5,allow
50973,80,57219,80,314164,13077,301087,356,25,144,212,allow
37253,443,5340,443,6840,1556,5284,32,26,17,15,allow
51807,10920,61477,10920,70,70,0,1,5,1,0,allow
49926,53,15614,53,180,94,86,2,30,1,1,allow
55038,445,0,0,66,66,0,1,0,1,0,drop
55030,445,0,0,66,66,0,1,0,1,0,drop
55034,445,0,0,66,66,0,1,0,1,0,drop
55036,445,0,0,66,66,0,1,0,1,0,drop
55035,445,0,0,66,66,0,1,0,1,0,drop
55033,445,0,0,66,66,0,1,0,1,0,drop
55037,445,0,0,66,66,0,1,0,1,0,drop
55031,445,0,0,66,66,0,1,0,1,0,drop
54687,445,0,0,70,70,0,1,0,1,0,drop
57564,56205,0,0,66,66,0,1,0,1,0,deny
60350,51505,0,0,66,66,0,1,0,1,0,deny
60312,57470,0,0,74,74,0,1,0,1,0,deny
49616,30188,0,0,66,66,0,1,0,1,0,deny
56785,39004,0,0,145,145,0,1,0,1,0,deny
42252,33303,0,0,60,60,0,1,0,1,0,deny
41346,30188,0,0,62,62,0,1,0,1,0,deny
54682,445,0,0,70,70,0,1,0,1,0,drop
48706,23393,0,0,60,60,0,1,0,1,0,deny
59649,445,0,0,70,70,0,1,0,1,0,drop
59637,445,0,0,70,70,0,1,0,1,0,drop
59635,445,0,0,70,70,0,1,0,1,0,drop
55018,445,0,0,66,66,0,1,0,1,0,drop
55015,445,0,0,66,66,0,1,0,1,0,drop
55016,445,0,0,66,66,0,1,0,1,0,drop
36566,37965,0,0,62,62,0,1,0,1,0,deny
58038,51505,0,0,146,146,0,1,0,1,0,deny
59634,445,0,0,70,70,0,1,0,1,0,drop
53459,37807,0,0,62,62,0,1,0,1,0,deny
13643,22114,0,0,146,146,0,1,0,1,0,deny
56582,37965,0,0,66,66,0,1,0,1,0,deny
17579,57470,0,0,62,62,0,1,0,1,0,deny
59631,445,0,0,70,70,0,1,0,1,0,drop
45964,2228,0,0,60,60,0,1,0,1,0,deny
59630,445,0,0,70,70,0,1,0,1,0,drop
59624,445,0,0,70,70,0,1,0,1,0,drop
59622,445,0,0,70,70,0,1,0,1,0,drop
54669,445,0,0,70,70,0,1,0,1,0,drop
54666,445,0,0,70,70,0,1,0,1,0,drop
58485,40740,0,0,145,145,0,1,0,1,0,deny
42865,55839,0,0,137,137,0,1,0,1,0,deny
43916,21,0,0,60,60,0,1,0,1,0,deny
10639,11392,0,0,62,62,0,1,0,1,0,deny
25469,57470,0,0,62,62,0,1,0,1,0,deny
65518,5710,0,0,62,62,0,1,0,1,0,deny
59612,445,0,0,70,70,0,1,0,1,0,drop
59610,445,0,0,70,70,0,1,0,1,0,drop
59609,445,0,0,70,70,0,1,0,1,0,drop
48676,53392,0,0,60,60,0,1,0,1,0,deny
54661,445,0,0,70,70,0,1,0,1,0,drop
44849,46478,0,0,74,74,0,1,0,1,0,deny
54660,445,0,0,70,70,0,1,0,1,0,drop
51920,30188,0,0,62,62,0,1,0,1,0,deny
57649,6881,0,0,146,146,0,1,0,1,0,deny
54658,445,0,0,70,70,0,1,0,1,0,drop
53774,51505,0,0,66,66,0,1,0,1,0,deny
11023,51505,0,0,66,66,0,1,0,1,0,deny
2425,23117,0,0,62,62,0,1,0,1,0,deny
54996,445,0,0,66,66,0,1,0,1,0,drop
34936,30188,0,0,66,66,0,1,0,1,0,deny
59606,445,0,0,70,70,0,1,0,1,0,drop
59604,445,0,0,70,70,0,1,0,1,0,drop
52929,1433,0,0,60,60,0,1,0,1,0,deny
52837,35440,0,0,66,66,0,1,0,1,0,deny
54651,445,0,0,70,70,0,1,0,1,0,drop
6666,8888,0,0,60,60,0,1,0,1,0,deny
52111,44847,0,0,62,62,0,1,0,1,0,deny
0,0,0,0,98,98,0,1,0,1,0,deny
52929,1433,0,0,60,60,0,1,0,1,0,deny
34808,22114,0,0,66,66,0,1,0,1,0,deny
54649,445,0,0,70,70,0,1,0,1,0,drop
54648,445,0,0,70,70,0,1,0,1,0,drop
13581,51505,0,0,62,62,0,1,0,1,0,deny
54988,445,0,0,66,66,0,1,0,1,0,drop
54647,445,0,0,70,70,0,1,0,1,0,drop
54196,11392,0,0,66,66,0,1,0,1,0,deny
54646,445,0,0,70,70,0,1,0,1,0,drop
41562,123,0,0,234,234,0,1,0,1,0,deny
54642,445,0,0,70,70,0,1,0,1,0,drop
54643,445,0,0,70,70,0,1,0,1,0,drop
54986,445,0,0,66,66,0,1,0,1,0,drop
59592,445,0,0,70,70,0,1,0,1,0,drop
59589,445,0,0,70,70,0,1,0,1,0,drop
59588,445,0,0,70,70,0,1,0,1,0,drop
59583,445,0,0,70,70,0,1,0,1,0,drop
54984,445,0,0,66,66,0,1,0,1,0,drop
52696,21247,0,0,66,66,0,1,0,1,0,deny
54628,445,0,0,70,70,0,1,0,1,0,drop
54627,445,0,0,70,70,0,1,0,1,0,drop
54624,445,0,0,70,70,0,1,0,1,0,drop
54618,445,0,0,70,70,0,1,0,1,0,drop
54617,445,0,0,70,70,0,1,0,1,0,drop
59563,56205,0,0,66,66,0,1,0,1,0,deny
59581,445,0,0,70,70,0,1,0,1,0,drop
46901,26672,0,0,60,60,0,1,0,1,0,deny
19875,30170,0,0,145,145,0,1,0,1,0,deny
59576,445,0,0,70,70,0,1,0,1,0,drop
59574,445,0,0,70,70,0,1,0,1,0,drop
59572,445,0,0,70,70,0,1,0,1,0,drop
24174,57470,0,0,62,62,0,1,0,1,0,deny
54977,445,0,0,66,66,0,1,0,1,0,drop
52177,25320,0,0,66,66,0,1,0,1,0,deny
54973,445,0,0,66,66,0,1,0,1,0,drop
54968,445,0,0,66,66,0,1,0,1,0,drop
54970,445,0,0,66,66,0,1,0,1,0,drop
62549,53733,0,0,66,66,0,1,0,1,0,deny
54967,445,0,0,66,66,0,1,0,1,0,drop
54964,445,0,0,66,66,0,1,0,1,0,drop
54965,445,0,0,66,66,0,1,0,1,0,drop
6037,43890,0,0,70,70,0,1,0,1,0,deny
4515,37807,0,0,62,62,0,1,0,1,0,deny
54606,445,0,0,70,70,0,1,0,1,0,drop
55201,22114,0,0,62,62,0,1,0,1,0,deny
17453,35440,0,0,66,66,0,1,0,1,0,deny
43047,80,45126,80,2088,472,1616,15,155,3,12,allow
27005,27015,61856,27015,888,126,762,2,30,1,1,allow
58805,80,4161,80,1702,1388,314,10,16,5,5,allow
55622,33342,17108,33342,70,70,0,1,5,1,0,allow
52912,53,52912,53,237,91,146,2,32,1,1,allow
53624,7370,56004,7370,70,70,0,1,5,1,0,allow
60325,80,16267,80,3697,2062,1635,16,61,9,7,allow
38820,80,32872,80,1150,613,537,10,16,6,4,allow
64367,443,15536,443,4741,1306,3435,26,300,14,12,allow
44949,443,16538,443,4093,2830,1263,21,24,11,10,allow
59210,80,59210,80,1990,833,1157,10,21,6,4,allow
57396,443,25332,443,9318,3350,5968,31,140,14,17,allow
37896,443,37896,443,4704,1797,2907,19,30,11,8,allow
51810,33776,47745,33776,66,66,0,1,5,1,0,allow
64366,443,7841,443,6205,1316,4889,27,301,14,13,allow
42567,80,40138,80,2161,1178,983,16,17,10,6,allow
42811,80,59018,80,1114,534,580,12,16,7,5,allow
60330,80,20724,80,374,192,182,7,61,4,3,allow
60329,80,45049,80,374,192,182,7,61,4,3,allow
52673,80,57831,80,23776,1372,22404,35,112,15,20,allow
53073,80,1603,80,2594,1200,1394,16,17,10,6,allow
60327,80,34206,80,2125,1159,966,13,61,7,6,allow
51811,20740,15988,20740,66,66,0,1,5,1,0,allow
57490,80,59652,80,1614,1300,314,10,15,5,5,allow
49883,443,6647,443,17238,4435,12803,32,103,15,17,allow
42172,443,15822,443,7071,1908,5163,29,944,14,15,allow
45816,443,45816,443,4430,1523,2907,19,27,11,8,allow
58757,5222,20717,5222,3815,2065,1750,37,309,19,18,allow
52774,80,57936,80,432,240,192,8,101,5,3,allow
52772,80,28043,80,2501,1085,1416,15,108,8,7,allow
55620,20795,41932,20795,70,70,0,1,5,1,0,allow
48865,443,7956,443,12824,2604,10220,46,255,20,26,allow
42022,80,12678,80,31196,607,30589,29,500,5,24,allow
61732,443,11286,443,8655,2300,6355,24,21,12,12,allow
53121,8986,30082,8986,70,70,0,1,5,1,0,allow
49225,53,55909,53,295,101,194,4,49,2,2,allow
57647,80,36132,80,1530,1216,314,10,15,5,5,allow
51806,49530,42413,49530,66,66,0,1,5,1,0,allow
35405,53,35405,53,217,87,130,2,30,1,1,allow
64368,443,54903,443,4741,1306,3435,26,300,14,12,allow
64347,53,36083,53,186,95,91,2,30,1,1,allow
57207,53,13941,53,190,97,93,2,30,1,1,allow
43676,80,43895,80,2132,997,1135,14,20,8,6,allow
51402,443,14600,443,7788,2581,5207,39,70,19,20,allow
64091,80,64091,80,2244,1505,739,11,146,6,5,allow
36417,443,64743,443,8611,2046,6565,31,394,10,21,allow
52775,80,57119,80,432,240,192,8,101,5,3,allow
49104,80,61237,80,1638,1324,314,10,15,5,5,allow
60328,80,20117,80,2006,1095,911,11,61,6,5,allow
53614,8999,9856,8999,928,541,387,8,17,5,3,allow
51825,25501,11280,25501,70,70,0,2,9,2,0,allow
60326,80,6892,80,3697,2062,1635,16,61,9,7,allow
51813,63933,44889,63933,66,66,0,1,5,1,0,allow
41924,53,41924,53,237,91,146,2,33,1,1,allow
39322,443,56925,443,7450,2503,4947,21,977,11,10,allow
57944,80,62722,80,1718,1404,314,11,15,6,5,allow
53632,58037,54997,58037,70,70,0,1,5,1,0,allow
43154,80,38984,80,139303,9065,130238,210,20,120,90,allow
28331,53,28331,53,213,87,126,2,30,1,1,allow
27005,27015,11957,27015,901,126,775,2,30,1,1,allow
27005,27015,54928,27015,882,126,756,2,30,1,1,allow
65530,53,49940,53,96,96,0,1,30,1,0,allow
56834,53,36228,53,172,88,84,2,30,1,1,allow
49919,443,28097,443,4534,909,3625,16,32,8,8,allow
33087,53,33087,53,228,97,131,2,31,1,1,allow
34246,53,34246,53,217,87,130,2,31,1,1,allow
13980,53,13980,53,213,87,126,2,31,1,1,allow
37965,62918,1138,62918,489,149,340,2,1200,1,1,allow
443,30054,0,0,60,60,0,1,91,1,0,allow
44783,443,27769,443,4173582,66515,4107067,3494,129,510,2984,allow
53580,443,57283,443,4669,2251,2418,14,137,7,7,allow
59845,44847,0,0,66,66,0,1,0,1,0,deny
34176,51505,0,0,146,146,0,1,0,1,0,deny
59568,445,0,0,70,70,0,1,0,1,0,drop
59570,445,0,0,70,70,0,1,0,1,0,drop
59569,445,0,0,70,70,0,1,0,1,0,drop
443,1340,0,0,85,85,0,1,0,1,0,deny
54962,445,0,0,66,66,0,1,0,1,0,drop
55539,57470,0,0,66,66,0,1,0,1,0,deny
59563,445,0,0,70,70,0,1,0,1,0,drop
54958,445,0,0,66,66,0,1,0,1,0,drop
54955,445,0,0,66,66,0,1,0,1,0,drop
62414,50584,0,0,62,62,0,1,0,1,0,deny
65355,443,1822,443,3563945,186679,3377266,4424,723,1877,2547,allow
57015,80,50968,80,1348,844,504,13,255,8,5,allow
49282,53,64879,53,178,94,84,2,30,1,1,allow
27005,27015,20017,27015,882,126,756,2,30,1,1,allow
49282,53,56718,53,178,94,84,2,30,1,1,allow
54602,445,0,0,70,70,0,1,0,1,0,drop
54954,445,0,0,66,66,0,1,0,1,0,drop
11677,56205,0,0,62,62,0,1,0,1,0,deny
48016,57470,0,0,62,62,0,1,0,1,0,deny
49479,56205,0,0,66,66,0,1,0,1,0,deny
54592,445,0,0,70,70,0,1,0,1,0,drop
54593,445,0,0,70,70,0,1,0,1,0,drop
47700,51505,0,0,66,66,0,1,0,1,0,deny
54588,445,0,0,70,70,0,1,0,1,0,drop
54590,445,0,0,70,70,0,1,0,1,0,drop
59557,445,0,0,70,70,0,1,0,1,0,drop
54586,445,0,0,70,70,0,1,0,1,0,drop
59549,445,0,0,70,70,0,1,0,1,0,drop
59546,445,0,0,70,70,0,1,0,1,0,drop
2541,51505,0,0,66,66,0,1,0,1,0,deny
64990,55442,0,0,66,66,0,1,0,1,0,deny
1024,57470,0,0,62,62,0,1,0,1,0,deny
54579,445,0,0,70,70,0,1,0,1,0,drop
56542,443,7908,443,3701,1521,2180,19,7,10,9,allow
62152,56205,0,0,66,66,0,1,0,1,0,deny
1024,50265,0,0,62,62,0,1,0,1,0,deny
63194,50265,0,0,66,66,0,1,0,1,0,deny
46362,35440,0,0,66,66,0,1,0,1,0,deny
55032,62413,0,0,62,62,0,1,0,1,0,deny
16474,50584,0,0,146,146,0,1,0,1,0,deny
61962,53733,0,0,62,62,0,1,0,1,0,deny
54935,445,0,0,66,66,0,1,0,1,0,drop
59535,445,0,0,70,70,0,1,0,1,0,drop
21348,22,0,0,60,60,0,1,0,1,0,deny
13985,34159,0,0,66,66,0,1,0,1,0,deny
54572,445,0,0,70,70,0,1,0,1,0,drop
54932,445,0,0,66,66,0,1,0,1,0,drop
54569,445,0,0,70,70,0,1,0,1,0,drop
30179,57470,0,0,60,60,0,1,0,1,0,deny
62337,44847,0,0,62,62,0,1,0,1,0,deny
54926,445,0,0,66,66,0,1,0,1,0,drop
54566,445,0,0,70,70,0,1,0,1,0,drop
59262,5228,3053,5228,7054,2076,4978,32,5115,11,21,allow
49867,443,24010,443,7461,2841,4620,19,103,11,8,allow
40363,80,1315,80,3566,1637,1929,18,81,11,7,allow
5236,35120,49591,35120,23369,64,23305,65,31,2,63,allow
63243,53,40178,53,330,228,102,3,33,2,1,allow
51812,15279,41054,15279,70,70,0,1,4,1,0,allow
51809,52528,58895,52528,70,70,0,1,4,1,0,allow
53629,51413,42166,51413,70,70,0,1,4,1,0,allow
46392,443,48556,443,232,172,60,3,5,2,1,allow
52731,80,58843,80,1029,567,462,10,17,6,4,allow
64695,53,40312,53,193,102,91,2,29,1,1,allow
55950,443,51183,443,6490,1789,4701,30,95,16,14,allow
60146,53,47250,53,218,78,140,2,30,1,1,allow
61682,80,36902,80,1804,884,920,12,49,6,6,allow
54536,80,14992,80,4096,3455,641,13,15,8,5,allow
53644,58085,31937,58085,70,70,0,2,7,2,0,allow
6881,50321,40130,50321,238,118,120,2,1199,1,1,allow
52777,80,21198,80,432,240,192,8,100,5,3,allow
49225,53,59832,53,295,101,194,4,49,2,2,allow
64617,53,31755,53,389,102,287,4,33,2,2,allow
51409,443,49977,443,394,70,324,7,31,2,5,allow
55301,443,54571,443,9881,1486,8395,22,200,12,10,allow
51815,28665,10000,28665,70,70,0,1,4,1,0,allow
51827,48432,37555,48432,164,70,94,2,4,1,1,allow
51814,55393,29283,55393,70,70,0,1,4,1,0,allow
49926,53,46406,53,333,90,243,4,41,2,2,allow
57207,53,1667,53,195,102,93,2,29,1,1,allow
49905,53,31462,53,180,94,86,2,29,1,1,allow
49323,53,50782,53,210,110,100,2,29,1,1,allow
46860,53,42204,53,447,101,346,4,29,2,2,allow
62155,53,41278,53,263,86,177,2,29,1,1,allow
55995,53,32542,53,329,118,211,2,30,1,1,allow
55242,443,59852,443,214,140,74,4,15,3,1,allow
57311,53,54078,53,211,102,109,2,30,1,1,allow
51948,443,29548,443,4876,2559,2317,32,56,18,14,allow
53239,443,22787,443,982624,22331,960293,976,137,293,683,allow
56654,443,29055,443,18544,4402,14142,31,191,14,17,allow
49343,53,20254,53,478,106,372,4,48,2,2,allow
46140,443,48726,443,172,172,0,2,5,2,0,allow
27005,27015,32214,27015,878,126,752,2,30,1,1,allow
33197,443,9055,443,1067,650,417,10,27,6,4,allow
49267,53,55057,53,209,94,115,2,30,1,1,allow
46269,123,16380,123,184,94,90,2,30,1,1,allow
36690,443,36517,443,1520,1058,462,12,29,8,4,allow
51947,443,7702,443,3893,2046,1847,29,56,16,13,allow
64329,53,19539,53,281,110,171,2,30,1,1,allow
65530,53,53494,53,194,102,92,2,30,1,1,allow
41943,443,27053,443,8385,3143,5242,35,98,18,17,allow
57643,80,14145,80,172,172,0,2,5,2,0,allow
45020,443,48024,443,10427,2928,7499,34,106,16,18,allow
56076,80,28614,80,5055,3100,1955,34,17,28,6,allow
60504,443,51319,443,1875,1165,710,13,28,7,6,allow
49225,53,22731,53,295,101,194,4,48,2,2,allow
64912,53,22829,53,258,102,156,2,30,1,1,allow
27005,27001,29327,27001,883,126,757,2,30,1,1,allow
55949,443,10704,443,21852,2269,19583,48,95,23,25,allow
60717,443,21678,443,61464,11538,49926,87,32,41,46,allow
63550,80,63550,80,1232,481,751,10,15,5,5,allow
60087,443,43883,443,5470,3223,2247,43,172,22,21,allow
41619,443,17467,443,188529,10173,178356,248,256,93,155,allow
52406,443,64172,443,13978,8842,5136,46,52,26,20,allow
60821,443,28093,443,16554,7445,9109,49,255,24,25,allow
6881,6881,9262,6881,501,150,351,2,1200,1,1,allow
52698,80,54306,80,8280,5678,2602,25,111,14,11,allow
51808,46390,34181,46390,70,70,0,1,4,1,0,allow
9823,53,9823,53,244,98,146,2,32,1,1,allow
53630,64745,36069,64745,70,70,0,1,4,1,0,allow
39423,80,38195,80,78,78,0,1,4,1,0,allow
49317,53,7671,53,657,187,470,6,72,3,3,allow
53626,33194,63366,33194,70,70,0,1,4,1,0,allow
51826,58925,42484,58925,70,70,0,2,9,2,0,allow
56393,443,8306,443,25779,3436,22343,42,109,19,23,allow
50056,27018,38815,27018,468,390,78,5,29,4,1,allow
56403,443,13577,443,1710,976,734,16,81,8,8,allow
65356,443,39597,443,3122508,193850,2928658,4050,681,1740,2310,allow
64071,53,46762,53,194,102,92,2,29,1,1,allow
53628,50514,36687,50514,70,70,0,1,4,1,0,allow
57938,443,57938,443,27787,5566,22221,60,47,31,29,allow
64772,53,16557,53,416,107,309,4,29,2,2,allow
55621,28144,63708,28144,70,70,0,1,5,1,0,allow
63960,53,46740,53,228,110,118,2,29,1,1,allow
64347,53,53125,53,193,102,91,2,29,1,1,allow
64756,53,60471,53,195,102,93,2,30,1,1,allow
55487,53,48616,53,199,102,97,2,29,1,1,allow
41813,443,58792,443,33072,3479,29593,71,98,38,33,allow
55639,53,39796,53,292,102,190,2,29,1,1,allow
65374,443,10199,443,629017,29841,599176,758,162,331,427,allow
55762,53,29389,53,249,94,155,2,29,1,1,allow
43460,80,58949,80,23394,1667,21727,38,18,20,18,allow
56834,53,24622,53,178,94,84,2,29,1,1,allow
64538,53,8098,53,194,102,92,2,29,1,1,allow
60716,443,27537,443,31452,6667,24785,54,32,29,25,allow
53252,443,33448,443,41435,6615,34820,85,193,46,39,allow
35517,443,27389,443,130,70,60,3,5,2,1,allow
40242,443,42973,443,7407,2516,4891,37,32,19,18,allow
49282,53,14515,53,178,94,84,2,30,1,1,allow
55379,53,3403,53,358,102,256,2,30,1,1,allow
56679,53,5371,53,216,102,114,2,30,1,1,allow
64756,53,21500,53,195,102,93,2,30,1,1,allow
56424,53,14436,53,306,94,212,2,30,1,1,allow
27005,4444,11098,4444,881,126,755,2,30,1,1,allow
53864,443,31491,443,3124,1556,1568,21,275,11,10,allow
65373,443,38852,443,3104883,106687,2998196,3406,190,1320,2086,allow
49225,53,32550,53,295,101,194,4,49,2,2,allow
49323,53,9705,53,210,110,100,2,30,1,1,allow
54511,53,42780,53,304,86,218,2,30,1,1,allow
49601,53,32118,53,178,94,84,2,30,1,1,allow
64756,53,35378,53,195,102,93,2,30,1,1,allow
65083,53,18755,53,198,94,104,2,30,1,1,allow
49631,53,32416,53,323,102,221,2,30,1,1,allow
44037,5223,40215,5223,5096,1030,4066,25,1751,9,16,allow
33409,53,54982,53,79268,76966,2302,936,88,923,13,allow
27005,27015,38552,27015,876,126,750,2,31,1,1,allow
63822,14382,65355,14382,66,66,0,2,8,2,0,allow
54322,443,16940,443,14649,11393,3256,49,99,22,27,allow
27005,27015,18205,27015,888,126,762,3,32,2,1,allow
27005,27016,42584,27016,1010,252,758,4,33,3,1,allow
37576,443,21717,443,11777,4005,7772,35,44,15,20,allow
53124,52917,46926,52917,70,70,0,2,8,2,0,allow
56538,443,26463,443,8490,2953,5537,27,569,15,12,allow
63263,57470,0,0,66,66,0,1,0,1,0,deny
60312,57470,0,0,74,74,0,1,0,1,0,deny
54564,445,0,0,70,70,0,1,0,1,0,drop
54922,445,0,0,66,66,0,1,0,1,0,drop
34422,64147,0,0,145,145,0,1,0,1,0,deny
10427,50584,0,0,146,146,0,1,0,1,0,deny
27641,39004,0,0,62,62,0,1,0,1,0,deny
58497,39004,0,0,66,66,0,1,0,1,0,deny
54560,445,0,0,70,70,0,1,0,1,0,drop
54559,445,0,0,70,70,0,1,0,1,0,drop
5729,22114,0,0,62,62,0,1,0,1,0,deny
59524,445,0,0,70,70,0,1,0,1,0,drop
59526,445,0,0,70,70,0,1,0,1,0,drop
59523,445,0,0,70,70,0,1,0,1,0,drop
54903,445,0,0,66,66,0,1,0,1,0,drop
54906,445,0,0,66,66,0,1,0,1,0,drop
54909,445,0,0,66,66,0,1,0,1,0,drop
54910,445,0,0,66,66,0,1,0,1,0,drop
54905,445,0,0,66,66,0,1,0,1,0,drop
54904,445,0,0,66,66,0,1,0,1,0,drop
54908,445,0,0,66,66,0,1,0,1,0,drop
54902,445,0,0,66,66,0,1,0,1,0,drop
42732,57470,0,0,62,62,0,1,0,1,0,deny
54554,445,0,0,70,70,0,1,0,1,0,drop
59518,445,0,0,70,70,0,1,0,1,0,drop
59514,445,0,0,70,70,0,1,0,1,0,drop
59507,445,0,0,70,70,0,1,0,1,0,drop
52459,5555,0,0,60,60,0,1,0,1,0,deny
53835,62413,0,0,146,146,0,1,0,1,0,deny
45060,37965,0,0,62,62,0,1,0,1,0,deny
6999,11119,0,0,143,143,0,1,0,1,0,deny
54888,445,0,0,66,66,0,1,0,1,0,drop
54889,445,0,0,66,66,0,1,0,1,0,drop
54887,445,0,0,66,66,0,1,0,1,0,drop
43916,21,0,0,60,60,0,1,0,1,0,deny
59506,445,0,0,70,70,0,1,0,1,0,drop
37988,64147,0,0,66,66,0,1,0,1,0,deny
1080,8391,0,0,66,66,0,1,0,1,0,deny
54541,445,0,0,70,70,0,1,0,1,0,drop
58213,37807,0,0,66,66,0,1,0,1,0,deny
59504,445,0,0,70,70,0,1,0,1,0,drop
64379,37965,0,0,66,66,0,1,0,1,0,deny
44849,46478,0,0,74,74,0,1,0,1,0,deny
59502,445,0,0,70,70,0,1,0,1,0,drop
59500,445,0,0,70,70,0,1,0,1,0,drop
59498,445,0,0,70,70,0,1,0,1,0,drop
54538,445,0,0,70,70,0,1,0,1,0,drop
57410,37965,0,0,66,66,0,1,0,1,0,deny
56544,443,50945,443,3413,1537,1876,19,7,10,9,allow
63998,21247,0,0,62,62,0,1,0,1,0,deny
58681,36829,0,0,70,70,0,1,0,1,0,deny
59696,57470,0,0,62,62,0,1,0,1,0,deny
46670,51505,0,0,62,62,0,1,0,1,0,deny
50914,51505,0,0,66,66,0,1,0,1,0,deny
60550,50584,0,0,146,146,0,1,0,1,0,deny
6572,23,0,0,60,60,0,1,0,1,0,deny
54533,445,0,0,70,70,0,1,0,1,0,drop
54532,445,0,0,70,70,0,1,0,1,0,drop
59486,445,0,0,70,70,0,1,0,1,0,drop
59481,445,0,0,70,70,0,1,0,1,0,drop
59482,445,0,0,70,70,0,1,0,1,0,drop
54530,445,0,0,70,70,0,1,0,1,0,drop
57982,64147,0,0,66,66,0,1,0,1,0,deny
20108,64147,0,0,66,66,0,1,0,1,0,deny
56440,56205,0,0,62,62,0,1,0,1,0,deny
59994,11446,0,0,66,66,0,1,0,1,0,deny
64878,26467,0,0,62,62,0,1,0,1,0,deny
1162,57470,0,0,62,62,0,1,0,1,0,deny
54523,445,0,0,70,70,0,1,0,1,0,drop
54867,445,0,0,66,66,0,1,0,1,0,drop
58226,52848,0,0,145,145,0,1,0,1,0,deny
59478,445,0,0,70,70,0,1,0,1,0,drop
59476,445,0,0,70,70,0,1,0,1,0,drop
60627,51050,0,0,62,62,0,1,0,1,0,deny
54521,445,0,0,70,70,0,1,0,1,0,drop
22714,30188,0,0,62,62,0,1,0,1,0,deny
54520,445,0,0,70,70,0,1,0,1,0,drop
46901,26672,0,0,60,60,0,1,0,1,0,deny
54519,445,0,0,70,70,0,1,0,1,0,drop
54518,445,0,0,70,70,0,1,0,1,0,drop
50227,57470,0,0,62,62,0,1,0,1,0,deny
54516,445,0,0,70,70,0,1,0,1,0,drop
54860,445,0,0,66,66,0,1,0,1,0,drop
54858,445,0,0,66,66,0,1,0,1,0,drop
59465,445,0,0,70,70,0,1,0,1,0,drop
59459,445,0,0,70,70,0,1,0,1,0,drop
59456,445,0,0,70,70,0,1,0,1,0,drop
59454,445,0,0,70,70,0,1,0,1,0,drop
54500,445,0,0,70,70,0,1,0,1,0,drop
54855,445,0,0,66,66,0,1,0,1,0,drop
54499,445,0,0,70,70,0,1,0,1,0,drop
54497,445,0,0,70,70,0,1,0,1,0,drop
14252,35993,0,0,66,66,0,1,0,1,0,deny
54490,445,0,0,70,70,0,1,0,1,0,drop
54489,445,0,0,70,70,0,1,0,1,0,drop
57470,54343,65136,54343,330,330,0,6,1200,6,0,allow
62888,53,0,0,193,78,115,2,30,1,1,allow
38602,443,28302,443,130,70,60,3,5,2,1,allow
26461,80,26461,80,490,264,226,8,32,5,3,allow
53142,443,26091,443,4962,887,4075,15,28,9,6,allow
51216,443,25956,443,4540,1056,3484,19,17,11,8,allow
29647,53,29647,53,197,76,121,2,30,1,1,allow
37751,53,37751,53,194,87,107,2,30,1,1,allow
47595,33435,0,0,106,106,0,1,60,1,0,allow
27005,27015,19502,27015,880,126,754,2,30,1,1,allow
49907,443,59724,443,5895,728,5167,16,47,8,8,allow
57598,80,57598,80,1810,821,989,10,20,6,4,allow
57286,443,36985,443,134,60,74,3,10,2,1,allow
26458,80,26458,80,490,264,226,8,32,5,3,allow
27005,27017,57092,27017,900,126,774,2,30,1,1,allow
63955,53,0,0,219,81,138,2,30,1,1,allow
38914,80,38914,80,2993,1469,1524,13,20,8,5,allow
26459,80,26459,80,490,264,226,8,32,5,3,allow
26449,80,26449,80,642,338,304,10,33,6,4,allow
63804,52520,44580,52520,66,66,0,1,5,1,0,allow
60410,18359,27575,18359,1759,820,939,18,16,8,10,allow
53016,443,53016,443,4787,1880,2907,19,27,11,8,allow
49902,443,13295,443,7456,1591,5865,32,54,15,17,allow
50668,443,5052,443,2881,642,2239,13,135,6,7,allow
43809,443,45485,443,9842,2961,6881,31,19,16,15,allow
26460,80,26460,80,490,264,226,8,32,5,3,allow
51213,443,22292,443,6333,2018,4315,25,17,15,10,allow
34672,53,34672,53,213,87,126,2,30,1,1,allow
38947,443,49748,443,16499,9522,6977,44,364,22,22,allow
53143,443,21953,443,4962,887,4075,15,28,9,6,allow
38795,40042,2140,40042,142,80,62,2,31,1,1,allow
62005,80,62005,80,11822,1162,10660,22,20,11,11,allow
60393,443,18640,443,3371,2029,1342,16,360,8,8,allow
41405,443,41405,443,4565,1658,2907,19,29,11,8,allow
56793,14902,9937,14902,264,70,194,4,19,1,3,allow
64785,80,45125,80,2107,1131,976,13,97,7,6,allow
64776,80,31533,80,4502,1072,3430,15,98,7,8,allow
63803,41439,24865,41439,66,66,0,1,5,1,0,allow
50667,80,50667,80,15686,1227,14459,24,20,11,13,allow
49742,80,32579,80,103346,1476,101870,87,17,16,71,allow
58131,53,58131,53,194,87,107,2,30,1,1,allow
64779,80,26888,80,82972,2084,80888,85,98,26,59,allow
49906,443,34595,443,159116,5586,153530,191,47,77,114,allow
27005,27015,17073,27015,886,126,760,2,30,1,1,allow
26452,80,26452,80,642,338,304,10,33,6,4,allow
53822,80,58040,80,1655,1341,314,10,15,5,5,allow
56532,443,17749,443,8381,2848,5533,26,572,14,12,allow
27471,53,27471,53,237,91,146,2,32,1,1,allow
47050,443,20550,443,10868,2200,8668,32,44,14,18,allow
26462,80,26462,80,490,264,226,8,32,5,3,allow
49744,80,34902,80,1111,749,362,9,15,5,4,allow
40146,53,0,0,300,86,214,2,30,1,1,allow
1575,53,0,0,254,86,168,2,30,1,1,allow
50284,80,36535,80,8269,1423,6846,20,75,10,10,allow
38350,80,18584,80,1678,1364,314,10,16,5,5,allow
63955,53,0,0,219,81,138,2,30,1,1,allow
64790,443,44733,443,15810,7525,8285,35,97,18,17,allow
27005,27015,42167,27015,869,126,743,2,30,1,1,allow
64799,443,56278,443,1671,1004,667,16,76,8,8,allow
33923,443,55200,443,4472,1666,2806,13,121,6,7,allow
51509,24855,0,0,66,66,0,1,90,1,0,allow
57869,443,47551,443,11947,2436,9511,19,121,9,10,allow
57679,443,27474,443,6568,2770,3798,20,121,10,10,allow
48817,51634,48817,51634,480,149,331,2,1200,1,1,allow
25085,30188,0,0,62,62,0,1,0,1,0,deny
63724,23,0,0,60,60,0,1,0,1,0,deny
45964,3111,0,0,60,60,0,1,0,1,0,deny
59449,445,0,0,70,70,0,1,0,1,0,drop
59448,445,0,0,70,70,0,1,0,1,0,drop
59447,445,0,0,70,70,0,1,0,1,0,drop
59444,445,0,0,70,70,0,1,0,1,0,drop
54849,445,0,0,66,66,0,1,0,1,0,drop
54845,445,0,0,66,66,0,1,0,1,0,drop
54844,445,0,0,66,66,0,1,0,1,0,drop
54846,445,0,0,66,66,0,1,0,1,0,drop
33706,23,0,0,60,60,0,1,0,1,0,deny
55440,443,52938,443,6622,859,5763,18,15,10,8,allow
51209,443,1552,443,11983,2674,9309,51,17,29,22,allow
64797,53,45567,53,216,102,114,2,30,1,1,allow
54638,36829,0,0,146,146,0,1,0,1,0,deny
41025,38191,0,0,157,157,0,1,0,1,0,deny
53043,51050,0,0,66,66,0,1,0,1,0,deny
54839,445,0,0,66,66,0,1,0,1,0,drop
54838,445,0,0,66,66,0,1,0,1,0,drop
54837,445,0,0,66,66,0,1,0,1,0,drop
54478,445,0,0,70,70,0,1,0,1,0,drop
58022,8080,0,0,60,60,0,1,0,1,0,deny
51197,57470,0,0,66,66,0,1,0,1,0,deny
52526,30188,0,0,66,66,0,1,0,1,0,deny
34731,22114,0,0,62,62,0,1,0,1,0,deny
60970,20541,0,0,66,66,0,1,0,1,0,deny
59442,445,0,0,70,70,0,1,0,1,0,drop
59440,445,0,0,70,70,0,1,0,1,0,drop
10166,44847,0,0,62,62,0,1,0,1,0,deny
57860,51505,0,0,62,62,0,1,0,1,0,deny
54832,445,0,0,66,66,0,1,0,1,0,drop
59435,445,0,0,70,70,0,1,0,1,0,drop
51742,30317,0,0,66,66,0,1,0,1,0,deny
54830,445,0,0,66,66,0,1,0,1,0,drop
54472,445,0,0,70,70,0,1,0,1,0,drop
54829,445,0,0,66,66,0,1,0,1,0,drop
54827,445,0,0,66,66,0,1,0,1,0,drop
54826,445,0,0,66,66,0,1,0,1,0,drop
61808,18375,0,0,66,66,0,1,0,1,0,deny
54463,445,0,0,70,70,0,1,0,1,0,drop
54461,445,0,0,70,70,0,1,0,1,0,drop
54458,445,0,0,70,70,0,1,0,1,0,drop
54457,445,0,0,70,70,0,1,0,1,0,drop
54455,445,0,0,70,70,0,1,0,1,0,drop
43584,26543,0,0,156,156,0,1,0,1,0,deny
32071,51221,0,0,62,62,0,1,0,1,0,deny
53928,15503,0,0,62,62,0,1,0,1,0,deny
59430,445,0,0,70,70,0,1,0,1,0,drop
62011,57354,0,0,159,159,0,1,0,1,0,deny
59422,445,0,0,70,70,0,1,0,1,0,drop
59423,445,0,0,70,70,0,1,0,1,0,drop
34348,22114,0,0,62,62,0,1,0,1,0,deny
1694,30188,0,0,62,62,0,1,0,1,0,deny
64294,64147,0,0,146,146,0,1,0,1,0,deny
54817,445,0,0,66,66,0,1,0,1,0,drop
59745,53635,0,0,66,66,0,1,0,1,0,deny
30179,57470,0,0,60,60,0,1,0,1,0,deny
31384,56205,0,0,62,62,0,1,0,1,0,deny
54450,445,0,0,70,70,0,1,0,1,0,drop
28624,23,0,0,60,60,0,1,0,1,0,deny
59210,8168,0,0,66,66,0,1,0,1,0,deny
45472,8168,0,0,62,62,0,1,0,1,0,deny
45155,53,0,0,226,86,140,2,29,1,1,allow
54775,443,18687,443,12150,2950,9200,35,341,17,18,allow
26448,80,26448,80,642,338,304,10,32,6,4,allow
26451,80,26451,80,642,338,304,10,32,6,4,allow
64571,443,18253,443,9155,2109,7046,27,31,15,12,allow
54525,443,38089,443,3766,1654,2112,10,120,5,5,allow
49637,53,40941,53,255,102,153,2,30,1,1,allow
26450,80,26450,80,642,338,304,10,32,6,4,allow
56539,443,36962,443,8335,2802,5533,26,567,14,12,allow
60758,40010,38736,40010,316,136,180,6,5,3,3,allow
55117,443,14752,443,1350,689,661,14,18,8,6,allow
39599,443,45420,443,1352,691,661,14,18,8,6,allow
39597,443,19827,443,1350,689,661,14,18,8,6,allow
56826,53,57035,53,94,94,0,1,29,1,0,allow
64288,53,63361,53,229,110,119,2,29,1,1,allow
64937,53,3891,53,360,118,242,2,30,1,1,allow
65263,53,26647,53,356,88,268,4,55,2,2,allow
57886,53,57886,53,216,90,126,2,29,1,1,allow
55437,443,17546,443,6622,859,5763,18,15,10,8,allow
42954,443,44795,443,6813,2515,4298,30,58,16,14,allow
55984,53,2333,53,216,102,114,2,30,1,1,allow
62122,53,41697,53,179,86,93,2,30,1,1,allow
50863,443,18214,443,1501,590,911,12,26,6,6,allow
56808,54393,38896,54393,70,70,0,1,5,1,0,allow
55438,443,39653,443,6686,923,5763,19,15,11,8,allow
64793,80,12166,80,508,256,252,9,77,5,4,allow
51206,443,30642,443,12274,2677,9597,51,17,29,22,allow
51698,80,35267,80,15609,1298,14311,26,75,14,12,allow
49504,443,14991,443,18746,2976,15770,32,32,12,20,allow
42286,443,57060,443,6021,1249,4772,20,23,11,9,allow
33446,80,33446,80,1753,833,920,10,20,6,4,allow
45963,443,45963,443,4592,1685,2907,19,27,11,8,allow
49903,443,42458,443,8078,1511,6567,30,54,14,16,allow
56585,443,49312,443,7157,2183,4974,22,16,12,10,allow
56599,53,21288,53,258,110,148,2,30,1,1,allow
27005,27015,45773,27015,899,126,773,2,30,1,1,allow
42286,5228,46877,5228,3489,1598,1891,25,631,7,18,allow
54664,443,62017,443,175780,7700,168080,196,36,78,118,allow
60769,443,3938,443,7639,2051,5588,33,120,17,16,allow
50862,443,25283,443,1501,590,911,12,26,6,6,allow
64767,80,54344,80,3199,988,2211,14,99,7,7,allow
49743,80,24003,80,2981,473,2508,9,16,5,4,allow
63800,80,60637,80,314,192,122,6,15,4,2,allow
51939,80,10449,80,103732,4081,99651,128,61,55,73,allow
53077,80,56021,80,1352,625,727,8,75,5,3,allow
49744,53,4877,53,211,102,109,2,30,1,1,allow
56529,443,43021,443,266757,6935,259822,274,19,97,177,allow
60896,443,6271,443,14819,8197,6622,47,45,26,21,allow
38554,443,64744,443,5021,1030,3991,16,30,9,7,allow
56819,37372,7815,37372,70,70,0,1,5,1,0,allow
49741,80,28243,80,1149,412,737,8,17,5,3,allow
55525,53,40797,53,210,102,108,2,30,1,1,allow
57470,51413,59920,51413,528,528,0,9,1199,9,0,allow
42465,443,2367,443,4885,895,3990,16,29,9,7,allow
51205,443,62572,443,8857,2827,6030,52,17,29,23,allow
55115,443,23390,443,1348,687,661,14,18,8,6,allow
47795,443,48531,443,8708,3949,4759,22,21,11,11,allow
39303,80,19010,80,3198,1493,1705,18,80,11,7,allow
61686,80,38395,80,4004,1513,2491,20,47,10,10,allow
63823,51558,34606,51558,66,66,0,2,7,2,0,allow
56623,80,56144,80,234,234,0,4,12,4,0,allow
63953,53,20506,53,426,89,337,4,49,2,2,allow
51207,443,64631,443,12171,2763,9408,53,17,30,23,allow
64800,80,8529,80,508,256,252,9,75,5,4,allow
49917,443,56620,443,5899,732,5167,16,41,8,8,allow
57198,80,57198,80,6738,909,5829,14,20,7,7,allow
49912,443,43170,443,2048821,56490,1992331,2082,44,522,1560,allow
63729,80,63729,80,7324,1017,6307,16,20,8,8,allow
57909,80,57909,80,2648,921,1727,12,20,7,5,allow
55444,443,64554,443,13284,3562,9722,38,26,21,17,allow
55627,26192,42431,26192,70,70,0,2,8,2,0,allow
51167,80,51167,80,1502,817,685,10,20,6,4,allow
60641,443,61674,443,34758,2573,32185,50,320,21,29,allow
52491,53,62857,53,289,86,203,2,30,1,1,allow
53613,11309,52250,11309,492,306,186,8,16,5,3,allow
47732,80,47732,80,9621,1618,8003,19,20,10,9,allow
37902,123,60994,123,184,94,90,2,30,1,1,allow
59792,80,59792,80,33435,1694,31741,43,20,18,25,allow
27005,27013,56795,27013,879,126,753,2,30,1,1,allow
60314,80,12778,80,1498,539,959,10,77,6,4,allow
60890,443,16222,443,5089,4217,872,23,47,13,10,allow
51407,443,40522,443,25490,8419,17071,54,48,30,24,allow
51211,443,40776,443,7638,2405,5233,44,17,25,19,allow
52076,443,51633,443,24299,8382,15917,69,93,35,34,allow
55626,63805,65310,63805,70,70,0,2,8,2,0,allow
51941,80,19964,80,82496,3881,78615,104,61,47,57,allow
51938,80,6039,80,82321,4061,78260,109,61,50,59,allow
51940,80,62105,80,278312,9722,268590,323,61,135,188,allow
38922,80,38922,80,20984,1380,19604,34,15,18,16,allow
27005,27015,48788,27015,913,126,787,2,30,1,1,allow
65320,53,12285,53,227,110,117,2,30,1,1,allow
50861,443,62102,443,1501,590,911,12,26,6,6,allow
51210,443,30801,443,8248,2460,5788,45,17,26,19,allow
49905,80,54689,80,1173,672,501,8,31,5,3,allow
55617,53,58686,53,196,94,102,2,30,1,1,allow
28699,53,53419,53,278,86,192,2,30,1,1,allow
64232,53,50382,53,258,110,148,2,30,1,1,allow
49928,53,15390,53,243,102,141,2,30,1,1,allow
44847,2499,58207,2499,502,150,352,2,1200,1,1,allow
55877,56036,49566,56036,469,150,319,2,1200,1,1,allow
6882,42505,24055,42505,207,118,89,2,1200,1,1,allow
48337,443,44874,443,227876,8050,219826,236,36,83,153,allow
51208,443,57276,443,8886,2767,6119,52,17,28,24,allow
51422,3027,51422,3027,156,156,0,3,8,3,0,allow
56586,443,35077,443,7110,2183,4927,22,16,12,10,allow
46653,443,4259,443,4037,1058,2979,12,120,6,6,allow
47388,443,44848,443,2897,728,2169,10,121,5,5,allow
57314,443,14727,443,134,60,74,3,6,2,1,allow
57310,443,42139,443,134,60,74,3,6,2,1,allow
63817,50808,9849,50808,66,66,0,2,8,2,0,allow
49534,80,31376,80,1702,611,1091,8,30,4,4,allow
65474,53,12902,53,198,94,104,2,30,1,1,allow
57311,443,59894,443,134,60,74,3,6,2,1,allow
57309,443,42080,443,134,60,74,3,6,2,1,allow
63731,26467,0,0,66,66,0,1,0,1,0,deny
6881,6881,0,0,146,146,0,1,0,1,0,deny
54807,445,0,0,66,66,0,1,0,1,0,drop
59407,445,0,0,70,70,0,1,0,1,0,drop
54442,445,0,0,70,70,0,1,0,1,0,drop
60602,15503,0,0,62,62,0,1,0,1,0,deny
54440,445,0,0,70,70,0,1,0,1,0,drop
54804,445,0,0,66,66,0,1,0,1,0,drop
51620,56205,0,0,66,66,0,1,0,1,0,deny
41447,64147,0,0,62,62,0,1,0,1,0,deny
51996,35440,0,0,66,66,0,1,0,1,0,deny
51424,30188,0,0,66,66,0,1,0,1,0,deny
54436,445,0,0,70,70,0,1,0,1,0,drop
54434,445,0,0,70,70,0,1,0,1,0,drop
54797,445,0,0,66,66,0,1,0,1,0,drop
64240,50584,0,0,66,66,0,1,0,1,0,deny
54794,445,0,0,66,66,0,1,0,1,0,drop
28839,30188,0,0,146,146,0,1,0,1,0,deny
60000,80,0,0,60,60,0,1,0,1,0,deny
54858,51505,0,0,66,66,0,1,0,1,0,deny
65068,23,0,0,60,60,0,1,0,1,0,deny
45941,23386,0,0,60,60,0,1,0,1,0,deny
54997,26467,0,0,62,62,0,1,0,1,0,deny
54430,445,0,0,70,70,0,1,0,1,0,drop
17811,23,0,0,60,60,0,1,0,1,0,deny
54429,445,0,0,70,70,0,1,0,1,0,drop
55986,26467,0,0,66,66,0,1,0,1,0,deny
1070,26467,0,0,62,62,0,1,0,1,0,deny
1026,57866,0,0,146,146,0,1,0,1,0,deny
64940,26467,0,0,62,62,0,1,0,1,0,deny
59397,445,0,0,70,70,0,1,0,1,0,drop
59396,445,0,0,70,70,0,1,0,1,0,drop
59395,445,0,0,70,70,0,1,0,1,0,drop
5664,36237,0,0,66,66,0,1,0,1,0,deny
17873,23117,0,0,66,66,0,1,0,1,0,deny
54780,445,0,0,66,66,0,1,0,1,0,drop
54776,445,0,0,66,66,0,1,0,1,0,drop
54779,445,0,0,66,66,0,1,0,1,0,drop
54781,445,0,0,66,66,0,1,0,1,0,drop
54782,445,0,0,66,66,0,1,0,1,0,drop
54774,445,0,0,66,66,0,1,0,1,0,drop
54778,445,0,0,66,66,0,1,0,1,0,drop
54775,445,0,0,66,66,0,1,0,1,0,drop
15922,44847,0,0,66,66,0,1,0,1,0,deny
54424,445,0,0,70,70,0,1,0,1,0,drop
57853,64147,0,0,66,66,0,1,0,1,0,deny
52741,24211,0,0,66,66,0,1,0,1,0,deny
57339,50584,0,0,62,62,0,1,0,1,0,deny
60129,55442,0,0,66,66,0,1,0,1,0,deny
52699,26467,0,0,62,62,0,1,0,1,0,deny
8239,37965,0,0,146,146,0,1,0,1,0,deny
1024,64147,0,0,62,62,0,1,0,1,0,deny
53490,62413,0,0,66,66,0,1,0,1,0,deny
58966,30188,0,0,66,66,0,1,0,1,0,deny
59394,445,0,0,70,70,0,1,0,1,0,drop
59389,445,0,0,70,70,0,1,0,1,0,drop
59390,445,0,0,70,70,0,1,0,1,0,drop
51740,37965,0,0,66,66,0,1,0,1,0,deny
443,23133,0,0,97,97,0,1,0,1,0,deny
54760,445,0,0,66,66,0,1,0,1,0,drop
54761,445,0,0,66,66,0,1,0,1,0,drop
54759,445,0,0,66,66,0,1,0,1,0,drop
59377,445,0,0,70,70,0,1,0,1,0,drop
54411,445,0,0,70,70,0,1,0,1,0,drop
43584,24748,0,0,156,156,0,1,0,1,0,deny
43584,24748,0,0,156,156,0,1,0,1,0,deny
59459,37807,0,0,66,66,0,1,0,1,0,deny
43584,24748,0,0,156,156,0,1,0,1,0,deny
42414,50939,0,0,148,148,0,1,0,1,0,deny
43584,24748,0,0,156,156,0,1,0,1,0,deny
43584,24748,0,0,156,156,0,1,0,1,0,deny
49690,50265,0,0,62,62,0,1,0,1,0,deny
13907,57470,0,0,66,66,0,1,0,1,0,deny
43584,24748,0,0,156,156,0,1,0,1,0,deny
59375,445,0,0,70,70,0,1,0,1,0,drop
39524,10104,0,0,137,137,0,1,0,1,0,deny
61457,21247,0,0,62,62,0,1,0,1,0,deny
54408,445,0,0,70,70,0,1,0,1,0,drop
0,0,0,0,156,156,0,2,0,2,0,deny
0,0,0,0,156,156,0,2,0,2,0,deny
0,0,0,0,156,156,0,2,0,2,0,deny
0,0,0,0,156,156,0,2,0,2,0,deny
0,0,0,0,124,64,60,2,0,1,1,allow
0,0,0,0,320,320,0,5,0,5,0,allow
59374,445,0,0,70,70,0,1,0,1,0,drop
59370,445,0,0,70,70,0,1,0,1,0,drop
59373,445,0,0,70,70,0,1,0,1,0,drop
34999,25864,0,0,74,74,0,1,0,1,0,deny
50624,26467,0,0,66,66,0,1,0,1,0,deny
17027,1,0,0,62,62,0,1,0,1,0,deny
56966,35440,0,0,66,66,0,1,0,1,0,deny
60133,1,0,0,66,66,0,1,0,1,0,deny
54742,50584,0,0,66,66,0,1,0,1,0,deny
50419,26467,0,0,66,66,0,1,0,1,0,deny
54403,445,0,0,70,70,0,1,0,1,0,drop
57768,37965,0,0,66,66,0,1,0,1,0,deny
54402,445,0,0,70,70,0,1,0,1,0,drop
54400,445,0,0,70,70,0,1,0,1,0,drop
59358,445,0,0,70,70,0,1,0,1,0,drop
59356,445,0,0,70,70,0,1,0,1,0,drop
59353,445,0,0,70,70,0,1,0,1,0,drop
3803,51505,0,0,66,66,0,1,0,1,0,deny
55600,22,0,0,60,60,0,1,0,1,0,deny
44854,26467,0,0,62,62,0,1,0,1,0,deny
46901,26672,0,0,60,60,0,1,0,1,0,deny
50027,21247,0,0,62,62,0,1,0,1,0,deny
54109,36829,0,0,62,62,0,1,0,1,0,deny
6889,45850,0,0,143,143,0,1,0,1,0,reset-both
54393,445,0,0,70,70,0,1,0,1,0,drop
35843,51505,0,0,146,146,0,1,0,1,0,deny
52076,44847,0,0,62,62,0,1,0,1,0,deny
54391,445,0,0,70,70,0,1,0,1,0,drop
54739,445,0,0,66,66,0,1,0,1,0,drop
45964,2666,0,0,60,60,0,1,0,1,0,deny
49677,64147,0,0,62,62,0,1,0,1,0,deny
59350,445,0,0,70,70,0,1,0,1,0,drop
59347,445,0,0,70,70,0,1,0,1,0,drop
1046,48817,0,0,62,62,0,1,0,1,0,deny
54786,30188,0,0,66,66,0,1,0,1,0,deny
54390,445,0,0,70,70,0,1,0,1,0,drop
49497,443,3660,443,8816,4876,3940,23,31,12,11,allow
50987,10086,44124,10086,217,157,60,2,5,1,1,allow
51540,3389,51540,3389,4425,2641,1784,21,33,12,9,allow
35356,53,0,0,82,82,0,1,30,1,0,allow
41028,80,41028,80,100182,8294,91888,137,127,69,68,allow
33992,53,33992,53,79,79,0,1,30,1,0,allow
53017,80,53017,80,184725,5028,179697,217,25,75,142,allow
53019,80,53019,80,181759,5146,176613,216,25,77,139,allow
53298,443,6587,443,5601,1187,4414,24,80,13,11,allow
44960,80,44960,80,4372,2093,2279,16,19,10,6,allow
12677,53,12677,53,234,93,141,2,30,1,1,allow
33992,53,33992,53,462,158,304,4,30,2,2,allow
27005,27015,49303,27015,868,126,742,2,30,1,1,allow
54405,53,0,0,174,79,95,2,30,1,1,allow
38038,443,62435,443,6180,3550,2630,27,272,13,14,allow
65410,443,49825,443,2494,1643,851,17,25,9,8,allow
34245,443,35232,443,11441,6765,4676,40,792,19,21,allow
51221,52423,24107,52423,322,149,173,2,1201,1,1,allow
15503,3082,40195,3082,480,149,331,2,1200,1,1,allow
39213,443,39213,443,4378,1471,2907,19,29,11,8,allow
53020,80,53020,80,134273,4066,130207,163,22,59,104,allow
37965,51413,23143,51413,2020,1090,930,18,1200,15,3,allow
50116,22,50116,22,184,120,64,4,10,3,1,allow
49290,443,20906,443,1629306,22920,1606386,1339,116,262,1077,allow
54998,80,32299,80,2814,2440,374,13,16,7,6,allow
23397,53,23397,53,234,93,141,2,30,1,1,allow
34028,443,55750,443,7804,2108,5696,24,32,14,10,allow
53640,28937,48559,28937,70,70,0,2,8,2,0,allow
58714,53,58714,53,197,76,121,2,30,1,1,allow
52280,995,52280,995,142,78,64,2,5,1,1,allow
57470,29500,37295,29500,2772,2772,0,43,2311,43,0,allow
50584,19051,19819,19051,300,300,0,3,1200,3,0,allow
65286,3389,65286,3389,3424,1710,1714,16,31,8,8,allow
53297,443,55944,443,5600,1187,4413,24,80,13,11,allow
53018,80,53018,80,182677,4908,177769,213,25,73,140,allow
60418,39537,32602,39537,70,70,0,2,8,2,0,allow
10101,443,13897,443,7563,1536,6027,26,316,14,12,allow
49624,443,56067,443,6440,1965,4475,22,36,12,10,allow
27005,27017,63290,27017,917,126,791,2,30,1,1,allow
27005,27015,7639,27015,919,126,793,2,30,1,1,allow
50584,12948,3713,12948,346,161,185,2,1200,1,1,allow
46573,50584,0,0,66,66,0,1,0,1,0,deny
52633,30188,0,0,66,66,0,1,0,1,0,deny
39313,37965,0,0,62,62,0,1,0,1,0,deny
54389,445,0,0,70,70,0,1,0,1,0,drop
54388,445,0,0,70,70,0,1,0,1,0,drop
53770,64147,0,0,66,66,0,1,0,1,0,deny
54386,445,0,0,70,70,0,1,0,1,0,drop
54385,445,0,0,70,70,0,1,0,1,0,drop
40082,2222,0,0,60,60,0,1,0,1,0,deny
1025,35447,0,0,62,62,0,1,0,1,0,deny
45908,33330,0,0,60,60,0,1,0,1,0,deny
54731,445,0,0,66,66,0,1,0,1,0,drop
65476,443,36901,443,93073,4939,88134,111,16,45,66,allow
52286,995,52286,995,146,82,64,2,5,1,1,allow
37965,30982,7359,30982,528,528,0,9,1199,9,0,allow
55746,53,18233,53,302,84,218,4,46,2,2,allow
43757,3389,43757,3389,3910,1805,2105,20,18,12,8,allow
64326,53,53148,53,323,107,216,4,38,2,2,allow
57315,443,25232,443,134,60,74,3,5,2,1,allow
64723,53,23544,53,677,198,479,6,68,3,3,allow
56476,53,63647,53,239,94,145,2,30,1,1,allow
59470,443,18542,443,3726,688,3038,14,119,7,7,allow
33811,443,49179,443,17406,8237,9169,53,165,21,32,allow
50840,80,15901,80,268155,6485,261670,281,25,97,184,allow
56276,443,43498,443,71414,17145,54269,194,292,91,103,allow
63820,27441,36322,27441,66,66,0,2,7,2,0,allow
40165,443,53877,443,232,172,60,3,5,2,1,allow
65207,443,12429,443,8188,2769,5419,22,611,12,10,allow
63819,18445,64902,18445,66,66,0,2,7,2,0,allow
35357,53,47462,53,291,86,205,2,29,1,1,allow
50977,80,13754,80,45483,4137,41346,68,21,36,32,allow
50975,80,19286,80,24781,3304,21477,43,21,24,19,allow
61674,443,44305,443,6117,1224,4893,21,50,12,9,allow
56596,53,31877,53,350,94,256,2,30,1,1,allow
63816,2073,29145,2073,66,66,0,2,7,2,0,allow
64494,53,52141,53,337,110,227,2,29,1,1,allow
57312,443,4774,443,134,60,74,3,5,2,1,allow
27005,27015,22389,27015,879,126,753,2,30,1,1,allow
48817,10528,48817,10528,2736,1992,744,37,1580,25,12,allow
50584,8622,56694,8622,166,166,0,1,1200,1,0,allow
49501,443,9020,443,15456,2581,12875,28,31,10,18,allow
49475,53,49996,53,243,110,133,2,30,1,1,allow
34922,443,21368,443,8093,2068,6025,23,360,11,12,allow
60715,443,1663,443,1716,1136,580,15,30,9,6,allow
56441,80,25376,80,130,70,60,2,15,1,1,allow
51981,80,47640,80,48165,2605,45560,63,15,31,32,allow
55190,443,14814,443,12801,4250,8551,40,118,21,19,allow
65475,443,62261,443,429726,12570,417156,440,16,154,286,allow
60416,55998,61754,55998,70,70,0,2,8,2,0,allow
53314,443,30512,443,12053,6627,5426,47,1043,26,21,allow
5235,34592,6891,34592,247495,256,247239,361,49,5,356,allow
57093,80,11310,80,130,70,60,2,15,1,1,allow
50584,26433,35868,26433,166,166,0,1,1200,1,0,allow
49450,53,42470,53,330,118,212,2,30,1,1,allow
50584,12754,22956,12754,161,161,0,2,1200,2,0,allow
27005,27015,50537,27015,878,126,752,2,30,1,1,allow
50978,80,49892,80,81390,4223,77167,103,21,49,54,allow
36754,7,13340,7,138,78,60,2,5,1,1,allow
56428,80,32588,80,17247,1619,15628,26,25,11,15,allow
53292,443,45740,443,4028,2584,1444,18,80,10,8,allow
4780,443,25705,443,1191,692,499,12,40,7,5,allow
51952,80,54561,80,1263,640,623,12,45,7,5,allow
57340,3333,57340,3333,24544,10921,13623,171,1095,89,82,allow
37769,80,60461,80,1213,471,742,10,255,6,4,allow
51951,80,24462,80,1265,642,623,12,45,7,5,allow
59106,443,57756,443,7398,2209,5189,23,35,11,12,allow
49404,53,39531,53,253,102,151,2,30,1,1,allow
27005,27018,24466,27018,882,126,756,2,30,1,1,allow
27005,27015,30434,27015,877,126,751,2,30,1,1,allow
27005,27444,25309,27444,893,126,767,2,30,1,1,allow
56579,53,36844,53,288,94,194,2,30,1,1,allow
50584,6881,16713,6881,166,166,0,1,1200,1,0,allow
49597,80,42235,80,130,70,60,2,15,1,1,allow
50414,443,29700,443,1346,918,428,10,25,6,4,allow
50974,80,38911,80,181877,8980,172897,207,22,87,120,allow
49920,443,45165,443,8888,2265,6623,18,15,9,9,allow
49218,443,48762,443,8929,3316,5613,38,255,18,20,allow
57425,443,11895,443,16413,6367,10046,60,17,28,32,allow
60417,55100,30057,55100,258,70,188,4,8,2,2,allow
63814,12906,64380,12906,66,66,0,2,7,2,0,allow
63818,19291,56455,19291,66,66,0,2,7,2,0,allow
53641,16605,38186,16605,70,70,0,2,7,2,0,allow
57319,443,43757,443,134,60,74,3,5,2,1,allow
57313,443,59852,443,134,60,74,3,5,2,1,allow
45566,443,9859,443,570475,25559,544916,712,32,341,371,allow
46092,443,17410,443,130,70,60,2,15,1,1,allow
45079,80,36951,80,233914,10359,223555,294,442,136,158,allow
63670,11648,33474,11648,4501,3174,1327,26,61,16,10,allow
64539,53,23141,53,712,214,498,6,44,3,3,allow
63813,53455,26592,53455,66,66,0,2,7,2,0,allow
57328,443,39932,443,134,60,74,3,4,2,1,allow
52285,995,52285,995,146,82,64,2,5,1,1,allow
49414,53,44484,53,561,112,449,4,53,2,2,allow
33932,443,50545,443,54451,2603,51848,70,16,30,40,allow
61361,443,55767,443,9604,5021,4583,29,86,15,14,allow
63994,53,4398,53,225,110,115,2,30,1,1,allow
63980,443,5737,443,5237,2844,2393,14,135,7,7,allow
58194,443,27436,443,3108,1047,2061,14,136,7,7,allow
43976,80,46864,80,130,70,60,2,15,1,1,allow
37805,443,7210,443,9481,3482,5999,58,16,29,29,allow
51944,80,27996,80,2120,1080,1040,17,55,10,7,allow
44164,443,64667,443,280,140,140,5,130,3,2,allow
50584,1191,3170,1191,161,161,0,2,1200,2,0,allow
53373,443,1651,443,8557,1755,6802,28,35,14,14,allow
47902,443,46766,443,2420,1462,958,18,170,10,8,allow
51950,80,41291,80,1268,645,623,12,45,7,5,allow
50584,6881,12157,6881,166,166,0,1,1200,1,0,allow
50584,6889,8974,6889,166,166,0,1,1200,1,0,allow
55981,80,16434,80,824,469,355,9,360,5,4,allow
35122,80,19351,80,130,70,60,2,15,1,1,allow
53244,53,53244,53,217,82,135,2,32,1,1,allow
50976,80,37762,80,3030,1372,1658,13,21,8,5,allow
55979,53,61976,53,275,110,165,2,30,1,1,allow
64731,53,27701,53,403,142,261,2,30,1,1,allow
55060,123,26864,123,184,94,90,2,30,1,1,allow
51434,443,45613,443,12291742,358717,11933025,12485,181,3846,8639,allow
37000,443,57961,443,280,140,140,5,130,3,2,allow
60980,443,25213,443,134,60,74,3,6,2,1,allow
48070,443,9695,443,10240,2295,7945,38,121,20,18,allow
49135,443,9255,443,2529,1230,1299,17,16,9,8,allow
48344,443,40212,443,232,172,60,3,5,2,1,allow
51508,443,54920,443,98292,24468,73824,179,52,81,98,allow
56930,53,11324,53,297,94,203,2,30,1,1,allow
49292,53,63112,53,323,94,229,2,31,1,1,allow
50209,1688,49264,1688,70,70,0,2,8,2,0,allow
63796,60557,4607,60557,70,70,0,1,5,1,0,allow
51515,443,8850,443,16287,13303,2984,49,38,26,23,allow
5753,65473,0,0,146,146,0,1,0,1,0,deny
59943,37807,0,0,62,62,0,1,0,1,0,deny
54730,445,0,0,66,66,0,1,0,1,0,drop
59328,445,0,0,70,70,0,1,0,1,0,drop
54370,445,0,0,70,70,0,1,0,1,0,drop
51166,31573,0,0,66,66,0,1,0,1,0,deny
54369,445,0,0,70,70,0,1,0,1,0,drop
54366,445,0,0,70,70,0,1,0,1,0,drop
59320,445,0,0,70,70,0,1,0,1,0,drop
59317,445,0,0,70,70,0,1,0,1,0,drop
59315,445,0,0,70,70,0,1,0,1,0,drop
54359,445,0,0,70,70,0,1,0,1,0,drop
54360,445,0,0,70,70,0,1,0,1,0,drop
62029,36237,0,0,66,66,0,1,0,1,0,deny
54728,445,0,0,66,66,0,1,0,1,0,drop
33453,64147,0,0,62,62,0,1,0,1,0,deny
49177,54532,0,0,60,60,0,1,0,1,0,deny
59301,445,0,0,70,70,0,1,0,1,0,drop
43104,26467,0,0,62,62,0,1,0,1,0,deny
20576,37965,0,0,62,62,0,1,0,1,0,deny
443,43775,0,0,97,97,0,1,0,1,0,deny
55933,64097,0,0,62,62,0,1,0,1,0,deny
59297,445,0,0,70,70,0,1,0,1,0,drop
59296,445,0,0,70,70,0,1,0,1,0,drop
59295,445,0,0,70,70,0,1,0,1,0,drop
38358,22300,0,0,60,60,0,1,0,1,0,deny
54721,445,0,0,66,66,0,1,0,1,0,drop
54348,445,0,0,70,70,0,1,0,1,0,drop
7104,23,0,0,60,60,0,1,0,1,0,deny
17226,35440,0,0,62,62,0,1,0,1,0,deny
54717,445,0,0,66,66,0,1,0,1,0,drop
54716,445,0,0,66,66,0,1,0,1,0,drop
54712,445,0,0,66,66,0,1,0,1,0,drop
9377,56205,0,0,66,66,0,1,0,1,0,deny
7749,36237,0,0,62,62,0,1,0,1,0,deny
54711,445,0,0,66,66,0,1,0,1,0,drop
54710,445,0,0,66,66,0,1,0,1,0,drop
54709,445,0,0,66,66,0,1,0,1,0,drop
47652,51505,0,0,62,62,0,1,0,1,0,deny
63586,46824,0,0,62,62,0,1,0,1,0,deny
1054,15503,0,0,62,62,0,1,0,1,0,deny
4269,26672,0,0,60,60,0,1,0,1,0,deny
59292,445,0,0,70,70,0,1,0,1,0,drop
59287,445,0,0,70,70,0,1,0,1,0,drop
59286,445,0,0,70,70,0,1,0,1,0,drop
50254,44847,0,0,62,62,0,1,0,1,0,deny
54343,445,0,0,70,70,0,1,0,1,0,drop
54706,445,0,0,66,66,0,1,0,1,0,drop
39540,37965,0,0,66,66,0,1,0,1,0,deny
59285,445,0,0,70,70,0,1,0,1,0,drop
56173,37807,0,0,62,62,0,1,0,1,0,deny
54702,445,0,0,66,66,0,1,0,1,0,drop
49982,37965,0,0,66,66,0,1,0,1,0,deny
53406,50584,0,0,62,62,0,1,0,1,0,deny
54701,445,0,0,66,66,0,1,0,1,0,drop
54700,445,0,0,66,66,0,1,0,1,0,drop
49716,5900,0,0,60,60,0,1,0,1,0,deny
30179,57470,0,0,60,60,0,1,0,1,0,deny
54334,445,0,0,70,70,0,1,0,1,0,drop
54335,445,0,0,70,70,0,1,0,1,0,drop
43194,32480,0,0,145,145,0,1,0,1,0,deny
54698,445,0,0,66,66,0,1,0,1,0,drop
54332,445,0,0,70,70,0,1,0,1,0,drop
54331,445,0,0,70,70,0,1,0,1,0,drop
54327,445,0,0,70,70,0,1,0,1,0,drop
58264,44847,0,0,66,66,0,1,0,1,0,deny
59277,445,0,0,70,70,0,1,0,1,0,drop
59273,445,0,0,70,70,0,1,0,1,0,drop
59270,445,0,0,70,70,0,1,0,1,0,drop
52361,23718,0,0,66,66,0,1,0,1,0,deny
54321,445,0,0,70,70,0,1,0,1,0,drop
54687,445,0,0,66,66,0,1,0,1,0,drop
12221,81,0,0,60,60,0,1,0,1,0,deny
43916,21,0,0,60,60,0,1,0,1,0,deny
64339,18375,0,0,62,62,0,1,0,1,0,deny
54314,445,0,0,70,70,0,1,0,1,0,drop
54679,445,0,0,66,66,0,1,0,1,0,drop
54312,445,0,0,70,70,0,1,0,1,0,drop
51051,22,51051,22,327,140,187,4,0,2,2,deny
59257,445,0,0,70,70,0,1,0,1,0,drop
34936,30188,0,0,66,66,0,1,0,1,0,deny
3559,30188,0,0,66,66,0,1,0,1,0,deny
18246,64097,0,0,66,66,0,1,0,1,0,deny
7992,64147,0,0,62,62,0,1,0,1,0,deny
55921,43890,0,0,66,66,0,1,0,1,0,deny
52217,22114,0,0,62,62,0,1,0,1,0,deny
59790,44847,0,0,62,62,0,1,0,1,0,deny
54676,445,0,0,66,66,0,1,0,1,0,drop
54308,445,0,0,70,70,0,1,0,1,0,drop
54306,445,0,0,70,70,0,1,0,1,0,drop
23089,48817,0,0,62,62,0,1,0,1,0,deny
54670,445,0,0,66,66,0,1,0,1,0,drop
41298,51050,0,0,62,62,0,1,0,1,0,deny
33822,57470,0,0,66,66,0,1,0,1,0,deny
54666,445,0,0,66,66,0,1,0,1,0,drop
54302,445,0,0,70,70,0,1,0,1,0,drop
63542,15503,0,0,62,62,0,1,0,1,0,deny
54301,445,0,0,70,70,0,1,0,1,0,drop
57131,35776,0,0,145,145,0,1,0,1,0,deny
63092,46776,0,0,78,78,0,1,0,1,0,deny
63772,35440,0,0,62,62,0,1,0,1,0,deny
64877,37450,0,0,62,62,0,1,0,1,0,deny
58721,51505,0,0,66,66,0,1,0,1,0,deny
53774,51505,0,0,66,66,0,1,0,1,0,deny
49255,44847,0,0,66,66,0,1,0,1,0,deny
59248,445,0,0,70,70,0,1,0,1,0,drop
59246,445,0,0,70,70,0,1,0,1,0,drop
59245,445,0,0,70,70,0,1,0,1,0,drop
54651,445,0,0,66,66,0,1,0,1,0,drop
54647,445,0,0,66,66,0,1,0,1,0,drop
54652,445,0,0,66,66,0,1,0,1,0,drop
54648,445,0,0,66,66,0,1,0,1,0,drop
54649,445,0,0,66,66,0,1,0,1,0,drop
54653,445,0,0,66,66,0,1,0,1,0,drop
54650,445,0,0,66,66,0,1,0,1,0,drop
54654,445,0,0,66,66,0,1,0,1,0,drop
10639,11392,0,0,62,62,0,1,0,1,0,deny
54296,445,0,0,70,70,0,1,0,1,0,drop
49805,64147,0,0,62,62,0,1,0,1,0,deny
53178,26467,0,0,62,62,0,1,0,1,0,deny
33362,50584,0,0,146,146,0,1,0,1,0,deny
0,0,0,0,244,244,0,2,0,2,0,allow
0,0,0,0,156,156,0,2,0,2,0,allow
52643,36237,0,0,66,66,0,1,0,1,0,deny
63456,37965,0,0,62,62,0,1,0,1,0,deny
59232,445,0,0,70,70,0,1,0,1,0,drop
59229,445,0,0,70,70,0,1,0,1,0,drop
59230,445,0,0,70,70,0,1,0,1,0,drop
61838,37965,0,0,66,66,0,1,0,1,0,deny
54196,11392,0,0,66,66,0,1,0,1,0,deny
54632,445,0,0,66,66,0,1,0,1,0,drop
54633,445,0,0,66,66,0,1,0,1,0,drop
54631,445,0,0,66,66,0,1,0,1,0,drop
36080,26467,0,0,62,62,0,1,0,1,0,deny
54283,445,0,0,70,70,0,1,0,1,0,drop
59227,445,0,0,70,70,0,1,0,1,0,drop
80,37649,0,0,60,60,0,1,0,1,0,deny
52696,21247,0,0,66,66,0,1,0,1,0,deny
41346,30188,0,0,62,62,0,1,0,1,0,deny
57632,7302,0,0,146,146,0,1,0,1,0,deny
54280,445,0,0,70,70,0,1,0,1,0,drop
59225,445,0,0,70,70,0,1,0,1,0,drop
59220,445,0,0,70,70,0,1,0,1,0,drop
59216,445,0,0,70,70,0,1,0,1,0,drop
59214,445,0,0,70,70,0,1,0,1,0,drop
6666,44818,0,0,60,60,0,1,0,1,0,deny
59563,56205,0,0,66,66,0,1,0,1,0,deny
30578,55783,0,0,145,145,0,1,0,1,0,deny
1511,3389,0,0,60,60,0,1,0,1,0,deny
22904,56205,0,0,62,62,0,1,0,1,0,deny
54276,445,0,0,70,70,0,1,0,1,0,drop
54274,445,0,0,70,70,0,1,0,1,0,drop
62549,53733,0,0,66,66,0,1,0,1,0,deny
54272,445,0,0,70,70,0,1,0,1,0,drop
1033,35440,0,0,146,146,0,1,0,1,0,deny
30114,65151,0,0,60,60,0,1,0,1,0,deny
10151,1042,12380,1042,490,149,341,2,1200,1,1,allow
41027,80,41027,80,18224,2763,15461,29,126,14,15,allow
41030,80,41030,80,80261,4766,75495,91,126,35,56,allow
27005,27015,43696,27015,876,126,750,2,30,1,1,allow
49289,443,60908,443,3890599,46254,3844345,3173,116,609,2564,allow
60312,80,47441,80,2390,532,1858,11,75,6,5,allow
49535,80,31379,80,1548,847,701,10,16,5,5,allow
50767,80,50767,80,30767,854,29913,38,15,13,25,allow
53016,80,53016,80,265868,5026,260842,277,24,75,202,allow
37981,80,45214,80,1572,755,817,11,15,6,5,allow
56002,53,0,0,213,88,125,2,30,1,1,allow
23916,53,23916,53,224,88,136,2,30,1,1,allow
39932,443,25651,443,8309,4385,3924,26,121,12,14,allow
33006,80,33006,80,6582,886,5696,15,16,7,8,allow
65239,53,65239,53,231,90,141,2,30,1,1,allow
3181,53,3181,53,214,97,117,2,30,1,1,allow
58611,53,0,0,172,78,94,2,30,1,1,allow
57700,53,0,0,300,90,210,2,30,1,1,allow
49233,8080,49233,8080,2602,846,1756,13,136,7,6,allow
49023,5223,36604,5223,139,139,0,1,5,1,0,allow
49536,80,12566,80,4544,3602,942,15,15,8,7,allow
44912,443,31289,443,414,140,274,7,26,3,4,allow
57674,53,0,0,195,79,116,2,30,1,1,allow
64172,53,0,0,174,79,95,2,30,1,1,allow
13699,53,13699,53,194,87,107,2,30,1,1,allow
58217,53,0,0,266,85,181,2,30,1,1,allow
57240,53,0,0,230,87,143,2,30,1,1,allow
58120,53,58120,53,825,99,726,2,30,1,1,allow
51091,53,51091,53,243,96,147,2,30,1,1,allow
55866,53,45530,53,732,89,643,2,30,1,1,allow
52763,53,0,0,296,87,209,2,30,1,1,allow
30960,45703,22089,45703,330,330,0,6,3609,6,0,allow
41029,80,41029,80,12386,2651,9735,24,126,12,12,allow
45336,443,30419,443,2312,1382,930,19,28,11,8,allow
43969,7000,43969,7000,3370,1595,1775,16,15,9,7,allow
51969,80,41756,80,7304882,206543,7098339,7398,37,2677,4721,allow
54908,53,0,0,174,79,95,2,30,1,1,allow
63799,13835,56478,13835,66,66,0,1,5,1,0,allow
44395,443,50721,443,18921,10848,8073,49,401,20,29,allow
42040,5228,65521,5228,3467,1977,1490,29,3742,14,15,allow
48786,80,30638,80,1834,1520,314,14,15,9,5,allow
59468,80,3821,80,1594,1280,314,10,15,5,5,allow
45337,443,2595,443,2312,1382,930,19,24,11,8,allow
23333,53,23333,53,215,80,135,2,33,1,1,allow
56077,80,50993,80,5302,704,4598,14,18,8,6,allow
49225,8080,49225,8080,43790,20134,23656,73,400,45,28,allow
51972,80,28549,80,7001170,112187,6888983,6101,29,1546,4555,allow
63797,47784,45642,47784,66,66,0,1,5,1,0,allow
49845,53,0,0,206,83,123,2,30,1,1,allow
61452,53,0,0,223,89,134,2,30,1,1,allow
49235,8080,49235,8080,2600,844,1756,13,136,7,6,allow
25251,53,25251,53,231,90,141,2,30,1,1,allow
42008,53,0,0,82,82,0,1,30,1,0,allow
42891,53,42891,53,224,88,136,2,30,1,1,allow
59891,53,0,0,248,75,173,2,30,1,1,allow
1955,53,1955,53,216,89,127,2,30,1,1,allow
27005,27017,10381,27017,600,126,474,2,30,1,1,allow
22633,53,0,0,300,90,210,2,30,1,1,allow
52033,443,12817,443,9609,3239,6370,25,143,12,13,allow
41032,80,41032,80,11428,2250,9178,22,126,11,11,allow
59208,445,0,0,70,70,0,1,0,1,0,drop
59207,445,0,0,70,70,0,1,0,1,0,drop
59203,445,0,0,70,70,0,1,0,1,0,drop
28229,51505,0,0,146,146,0,1,0,1,0,deny
59845,44847,0,0,66,66,0,1,0,1,0,deny
24174,57470,0,0,62,62,0,1,0,1,0,deny
17453,35440,0,0,66,66,0,1,0,1,0,deny
55539,57470,0,0,66,66,0,1,0,1,0,deny
80,53945,0,0,60,60,0,1,0,1,0,deny
54265,445,0,0,70,70,0,1,0,1,0,drop
54263,445,0,0,70,70,0,1,0,1,0,drop
2541,51505,0,0,66,66,0,1,0,1,0,deny
61415,443,64279,443,6143,1796,4347,21,21,11,10,allow
38028,443,50090,443,8805,1300,7505,23,30,12,11,allow
64378,53,28947,53,273,94,179,2,30,1,1,allow
41901,443,21025,443,5586,1404,4182,17,212,10,7,allow
57304,443,45886,443,134,60,74,3,5,2,1,allow
48706,23393,0,0,60,60,0,1,0,1,0,deny
54612,445,0,0,66,66,0,1,0,1,0,drop
46679,64147,0,0,62,62,0,1,0,1,0,deny
54262,445,0,0,70,70,0,1,0,1,0,drop
59200,445,0,0,70,70,0,1,0,1,0,drop
59198,445,0,0,70,70,0,1,0,1,0,drop
54261,445,0,0,70,70,0,1,0,1,0,drop
54260,445,0,0,70,70,0,1,0,1,0,drop
28498,36237,0,0,146,146,0,1,0,1,0,deny
54254,445,0,0,70,70,0,1,0,1,0,drop
54256,445,0,0,70,70,0,1,0,1,0,drop
48706,23393,0,0,60,60,0,1,0,1,0,deny
49177,54532,0,0,60,60,0,1,0,1,0,deny
51558,37965,0,0,72,72,0,1,0,1,0,deny
56906,50584,0,0,146,146,0,1,0,1,0,deny
54605,445,0,0,66,66,0,1,0,1,0,drop
54242,445,0,0,70,70,0,1,0,1,0,drop
54241,445,0,0,70,70,0,1,0,1,0,deny
54235,445,0,0,70,70,0,1,0,1,0,drop
54232,445,0,0,70,70,0,1,0,1,0,drop
54231,445,0,0,70,70,0,1,0,1,0,drop
54602,445,0,0,66,66,0,1,0,1,0,drop
65115,50584,0,0,62,62,0,1,0,1,0,deny
59186,445,0,0,70,70,0,1,0,1,0,drop
2394,43890,0,0,62,62,0,1,0,1,0,deny
22683,39210,0,0,60,60,0,1,0,1,0,deny
443,56858,0,0,85,85,0,1,0,1,0,deny
52643,15941,0,0,66,66,0,1,0,1,0,deny
59181,445,0,0,70,70,0,1,0,1,0,drop
59180,445,0,0,70,70,0,1,0,1,0,drop
59177,445,0,0,70,70,0,1,0,1,0,drop
21145,11392,0,0,146,146,0,1,0,1,0,deny
54600,445,0,0,66,66,0,1,0,1,0,drop
49479,56205,0,0,66,66,0,1,0,1,0,deny
34134,30188,0,0,62,62,0,1,0,1,0,deny
50280,57470,0,0,78,78,0,1,0,1,0,deny
64835,53,44115,53,371,126,245,2,30,1,1,allow
39228,53,7632,53,199,94,105,2,30,1,1,allow
45218,443,18311,443,16297,12965,3332,54,193,30,24,allow
53013,80,53013,80,258732,4788,253944,268,25,71,197,allow
3440,7000,3440,7000,3127,676,2451,15,19,7,8,allow
63798,16357,31313,16357,70,70,0,1,4,1,0,allow
49533,80,42327,80,8220,849,7371,13,28,5,8,allow
63795,52376,52814,52376,70,70,0,1,4,1,0,allow
36788,443,36788,443,4555,1648,2907,19,29,11,8,allow
40236,443,44776,443,4945,1401,3544,21,25,11,10,allow
51522,443,24413,443,8517,2719,5798,24,360,12,12,allow
55684,53,0,0,219,86,133,2,29,1,1,allow
52837,53,0,0,86,86,0,1,29,1,0,allow
35187,443,44307,443,27553,21226,6327,57,216,31,26,allow
50211,53,50211,53,217,90,127,2,29,1,1,allow
50491,53,0,0,183,86,97,2,29,1,1,allow
56969,53,53086,53,196,94,102,2,29,1,1,allow
14237,53,14237,53,245,98,147,2,29,1,1,allow
65191,53,21889,53,196,94,102,2,29,1,1,allow
58126,443,22478,443,3179,954,2225,10,120,5,5,allow
57426,66,63838,66,70,70,0,1,5,1,0,allow
56804,33375,57101,33375,70,70,0,1,5,1,0,allow
49710,53,2087,53,179,94,85,2,30,1,1,allow
27005,27019,52593,27019,1007,252,755,4,32,3,1,allow
51433,443,11382,443,194,70,124,3,11,1,2,allow
49234,8080,49234,8080,2604,848,1756,13,136,7,6,allow
5588,5588,0,0,3354,1792,1562,46,192,23,23,allow
59752,443,56734,443,2233,1237,996,18,75,9,9,allow
56592,53,8567,53,262,94,168,2,30,1,1,allow
52189,443,26207,443,4688,3009,1679,33,80,17,16,allow
54136,80,22556,80,25148,5233,19915,39,71,21,18,allow
34535,443,2952,443,74325,3719,70606,98,200,44,54,allow
49416,443,60402,443,625995,31468,594527,722,199,256,466,allow
49710,53,37323,53,179,94,85,2,30,1,1,allow
50265,43974,25412,43974,132,132,0,3,1200,3,0,allow
52763,53,0,0,641,87,554,2,30,1,1,allow
53310,443,4749,443,2253,1403,850,15,121,9,6,allow
56818,45179,49960,45179,70,70,0,1,5,1,0,allow
61421,443,24287,443,7206,1897,5309,20,21,11,9,allow
52071,443,56996,443,8232,3997,4235,21,16,11,10,allow
49562,53,45656,53,380,90,290,4,48,2,2,allow
60756,40010,4489,40010,316,136,180,6,6,3,3,allow
42776,443,39063,443,4353,687,3666,14,25,8,6,allow
37082,443,41934,443,2419,1461,958,18,170,10,8,allow
56235,53,15523,53,199,94,105,2,30,1,1,allow
27005,27222,42780,27222,890,126,764,2,30,1,1,allow
65200,53,35834,53,290,102,188,2,30,1,1,allow
41031,80,41031,80,2791,1259,1532,13,125,7,6,allow
58830,28678,13686,28678,1806,1806,0,22,224,22,0,allow
60240,443,63324,443,4310,2523,1787,42,120,24,18,allow
53318,80,64678,80,1536,982,554,10,76,6,4,allow
54246,80,56298,80,506,292,214,8,16,5,3,allow
56622,80,24066,80,234,234,0,4,12,4,0,allow
60411,58131,27448,58131,70,70,0,1,5,1,0,allow
53716,443,15837,443,70,70,0,1,5,1,0,allow
39059,443,37868,443,3221,1299,1922,15,19,9,6,allow
42777,443,6253,443,4353,687,3666,14,25,8,6,allow
50827,443,28235,443,166814,93487,73327,620,4017,312,308,allow
49493,443,39689,443,9692,6055,3637,21,30,11,10,allow
43776,7000,43776,7000,3174,1617,1557,17,18,9,8,allow
50121,443,39430,443,29425,9485,19940,54,35,27,27,allow
53120,49860,25192,49860,70,70,0,1,5,1,0,allow
58346,443,42517,443,5571,1518,4053,22,614,13,9,allow
49434,53,30404,53,326,134,192,2,30,1,1,allow
65009,53,56985,53,737,94,643,2,30,1,1,allow
51789,443,60352,443,6218,4326,1892,31,124,17,14,allow
27005,27017,61483,27017,878,126,752,2,30,1,1,allow
27005,27333,2413,27333,890,126,764,2,30,1,1,allow
52734,443,39307,443,257777,12962,244815,347,41,162,185,allow
27005,27015,17359,27015,878,126,752,2,30,1,1,allow
60412,12965,9031,12965,70,70,0,1,5,1,0,allow
51432,443,60618,443,194,70,124,3,11,1,2,allow
60013,443,65408,443,145369,7769,137600,224,21,106,118,allow
55368,443,50740,443,8551,2955,5596,28,423,15,13,allow
53319,443,19200,443,2246,1396,850,15,117,9,6,allow
50567,443,27568,443,198,120,78,4,15,3,1,allow
49881,53,28793,53,395,102,293,2,30,1,1,allow
50265,2710,57990,2710,320,320,0,6,1200,6,0,allow
57470,17984,5691,17984,402,132,270,6,1209,3,3,allow
35844,443,58126,443,5196,1875,3321,45,5922,12,33,allow
60384,443,3369,443,4315,928,3387,16,15,10,6,allow
32777,443,20717,443,8080,2049,6031,23,255,12,11,allow
55624,80,8124,80,70,70,0,2,8,2,0,allow
51447,443,8869,443,202,70,132,3,11,1,2,allow
52729,443,62575,443,9026,3447,5579,50,45,26,24,allow
50122,443,3201,443,15217,5689,9528,52,35,27,25,allow
50705,21,33829,21,2222,983,1239,27,18,13,14,allow
49849,53,48086,53,325,126,199,2,30,1,1,allow
53707,53,63109,53,86,86,0,1,30,1,0,allow
63990,53,19922,53,270,94,176,2,30,1,1,allow
45743,8765,60687,8765,336,150,186,6,89,3,3,allow
27005,27111,57650,27111,893,126,767,2,30,1,1,allow
27005,27015,50781,27015,881,126,755,2,30,1,1,allow
49266,443,52610,443,183,70,113,2,120,1,1,allow
37965,63402,11159,63402,2118,858,1260,28,1283,14,14,allow
59157,443,21885,443,7139,3570,3569,22,166,11,11,allow
57470,52217,58146,52217,1969,730,1239,19,1199,10,9,allow
52741,443,63085,443,85011,4398,80613,113,26,52,61,allow
53981,53,31166,53,199,94,105,2,31,1,1,allow
40967,443,61086,443,1786,172,1614,7,121,3,4,allow
52745,443,60430,443,19919,2270,17649,38,26,21,17,allow
52743,443,59107,443,1547,960,587,14,26,8,6,allow
52742,443,24275,443,69884,4367,65517,96,26,44,52,allow
52098,5228,3628,5228,3117,1602,1515,31,66,16,15,allow
56652,80,44398,80,9012,4718,4294,43,81,21,22,allow
53201,443,8091,443,3907,2251,1656,16,321,8,8,allow
59329,53,2601,53,199,94,105,2,30,1,1,allow
43531,53,58732,53,199,94,105,2,30,1,1,allow
4269,26672,0,0,60,60,0,1,0,1,0,deny
35722,30188,0,0,146,146,0,1,0,1,0,deny
51525,35440,0,0,66,66,0,1,0,1,0,deny
59174,445,0,0,70,70,0,1,0,1,0,drop
45941,23386,0,0,60,60,0,1,0,1,0,deny
61223,37965,0,0,66,66,0,1,0,1,0,deny
57676,64147,0,0,70,70,0,1,0,1,0,deny
3436,46783,0,0,145,145,0,1,0,1,0,deny
45941,23386,0,0,60,60,0,1,0,1,0,deny
1866,51505,0,0,62,62,0,1,0,1,0,deny
54220,445,0,0,70,70,0,1,0,1,0,drop
59170,445,0,0,70,70,0,1,0,1,0,drop
59168,445,0,0,70,70,0,1,0,1,0,drop
59166,445,0,0,70,70,0,1,0,1,0,drop
54593,445,0,0,66,66,0,1,0,1,0,drop
30179,57470,0,0,60,60,0,1,0,1,0,deny
54587,445,0,0,66,66,0,1,0,1,0,drop
54588,445,0,0,66,66,0,1,0,1,0,drop
54586,445,0,0,66,66,0,1,0,1,0,drop
13985,34159,0,0,66,66,0,1,0,1,0,deny
54583,445,0,0,66,66,0,1,0,1,0,drop
54582,445,0,0,66,66,0,1,0,1,0,drop
54580,445,0,0,66,66,0,1,0,1,0,drop
50369,50584,0,0,62,62,0,1,0,1,0,deny
59430,50584,0,0,66,66,0,1,0,1,0,deny
54216,445,0,0,70,70,0,1,0,1,0,deny
59164,445,0,0,70,70,0,1,0,1,0,drop
59162,445,0,0,70,70,0,1,0,1,0,drop
59159,445,0,0,70,70,0,1,0,1,0,drop
57289,31573,0,0,62,62,0,1,0,1,0,deny
54577,445,0,0,66,66,0,1,0,1,0,drop
51909,6881,0,0,62,62,0,1,0,1,0,deny
59157,445,0,0,70,70,0,1,0,1,0,drop
54575,445,0,0,66,66,0,1,0,1,0,drop
54205,445,0,0,70,70,0,1,0,1,0,drop
54206,445,0,0,70,70,0,1,0,1,0,drop
54204,445,0,0,70,70,0,1,0,1,0,drop
54201,445,0,0,70,70,0,1,0,1,0,drop
54573,445,0,0,66,66,0,1,0,1,0,drop
54572,445,0,0,66,66,0,1,0,1,0,drop
54200,445,0,0,70,70,0,1,0,1,0,drop
50360,35440,0,0,62,62,0,1,0,1,0,deny
54570,445,0,0,66,66,0,1,0,1,0,drop
14070,62413,0,0,62,62,0,1,0,1,0,deny
28221,37965,0,0,62,62,0,1,0,1,0,deny
25304,64147,0,0,146,146,0,1,0,1,0,deny
59149,445,0,0,70,70,0,1,0,1,0,drop
59146,445,0,0,70,70,0,1,0,1,0,drop
55898,443,55898,443,1850,431,1419,5,0,3,2,deny
59139,445,0,0,70,70,0,1,0,1,0,drop
45673,30188,0,0,62,62,0,1,0,1,0,deny
54194,445,0,0,70,70,0,1,0,1,0,drop
21534,42246,0,0,66,66,0,1,0,1,0,deny
54559,445,0,0,66,66,0,1,0,1,0,drop
54186,445,0,0,70,70,0,1,0,1,0,drop
42332,22114,0,0,66,66,0,1,0,1,0,deny
54183,445,0,0,70,70,0,1,0,1,0,drop
54551,445,0,0,66,66,0,1,0,1,0,drop
59129,445,0,0,70,70,0,1,0,1,0,drop
49485,11392,0,0,62,62,0,1,0,1,0,deny
61323,23117,0,0,62,62,0,1,0,1,0,deny
54180,445,0,0,70,70,0,1,0,1,0,drop
45941,23388,0,0,60,60,0,1,0,1,0,deny
54178,445,0,0,70,70,0,1,0,1,0,drop
54549,445,0,0,66,66,0,1,0,1,0,drop
63092,46776,0,0,78,78,0,1,0,1,0,deny
55396,26467,0,0,62,62,0,1,0,1,0,deny
54174,445,0,0,70,70,0,1,0,1,0,drop
54540,445,0,0,66,66,0,1,0,1,0,drop
54539,445,0,0,66,66,0,1,0,1,0,drop
64880,9694,0,0,66,66,0,1,0,1,0,deny
28345,11392,0,0,62,62,0,1,0,1,0,deny
54173,445,0,0,70,70,0,1,0,1,0,drop
13441,57470,0,0,62,62,0,1,0,1,0,deny
57410,37965,0,0,66,66,0,1,0,1,0,deny
20108,64147,0,0,66,66,0,1,0,1,0,deny
54168,445,0,0,70,70,0,1,0,1,0,drop
59122,445,0,0,70,70,0,1,0,1,0,drop
59118,445,0,0,70,70,0,1,0,1,0,drop
59117,445,0,0,70,70,0,1,0,1,0,drop
3911,50584,0,0,62,62,0,1,0,1,0,deny
54518,445,0,0,66,66,0,1,0,1,0,drop
54520,445,0,0,66,66,0,1,0,1,0,drop
54524,445,0,0,66,66,0,1,0,1,0,drop
54521,445,0,0,66,66,0,1,0,1,0,drop
54526,445,0,0,66,66,0,1,0,1,0,drop
54525,445,0,0,66,66,0,1,0,1,0,drop
54523,445,0,0,66,66,0,1,0,1,0,drop
54519,445,0,0,66,66,0,1,0,1,0,drop
57431,15503,0,0,62,62,0,1,0,1,0,deny
56440,56205,0,0,62,62,0,1,0,1,0,deny
42798,26467,0,0,62,62,0,1,0,1,0,deny
60423,35440,0,0,146,146,0,1,0,1,0,deny
60152,26467,0,0,62,62,0,1,0,1,0,deny
31978,57470,0,0,60,60,0,1,0,1,0,deny
22714,30188,0,0,62,62,0,1,0,1,0,deny
80,9918,0,0,60,60,0,1,0,1,0,deny
46495,4607,0,0,60,60,0,1,0,1,0,deny
19875,30170,0,0,145,145,0,1,0,1,0,deny
59112,445,0,0,70,70,0,1,0,1,0,drop
59109,445,0,0,70,70,0,1,0,1,0,drop
59101,445,0,0,70,70,0,1,0,1,0,drop
54155,445,0,0,70,70,0,1,0,1,0,drop
54505,445,0,0,66,66,0,1,0,1,0,drop
54504,445,0,0,66,66,0,1,0,1,0,drop
54503,445,0,0,66,66,0,1,0,1,0,drop
57545,35440,0,0,66,66,0,1,0,1,0,deny
54152,445,0,0,70,70,0,1,0,1,0,drop
59100,445,0,0,70,70,0,1,0,1,0,drop
9106,53,9106,53,227,89,138,2,30,1,1,allow
52052,80,64577,80,2188,593,1595,11,16,5,6,allow
45184,80,27181,80,1718,1404,314,11,15,6,5,allow
27005,27015,57619,27015,902,126,776,2,30,1,1,allow
48753,80,48753,80,19937,2162,17775,36,24,19,17,allow
52737,443,14623,443,32774,3629,29145,52,26,27,25,allow
51803,33973,32167,33973,66,66,0,1,5,1,0,allow
41543,443,55490,443,234,234,0,4,12,4,0,allow
53616,44166,57712,44166,70,70,0,1,5,1,0,allow
55196,443,1122,443,13568,2119,11449,35,316,17,18,allow
37183,443,43656,443,9631,4184,5447,33,271,17,16,allow
56590,53,0,0,82,82,0,1,30,1,0,allow
2939,53,2939,53,200,90,110,2,30,1,1,allow
18105,53,18105,53,216,98,118,2,30,1,1,allow
52740,443,65500,443,168753,7954,160799,212,26,95,117,allow
46232,53,46232,53,194,87,107,2,30,1,1,allow
35185,3389,35185,3389,3424,1710,1714,16,33,8,8,allow
52886,443,7611,443,26307,17595,8712,52,498,29,23,allow
53536,443,47086,443,7901,3483,4418,24,30,13,11,allow
58771,443,59212,443,5750,1163,4587,25,258,13,12,allow
52738,443,34014,443,56339,3530,52809,79,26,39,40,allow
51818,43942,37942,43942,258,70,188,4,8,2,2,allow
53615,867,2680,867,70,70,0,1,5,1,0,allow
45632,443,51632,443,55844,3452,52392,85,255,38,47,allow
52480,443,40106,443,7103,2432,4671,18,76,10,8,allow
30960,45701,51481,45701,330,330,0,6,3609,6,0,allow
34417,53,11898,53,168,78,90,2,30,1,1,allow
40296,80,40296,80,1032410,43358,989052,1356,72,591,765,allow
40907,443,19035,443,7183,1824,5359,27,316,14,13,allow
52064,80,49794,80,2125,709,1416,11,16,5,6,allow
58115,53,48692,53,578,286,292,9,15,5,4,allow
35156,8635,35156,8635,138,78,60,2,5,1,1,allow
63807,38976,18542,38976,66,66,0,2,8,2,0,allow
42731,443,42301,443,6131,1399,4732,20,983,10,10,allow
49290,443,44950,443,4783,2366,2417,16,203,8,8,allow
51548,80,33223,80,1654,1340,314,11,15,6,5,allow
63809,45193,55784,45193,66,66,0,2,8,2,0,allow
50393,8080,50393,8080,378,180,198,7,31,4,3,allow
52476,443,35367,443,7787,3056,4731,19,87,10,9,allow
52739,443,43890,443,25048,2850,22198,45,26,23,22,allow
52963,80,22153,80,1600,581,1019,10,15,6,4,allow
55276,80,42794,80,1594,1280,314,10,15,5,5,allow
45335,443,8948,443,2814,1454,1360,23,28,12,11,allow
49528,443,34727,443,5968,985,4983,17,28,8,9,allow
27005,27013,37862,27013,869,126,743,2,30,1,1,allow
30906,53,30906,53,227,89,138,2,30,1,1,allow
7539,53,7539,53,194,87,107,2,30,1,1,allow
35311,443,37900,443,6584,1945,4639,14,120,7,7,allow
56987,443,32142,443,3800,1324,2476,14,136,7,7,allow
52773,443,22036,443,19594,11977,7617,48,100,25,23,allow
59097,445,0,0,70,70,0,1,0,1,0,drop
53833,26467,0,0,66,66,0,1,0,1,0,deny
14694,443,0,0,60,60,0,1,0,1,0,deny
59093,445,0,0,70,70,0,1,0,1,0,drop
59091,445,0,0,70,70,0,1,0,1,0,drop
59089,445,0,0,70,70,0,1,0,1,0,drop
46576,23718,0,0,66,66,0,1,0,1,0,deny
53168,44847,0,0,146,146,0,1,0,1,0,deny
9605,57470,0,0,62,62,0,1,0,1,0,deny
11133,51505,0,0,66,66,0,1,0,1,0,deny
54148,445,0,0,70,70,0,1,0,1,0,drop
53650,64147,0,0,62,62,0,1,0,1,0,deny
58343,23718,0,0,66,66,0,1,0,1,0,deny
54146,445,0,0,70,70,0,1,0,1,0,drop
45964,2666,0,0,60,60,0,1,0,1,0,deny
58564,50432,0,0,66,66,0,1,0,1,0,deny
10448,14914,0,0,143,143,0,1,0,1,0,deny
54144,445,0,0,70,70,0,1,0,1,0,drop
54819,443,59534,443,3429,1188,2241,13,134,6,7,allow
47711,443,57619,443,11793,7188,4605,34,128,17,17,allow
65199,53,63329,53,793,207,586,6,59,3,3,allow
57256,5228,53413,5228,7144,1872,5272,36,22,20,16,allow
49212,80,1671,80,1013,566,447,8,134,5,3,allow
51804,31012,28842,31012,70,70,0,1,5,1,0,allow
20,64488,20,50706,624666,17676,606990,671,14,267,404,allow
39916,53,62317,53,168,78,90,2,30,1,1,allow
27005,27016,9591,27016,884,126,758,2,30,1,1,allow
56180,53,56180,53,229,98,131,2,30,1,1,allow
52744,443,47091,443,14838,2048,12790,32,25,18,14,allow
52728,443,50981,443,186399,56439,129960,335,45,170,165,allow
52736,443,12534,443,1217451,39642,1177809,1359,39,539,820,allow
52732,443,31396,443,27467,22472,4995,85,42,45,40,allow
49986,443,61933,443,25918,2247,23671,53,124,26,27,allow
37321,53,37321,53,197,90,107,2,30,1,1,allow
56817,48650,23825,48650,130,70,60,2,5,1,1,allow
57492,443,47894,443,380975,82011,298964,804,171,343,461,allow
37002,443,19218,443,6646,2747,3899,20,134,10,10,allow
23226,53,23226,53,217,82,135,2,33,1,1,allow
56358,443,56358,443,4674,1767,2907,19,29,11,8,allow
42843,53,7011,53,168,78,90,2,30,1,1,allow
50550,53,58594,53,168,78,90,2,30,1,1,allow
10151,53,10151,53,220,90,130,2,30,1,1,allow
56555,443,29813,443,6308,829,5479,18,15,9,9,allow
64221,53,19919,53,262,102,160,2,30,1,1,allow
49761,80,49761,80,2937,703,2234,13,142,6,7,allow
36448,53,11652,53,199,94,105,2,30,1,1,allow
11295,53,11295,53,197,90,107,2,30,1,1,allow
49574,53,2504,53,496,92,404,4,58,2,2,allow
24412,53,24412,53,200,90,110,2,30,1,1,allow
51805,15298,5839,15298,70,70,0,1,5,1,0,allow
59750,443,51830,443,2633,1179,1454,20,74,8,12,allow
49502,443,43578,443,31780,3232,28548,44,29,16,28,allow
65138,53,7886,53,418,94,324,2,30,1,1,allow
19473,58093,47634,58093,460,150,310,2,1200,1,1,allow
59748,443,39145,443,8789,1592,7197,25,75,13,12,allow
6881,40783,51733,40783,509,150,359,2,1199,1,1,allow
34957,80,4367,80,7136,3526,3610,42,1239,21,21,allow
49899,443,2357,443,26284,21857,4427,72,83,39,33,allow
60665,443,60665,443,5715,1432,4283,19,15,9,10,allow
27005,27017,7063,27017,877,126,751,3,31,2,1,allow
27005,27015,62315,27015,1006,252,754,4,32,3,1,allow
57918,443,47624,443,38204,3737,34467,77,95,40,37,allow
61711,443,17336,443,7485,1962,5523,27,95,13,14,allow
52733,443,22448,443,613606,29392,584214,757,42,337,420,allow
63793,48970,37013,48970,70,70,0,1,4,1,0,allow
53123,59228,32782,59228,70,70,0,2,8,2,0,allow
49177,443,60972,443,654956,17062,637894,673,18,244,429,allow
51159,443,36632,443,6405463,157088,6248375,6383,90,2146,4237,allow
52746,443,40862,443,104383,5038,99345,135,25,62,73,allow
47976,443,55009,443,16187,11705,4482,33,159,19,14,allow
52727,443,14385,443,1369,708,661,14,45,8,6,allow
50552,443,41023,443,8311,3156,5155,29,17,16,13,allow
49537,53,41171,53,686,276,410,8,74,4,4,allow
33919,53,58115,53,168,78,90,2,30,1,1,allow
63974,53,33864,53,618,111,507,4,30,2,2,allow
49823,53,39316,53,388,102,286,2,30,1,1,allow
8283,45858,63554,45858,130,70,60,2,30,1,1,allow
55044,53,47229,53,168,78,90,2,30,1,1,allow
27005,27016,25142,27016,883,126,757,2,30,1,1,allow
27005,27015,25382,27015,937,126,811,2,30,1,1,allow
35408,53,57895,53,168,78,90,2,30,1,1,allow
44400,443,34284,443,6576,1937,4639,14,120,7,7,allow
46544,443,31614,443,332590,15084,317506,341,139,89,252,allow
47500,443,47942,443,7464,2375,5089,15,120,7,8,allow
52447,443,48925,443,7980,5952,2028,22,99,12,10,allow
10056,443,53947,443,12677,10470,2207,42,80,23,19,allow
61673,443,54566,443,9218,3728,5490,30,50,16,14,allow
11826,53,11826,53,216,98,118,2,30,1,1,allow
55392,53,63211,53,418,94,324,2,30,1,1,allow
59316,443,4398,443,17547,11857,5690,34,159,20,14,allow
56816,12523,45890,12523,70,70,0,1,5,1,0,allow
46232,53,46232,53,216,90,126,2,30,1,1,allow
27005,49000,39068,49000,887,126,761,2,30,1,1,allow
51836,53,49755,53,168,78,90,2,30,1,1,allow
34565,53,14106,53,168,78,90,2,30,1,1,allow
58785,53,58785,53,216,90,126,2,30,1,1,allow
29413,53,29413,53,217,82,135,2,32,1,1,allow
49760,80,49760,80,613303,16858,596445,666,143,251,415,allow
58794,5222,61380,5222,47445,16812,30633,144,870,65,79,allow
51666,443,15224,443,3256,2213,1043,16,15,8,8,allow
49304,7010,49304,7010,6247,4138,2109,21,15,13,8,allow
27005,27015,28808,27015,873,126,747,2,30,1,1,allow
44901,443,19443,443,11891,6219,5672,35,174,16,19,allow
50584,60395,46252,60395,166,166,0,1,1200,1,0,allow
52183,443,6530,443,3560269,64410,3495859,2930,132,383,2547,allow
45401,443,44939,443,9535,3495,6040,18,121,10,8,allow
50584,56209,14402,56209,166,166,0,1,1200,1,0,allow
27005,31000,35910,31000,898,126,772,2,31,1,1,allow
56962,80,49373,80,8730,5681,3049,21,31,12,9,allow
60505,443,23004,443,1061,727,334,9,26,4,5,allow
50625,80,24486,80,8688,4248,4440,56,131,34,22,allow
49439,443,14852,443,9495,2281,7214,22,78,11,11,allow
49920,443,27141,443,9759,1989,7770,25,16,13,12,allow
49633,443,1902,443,60196,10141,50055,122,33,62,60,allow
57620,443,56080,443,5177,3010,2167,37,83,17,20,allow
55041,80,12804,80,486,240,246,9,35,5,4,allow
56114,53,31669,53,194,86,108,2,30,1,1,allow
15986,8000,14701,8000,274,150,124,4,61,2,2,allow
49437,443,4843,443,9621,2347,7274,24,78,12,12,allow
30472,53,56482,53,223,86,137,2,30,1,1,allow
55046,80,10209,80,2775,1332,1443,12,34,7,5,allow
60173,443,14780,443,7909,3501,4408,19,181,9,10,allow
3578,51505,0,0,62,62,0,1,0,1,0,deny
6881,55839,0,0,139,139,0,1,0,1,0,deny
62386,37965,0,0,62,62,0,1,0,1,0,deny
1162,57470,0,0,62,62,0,1,0,1,0,deny
51197,57470,0,0,66,66,0,1,0,1,0,deny
59080,445,0,0,70,70,0,1,0,1,0,drop
59079,445,0,0,70,70,0,1,0,1,0,drop
59075,445,0,0,70,70,0,1,0,1,0,drop
49177,54532,0,0,60,60,0,1,0,1,0,deny
54137,445,0,0,70,70,0,1,0,1,0,drop
51742,30317,0,0,66,66,0,1,0,1,0,deny
54135,445,0,0,70,70,0,1,0,1,0,drop
9219,32480,0,0,72,72,0,1,0,1,0,deny
59505,53733,0,0,66,66,0,1,0,1,0,deny
54134,445,0,0,70,70,0,1,0,1,0,drop
54133,445,0,0,70,70,0,1,0,1,0,drop
54132,445,0,0,70,70,0,1,0,1,0,drop
52887,37807,0,0,66,66,0,1,0,1,0,deny
54129,445,0,0,70,70,0,1,0,1,0,drop
54128,445,0,0,70,70,0,1,0,1,0,drop
54484,445,0,0,66,66,0,1,0,1,0,drop
59072,445,0,0,70,70,0,1,0,1,0,drop
59070,445,0,0,70,70,0,1,0,1,0,drop
61881,48817,0,0,148,148,0,1,0,1,0,deny
62566,35993,0,0,66,66,0,1,0,1,0,deny
4269,26672,0,0,60,60,0,1,0,1,0,deny
53453,2767,0,0,66,66,0,1,0,1,0,deny
34348,22114,0,0,62,62,0,1,0,1,0,deny
54114,445,0,0,70,70,0,1,0,1,0,drop
54113,445,0,0,70,70,0,1,0,1,0,drop
54109,445,0,0,70,70,0,1,0,1,0,drop
54103,445,0,0,70,70,0,1,0,1,0,drop
54104,445,0,0,70,70,0,1,0,1,0,drop
52064,22114,0,0,62,62,0,1,0,1,0,deny
54475,445,0,0,66,66,0,1,0,1,0,drop
54474,445,0,0,66,66,0,1,0,1,0,drop
59062,445,0,0,70,70,0,1,0,1,0,drop
59053,445,0,0,70,70,0,1,0,1,0,drop
59049,445,0,0,70,70,0,1,0,1,0,drop
59050,445,0,0,70,70,0,1,0,1,0,drop
44538,50584,0,0,146,146,0,1,0,1,0,deny
54471,445,0,0,66,66,0,1,0,1,0,drop
52431,50265,0,0,62,62,0,1,0,1,0,deny
52459,5555,0,0,60,60,0,1,0,1,0,deny
50088,1604,0,0,84,84,0,1,0,1,0,deny
54092,445,0,0,70,70,0,1,0,1,0,drop
23934,41615,0,0,145,145,0,1,0,1,0,deny
23934,41615,0,0,145,145,0,1,0,1,0,deny
15296,37965,0,0,66,66,0,1,0,1,0,deny
59781,56205,0,0,66,66,0,1,0,1,0,deny
11859,64147,0,0,62,62,0,1,0,1,0,deny
48692,57470,0,0,62,62,0,1,0,1,0,deny
59044,445,0,0,70,70,0,1,0,1,0,drop
36908,26467,0,0,62,62,0,1,0,1,0,deny
58486,57470,0,0,66,66,0,1,0,1,0,deny
59042,445,0,0,70,70,0,1,0,1,0,drop
59041,445,0,0,70,70,0,1,0,1,0,drop
59039,445,0,0,70,70,0,1,0,1,0,drop
54464,445,0,0,66,66,0,1,0,1,0,drop
54460,445,0,0,66,66,0,1,0,1,0,drop
54459,445,0,0,66,66,0,1,0,1,0,drop
54456,445,0,0,66,66,0,1,0,1,0,drop
51424,30188,0,0,66,66,0,1,0,1,0,deny
54454,445,0,0,66,66,0,1,0,1,0,drop
54455,445,0,0,66,66,0,1,0,1,0,drop
54452,445,0,0,66,66,0,1,0,1,0,drop
64240,50584,0,0,66,66,0,1,0,1,0,deny
54088,445,0,0,70,70,0,1,0,1,0,drop
6416,22114,0,0,62,62,0,1,0,1,0,deny
62908,21,0,0,60,60,0,1,0,1,0,deny
6712,161,0,0,82,82,0,1,0,1,0,deny
59034,445,0,0,70,70,0,1,0,1,0,drop
59033,445,0,0,70,70,0,1,0,1,0,drop
59030,445,0,0,70,70,0,1,0,1,0,drop
54078,445,0,0,70,70,0,1,0,1,0,drop
54077,445,0,0,70,70,0,1,0,1,0,drop
35460,35440,0,0,62,62,0,1,0,1,0,deny
54450,445,0,0,66,66,0,1,0,1,0,drop
54074,445,0,0,70,70,0,1,0,1,0,drop
54076,445,0,0,70,70,0,1,0,1,0,drop
59029,445,0,0,70,70,0,1,0,1,0,drop
23528,44847,0,0,62,62,0,1,0,1,0,deny
54071,445,0,0,70,70,0,1,0,1,0,drop
54446,445,0,0,66,66,0,1,0,1,0,drop
54445,445,0,0,66,66,0,1,0,1,0,drop
54443,445,0,0,66,66,0,1,0,1,0,drop
64066,23718,0,0,66,66,0,1,0,1,0,deny
46478,64147,0,0,62,62,0,1,0,1,0,deny
54442,445,0,0,66,66,0,1,0,1,0,drop
57131,31061,0,0,145,145,0,1,0,1,0,deny
63221,53436,0,0,62,62,0,1,0,1,0,deny
59459,37807,0,0,66,66,0,1,0,1,0,deny
33324,42873,0,0,62,62,0,1,0,1,0,deny
41447,64147,0,0,62,62,0,1,0,1,0,deny
57853,64147,0,0,66,66,0,1,0,1,0,deny
59021,445,0,0,70,70,0,1,0,1,0,drop
54065,445,0,0,70,70,0,1,0,1,0,drop
26084,36237,0,0,62,62,0,1,0,1,0,deny
59013,445,0,0,70,70,0,1,0,1,0,drop
59012,445,0,0,70,70,0,1,0,1,0,drop
60162,53436,0,0,66,66,0,1,0,1,0,deny
63092,46776,0,0,78,78,0,1,0,1,0,deny
54432,445,0,0,66,66,0,1,0,1,0,drop
54058,445,0,0,70,70,0,1,0,1,0,drop
61701,44847,0,0,66,66,0,1,0,1,0,deny
54057,445,0,0,70,70,0,1,0,1,0,drop
6015,23,0,0,60,60,0,1,0,1,0,deny
1384,44847,0,0,66,66,0,1,0,1,0,deny
3377,50584,0,0,66,66,0,1,0,1,0,deny
54423,445,0,0,66,66,0,1,0,1,0,drop
54051,445,0,0,70,70,0,1,0,1,0,drop
59001,445,0,0,70,70,0,1,0,1,0,drop
50624,26467,0,0,66,66,0,1,0,1,0,deny
54050,445,0,0,70,70,0,1,0,1,0,drop
44855,58414,0,0,146,146,0,1,0,1,0,deny
45941,23386,0,0,60,60,0,1,0,1,0,deny
54420,445,0,0,66,66,0,1,0,1,0,drop
50804,1,0,0,62,62,0,1,0,1,0,deny
57500,37965,0,0,62,62,0,1,0,1,0,deny
54046,445,0,0,70,70,0,1,0,1,0,drop
57325,37965,0,0,62,62,0,1,0,1,0,deny
17027,1,0,0,62,62,0,1,0,1,0,deny
60133,1,0,0,66,66,0,1,0,1,0,deny
10006,64147,0,0,62,62,0,1,0,1,0,deny
54413,445,0,0,66,66,0,1,0,1,0,drop
51674,51505,0,0,66,66,0,1,0,1,0,deny
54045,445,0,0,70,70,0,1,0,1,0,drop
54410,445,0,0,66,66,0,1,0,1,0,drop
56966,35440,0,0,66,66,0,1,0,1,0,deny
53779,51505,0,0,66,66,0,1,0,1,0,deny
62737,64147,0,0,66,66,0,1,0,1,0,deny
45964,5333,0,0,60,60,0,1,0,1,0,deny
54040,445,0,0,70,70,0,1,0,1,0,drop
31978,57470,0,0,60,60,0,1,0,1,0,deny
61520,23718,0,0,62,62,0,1,0,1,0,deny
51026,37450,0,0,66,66,0,1,0,1,0,deny
58992,445,0,0,70,70,0,1,0,1,0,drop
58991,445,0,0,70,70,0,1,0,1,0,drop
58989,445,0,0,70,70,0,1,0,1,0,drop
443,64347,0,0,131,131,0,1,0,1,0,deny
51192,15503,0,0,66,66,0,1,0,1,0,deny
10319,42707,0,0,62,62,0,1,0,1,0,deny
54392,445,0,0,66,66,0,1,0,1,0,drop
54395,445,0,0,66,66,0,1,0,1,0,drop
54397,445,0,0,66,66,0,1,0,1,0,drop
54398,445,0,0,66,66,0,1,0,1,0,drop
54394,445,0,0,66,66,0,1,0,1,0,drop
54393,445,0,0,66,66,0,1,0,1,0,drop
54396,445,0,0,66,66,0,1,0,1,0,drop
54390,445,0,0,66,66,0,1,0,1,0,drop
60750,42707,0,0,66,66,0,1,0,1,0,deny
64940,26467,0,0,62,62,0,1,0,1,0,deny
50419,26467,0,0,66,66,0,1,0,1,0,deny
46573,50584,0,0,66,66,0,1,0,1,0,deny
54786,30188,0,0,66,66,0,1,0,1,0,deny
65454,61600,0,0,66,66,0,1,0,1,0,deny
53608,1024,20573,1024,70,70,0,1,5,1,0,allow
53126,443,10677,443,6668,2026,4642,15,120,8,7,allow
53599,47783,42378,47783,618,432,186,9,17,6,3,allow
58429,443,42456,443,10588,1664,8924,29,631,11,18,allow
27005,27016,53095,27016,889,126,763,3,31,2,1,allow
27997,80,36977,80,3683,591,3092,11,45,6,5,allow
56944,80,48541,80,214,140,74,4,30,3,1,allow
53612,1032,48115,1032,130,70,60,2,6,1,1,allow
60413,43555,44163,43555,70,70,0,2,8,2,0,allow
33640,53,0,0,138,69,69,2,30,1,1,allow
63755,17866,46456,17866,2568,1944,624,20,29,13,7,allow
44731,443,63210,443,4920,2738,2182,33,259,16,17,allow
61189,443,61189,443,1092,645,447,10,34,6,4,allow
27186,53,27186,53,821,97,724,2,30,1,1,allow
19557,53,19557,53,194,87,107,2,30,1,1,allow
39148,443,64587,443,6818,1800,5018,30,271,16,14,allow
63991,443,63991,443,4597,1690,2907,19,28,11,8,allow
53072,443,53072,443,49826,37097,12729,66,163,40,26,allow
34600,443,63857,443,7950,1925,6025,26,66,14,12,allow
49529,443,17894,443,9047,1436,7611,22,27,10,12,allow
51821,28306,23516,28306,316,136,180,6,6,3,3,allow
53597,42845,3911,42845,678,492,186,10,18,7,3,allow
39328,80,5790,80,78,78,0,1,5,1,0,allow
53609,38060,54791,38060,70,70,0,1,5,1,0,allow
51823,15843,1473,15843,70,70,0,1,5,1,0,allow
49616,443,57635,443,7238,2601,4637,20,17,10,10,allow
52267,443,8782,443,24712,9272,15440,65,136,34,31,allow
56644,443,7171,443,12924,3689,9235,31,82,17,14,allow
49352,443,43143,443,2118582,46411,2072171,2066,90,617,1449,allow
21133,43408,64774,43408,480,149,331,2,1200,1,1,allow
40599,443,12842,443,89724,81316,8408,148,404,69,79,allow
10088,443,42389,443,7243,1860,5383,26,330,14,12,allow
55038,443,26774,443,4424,876,3548,15,35,8,7,allow
24961,53,24961,53,215,80,135,2,33,1,1,allow
1431,53,1431,53,215,80,135,2,32,1,1,allow
54144,443,15023,443,2227,1018,1209,17,16,8,9,allow
27996,80,2657,80,2058,589,1469,10,45,6,4,allow
46280,443,46280,443,4754,1847,2907,19,26,11,8,allow
49485,443,26234,443,49823,7236,42587,56,29,20,36,allow
55813,443,55813,443,4543,1636,2907,19,29,11,8,allow
30728,53,30728,53,196,88,108,2,30,1,1,allow
30227,3386,30227,3386,146,60,86,2,30,1,1,allow
27005,27015,31216,27015,939,126,813,2,30,1,1,allow
55765,443,54125,443,4660,1915,2745,23,120,12,11,allow
27005,27017,14487,27017,882,126,756,2,31,1,1,allow
36939,80,43312,80,5733,3036,2697,25,235,9,16,allow
41270,443,43404,443,14659,5023,9636,46,400,14,32,allow
30960,45700,20531,45700,330,330,0,6,3609,6,0,allow
27005,27018,60808,27018,881,126,755,2,31,1,1,allow
49237,443,19934,443,8293,4179,4114,22,128,11,11,allow
54693,30188,0,0,62,62,0,1,0,1,0,deny
54146,5900,0,0,60,60,0,1,0,1,0,deny
58981,445,0,0,70,70,0,1,0,1,0,drop
58980,445,0,0,70,70,0,1,0,1,0,drop
58973,445,0,0,70,70,0,1,0,1,0,drop
51544,34476,0,0,137,137,0,1,0,1,0,deny
4961,62741,0,0,66,66,0,1,0,1,0,deny
4447,35440,0,0,66,66,0,1,0,1,0,deny
60772,36829,0,0,66,66,0,1,0,1,0,deny
50316,37965,0,0,66,66,0,1,0,1,0,deny
54024,445,0,0,70,70,0,1,0,1,0,drop
54377,445,0,0,66,66,0,1,0,1,0,drop
64315,53,11433,53,322,102,220,2,30,1,1,allow
51816,27721,33144,27721,70,70,0,2,8,2,0,allow
60798,443,60798,443,1092,645,447,10,34,6,4,allow
49765,53,55989,53,233,102,131,2,30,1,1,allow
33247,443,33617,443,7527,2435,5092,16,120,8,8,allow
48163,443,22836,443,20124,12085,8039,54,385,29,25,allow
55047,80,59301,80,306,180,126,6,32,4,2,allow
44095,443,27127,443,6109,3363,2746,60,615,33,27,allow
48467,80,55817,80,1113,534,579,12,15,7,5,allow
56960,80,32758,80,6363,3790,2573,16,30,10,6,allow
64184,443,64184,443,4561,1654,2907,19,28,11,8,allow
49504,443,22336,443,62,62,0,1,5,1,0,allow
56958,80,27013,80,9535,3968,5567,21,30,12,9,allow
48279,8080,0,0,368,156,212,5,13,3,2,allow
55037,443,19621,443,10640,3171,7469,28,45,15,13,allow
56445,53,50550,53,353,110,243,4,46,2,2,allow
56966,80,60389,80,214,140,74,4,30,3,1,allow
56939,80,26245,80,194,128,66,4,31,3,1,allow
54437,443,40534,443,716056,89267,626789,952,300,368,584,allow
55042,80,32886,80,306,180,126,6,34,4,2,allow
56815,50510,55664,50510,70,70,0,1,5,1,0,allow
56813,37092,33767,37092,70,70,0,1,5,1,0,allow
35400,443,23133,443,11083,4080,7003,38,40,14,24,allow
55213,53,60229,53,238,94,144,2,30,1,1,allow
35685,123,34944,123,184,94,90,2,30,1,1,allow
53669,80,61903,80,1119,665,454,12,15,7,5,allow
55043,80,21312,80,306,180,126,6,34,4,2,allow
64067,53,26067,53,331,102,229,2,30,1,1,allow
49506,443,26865,443,18260,2912,15348,30,28,11,19,allow
60415,40829,35259,40829,70,70,0,2,8,2,0,allow
54859,443,24991,443,6677,1006,5671,19,26,11,8,allow
49998,53,11230,53,467,90,377,4,39,2,2,allow
60709,443,60709,443,1092,645,447,10,34,6,4,allow
42898,443,46834,443,4999,2845,2154,41,87,22,19,allow
49921,80,16260,80,1126,609,517,11,15,6,5,allow
56788,443,35911,443,22508,1965,20543,32,17,13,19,allow
49922,80,11141,80,1126,609,517,11,15,6,5,allow
50249,443,46250,443,6125,1674,4451,22,81,11,11,allow
63218,22,63218,22,9001,4087,4914,59,39,27,32,allow
56965,80,39996,80,526,304,222,8,30,5,3,allow
49923,80,28185,80,1126,609,517,11,15,6,5,allow
57929,53,0,0,294,86,208,2,30,1,1,allow
50419,80,4719,80,350,350,0,1,120,1,0,allow
64349,53,48163,53,392,102,290,2,30,1,1,allow
55209,53,33482,53,196,102,94,2,33,1,1,allow
57353,443,50919,443,70,70,0,1,5,1,0,allow
54287,443,5975,443,250,190,60,2,5,1,1,allow
60891,443,53303,443,204,70,134,4,25,2,2,allow
49860,53,13520,53,550,129,421,4,57,2,2,allow
37991,443,14336,443,8365,3018,5347,31,271,15,16,allow
64379,53,61307,53,333,94,239,2,30,1,1,allow
64506,53,36287,53,184,86,98,2,30,1,1,allow
60731,80,1160,80,5911,4727,1184,20,16,11,9,allow
55040,80,41951,80,486,240,246,9,34,5,4,allow
55044,80,26880,80,306,180,126,6,34,4,2,allow
49326,443,20775,443,9303,2551,6752,33,16,18,15,allow
53131,443,19273,443,10705,5303,5402,36,650,16,20,allow
56963,80,25455,80,6974,3906,3068,19,30,11,8,allow
55619,42873,30146,42873,422,140,282,6,16,3,3,allow
42520,443,59710,443,6795,2090,4705,27,21,15,12,allow
56959,80,53934,80,15752,5736,10016,28,30,14,14,allow
56961,80,26352,80,5885,3796,2089,16,30,10,6,allow
56899,443,29729,443,29904,3111,26793,68,164,35,33,allow
53607,51631,46867,51631,70,70,0,1,4,1,0,allow
60409,44739,64818,44739,70,70,0,1,5,1,0,allow
56814,56255,27834,56255,70,70,0,1,5,1,0,allow
53605,13468,43310,13468,70,70,0,1,4,1,0,allow
56800,1,46367,1,70,70,0,1,5,1,0,allow
49897,443,63900,443,113036,13164,99872,191,144,89,102,allow
51824,53021,41842,53021,70,70,0,1,5,1,0,allow
58858,443,49748,443,208,60,148,4,10,2,2,allow
56955,80,64782,80,214,140,74,4,30,3,1,allow
60407,8106,10620,8106,2541,1158,1383,19,16,9,10,allow
48697,5222,62184,5222,8355,4135,4220,79,616,41,38,allow
41184,53,29887,53,168,78,90,2,30,1,1,allow
50564,443,39683,443,8182,1488,6694,23,133,13,10,allow
64102,53,25876,53,274,94,180,2,29,1,1,allow
64353,53,31104,53,225,102,123,2,29,1,1,allow
54807,443,9391,443,10078,2210,7868,36,120,19,17,allow
33461,443,33205,443,8366,3900,4466,19,120,10,9,allow
64162,53,14611,53,225,110,115,2,30,1,1,allow
6881,6881,30399,6881,238,118,120,2,1199,1,1,allow
60414,52559,64596,52559,70,70,0,2,8,2,0,allow
51801,33531,13546,33531,70,70,0,1,5,1,0,allow
51800,63796,15243,63796,70,70,0,1,5,1,0,allow
60377,443,48988,443,8588,2020,6568,20,76,10,10,allow
48905,80,43588,80,1868,1374,494,12,15,7,5,allow
20957,53,20957,53,216,90,126,2,30,1,1,allow
27005,27015,5485,27015,889,126,763,2,30,1,1,allow
27005,27020,57425,27020,890,126,764,2,30,1,1,allow
18102,53,59095,53,223,86,137,2,30,1,1,allow
27005,27016,11653,27016,876,126,750,3,31,2,1,allow
49924,80,4925,80,1126,609,517,11,15,6,5,allow
60875,443,60875,443,1092,645,447,10,34,6,4,allow
60721,443,60721,443,1092,645,447,10,34,6,4,allow
56621,80,4891,80,234,234,0,4,12,4,0,allow
51798,37020,7892,37020,70,70,0,1,5,1,0,allow
53119,58118,18768,58118,70,70,0,1,5,1,0,allow
56946,80,58825,80,214,140,74,4,30,3,1,allow
56945,80,24790,80,214,140,74,4,30,3,1,allow
43086,443,19069,443,6496,2026,4470,20,16,12,8,allow
27005,30000,59167,30000,913,126,787,2,30,1,1,allow
49774,53,40062,53,234,102,132,2,30,1,1,allow
50875,53,21370,53,78,78,0,1,30,1,0,allow
60031,443,5116,443,350,210,140,6,15,4,2,allow
51943,53,57117,53,200,86,114,2,30,1,1,allow
39435,443,17310,443,2403265,93626,2309639,2795,243,1103,1692,allow
63941,53,9002,53,228,94,134,2,30,1,1,allow
52245,443,44464,443,7488,2474,5014,23,3600,12,11,allow
43595,443,60251,443,31194,5024,26170,44,121,18,26,allow
47823,443,63568,443,9842,2224,7618,20,122,10,10,allow
56970,443,2688,443,20635942,626393,20009549,21680,138,6969,14711,allow
6881,6881,43994,6881,502,150,352,2,1200,1,1,allow
52478,443,31557,443,7985,2085,5900,18,121,8,10,allow
49919,443,15575,443,16012,2097,13915,33,16,15,18,allow
41311,443,64855,443,70,70,0,1,5,1,0,allow
58930,443,53896,443,70,70,0,1,5,1,0,allow
50188,80,44459,80,1746,780,966,19,56,7,12,allow
53668,80,20063,80,1173,665,508,13,16,7,6,allow
57545,443,29665,443,25540,8247,17293,187,574,79,108,allow
49178,2710,40497,2710,70,70,0,1,5,1,0,allow
54376,445,0,0,66,66,0,1,0,1,0,drop
54375,445,0,0,66,66,0,1,0,1,0,drop
58971,445,0,0,70,70,0,1,0,1,0,drop
57768,37965,0,0,66,66,0,1,0,1,0,deny
58969,445,0,0,70,70,0,1,0,1,0,drop
54019,445,0,0,70,70,0,1,0,1,0,drop
58968,445,0,0,70,70,0,1,0,1,0,drop
58962,445,0,0,70,70,0,1,0,1,0,drop
58959,445,0,0,70,70,0,1,0,1,0,drop
59943,37807,0,0,62,62,0,1,0,1,0,deny
54018,445,0,0,70,70,0,1,0,1,0,drop
49177,54532,0,0,60,60,0,1,0,1,0,deny
47762,36180,0,0,146,146,0,1,0,1,0,deny
58811,53976,0,0,66,66,0,1,0,1,0,deny
54016,445,0,0,70,70,0,1,0,1,0,drop
1025,35447,0,0,62,62,0,1,0,1,0,deny
58562,57587,0,0,66,66,0,1,0,1,0,deny
43611,50939,0,0,145,145,0,1,0,1,0,deny
52095,56079,0,0,66,66,0,1,0,1,0,deny
47652,51505,0,0,62,62,0,1,0,1,0,deny
58952,445,0,0,70,70,0,1,0,1,0,drop
58950,445,0,0,70,70,0,1,0,1,0,drop
58946,445,0,0,70,70,0,1,0,1,0,drop
4269,26672,0,0,60,60,0,1,0,1,0,deny
54009,445,0,0,70,70,0,1,0,1,0,drop
27153,992,0,0,60,60,0,1,0,1,0,deny
50280,57470,0,0,78,78,0,1,0,1,0,deny
33305,54532,0,0,60,60,0,1,0,1,0,deny
39313,37965,0,0,62,62,0,1,0,1,0,deny
54007,445,0,0,70,70,0,1,0,1,0,drop
39540,37965,0,0,66,66,0,1,0,1,0,deny
48706,23393,0,0,60,60,0,1,0,1,0,deny
5774,37965,0,0,66,66,0,1,0,1,0,deny
54006,445,0,0,70,70,0,1,0,1,0,drop
54005,445,0,0,70,70,0,1,0,1,0,drop
54004,445,0,0,70,70,0,1,0,1,0,drop
54002,445,0,0,70,70,0,1,0,1,0,drop
53999,445,0,0,70,70,0,1,0,1,0,drop
54355,445,0,0,66,66,0,1,0,1,0,drop
58944,445,0,0,70,70,0,1,0,1,0,drop
58941,445,0,0,70,70,0,1,0,1,0,drop
58264,44847,0,0,66,66,0,1,0,1,0,deny
53986,445,0,0,70,70,0,1,0,1,0,drop
53985,445,0,0,70,70,0,1,0,1,0,drop
53976,445,0,0,70,70,0,1,0,1,0,drop
53975,445,0,0,70,70,0,1,0,1,0,drop
62907,21,0,0,60,60,0,1,0,1,0,deny
58751,9571,0,0,62,62,0,1,0,1,0,deny
16948,990,0,0,60,60,0,1,0,1,0,deny
54348,445,0,0,66,66,0,1,0,1,0,drop
6712,161,0,0,82,82,0,1,0,1,0,deny
12232,41864,0,0,139,139,0,1,0,1,0,deny
54345,445,0,0,66,66,0,1,0,1,0,drop
58934,445,0,0,70,70,0,1,0,1,0,drop
64586,50584,0,0,146,146,0,1,0,1,0,deny
58924,445,0,0,70,70,0,1,0,1,0,drop
58923,445,0,0,70,70,0,1,0,1,0,drop
58922,445,0,0,70,70,0,1,0,1,0,drop
54342,445,0,0,66,66,0,1,0,1,0,drop
3559,30188,0,0,66,66,0,1,0,1,0,deny
50522,443,53720,443,460,394,66,4,0,3,1,allow
43688,22114,0,0,62,62,0,1,0,1,0,deny
53964,445,0,0,70,70,0,1,0,1,0,drop
63586,46824,0,0,62,62,0,1,0,1,0,deny
18246,64097,0,0,66,66,0,1,0,1,0,deny
45941,23386,0,0,60,60,0,1,0,1,0,deny
55921,43890,0,0,66,66,0,1,0,1,0,deny
58917,445,0,0,70,70,0,1,0,1,0,drop
55225,11392,0,0,62,62,0,1,0,1,0,deny
58914,445,0,0,70,70,0,1,0,1,0,drop
58910,445,0,0,70,70,0,1,0,1,0,drop
58912,445,0,0,70,70,0,1,0,1,0,drop
10265,64147,0,0,62,62,0,1,0,1,0,deny
54336,445,0,0,66,66,0,1,0,1,0,drop
52160,1,0,0,145,145,0,1,0,1,0,deny
54330,445,0,0,66,66,0,1,0,1,0,drop
54332,445,0,0,66,66,0,1,0,1,0,drop
54328,445,0,0,66,66,0,1,0,1,0,drop
43611,32480,0,0,109,109,0,1,0,1,0,deny
53960,445,0,0,70,70,0,1,0,1,0,drop
54324,445,0,0,66,66,0,1,0,1,0,drop
54323,445,0,0,66,66,0,1,0,1,0,drop
54325,445,0,0,66,66,0,1,0,1,0,drop
52726,56205,0,0,62,62,0,1,0,1,0,deny
63205,9571,0,0,62,62,0,1,0,1,0,deny
41298,51050,0,0,62,62,0,1,0,1,0,deny
19697,26296,0,0,159,159,0,1,0,1,0,deny
26494,26467,0,0,62,62,0,1,0,1,0,deny
53950,445,0,0,70,70,0,1,0,1,0,drop
53949,445,0,0,70,70,0,1,0,1,0,drop
53945,445,0,0,70,70,0,1,0,1,0,drop
53948,445,0,0,70,70,0,1,0,1,0,drop
59377,9319,0,0,62,62,0,1,0,1,0,deny
58909,445,0,0,70,70,0,1,0,1,0,drop
58906,445,0,0,70,70,0,1,0,1,0,drop
53944,445,0,0,70,70,0,1,0,1,0,drop
58902,445,0,0,70,70,0,1,0,1,0,drop
54320,445,0,0,66,66,0,1,0,1,0,drop
58901,445,0,0,70,70,0,1,0,1,0,drop
51920,30188,0,0,66,66,0,1,0,1,0,deny
42241,11392,0,0,62,62,0,1,0,1,0,deny
54318,445,0,0,66,66,0,1,0,1,0,drop
50116,22,0,0,60,60,0,1,0,1,0,deny
54315,445,0,0,66,66,0,1,0,1,0,drop
54314,445,0,0,66,66,0,1,0,1,0,drop
54313,445,0,0,66,66,0,1,0,1,0,drop
26480,64147,0,0,62,62,0,1,0,1,0,deny
2425,23117,0,0,66,66,0,1,0,1,0,deny
53938,445,0,0,70,70,0,1,0,1,0,drop
58893,445,0,0,70,70,0,1,0,1,0,drop
49255,44847,0,0,66,66,0,1,0,1,0,deny
13285,29892,0,0,145,145,0,1,0,1,0,deny
13285,29892,0,0,145,145,0,1,0,1,0,deny
58891,445,0,0,70,70,0,1,0,1,0,drop
58888,445,0,0,70,70,0,1,0,1,0,drop
21892,15503,0,0,62,62,0,1,0,1,0,deny
53930,445,0,0,70,70,0,1,0,1,0,drop
52111,44847,0,0,66,66,0,1,0,1,0,deny
53928,445,0,0,70,70,0,1,0,1,0,drop
61234,48817,0,0,106,106,0,1,0,1,0,deny
38320,51505,0,0,66,66,0,1,0,1,0,deny
54304,445,0,0,66,66,0,1,0,1,0,drop
61838,37965,0,0,66,66,0,1,0,1,0,deny
13581,51505,0,0,66,66,0,1,0,1,0,deny
53924,445,0,0,70,70,0,1,0,1,0,drop
15959,56205,0,0,62,62,0,1,0,1,0,deny
53922,445,0,0,70,70,0,1,0,1,0,drop
54294,445,0,0,66,66,0,1,0,1,0,drop
58879,445,0,0,70,70,0,1,0,1,0,drop
53918,445,0,0,70,70,0,1,0,1,0,drop
31978,57470,0,0,60,60,0,1,0,1,0,deny
54292,445,0,0,66,66,0,1,0,1,0,drop
21173,37965,0,0,62,62,0,1,0,1,0,deny
53917,445,0,0,70,70,0,1,0,1,0,drop
5357,32468,0,0,62,62,0,1,0,1,0,deny
52177,25320,0,0,66,66,0,1,0,1,0,deny
1026,64147,0,0,145,145,0,1,0,1,0,deny
54285,445,0,0,66,66,0,1,0,1,0,drop
1024,5529,0,0,146,146,0,1,0,1,0,deny
54278,445,0,0,66,66,0,1,0,1,0,drop
1067,51221,0,0,62,62,0,1,0,1,0,deny
6037,43890,0,0,74,74,0,1,0,1,0,deny
57504,44847,0,0,66,66,0,1,0,1,0,deny
27005,27017,65015,27017,880,126,754,2,30,1,1,allow
37096,443,16174,443,130,70,60,2,15,1,1,allow
64570,443,7059,443,24984,2042,22942,41,32,19,22,allow
49486,443,60567,443,4160,1015,3145,16,28,8,8,allow
49527,443,43125,443,5968,985,4983,17,26,8,9,allow
53624,7370,12914,7370,70,70,0,2,8,2,0,allow
53632,58037,4206,58037,70,70,0,2,8,2,0,allow
55622,33342,63556,33342,70,70,0,2,8,2,0,allow
53012,80,53012,80,278027,5087,272940,288,22,76,212,allow
37182,80,39276,80,1638,1324,314,10,16,5,5,allow
50604,443,50604,443,4716,1809,2907,19,30,11,8,allow
49498,443,53084,443,4172,1018,3154,16,27,8,8,allow
54125,443,54125,443,65572,14874,50698,92,84,48,44,allow
55691,443,55691,443,165616,8760,156856,199,82,79,120,allow
20520,53,20520,53,215,80,135,2,32,1,1,allow
55620,20795,23864,20795,70,70,0,2,8,2,0,allow
64797,80,54604,80,378,192,186,7,71,4,3,allow
54124,443,54124,443,105609,16179,89430,150,84,79,71,allow
47750,443,44039,443,70,70,0,1,5,1,0,allow
39630,443,32291,443,70,70,0,1,5,1,0,allow
47871,443,47202,443,70,70,0,1,5,1,0,allow
56515,443,56741,443,5083,969,4114,18,32,10,8,allow
56973,443,43404,443,22953,5010,17943,38,123,14,24,allow
27005,27015,35469,27015,886,126,760,2,30,1,1,allow
40603,443,49368,443,9462,6402,3060,32,394,11,21,allow
49512,443,31852,443,7626,1741,5885,35,256,17,18,allow
54711,443,57738,443,7169,2405,4764,18,135,10,8,allow
51813,63933,50803,63933,70,70,0,2,8,2,0,allow
38557,443,3043,443,70,70,0,1,5,1,0,allow
51819,59208,38763,59208,70,70,0,1,5,1,0,allow
56968,80,38598,80,2273,1511,762,7,29,4,3,allow
43029,443,37384,443,6053,1321,4732,19,980,9,10,allow
53121,8986,41857,8986,70,70,0,2,8,2,0,allow
34203,443,27925,443,33068,2556,30512,48,81,21,27,allow
49526,443,23120,443,6032,1049,4983,18,26,9,9,allow
61168,443,61168,443,4599,1692,2907,19,29,11,8,allow
1183,53,1183,53,213,79,134,2,33,1,1,allow
49859,80,22070,80,1644,1324,320,10,15,5,5,allow
58477,443,37357,443,10026,5706,4320,20,120,10,10,allow
55619,443,51009,443,13144,7075,6069,33,161,16,17,allow
56514,443,14098,443,5084,969,4115,18,32,10,8,allow
51817,54601,57265,54601,316,136,180,6,7,3,3,allow
54121,443,54121,443,184574,24037,160537,209,84,87,122,allow
54114,443,54114,443,171467,27550,143917,220,85,108,112,allow
27930,53,0,0,222,82,140,2,30,1,1,allow
54122,443,54122,443,186718,24971,161747,253,84,127,126,allow
59240,53,59240,53,194,87,107,2,30,1,1,allow
6881,6881,7756,6881,501,150,351,2,1200,1,1,allow
55201,22114,0,0,66,66,0,1,0,1,0,deny
9104,26296,0,0,157,157,0,1,0,1,0,deny
53912,445,0,0,70,70,0,1,0,1,0,drop
58865,445,0,0,70,70,0,1,0,1,0,drop
58862,445,0,0,70,70,0,1,0,1,0,drop
58861,445,0,0,70,70,0,1,0,1,0,drop
61481,443,1524,443,23229,1880,21349,46,80,21,25,allow
3254,3389,3254,3389,3790,1685,2105,18,17,10,8,allow
53626,33194,41822,33194,70,70,0,2,7,2,0,allow
53629,51413,13341,51413,70,70,0,2,7,2,0,allow
55996,53,10816,53,168,86,82,2,30,1,1,allow
55431,443,58607,443,999955,25445,974510,1003,171,325,678,allow
39446,443,32219,443,1647482,62713,1584769,1898,219,744,1154,allow
63788,80,49704,80,314,192,122,6,15,4,2,allow
49636,443,28958,443,50297,4871,45426,86,31,40,46,allow
27005,27016,25389,27016,1006,252,754,4,32,3,1,allow
51403,443,50805,443,190,70,120,4,8,2,2,allow
52438,443,56919,443,70,70,0,1,4,1,0,allow
57160,53,20461,53,255,110,145,2,29,1,1,allow
39596,53,5876,53,168,78,90,2,30,1,1,allow
64700,53,35656,53,239,86,153,2,29,1,1,allow
65404,53,47407,53,334,226,108,3,29,2,1,allow
62724,443,47821,443,87797,47766,40031,754,453,303,451,allow
52409,443,39608,443,1369,708,661,14,24,8,6,allow
55429,443,27216,443,343735,15691,328044,423,171,179,244,allow
50469,443,24709,443,3049,1569,1480,17,19,10,7,allow
50460,443,36423,443,5572,4252,1320,18,34,11,7,allow
56519,80,41989,80,370,222,148,6,32,4,2,allow
52405,53,59064,53,168,78,90,2,30,1,1,allow
46972,443,1778,443,45264,4281,40983,59,120,24,35,allow
37965,4546,34269,4546,3957,2324,1633,51,1720,29,22,allow
56351,53,2881,53,195,102,93,2,30,1,1,allow
49494,443,9142,443,4168,1018,3150,16,27,8,8,allow
55996,53,61146,53,196,86,110,2,30,1,1,allow
49511,443,56126,443,1200,623,577,13,27,6,7,allow
60192,53,4239,53,236,94,142,2,30,1,1,allow
56259,53,56259,53,244,98,146,2,32,1,1,allow
41472,443,2469,443,4500,2769,1731,29,80,14,15,allow
49531,443,58024,443,8107,2474,5633,24,25,12,12,allow
56452,53,0,0,82,82,0,2,40,2,0,allow
50456,80,33099,80,4473,3398,1075,14,34,8,6,allow
52410,443,38111,443,128802,48896,79906,237,24,121,116,allow
49495,443,17412,443,12452,10841,1611,26,27,14,12,allow
55428,443,63993,443,74784,4781,70003,122,171,55,67,allow
56502,443,5913,443,5414,1010,4404,17,33,9,8,allow
42804,443,52813,443,8113,1626,6487,24,21,14,10,allow
52411,443,20618,443,9428,3770,5658,54,24,28,26,allow
50454,80,32603,80,4185,3618,567,14,34,8,6,allow
36682,443,16201,443,4590,3104,1486,25,95,14,11,allow
55980,123,7764,123,184,94,90,2,30,1,1,allow
50453,80,44692,80,5978,3592,2386,15,34,8,7,allow
56584,53,11866,53,214,102,112,2,30,1,1,allow
56977,53,42818,53,273,102,171,2,30,1,1,allow
53392,53,29793,53,164,78,86,2,31,1,1,allow
49522,443,12494,443,3090,1796,1294,19,26,10,9,allow
49477,443,54783,443,1332,876,456,11,27,6,5,allow
49532,80,7798,80,4577,3951,626,11,25,6,5,allow
51815,28665,41311,28665,70,70,0,2,7,2,0,allow
55621,28144,20259,28144,70,70,0,2,8,2,0,allow
59789,443,5705,443,6695,2021,4674,23,45,11,12,allow
49518,80,62849,80,11011,7675,3336,21,26,11,10,allow
50229,80,35977,80,1743,979,764,13,81,7,6,allow
54123,443,54123,443,79652,20710,58942,112,84,58,54,allow
41064,80,41064,80,2118,1493,625,9,82,6,3,allow
49637,443,18252,443,50296,4666,45630,90,31,43,47,allow
64907,53,16767,53,211,102,109,2,30,1,1,allow
27005,27017,4799,27017,883,126,757,2,30,1,1,allow
63464,443,28849,443,3120,976,2144,13,135,6,7,allow
56258,443,7050,443,3325,1067,2258,13,135,6,7,allow
56351,53,53304,53,195,102,93,2,33,1,1,allow
51796,48779,32373,48779,70,70,0,1,5,1,0,allow
50471,80,51148,80,1658,1247,411,8,15,5,3,allow
50631,443,5471,443,4158,1021,3137,15,26,8,7,allow
55430,443,62629,443,805321,15163,790158,752,171,204,548,allow
56513,443,40120,443,4989,1014,3975,16,32,9,7,allow
49508,443,35365,443,4151,1015,3136,16,27,8,8,allow
49491,443,28351,443,1627,884,743,12,27,6,6,allow
64778,53,20977,53,269,110,159,2,30,1,1,allow
34671,53,40615,53,168,78,90,2,30,1,1,allow
49988,53,19025,53,214,102,112,2,30,1,1,allow
27005,27015,3616,27015,887,126,761,2,30,1,1,allow
60180,53,36445,53,225,110,115,2,30,1,1,allow
53628,50514,20883,50514,70,70,0,2,7,2,0,allow
36516,443,59096,443,70,70,0,1,4,1,0,allow
64609,53,8196,53,404,95,309,4,43,2,2,allow
40848,8434,40848,8434,156,156,0,3,8,3,0,allow
51814,55393,12935,55393,70,70,0,2,7,2,0,allow
42469,80,53240,80,2169,1419,750,10,15,6,4,allow
51518,443,15866,443,38155,33545,4610,79,26,42,37,allow
49496,443,45834,443,15404,11220,4184,29,27,16,13,allow
48713,80,47813,80,1767,751,1016,10,15,6,4,allow
44417,53,0,0,82,82,0,2,40,2,0,allow
51501,443,62787,443,10861,5281,5580,65,49,33,32,allow
53630,64745,62898,64745,70,70,0,2,7,2,0,allow
64488,53,54282,53,356,98,258,4,35,2,2,allow
50461,443,58774,443,5440,4368,1072,19,34,11,8,allow
54972,80,43170,80,1074,691,383,12,66,7,5,allow
62883,53,56502,53,205,86,119,2,29,1,1,allow
48883,53,16845,53,168,78,90,2,30,1,1,allow
53600,8999,29889,8999,492,306,186,8,15,5,3,allow
49489,443,60116,443,1627,884,743,12,27,6,6,allow
65087,53,63765,53,230,110,120,2,30,1,1,allow
64979,53,11759,53,254,102,152,2,30,1,1,allow
65072,53,64909,53,338,110,228,2,29,1,1,allow
57470,6881,50879,6881,1806,726,1080,24,2426,12,12,allow
45563,443,24709,443,1022491,42917,979574,1099,36,416,683,allow
61480,443,37591,443,5716,1341,4375,29,80,16,13,allow
51820,53738,52497,53738,70,70,0,1,5,1,0,allow
50455,80,38947,80,4395,3599,796,15,34,8,7,allow
49490,443,58298,443,1627,884,743,12,27,6,6,allow
50265,37083,2868,37083,490,150,340,2,1200,1,1,allow
51797,30712,27964,30712,70,70,0,1,5,1,0,allow
50465,80,35475,80,8499,2011,6488,17,21,8,9,allow
50447,80,50342,80,67694,29654,38040,85,37,40,45,allow
60889,443,46801,443,9959,2430,7529,27,46,16,11,allow
30127,53,30127,53,197,90,107,2,30,1,1,allow
63925,53,47553,53,388,134,254,2,30,1,1,allow
49713,53,41539,53,233,94,139,2,30,1,1,allow
65037,53,14259,53,243,94,149,2,30,1,1,allow
49509,443,19603,443,4091,1015,3076,15,27,8,7,allow
49507,443,13013,443,4151,1015,3136,16,27,8,8,allow
49500,443,37954,443,1197,620,577,13,27,6,7,allow
53103,443,15301,443,130,70,60,2,15,1,1,allow
65340,53,10565,53,226,102,124,2,30,1,1,allow
65102,53,16634,53,210,102,108,2,30,1,1,allow
59052,53,10639,53,504,110,394,2,30,1,1,allow
17750,58572,62694,58572,150,150,0,1,1200,1,0,allow
56816,53,22918,53,233,94,139,2,30,1,1,allow
57470,27232,13855,27232,4212,2724,1488,57,2411,33,24,allow
49503,443,6313,443,20565,2848,17717,31,27,10,21,allow
56940,80,20270,80,2925,1480,1445,11,30,7,4,allow
65209,53,17107,53,212,102,110,2,30,1,1,allow
56707,53,58987,53,199,94,105,2,30,1,1,allow
44550,80,64720,80,3577,1983,1594,18,153,9,9,allow
37307,443,33957,443,9563,2336,7227,25,15,14,11,allow
56599,443,36954,443,348780,9144,339636,358,32,123,235,allow
48658,443,56881,443,6799,4474,2325,38,85,20,18,allow
60755,40010,18324,40010,316,136,180,6,7,3,3,allow
51558,37965,0,0,72,72,0,1,0,1,0,deny
54266,445,0,0,66,66,0,1,0,1,0,drop
54269,445,0,0,66,66,0,1,0,1,0,drop
54264,445,0,0,66,66,0,1,0,1,0,drop
54267,445,0,0,66,66,0,1,0,1,0,drop
54268,445,0,0,66,66,0,1,0,1,0,drop
54263,445,0,0,66,66,0,1,0,1,0,drop
54262,445,0,0,66,66,0,1,0,1,0,drop
54261,445,0,0,66,66,0,1,0,1,0,drop
36080,26467,0,0,62,62,0,1,0,1,0,deny
62414,50584,0,0,66,66,0,1,0,1,0,deny
11677,56205,0,0,66,66,0,1,0,1,0,deny
60147,25198,0,0,148,148,0,1,0,1,0,deny
18950,50584,0,0,146,146,0,1,0,1,0,deny
18950,50584,0,0,62,62,0,1,0,1,0,deny
47700,51505,0,0,66,66,0,1,0,1,0,deny
53899,445,0,0,70,70,0,1,0,1,0,drop
8191,51221,0,0,62,62,0,1,0,1,0,deny
11385,48543,0,0,145,145,0,1,0,1,0,deny
43260,41615,0,0,145,145,0,1,0,1,0,deny
53894,445,0,0,70,70,0,1,0,1,0,drop
58853,445,0,0,70,70,0,1,0,1,0,drop
58851,445,0,0,70,70,0,1,0,1,0,drop
58850,445,0,0,70,70,0,1,0,1,0,drop
54248,445,0,0,66,66,0,1,0,1,0,drop
54247,445,0,0,66,66,0,1,0,1,0,drop
54246,445,0,0,66,66,0,1,0,1,0,drop
52643,15941,0,0,66,66,0,1,0,1,0,deny
24450,48817,0,0,157,157,0,1,0,1,0,deny
55032,62413,0,0,66,66,0,1,0,1,0,deny
2394,43890,0,0,62,62,0,1,0,1,0,deny
62152,56205,0,0,66,66,0,1,0,1,0,deny
443,1785,0,0,97,97,0,1,0,1,0,deny
55248,67,0,0,60,60,0,1,0,1,0,deny
53890,445,0,0,70,70,0,1,0,1,0,drop
61962,53733,0,0,66,66,0,1,0,1,0,deny
7286,51221,0,0,62,62,0,1,0,1,0,deny
58841,445,0,0,70,70,0,1,0,1,0,drop
55157,7302,0,0,66,66,0,1,0,1,0,deny
58840,445,0,0,70,70,0,1,0,1,0,drop
58839,445,0,0,70,70,0,1,0,1,0,drop
58835,445,0,0,70,70,0,1,0,1,0,drop
57473,23,0,0,60,60,0,1,0,1,0,deny
51525,35440,0,0,66,66,0,1,0,1,0,deny
53886,445,0,0,70,70,0,1,0,1,0,drop
50280,57470,0,0,78,78,0,1,0,1,0,deny
33305,54532,0,0,60,60,0,1,0,1,0,deny
1024,57470,0,0,62,62,0,1,0,1,0,deny
61223,37965,0,0,66,66,0,1,0,1,0,deny
59201,51221,0,0,62,62,0,1,0,1,0,deny
62337,44847,0,0,66,66,0,1,0,1,0,deny
43129,15503,0,0,62,62,0,1,0,1,0,deny
6931,55108,0,0,139,139,0,1,0,1,0,deny
50031,44847,0,0,70,70,0,1,0,1,0,deny
59430,50584,0,0,66,66,0,1,0,1,0,deny
63263,57470,0,0,66,66,0,1,0,1,0,deny
50562,37965,0,0,62,62,0,1,0,1,0,deny
53879,445,0,0,70,70,0,1,0,1,0,drop
1880,57470,0,0,146,146,0,1,0,1,0,deny
58824,445,0,0,70,70,0,1,0,1,0,drop
58822,445,0,0,70,70,0,1,0,1,0,drop
58818,445,0,0,70,70,0,1,0,1,0,drop
53877,445,0,0,70,70,0,1,0,1,0,drop
53876,445,0,0,70,70,0,1,0,1,0,drop
53875,445,0,0,70,70,0,1,0,1,0,drop
53874,445,0,0,70,70,0,1,0,1,0,drop
53872,445,0,0,70,70,0,1,0,1,0,drop
53870,445,0,0,70,70,0,1,0,1,0,drop
5729,22114,0,0,66,66,0,1,0,1,0,deny
22904,56205,0,0,62,62,0,1,0,1,0,deny
22904,56205,0,0,146,146,0,1,0,1,0,deny
1880,57470,0,0,146,146,0,1,0,1,0,deny
54223,445,0,0,66,66,0,1,0,1,0,drop
64175,56502,0,0,66,66,0,1,0,1,0,deny
32007,1212,0,0,145,145,0,1,0,1,0,deny
58815,445,0,0,70,70,0,1,0,1,0,drop
58814,445,0,0,70,70,0,1,0,1,0,drop
53856,445,0,0,70,70,0,1,0,1,0,drop
53855,445,0,0,70,70,0,1,0,1,0,drop
53853,445,0,0,70,70,0,1,0,1,0,drop
53845,445,0,0,70,70,0,1,0,1,0,drop
53846,445,0,0,70,70,0,1,0,1,0,drop
52112,26467,0,0,66,66,0,1,0,1,0,deny
80,44459,0,0,66,66,0,1,0,1,0,deny
17640,55442,0,0,62,62,0,1,0,1,0,deny
45673,30188,0,0,62,62,0,1,0,1,0,deny
54991,36829,0,0,62,62,0,1,0,1,0,deny
54218,445,0,0,66,66,0,1,0,1,0,drop
25015,64147,0,0,66,66,0,1,0,1,0,deny
42732,57470,0,0,62,62,0,1,0,1,0,deny
42332,22114,0,0,66,66,0,1,0,1,0,deny
54217,445,0,0,66,66,0,1,0,1,0,drop
58801,445,0,0,70,70,0,1,0,1,0,drop
47030,81,0,0,60,60,0,1,0,1,0,deny
58800,445,0,0,70,70,0,1,0,1,0,drop
58795,445,0,0,70,70,0,1,0,1,0,drop
58792,445,0,0,70,70,0,1,0,1,0,drop
53834,445,0,0,70,70,0,1,0,1,0,drop
54214,445,0,0,66,66,0,1,0,1,0,drop
45060,37965,0,0,62,62,0,1,0,1,0,deny
21213,23,0,0,60,60,0,1,0,1,0,deny
64379,37965,0,0,66,66,0,1,0,1,0,deny
58790,445,0,0,70,70,0,1,0,1,0,drop
58786,445,0,0,70,70,0,1,0,1,0,drop
58785,445,0,0,70,70,0,1,0,1,0,drop
58782,445,0,0,70,70,0,1,0,1,0,drop
51745,57470,0,0,145,145,0,1,0,1,0,deny
15341,23,0,0,60,60,0,1,0,1,0,deny
48676,53392,0,0,60,60,0,1,0,1,0,deny
54206,445,0,0,66,66,0,1,0,1,0,drop
53830,445,0,0,70,70,0,1,0,1,0,drop
34134,30188,0,0,62,62,0,1,0,1,0,deny
54204,445,0,0,66,66,0,1,0,1,0,drop
54202,445,0,0,66,66,0,1,0,1,0,drop
54199,445,0,0,66,66,0,1,0,1,0,drop
63998,21247,0,0,66,66,0,1,0,1,0,deny
58681,36829,0,0,74,74,0,1,0,1,0,deny
16319,44847,0,0,146,146,0,1,0,1,0,deny
54197,445,0,0,66,66,0,1,0,1,0,drop
54198,445,0,0,66,66,0,1,0,1,0,drop
54196,445,0,0,66,66,0,1,0,1,0,drop
42034,28189,0,0,62,62,0,1,0,1,0,deny
53820,445,0,0,70,70,0,1,0,1,0,drop
53819,445,0,0,70,70,0,1,0,1,0,drop
63598,64147,0,0,66,66,0,1,0,1,0,deny
53817,445,0,0,70,70,0,1,0,1,0,drop
53816,445,0,0,70,70,0,1,0,1,0,drop
64880,9694,0,0,66,66,0,1,0,1,0,deny
53813,445,0,0,70,70,0,1,0,1,0,drop
58779,445,0,0,70,70,0,1,0,1,0,drop
58778,445,0,0,70,70,0,1,0,1,0,drop
58777,445,0,0,70,70,0,1,0,1,0,drop
0,0,0,0,152,78,74,2,0,1,1,allow
54191,445,0,0,66,66,0,1,0,1,0,drop
58773,445,0,0,70,70,0,1,0,1,0,drop
54189,445,0,0,66,66,0,1,0,1,0,drop
57982,64147,0,0,66,66,0,1,0,1,0,deny
54188,445,0,0,66,66,0,1,0,1,0,drop
54187,445,0,0,66,66,0,1,0,1,0,drop
54184,445,0,0,66,66,0,1,0,1,0,drop
53807,445,0,0,70,70,0,1,0,1,0,drop
3911,50584,0,0,62,62,0,1,0,1,0,deny
59696,57470,0,0,62,62,0,1,0,1,0,deny
32007,26543,0,0,145,145,0,1,0,1,0,deny
58765,445,0,0,70,70,0,1,0,1,0,drop
60627,51050,0,0,66,66,0,1,0,1,0,deny
65501,26467,0,0,62,62,0,1,0,1,0,deny
58764,445,0,0,70,70,0,1,0,1,0,drop
58759,445,0,0,70,70,0,1,0,1,0,drop
53800,445,0,0,70,70,0,1,0,1,0,drop
53799,445,0,0,70,70,0,1,0,1,0,drop
32096,55108,0,0,139,139,0,1,0,1,0,deny
31978,57470,0,0,60,60,0,1,0,1,0,deny
60875,50584,0,0,62,62,0,1,0,1,0,deny
55396,26467,0,0,62,62,0,1,0,1,0,deny
53833,26467,0,0,66,66,0,1,0,1,0,deny
50227,57470,0,0,66,66,0,1,0,1,0,deny
54176,445,0,0,66,66,0,1,0,1,0,drop
53794,445,0,0,70,70,0,1,0,1,0,drop
60294,30188,0,0,62,62,0,1,0,1,0,deny
53792,445,0,0,70,70,0,1,0,1,0,drop
58074,11392,0,0,62,62,0,1,0,1,0,deny
61323,23117,0,0,62,62,0,1,0,1,0,deny
45964,5333,0,0,60,60,0,1,0,1,0,deny
54166,445,0,0,66,66,0,1,0,1,0,drop
58747,445,0,0,70,70,0,1,0,1,0,drop
25085,30188,0,0,66,66,0,1,0,1,0,deny
53788,445,0,0,70,70,0,1,0,1,0,deny
3564,57470,0,0,62,62,0,1,0,1,0,deny
46576,23718,0,0,66,66,0,1,0,1,0,deny
34095,53,34095,53,243,104,139,2,30,1,1,allow
28121,443,57798,443,9075,2662,6413,34,462,16,18,allow
56645,443,5860,443,32966,3481,29485,49,80,21,28,allow
33784,443,3722,443,2378,1126,1252,14,979,7,7,allow
46859,15000,30674,15000,130,70,60,2,6,1,1,allow
51811,20740,61529,20740,70,70,0,2,8,2,0,allow
36241,443,45879,443,7768,3776,3992,21,132,11,10,allow
35012,443,7162,443,1461,980,481,11,25,7,4,allow
27005,27016,47379,27016,882,126,756,2,30,1,1,allow
59543,443,39979,443,7358,2661,4697,22,17,11,11,allow
27005,52013,29857,52013,252,252,0,3,32,3,0,allow
63804,52520,33916,52520,66,66,0,2,8,2,0,allow
36445,443,53718,443,78,78,0,1,5,1,0,allow
44320,443,45352,443,1657,1128,529,15,35,9,6,allow
56642,443,26637,443,27108,2396,24712,40,80,18,22,allow
49283,6881,34041,6881,803,617,186,6,16,3,3,allow
51035,443,33243,443,2227,1018,1209,17,16,8,9,allow
58104,443,9408,443,2396,1144,1252,14,979,7,7,allow
65257,53,65257,53,176,78,98,2,30,1,1,allow
64253,53,64253,53,288,83,205,2,30,1,1,allow
64607,443,37548,443,3182,1568,1614,8,120,4,4,allow
53011,80,53011,80,349769,6527,343242,368,22,100,268,allow
49710,53,26259,53,89,89,0,1,30,1,0,allow
47272,443,40986,443,6318,1025,5293,17,35,9,8,allow
63803,41439,2152,41439,66,66,0,2,8,2,0,allow
35105,5222,32302,5222,1964,919,1045,20,16,10,10,allow
59830,443,59830,443,21205,1711,19494,32,1806,11,21,allow
55618,45341,56428,45341,70,70,0,1,5,1,0,allow
53627,1099,28999,1099,320,140,180,6,7,3,3,allow
10570,53,10570,53,215,80,135,2,32,1,1,allow
49282,6881,35216,6881,709,523,186,6,16,3,3,allow
53366,53,53366,53,237,98,139,2,30,1,1,allow
49891,443,42695,443,8211,3683,4528,27,623,14,13,allow
59177,53,0,0,619,76,543,2,30,1,1,allow
47257,443,58413,443,64727,10981,53746,91,141,36,55,allow
57470,44667,49855,44667,480,149,331,2,1200,1,1,allow
47595,33434,0,0,106,106,0,1,60,1,0,allow
56643,443,30724,443,8167,1980,6187,22,80,12,10,allow
43113,443,54317,443,3083,1817,1266,18,15,8,10,allow
27005,27015,11588,27015,1019,252,767,4,32,3,1,allow
54444,443,57397,443,9802,2594,7208,25,360,10,15,allow
9402,53,9402,53,237,91,146,2,32,1,1,allow
48668,7275,13487,7275,276,70,206,5,32,2,3,allow
38168,443,45970,443,6136,1404,4732,20,979,10,10,allow
60405,64722,55660,64722,70,70,0,1,5,1,0,allow
59177,53,0,0,426,152,274,4,30,2,2,allow
57709,53,57709,53,265,111,154,2,30,1,1,allow
27988,40012,43574,40012,253,190,63,2,30,1,1,allow
27005,27014,39253,27014,882,126,756,2,30,1,1,allow
27005,27016,26467,27016,885,126,759,2,30,1,1,allow
64755,443,45264,443,23561,3667,19894,40,121,19,21,allow
10920,53,0,0,266,85,181,2,31,1,1,allow
44399,443,14238,443,11367,9355,2012,32,395,13,19,allow
6882,6889,19915,6889,492,150,342,2,1200,1,1,allow
57470,6882,62846,6882,528,528,0,9,1200,9,0,allow
59766,443,36182,443,508206,39212,468994,748,192,296,452,allow
51086,443,36949,443,11749,5336,6413,32,153,18,14,allow
33965,443,58848,443,31008,10449,20559,69,130,31,38,allow
42744,443,24894,443,224178,118713,105465,333,140,162,171,allow
37965,47686,60898,47686,480,149,331,2,1200,1,1,allow
42898,43890,0,0,62,62,0,1,0,1,0,deny
54164,445,0,0,66,66,0,1,0,1,0,drop
53786,445,0,0,70,70,0,1,0,1,0,drop
6666,401,0,0,60,60,0,1,0,1,0,deny
60319,23,0,0,60,60,0,1,0,1,0,deny
52356,55442,0,0,62,62,0,1,0,1,0,deny
58564,50432,0,0,66,66,0,1,0,1,0,deny
64878,26467,0,0,62,62,0,1,0,1,0,deny
58343,23718,0,0,66,66,0,1,0,1,0,deny
54155,445,0,0,66,66,0,1,0,1,0,drop
21399,35440,0,0,146,146,0,1,0,1,0,deny
54149,445,0,0,66,66,0,1,0,1,0,drop
60406,64337,21894,64337,70,70,0,1,5,1,0,allow
51628,443,16414,443,8084,2509,5575,36,195,19,17,allow
52667,443,52477,443,4797,2794,2003,20,271,11,9,allow
53626,443,63196,443,10520,3200,7320,29,38,16,13,allow
58147,443,65421,443,8365,2826,5539,27,693,15,12,allow
41292,443,17156,443,7644,1098,6546,19,35,10,9,allow
48681,80,45826,80,918,461,457,9,15,6,3,allow
58182,443,50635,443,15327,8305,7022,49,137,24,25,allow
60404,37869,1264,37869,164,70,94,2,5,1,1,allow
41295,443,40323,443,7661,1115,6546,19,35,10,9,allow
39317,443,31071,443,2045,1025,1020,17,80,9,8,allow
49778,53,5798,53,319,98,221,4,53,2,2,allow
56947,53,0,0,86,86,0,1,29,1,0,allow
64099,53,12065,53,227,110,117,2,30,1,1,allow
47091,443,62680,443,3543,1570,1973,18,120,9,9,allow
60752,28080,10717,28080,70,70,0,1,5,1,0,allow
27454,53,27454,53,244,98,146,2,32,1,1,allow
51812,15279,9004,15279,70,70,0,2,8,2,0,allow
51270,48061,22070,48061,70,70,0,1,5,1,0,allow
5588,5588,0,0,3354,1792,1562,46,192,23,23,allow
40498,443,31302,443,9807,2542,7265,47,19,24,23,allow
27005,27018,12355,27018,879,126,753,2,30,1,1,allow
64219,53,37826,53,264,102,162,2,30,1,1,allow
64596,53,15356,53,215,86,129,2,30,1,1,allow
56808,54393,51587,54393,70,70,0,2,8,2,0,allow
35670,443,58907,443,295458,11828,283630,339,185,137,202,allow
51794,53911,18093,53911,70,70,0,1,5,1,0,allow
10051,443,38650,443,11412,1763,9649,27,110,13,14,allow
55708,443,3177,443,10710,4573,6137,53,3376,31,22,allow
49176,443,46832,443,2802,1902,900,22,1118,12,10,allow
50632,443,47511,443,4158,1021,3137,15,26,8,7,allow
39423,80,5862,80,234,234,0,4,12,4,0,allow
64667,53,24129,53,353,118,235,2,30,1,1,allow
46034,53,59880,53,168,78,90,2,30,1,1,allow
49510,443,46546,443,1012,495,517,10,26,4,6,allow
63652,443,53205,443,51005,2084,48921,61,120,22,39,allow
36410,53,36410,53,268,114,154,2,30,1,1,allow
49518,53,34801,53,213,102,111,2,30,1,1,allow
51788,443,22272,443,3679,1712,1967,14,135,7,7,allow
27005,27016,18663,27016,892,126,766,2,30,1,1,allow
56620,80,60684,80,234,234,0,4,12,4,0,allow
49316,53,52712,53,338,102,236,2,30,1,1,allow
27005,27016,43090,27016,878,126,752,2,30,1,1,allow
51795,60258,28772,60258,70,70,0,1,5,1,0,allow
56792,42155,44462,42155,70,70,0,1,5,1,0,allow
49180,53,47398,53,402,102,300,2,30,1,1,allow
63062,53,18913,53,70,70,0,1,30,1,0,allow
50867,443,9876,443,2782,1480,1302,17,15,9,8,allow
41294,443,46411,443,7595,1115,6480,18,35,10,8,allow
49020,80,13819,80,3422,2088,1334,18,152,9,9,allow
39487,80,41504,80,1403,651,752,10,15,6,4,allow
37965,54371,6962,54371,132,132,0,3,1199,3,0,allow
55849,443,27388,443,5944,1501,4443,27,163,13,14,allow
56145,3389,56145,3389,4286,2261,2025,20,17,11,9,allow
51654,80,36290,80,170875,6864,164011,255,35,93,162,allow
60408,55557,8506,55557,70,70,0,1,5,1,0,allow
49402,80,31803,80,405,285,120,5,15,3,2,allow
57419,443,3080,443,9224,2381,6843,29,19,14,15,allow
56791,11500,23499,11500,70,70,0,1,5,1,0,allow
38761,123,12089,123,184,94,90,2,30,1,1,allow
56810,33957,19531,33957,70,70,0,1,5,1,0,allow
64370,53,62116,53,399,102,297,4,54,2,2,allow
64075,53,49394,53,352,86,266,4,36,2,2,allow
65194,53,62268,53,298,102,196,2,29,1,1,allow
54891,80,41573,80,1222,782,440,11,15,6,5,allow
54160,53,34866,53,199,94,105,2,29,1,1,allow
10053,443,28179,443,1832,1113,719,18,110,10,8,allow
27005,27015,45197,27015,881,126,755,2,30,1,1,allow
64893,53,31080,53,232,102,130,2,30,1,1,allow
57432,443,39026,443,2714,336,2378,10,120,5,5,allow
58568,53,2690,53,294,86,208,2,30,1,1,allow
59030,443,52271,443,10079,2210,7869,36,120,19,17,allow
34325,80,9980,80,2243,1115,1128,14,152,7,7,allow
51660,80,21356,80,52002,2984,49018,77,35,35,42,allow
61981,443,61981,443,4533,1626,2907,19,29,11,8,allow
60755,443,57914,443,61151,2474,58677,61,25,16,45,allow
65474,443,34045,443,355358,10960,344398,369,16,131,238,allow
51791,56116,24331,56116,70,70,0,1,5,1,0,allow
51221,47391,14393,47391,323,150,173,2,1203,1,1,allow
56723,53,3556,53,198,94,104,2,30,1,1,allow
33255,443,24023,443,7579,3093,4486,25,21,14,11,allow
51793,12210,25465,12210,70,70,0,1,5,1,0,allow
64276,53,2055,53,436,89,347,4,42,2,2,allow
51499,443,54241,443,1610,1073,537,14,15,8,6,allow
10031,443,14432,443,34551,3731,30820,54,112,23,31,allow
36877,443,64698,443,9787,2382,7405,17,120,7,10,allow
60022,443,9132,443,6906,1458,5448,24,16,14,10,allow
10052,443,12703,443,1832,1113,719,18,110,10,8,allow
64649,53,33149,53,225,102,123,2,30,1,1,allow
50471,53,24459,53,168,78,90,2,30,1,1,allow
44847,6881,11410,6881,502,150,352,2,1200,1,1,allow
47450,443,63060,443,9950,4684,5266,26,306,12,14,allow
63787,18318,22110,18318,70,70,0,1,5,1,0,allow
53602,12395,5014,12395,70,70,0,1,5,1,0,allow
63585,443,56391,443,123421,11745,111676,267,125,108,159,allow
54130,53,45665,53,168,78,90,2,30,1,1,allow
63786,50091,41625,50091,70,70,0,1,5,1,0,allow
1024,57470,0,0,62,62,0,1,0,1,0,deny
53782,445,0,0,70,70,0,1,0,1,0,drop
18632,51505,0,0,66,66,0,1,0,1,0,deny
41037,55839,0,0,157,157,0,1,0,1,0,deny
5690,23,0,0,60,60,0,1,0,1,0,deny
58736,445,0,0,70,70,0,1,0,1,0,drop
58734,445,0,0,70,70,0,1,0,1,0,drop
58733,445,0,0,70,70,0,1,0,1,0,drop
29203,26467,0,0,62,62,0,1,0,1,0,deny
54141,445,0,0,66,66,0,1,0,1,0,drop
54139,445,0,0,66,66,0,1,0,1,0,drop
54138,445,0,0,66,66,0,1,0,1,0,drop
54140,445,0,0,66,66,0,1,0,1,0,drop
54137,445,0,0,66,66,0,1,0,1,0,drop
54136,445,0,0,66,66,0,1,0,1,0,drop
54135,445,0,0,66,66,0,1,0,1,0,drop
54133,445,0,0,66,66,0,1,0,1,0,drop
59505,53733,0,0,66,66,0,1,0,1,0,deny
27064,51221,0,0,72,72,0,1,0,1,0,deny
60683,5900,0,0,60,60,0,1,0,1,0,deny
9219,32480,0,0,72,72,0,1,0,1,0,deny
61808,18375,0,0,66,66,0,1,0,1,0,deny
20012,311,0,0,60,60,0,1,0,1,0,deny
52887,37807,0,0,66,66,0,1,0,1,0,deny
53769,445,0,0,70,70,0,1,0,1,0,drop
53453,2767,0,0,66,66,0,1,0,1,0,deny
32071,51221,0,0,66,66,0,1,0,1,0,deny
62566,35993,0,0,66,66,0,1,0,1,0,deny
6881,26296,0,0,146,146,0,1,0,1,0,deny
53766,445,0,0,70,70,0,1,0,1,0,drop
50280,57470,0,0,78,78,0,1,0,1,0,deny
33305,54532,0,0,60,60,0,1,0,1,0,deny
59745,53635,0,0,66,66,0,1,0,1,0,deny
58729,445,0,0,70,70,0,1,0,1,0,drop
58728,445,0,0,70,70,0,1,0,1,0,drop
58727,445,0,0,70,70,0,1,0,1,0,drop
60152,26467,0,0,62,62,0,1,0,1,0,deny
2949,57470,0,0,66,66,0,1,0,1,0,deny
54121,445,0,0,66,66,0,1,0,1,0,drop
54120,445,0,0,66,66,0,1,0,1,0,drop
54119,445,0,0,66,66,0,1,0,1,0,drop
30765,56205,0,0,66,66,0,1,0,1,0,deny
4127,26467,0,0,62,62,0,1,0,1,0,deny
53928,15503,0,0,62,62,0,1,0,1,0,deny
53761,445,0,0,70,70,0,1,0,1,0,drop
58716,445,0,0,70,70,0,1,0,1,0,drop
60602,15503,0,0,66,66,0,1,0,1,0,deny
53760,445,0,0,70,70,0,1,0,1,0,drop
45941,23388,0,0,60,60,0,1,0,1,0,deny
37876,23,0,0,60,60,0,1,0,1,0,deny
41561,23,0,0,60,60,0,1,0,1,0,deny
53758,445,0,0,70,70,0,1,0,1,0,drop
58713,445,0,0,70,70,0,1,0,1,0,drop
58705,445,0,0,70,70,0,1,0,1,0,drop
58703,445,0,0,70,70,0,1,0,1,0,drop
58701,445,0,0,70,70,0,1,0,1,0,drop
15296,37965,0,0,66,66,0,1,0,1,0,deny
51996,35440,0,0,66,66,0,1,0,1,0,deny
50820,57470,0,0,62,62,0,1,0,1,0,deny
48692,57470,0,0,62,62,0,1,0,1,0,deny
53751,445,0,0,70,70,0,1,0,1,0,drop
53749,445,0,0,70,70,0,1,0,1,0,drop
58694,445,0,0,70,70,0,1,0,1,0,drop
58695,445,0,0,70,70,0,1,0,1,0,drop
58691,445,0,0,70,70,0,1,0,1,0,drop
42798,26467,0,0,62,62,0,1,0,1,0,deny
54997,26467,0,0,66,66,0,1,0,1,0,deny
53748,445,0,0,70,70,0,1,0,1,0,drop
49842,7302,0,0,62,62,0,1,0,1,0,deny
25565,34677,0,0,60,60,0,1,0,1,0,deny
53747,445,0,0,70,70,0,1,0,1,0,drop
60805,5900,0,0,60,60,0,1,0,1,0,deny
53746,445,0,0,70,70,0,1,0,1,0,drop
57478,7302,0,0,62,62,0,1,0,1,0,deny
53740,445,0,0,70,70,0,1,0,1,0,drop
53741,445,0,0,70,70,0,1,0,1,0,drop
50067,64147,0,0,62,62,0,1,0,1,0,deny
7275,9524,0,0,66,66,0,1,0,1,0,deny
23528,44847,0,0,62,62,0,1,0,1,0,deny
64066,23718,0,0,66,66,0,1,0,1,0,deny
3541,22114,0,0,62,62,0,1,0,1,0,deny
11859,64147,0,0,62,62,0,1,0,1,0,deny
53728,445,0,0,70,70,0,1,0,1,0,drop
53727,445,0,0,70,70,0,1,0,1,0,drop
53722,445,0,0,70,70,0,1,0,1,0,drop
54096,445,0,0,66,66,0,1,0,1,0,drop
53718,445,0,0,70,70,0,1,0,1,0,drop
53717,445,0,0,70,70,0,1,0,1,0,drop
22357,6004,0,0,62,62,0,1,0,1,0,deny
58686,445,0,0,70,70,0,1,0,1,0,drop
58685,445,0,0,70,70,0,1,0,1,0,drop
6666,6379,0,0,60,60,0,1,0,1,0,deny
52741,24211,0,0,66,66,0,1,0,1,0,deny
63221,53436,0,0,62,62,0,1,0,1,0,deny
60162,53436,0,0,66,66,0,1,0,1,0,deny
49001,48817,0,0,160,160,0,1,0,1,0,deny
35319,51505,0,0,146,146,0,1,0,1,0,deny
33793,23,0,0,60,60,0,1,0,1,0,deny
38763,30188,0,0,146,146,0,1,0,1,0,deny
48488,50584,0,0,146,146,0,1,0,1,0,deny
64756,11392,0,0,146,146,0,1,0,1,0,deny
50878,53733,0,0,62,62,0,1,0,1,0,deny
54091,445,0,0,66,66,0,1,0,1,0,drop
1024,64147,0,0,62,62,0,1,0,1,0,deny
40547,24051,0,0,74,74,0,1,0,1,0,deny
58468,57587,0,0,66,66,0,1,0,1,0,deny
54089,445,0,0,66,66,0,1,0,1,0,drop
57339,50584,0,0,66,66,0,1,0,1,0,deny
53706,445,0,0,70,70,0,1,0,1,0,drop
58678,445,0,0,70,70,0,1,0,1,0,drop
4000,44847,0,0,66,66,0,1,0,1,0,deny
58671,445,0,0,70,70,0,1,0,1,0,drop
58668,445,0,0,70,70,0,1,0,1,0,drop
58665,445,0,0,70,70,0,1,0,1,0,drop
45964,2225,0,0,60,60,0,1,0,1,0,deny
48020,7484,0,0,60,60,0,1,0,1,0,deny
54086,445,0,0,66,66,0,1,0,1,0,drop
3377,50584,0,0,66,66,0,1,0,1,0,deny
61457,21247,0,0,66,66,0,1,0,1,0,deny
46093,32661,0,0,74,74,0,1,0,1,0,deny
0,0,0,0,480,244,236,4,0,2,2,allow
49690,50265,0,0,66,66,0,1,0,1,0,deny
58660,445,0,0,70,70,0,1,0,1,0,drop
53702,445,0,0,70,70,0,1,0,1,0,drop
58238,23,0,0,60,60,0,1,0,1,0,deny
58658,445,0,0,70,70,0,1,0,1,0,drop
58656,445,0,0,70,70,0,1,0,1,0,drop
58654,445,0,0,70,70,0,1,0,1,0,drop
51413,25864,0,0,72,72,0,1,0,1,0,deny
54078,445,0,0,66,66,0,1,0,1,0,drop
54073,445,0,0,66,66,0,1,0,1,0,drop
54075,445,0,0,66,66,0,1,0,1,0,drop
54074,445,0,0,66,66,0,1,0,1,0,drop
53692,445,0,0,70,70,0,1,0,1,0,drop
53693,445,0,0,70,70,0,1,0,1,0,drop
39895,26467,0,0,62,62,0,1,0,1,0,deny
26799,50584,0,0,62,62,0,1,0,1,0,deny
53688,445,0,0,70,70,0,1,0,1,0,drop
53689,445,0,0,70,70,0,1,0,1,0,drop
54070,445,0,0,66,66,0,1,0,1,0,drop
54069,445,0,0,66,66,0,1,0,1,0,drop
54067,445,0,0,66,66,0,1,0,1,0,drop
53685,445,0,0,70,70,0,1,0,1,0,drop
54062,49813,0,0,62,62,0,1,0,1,0,deny
26560,26467,0,0,66,66,0,1,0,1,0,deny
51244,30228,0,0,100,100,0,1,0,1,0,deny
53779,51505,0,0,66,66,0,1,0,1,0,deny
52447,43890,0,0,62,62,0,1,0,1,0,deny
58652,445,0,0,70,70,0,1,0,1,0,drop
58649,445,0,0,70,70,0,1,0,1,0,drop
58646,445,0,0,70,70,0,1,0,1,0,drop
54064,445,0,0,66,66,0,1,0,1,0,drop
58645,445,0,0,70,70,0,1,0,1,0,drop
54061,445,0,0,66,66,0,1,0,1,0,drop
44854,26467,0,0,62,62,0,1,0,1,0,deny
51026,37450,0,0,66,66,0,1,0,1,0,deny
19875,30170,0,0,145,145,0,1,0,1,0,deny
54060,445,0,0,66,66,0,1,0,1,0,drop
54059,445,0,0,66,66,0,1,0,1,0,drop
53680,445,0,0,70,70,0,1,0,1,0,drop
54057,445,0,0,66,66,0,1,0,1,0,drop
8999,57099,0,0,146,146,0,1,0,1,0,deny
50027,21247,0,0,66,66,0,1,0,1,0,deny
10319,42707,0,0,62,62,0,1,0,1,0,deny
8999,59353,0,0,146,146,0,1,0,1,0,deny
54109,36829,0,0,66,66,0,1,0,1,0,deny
39868,55839,0,0,137,137,0,1,0,1,0,deny
24972,27262,0,0,60,60,0,1,0,1,0,deny
60750,42707,0,0,66,66,0,1,0,1,0,deny
52076,44847,0,0,66,66,0,1,0,1,0,deny
49677,64147,0,0,62,62,0,1,0,1,0,deny
53672,445,0,0,70,70,0,1,0,1,0,drop
44934,443,47157,443,416,210,206,7,24,4,3,allow
61666,80,7138,80,16580,1400,15180,33,48,15,18,allow
46983,443,17844,443,2809,1884,925,19,25,11,8,allow
63571,443,39273,443,1882441,60775,1821666,2129,129,795,1334,allow
55877,27906,5770,27906,480,149,331,2,1200,1,1,allow
38133,53,38133,53,194,87,107,2,30,1,1,allow
44564,22,44564,22,5130,2103,3027,28,21,16,12,allow
51496,443,43516,443,416,210,206,7,15,4,3,allow
59952,53,59952,53,215,80,135,2,32,1,1,allow
52375,80,39641,80,78,78,0,1,5,1,0,allow
35608,443,36107,443,8530,2685,5845,25,100,15,10,allow
40763,443,27693,443,15679,4305,11374,32,43,17,15,allow
59762,443,29034,443,382,164,218,2,31,1,1,allow
63529,53,63529,53,217,91,126,2,30,1,1,allow
56118,53,56118,53,233,91,142,2,30,1,1,allow
60939,53,60939,53,237,91,146,2,32,1,1,allow
58638,445,0,0,70,70,0,1,0,1,0,drop
53670,445,0,0,70,70,0,1,0,1,0,drop
54600,6881,0,0,62,62,0,1,0,1,0,deny
58634,445,0,0,70,70,0,1,0,1,0,drop
58631,445,0,0,70,70,0,1,0,1,0,drop
35460,35440,0,0,62,62,0,1,0,1,0,deny
22327,53,22327,53,237,91,146,2,32,1,1,allow
43319,53,43319,53,237,91,146,2,32,1,1,allow
49238,53,49238,53,235,90,145,2,32,1,1,allow
53622,61393,55834,61393,320,140,180,6,7,3,3,allow
55689,443,55689,443,177498,9805,167693,244,80,119,125,allow
55690,443,55690,443,14768,2185,12583,32,80,13,19,allow
59761,53,13611,53,569,164,405,2,31,1,1,allow
56766,41605,18996,41605,1639,460,1179,8,30,4,4,allow
7231,53,7231,53,215,80,135,2,33,1,1,allow
38655,443,22510,443,498,210,288,8,26,4,4,allow
43601,80,43601,80,1252,539,713,10,20,5,5,allow
37052,53,37052,53,259,104,155,2,30,1,1,allow
27005,27016,44583,27016,898,126,772,3,31,2,1,allow
1165,53,1165,53,196,88,108,2,30,1,1,allow
51810,33776,19037,33776,70,70,0,2,8,2,0,allow
58887,80,17469,80,1493,765,728,10,90,6,4,allow
47521,53,9404,53,198,93,105,2,30,1,1,allow
44808,443,1785,443,22366,9583,12783,50,37,25,25,allow
38867,53,38867,53,213,79,134,2,32,1,1,allow
35055,80,30586,80,3650999,83941,3567058,3541,21,1184,2357,allow
64645,443,28393,443,7752,4399,3353,34,159,17,17,allow
35609,443,52136,443,9225,2759,6466,27,100,16,11,allow
47821,53,47821,53,228,97,131,2,30,1,1,allow
45846,443,47275,443,2227,1018,1209,17,15,8,9,allow
51998,80,30634,80,52288,7809,44479,105,37,40,65,allow
57824,443,57824,443,4669,1762,2907,19,30,11,8,allow
55688,443,55688,443,115875,6637,109238,158,80,71,87,allow
55693,443,55693,443,23467,2707,20760,45,80,21,24,allow
50422,53,50422,53,194,87,107,2,30,1,1,allow
57925,443,19196,443,43126,33414,9712,214,220,108,106,allow
36037,53,7009,53,198,93,105,2,30,1,1,allow
36649,53,5716,53,198,93,105,2,30,1,1,allow
59831,53,14617,53,198,93,105,2,30,1,1,allow
34158,53,34158,53,217,87,130,2,30,1,1,allow
49465,443,48053,443,2894,725,2169,10,121,5,5,allow
48808,443,13852,443,8192,2071,6121,23,361,10,13,allow
56568,5228,36431,5228,2387,1435,952,16,3600,8,8,allow
49160,13917,61966,13917,150,150,0,1,1201,1,0,allow
59477,443,16193,443,7825,4076,3749,19,121,10,9,allow
5786,53,5786,53,213,87,126,2,31,1,1,allow
48817,61613,48817,61613,490,149,341,2,1200,1,1,allow
38238,443,28773,443,33229,5348,27881,55,125,26,29,allow
53770,64147,0,0,66,66,0,1,0,1,0,deny
53665,445,0,0,70,70,0,1,0,1,0,drop
54047,445,0,0,66,66,0,1,0,1,0,drop
57325,37965,0,0,62,62,0,1,0,1,0,deny
50316,37965,0,0,66,66,0,1,0,1,0,deny
53664,445,0,0,70,70,0,1,0,1,0,drop
60772,36829,0,0,66,66,0,1,0,1,0,deny
20576,37965,0,0,62,62,0,1,0,1,0,deny
33324,42873,0,0,62,62,0,1,0,1,0,deny
51166,31573,0,0,66,66,0,1,0,1,0,deny
5223,11387,0,0,66,66,0,1,0,1,0,deny
42532,22114,0,0,62,62,0,1,0,1,0,deny
27005,27018,46285,27018,895,126,769,2,30,1,1,allow
37759,53,3026,53,199,94,105,2,30,1,1,allow
34286,53,18958,53,199,94,105,2,30,1,1,allow
63586,443,51785,443,12760,2205,10555,39,122,21,18,allow
53268,80,36603,80,2960,1928,1032,13,75,8,5,allow
51497,443,10165,443,350,210,140,6,14,4,2,allow
49904,53,31561,53,217,94,123,2,29,1,1,allow
48620,53,31132,53,199,94,105,2,29,1,1,allow
33849,53,34954,53,336,231,105,3,30,2,1,allow
50777,53,12522,53,199,94,105,2,30,1,1,allow
55443,443,53890,443,12806,2828,9978,55,2983,24,31,allow
55528,443,24685,443,7845,1860,5985,24,81,14,10,allow
65473,443,51323,443,91831,4379,87452,101,15,37,64,allow
55454,53,34563,53,321,105,216,4,40,2,2,allow
57470,10714,2677,10714,132,132,0,3,1199,3,0,allow
2267,53,36345,53,468,320,148,5,49,3,2,allow
53601,30160,62732,30160,70,70,0,1,4,1,0,allow
53595,28976,64230,28976,492,306,186,8,15,5,3,allow
43674,53,36130,53,199,94,105,2,30,1,1,allow
36394,443,63478,443,6485,1692,4793,23,170,13,10,allow
49918,443,5366,443,3291,1714,1577,18,16,11,7,allow
60473,8765,52424,8765,1370,750,620,21,329,11,10,allow
47050,53,14793,53,199,94,105,2,30,1,1,allow
53793,53,24147,53,213,78,135,2,30,1,1,allow
27005,27018,55202,27018,881,126,755,2,30,1,1,allow
27005,27025,27504,27025,895,126,769,2,30,1,1,allow
51808,46390,6189,46390,70,70,0,2,8,2,0,allow
60751,20010,62533,20010,70,70,0,1,5,1,0,allow
55329,443,18522,443,9458,2227,7231,23,15,12,11,allow
40501,443,64068,443,6517,1812,4705,21,255,11,10,allow
44948,443,65427,443,4792,3072,1720,31,80,16,15,allow
63957,53,57529,53,211,102,109,2,30,1,1,allow
47824,53,65037,53,199,94,105,2,30,1,1,allow
57415,53,16994,53,223,86,137,2,30,1,1,allow
58601,53,45683,53,198,86,112,2,30,1,1,allow
50864,443,25636,443,6391,1285,5106,19,15,10,9,allow
64294,53,36421,53,329,118,211,2,30,1,1,allow
60287,53,47078,53,215,86,129,2,30,1,1,allow
58415,443,47391,443,145249,142210,3039,143,185,106,37,allow
43039,53,37075,53,241,78,163,2,30,1,1,allow
64752,53,43912,53,210,94,116,2,30,1,1,allow
55080,53,5647,53,330,86,244,2,30,1,1,allow
59764,53,23530,53,304,86,218,2,30,1,1,allow
25758,53,25758,53,198,90,108,2,30,1,1,allow
64753,443,41377,443,145226,5591,139635,164,120,58,106,allow
56740,443,56740,443,41851,2810,39041,66,45,31,35,allow
53594,27639,27513,27639,552,306,246,9,15,5,4,allow
64280,53,51701,53,211,94,117,2,30,1,1,allow
56738,443,56738,443,48740,2961,45779,73,46,33,40,allow
51790,46839,56676,46839,70,70,0,1,5,1,0,allow
58600,443,58600,443,4396,1489,2907,19,26,11,8,allow
59765,443,22401,443,571,166,405,2,30,1,1,allow
64019,53,58991,53,267,94,173,2,30,1,1,allow
62023,53,10426,53,301,102,199,2,30,1,1,allow
57138,443,50278,443,498,210,288,8,26,4,4,allow
63967,53,14948,53,283,97,186,4,36,2,2,allow
63589,443,25041,443,19134,2422,16712,49,120,22,27,allow
53192,80,30945,80,814,335,479,10,15,5,5,allow
42960,443,37505,443,5057,2448,2609,27,544,12,15,allow
53603,53796,21410,53796,70,70,0,1,4,1,0,allow
44805,443,37165,443,6975,2168,4807,20,15,11,9,allow
42705,80,6053,80,1222,782,440,11,15,6,5,allow
51448,80,39374,80,214,140,74,4,15,3,1,allow
51689,53,28477,53,198,86,112,2,29,1,1,allow
34798,53,14935,53,199,94,105,2,30,1,1,allow
57149,53,45353,53,222,86,136,2,30,1,1,allow
57423,443,2574,443,10222,4415,5807,26,15,11,15,allow
50061,443,34942,443,4819,2004,2815,22,80,11,11,allow
44947,443,36944,443,6359,4441,1918,33,80,17,16,allow
27005,27016,63808,27016,879,126,753,2,30,1,1,allow
57952,443,57780,443,480591,8786,471805,442,46,102,340,allow
55321,443,9589,443,9462,2297,7165,23,15,13,10,allow
27005,27015,32826,27015,880,126,754,2,30,1,1,allow
56508,80,35273,80,318,192,126,6,30,4,2,allow
27005,27015,45042,27015,878,126,752,2,30,1,1,allow
123,123,22929,123,184,94,90,2,29,1,1,allow
61559,53,9585,53,376,86,290,2,29,1,1,allow
55784,53,34530,53,199,94,105,2,29,1,1,allow
42895,53,15137,53,168,78,90,2,30,1,1,allow
59766,53,33803,53,512,166,346,2,30,1,1,allow
59752,443,12592,443,304,86,218,2,30,1,1,allow
59751,53,11335,53,304,86,218,2,30,1,1,allow
47478,443,52438,443,4019,1462,2557,21,120,11,10,allow
35195,443,32117,443,3672,1259,2413,16,120,8,8,allow
57347,443,40026,443,3889,1296,2593,11,120,6,5,allow
55763,443,52551,443,48162,46496,1666,59,136,39,20,allow
1462,41599,5098,41599,70,70,0,1,5,1,0,allow
56932,80,33047,80,8325,5642,2683,16,28,9,7,allow
56878,443,56878,443,27657,5506,22151,58,46,30,28,allow
39484,80,6764,80,1403,651,752,10,16,6,4,allow
64449,53,61840,53,197,94,103,2,30,1,1,allow
53792,53,47522,53,224,86,138,2,30,1,1,allow
55454,53,16777,53,168,78,90,2,30,1,1,allow
53791,53,53567,53,260,86,174,2,30,1,1,allow
56739,443,56739,443,94524,4465,90059,126,45,56,70,allow
55692,443,55692,443,7516,1498,6018,25,79,11,14,allow
58511,53,45280,53,302,86,216,2,30,1,1,allow
49762,53,13712,53,335,142,193,2,30,1,1,allow
59763,443,40613,443,304,86,218,2,30,1,1,allow
57344,443,60771,443,3872,1641,2231,14,125,6,8,allow
51809,52528,62433,52528,70,70,0,2,8,2,0,allow
41464,443,7904,443,3978,2714,1264,24,83,13,11,allow
60318,123,6592,123,184,94,90,2,30,1,1,allow
45937,53,13210,53,241,78,163,2,30,1,1,allow
43382,53,39674,53,86,86,0,1,30,1,0,allow
40151,443,46330,443,80789,5008,75781,92,128,33,59,allow
52239,443,55922,443,6564,3283,3281,19,140,10,9,allow
60308,443,63284,443,2622412,144918,2477494,3052,316,1078,1974,allow
15503,36501,26789,36501,323,150,173,2,1201,1,1,allow
37635,443,29591,443,4266,1768,2498,18,121,8,10,allow
63798,16357,18681,16357,66,66,0,2,8,2,0,allow
58616,80,39662,80,1056,682,374,10,15,6,4,allow
49720,443,3612,443,180777,5704,175073,204,105,67,137,allow
64989,53,60666,53,214,102,112,2,30,1,1,allow
53789,53,10128,53,167,78,89,2,30,1,1,allow
45237,53,45237,53,235,90,145,2,33,1,1,allow
61075,53,61075,53,244,98,146,2,32,1,1,allow
63795,52376,47084,52376,66,66,0,2,8,2,0,allow
51787,35661,9669,35661,70,70,0,1,5,1,0,allow
53442,443,20405,443,10500,2835,7665,34,114,14,20,allow
49914,53,31140,53,215,86,129,2,30,1,1,allow
49863,53,59500,53,200,86,114,2,30,1,1,allow
59755,443,15018,443,448,166,282,2,30,1,1,allow
14697,8000,26641,8000,212,150,62,2,31,1,1,allow
64180,53,33989,53,296,91,205,4,55,2,2,allow
63796,60557,39305,60557,66,66,0,2,8,2,0,allow
64858,53,1882,53,227,102,125,2,30,1,1,allow
64468,53,38719,53,259,118,141,2,30,1,1,allow
53660,445,0,0,70,70,0,1,0,1,0,drop
54038,445,0,0,66,66,0,1,0,1,0,drop
58624,445,0,0,70,70,0,1,0,1,0,drop
53659,445,0,0,70,70,0,1,0,1,0,drop
35749,18375,0,0,146,146,0,1,0,1,0,deny
58811,53976,0,0,66,66,0,1,0,1,0,deny
54035,445,0,0,66,66,0,1,0,1,0,drop
21420,44847,0,0,66,66,0,1,0,1,0,deny
27642,23,0,0,60,60,0,1,0,1,0,deny
58562,57587,0,0,66,66,0,1,0,1,0,deny
54029,445,0,0,66,66,0,1,0,1,0,drop
53654,445,0,0,70,70,0,1,0,1,0,drop
7749,36237,0,0,66,66,0,1,0,1,0,deny
52095,56079,0,0,66,66,0,1,0,1,0,deny
49982,37965,0,0,66,66,0,1,0,1,0,deny
54021,445,0,0,66,66,0,1,0,1,0,drop
34234,993,0,0,60,60,0,1,0,1,0,deny
34233,993,0,0,60,60,0,1,0,1,0,deny
52860,9694,0,0,62,62,0,1,0,1,0,deny
49950,23,0,0,60,60,0,1,0,1,0,deny
51244,42416,0,0,100,100,0,1,0,1,0,deny
50254,44847,0,0,66,66,0,1,0,1,0,deny
33453,64147,0,0,62,62,0,1,0,1,0,deny
33305,54532,0,0,60,60,0,1,0,1,0,deny
50280,57470,0,0,78,78,0,1,0,1,0,deny
18415,37965,0,0,62,62,0,1,0,1,0,deny
56173,37807,0,0,66,66,0,1,0,1,0,deny
5774,37965,0,0,66,66,0,1,0,1,0,deny
57500,37965,0,0,62,62,0,1,0,1,0,deny
65203,30188,0,0,66,66,0,1,0,1,0,deny
53476,5900,0,0,60,60,0,1,0,1,0,deny
52459,5555,0,0,60,60,0,1,0,1,0,deny
58609,445,0,0,70,70,0,1,0,1,0,drop
58606,445,0,0,70,70,0,1,0,1,0,drop
58605,445,0,0,70,70,0,1,0,1,0,drop
59592,37965,0,0,62,62,0,1,0,1,0,deny
53406,50584,0,0,66,66,0,1,0,1,0,deny
20004,48817,0,0,146,146,0,1,0,1,0,deny
54013,445,0,0,66,66,0,1,0,1,0,drop
54011,445,0,0,66,66,0,1,0,1,0,drop
54012,445,0,0,66,66,0,1,0,1,0,drop
54010,445,0,0,66,66,0,1,0,1,0,drop
54009,445,0,0,66,66,0,1,0,1,0,drop
54007,445,0,0,66,66,0,1,0,1,0,drop
54006,445,0,0,66,66,0,1,0,1,0,drop
54005,445,0,0,66,66,0,1,0,1,0,drop
22583,9822,0,0,62,62,0,1,0,1,0,deny
53641,445,0,0,70,70,0,1,0,1,0,drop
8999,52290,0,0,146,146,0,1,0,1,0,deny
53469,44847,0,0,62,62,0,1,0,1,0,deny
51244,50432,0,0,100,100,0,1,0,1,0,deny
10822,48817,0,0,140,140,0,1,0,1,0,deny
53638,445,0,0,70,70,0,1,0,1,0,drop
6712,5632,0,0,60,60,0,1,0,1,0,deny
54703,23,0,0,60,60,0,1,0,1,0,deny
55600,22,0,0,60,60,0,1,0,1,0,deny
20939,60461,0,0,60,60,0,1,0,1,0,deny
52361,23718,0,0,66,66,0,1,0,1,0,deny
58602,445,0,0,70,70,0,1,0,1,0,drop
58596,445,0,0,70,70,0,1,0,1,0,drop
58594,445,0,0,70,70,0,1,0,1,0,drop
1054,15503,0,0,62,62,0,1,0,1,0,deny
20939,60461,0,0,60,60,0,1,0,1,0,deny
53634,445,0,0,70,70,0,1,0,1,0,drop
53990,445,0,0,66,66,0,1,0,1,0,drop
53992,445,0,0,66,66,0,1,0,1,0,drop
53991,445,0,0,66,66,0,1,0,1,0,drop
19999,30170,0,0,145,145,0,1,0,1,0,deny
53632,445,0,0,70,70,0,1,0,1,0,drop
24812,44847,0,0,146,146,0,1,0,1,0,deny
12608,21247,0,0,66,66,0,1,0,1,0,deny
58587,445,0,0,70,70,0,1,0,1,0,drop
53630,445,0,0,70,70,0,1,0,1,0,drop
64339,18375,0,0,66,66,0,1,0,1,0,deny
30046,15503,0,0,62,62,0,1,0,1,0,deny
58585,445,0,0,70,70,0,1,0,1,0,drop
9377,56205,0,0,66,66,0,1,0,1,0,deny
6886,55839,0,0,139,139,0,1,0,1,0,deny
58576,445,0,0,70,70,0,1,0,1,0,drop
58575,445,0,0,70,70,0,1,0,1,0,drop
58574,445,0,0,70,70,0,1,0,1,0,drop
29424,37807,0,0,62,62,0,1,0,1,0,deny
52217,22114,0,0,66,66,0,1,0,1,0,deny
59790,44847,0,0,66,66,0,1,0,1,0,deny
37589,443,25099,443,499,425,74,4,0,3,1,allow
37590,443,21881,443,499,425,74,4,0,3,1,allow
37592,443,5868,443,499,425,74,4,0,3,1,allow
37588,443,34121,443,499,425,74,4,0,3,1,allow
37591,443,50251,443,499,425,74,4,0,3,1,allow
37585,443,50718,443,499,425,74,4,2,3,1,allow
53178,26467,0,0,62,62,0,1,0,1,0,deny
53623,445,0,0,70,70,0,1,0,1,0,drop
37902,23718,0,0,62,62,0,1,0,1,0,deny
63542,15503,0,0,66,66,0,1,0,1,0,deny
21833,22114,0,0,62,62,0,1,0,1,0,deny
53621,445,0,0,70,70,0,1,0,1,0,drop
53620,445,0,0,70,70,0,1,0,1,0,drop
58568,445,0,0,70,70,0,1,0,1,0,drop
58566,445,0,0,70,70,0,1,0,1,0,drop
58562,445,0,0,70,70,0,1,0,1,0,drop
53619,445,0,0,70,70,0,1,0,1,0,drop
53618,445,0,0,70,70,0,1,0,1,0,drop
53616,445,0,0,70,70,0,1,0,1,0,drop
53614,445,0,0,70,70,0,1,0,1,0,drop
63772,35440,0,0,66,66,0,1,0,1,0,deny
51920,30188,0,0,66,66,0,1,0,1,0,deny
64877,37450,0,0,66,66,0,1,0,1,0,deny
58721,51505,0,0,66,66,0,1,0,1,0,deny
53810,23,0,0,60,60,0,1,0,1,0,deny
53600,445,0,0,70,70,0,1,0,1,0,drop
53599,445,0,0,70,70,0,1,0,1,0,drop
53594,445,0,0,70,70,0,1,0,1,0,drop
53590,445,0,0,70,70,0,1,0,1,0,drop
53589,445,0,0,70,70,0,1,0,1,0,drop
2425,23117,0,0,66,66,0,1,0,1,0,deny
53968,445,0,0,66,66,0,1,0,1,0,drop
58558,445,0,0,70,70,0,1,0,1,0,drop
58559,445,0,0,70,70,0,1,0,1,0,drop
26494,26467,0,0,62,62,0,1,0,1,0,deny
49805,64147,0,0,66,66,0,1,0,1,0,deny
0,0,0,0,320,320,0,5,0,5,0,allow
52643,36237,0,0,66,66,0,1,0,1,0,deny
53578,445,0,0,70,70,0,1,0,1,0,drop
53963,445,0,0,66,66,0,1,0,1,0,drop
52111,44847,0,0,66,66,0,1,0,1,0,deny
13581,51505,0,0,66,66,0,1,0,1,0,deny
53961,445,0,0,66,66,0,1,0,1,0,drop
58549,445,0,0,70,70,0,1,0,1,0,drop
11983,57470,0,0,62,62,0,1,0,1,0,deny
58541,445,0,0,70,70,0,1,0,1,0,drop
58542,445,0,0,70,70,0,1,0,1,0,drop
58536,445,0,0,70,70,0,1,0,1,0,drop
2697,28189,0,0,60,60,0,1,0,1,0,deny
53959,445,0,0,66,66,0,1,0,1,0,drop
5283,56205,0,0,146,146,0,1,0,1,0,deny
53573,445,0,0,70,70,0,1,0,1,0,drop
52743,15503,0,0,66,66,0,1,0,1,0,deny
58533,445,0,0,70,70,0,1,0,1,0,drop
58530,445,0,0,70,70,0,1,0,1,0,drop
58526,445,0,0,70,70,0,1,0,1,0,drop
58528,445,0,0,70,70,0,1,0,1,0,drop
53563,445,0,0,70,70,0,1,0,1,0,drop
53564,445,0,0,70,70,0,1,0,1,0,drop
53951,445,0,0,66,66,0,1,0,1,0,drop
53562,445,0,0,70,70,0,1,0,1,0,drop
53559,445,0,0,70,70,0,1,0,1,0,drop
53557,445,0,0,70,70,0,1,0,1,0,drop
53948,445,0,0,66,66,0,1,0,1,0,drop
53949,445,0,0,66,66,0,1,0,1,0,drop
53947,445,0,0,66,66,0,1,0,1,0,drop
52177,25320,0,0,66,66,0,1,0,1,0,deny
53942,445,0,0,66,66,0,1,0,1,0,drop
53940,445,0,0,66,66,0,1,0,1,0,drop
53939,445,0,0,66,66,0,1,0,1,0,drop
52339,26467,0,0,66,66,0,1,0,1,0,deny
61420,64097,0,0,62,62,0,1,0,1,0,deny
7992,64147,0,0,62,62,0,1,0,1,0,deny
6037,43890,0,0,74,74,0,1,0,1,0,deny
55201,22114,0,0,66,66,0,1,0,1,0,deny
34553,48637,0,0,60,60,0,1,0,1,0,deny
58524,445,0,0,70,70,0,1,0,1,0,drop
58521,445,0,0,70,70,0,1,0,1,0,drop
54862,19000,22196,19000,476,216,260,2,30,1,1,allow
53116,32014,29630,32014,698,320,378,10,17,6,4,allow
42310,443,52115,443,6673,2151,4522,27,125,13,14,allow
27005,27018,58513,27018,888,126,762,2,30,1,1,allow
49721,443,34964,443,65732,3951,61781,102,65,40,62,allow
56809,40641,18349,40641,70,70,0,1,5,1,0,allow
53708,80,59470,80,2434,516,1918,12,76,6,6,allow
10039,443,49424,443,12579,1722,10857,29,171,12,17,allow
49727,443,37710,443,5037,1135,3902,16,18,9,7,allow
20378,53,20378,53,235,90,145,2,32,1,1,allow
59404,53,59404,53,237,91,146,2,32,1,1,allow
51806,49530,21191,49530,70,70,0,2,8,2,0,allow
31132,53,31132,53,227,89,138,2,30,1,1,allow
27005,27020,41783,27020,898,126,772,2,30,1,1,allow
15733,3389,15733,3389,3910,1805,2105,20,19,12,8,allow
62731,443,8633,443,27905,17646,10259,131,308,73,58,allow
49725,443,10242,443,311104,8270,302834,336,18,99,237,allow
58356,443,14561,443,10817,2611,8206,44,135,21,23,allow
49726,443,20489,443,5393,1263,4130,21,18,11,10,allow
63797,47784,12377,47784,66,66,0,2,8,2,0,allow
53010,80,53010,80,210304,4398,205906,225,21,65,160,allow
60888,443,18783,443,7454,3131,4323,23,46,13,10,allow
63799,13835,2064,13835,66,66,0,2,8,2,0,allow
56785,28902,26302,28902,66,66,0,1,5,1,0,allow
59754,53,13358,53,303,85,218,2,30,1,1,allow
45918,443,28786,443,12351,7584,4767,38,48,22,16,allow
49728,443,36312,443,5037,1135,3902,16,18,9,7,allow
10006,80,62598,80,1142,636,506,10,45,6,4,allow
15420,53,15420,53,237,91,146,2,32,1,1,allow
49722,443,49212,443,28376,3058,25318,42,63,17,25,allow
59457,53,59457,53,213,87,126,2,30,1,1,allow
50367,53,22257,53,578,286,292,9,15,5,4,allow
54051,53,54051,53,617,67,550,2,30,1,1,allow
59753,443,43725,443,303,85,218,2,30,1,1,allow
59993,443,5215,443,6452,2146,4306,30,125,14,16,allow
54991,443,64659,443,15109,5866,9243,71,362,29,42,allow
64842,443,46917,443,5467,2738,2729,23,137,11,12,allow
54137,443,48423,443,2573,330,2243,12,136,5,7,allow
58519,445,0,0,70,70,0,1,0,1,0,drop
53937,445,0,0,66,66,0,1,0,1,0,drop
53676,35974,0,0,60,60,0,1,0,1,0,deny
34677,51185,0,0,60,60,0,1,0,1,0,deny
58517,445,0,0,70,70,0,1,0,1,0,drop
49805,6881,0,0,62,62,0,1,0,1,0,deny
53551,445,0,0,70,70,0,1,0,1,0,drop
53933,445,0,0,66,66,0,1,0,1,0,drop
44594,64147,0,0,66,66,0,1,0,1,0,deny
30114,65151,0,0,60,60,0,1,0,1,0,deny
53931,445,0,0,66,66,0,1,0,1,0,drop
53930,445,0,0,66,66,0,1,0,1,0,drop
54575,11392,0,0,66,66,0,1,0,1,0,deny
56986,2310,0,0,159,159,0,1,0,1,0,deny
18950,50584,0,0,62,62,0,1,0,1,0,deny
53928,445,0,0,66,66,0,1,0,1,0,drop
46906,25604,0,0,100,100,0,1,0,1,0,deny
62414,50584,0,0,66,66,0,1,0,1,0,deny
50305,443,65523,443,7725,2029,5696,23,136,13,10,allow
59060,443,38409,443,16775,1879,14896,36,16,17,19,allow
53716,443,47470,443,70,70,0,2,8,2,0,allow
53544,445,0,0,70,70,0,1,0,1,0,drop
53543,445,0,0,70,70,0,1,0,1,0,deny
45908,33330,0,0,60,60,0,1,0,1,0,deny
58510,445,0,0,70,70,0,1,0,1,0,drop
6886,45378,0,0,139,139,0,1,0,1,0,deny
47700,51505,0,0,66,66,0,1,0,1,0,deny
58507,445,0,0,70,70,0,1,0,1,0,drop
58505,445,0,0,70,70,0,1,0,1,0,drop
53538,445,0,0,70,70,0,1,0,1,0,drop
53536,445,0,0,70,70,0,1,0,1,0,drop
53917,445,0,0,66,66,0,1,0,1,0,drop
65115,50584,0,0,66,66,0,1,0,1,0,deny
51682,443,60633,443,5060,2867,2193,26,398,9,17,allow
27005,27017,13207,27017,890,126,764,2,30,1,1,allow
41466,443,58480,443,3356,2158,1198,21,82,11,10,allow
51807,10920,47874,10920,70,70,0,2,8,2,0,allow
56624,53,53106,53,259,118,141,2,29,1,1,allow
49729,443,33717,443,8322,2585,5737,23,16,12,11,allow
65516,53,35992,53,305,89,216,4,41,2,2,allow
49723,443,17483,443,11181,3795,7386,50,20,23,27,allow
61352,443,38180,443,14131,5620,8511,38,216,20,18,allow
46287,443,19273,443,7071,2628,4443,32,23,16,16,allow
49185,53,26156,53,307,94,213,2,29,1,1,allow
64305,53,21382,53,598,196,402,6,71,3,3,allow
50015,53,57649,53,287,94,193,2,29,1,1,allow
59749,443,34617,443,304,86,218,2,29,1,1,allow
31630,53,31630,53,220,90,130,2,30,1,1,allow
49483,53,5607,53,273,94,179,2,30,1,1,allow
59750,53,24886,53,304,86,218,2,29,1,1,allow
51491,443,61886,443,343,163,180,6,15,3,3,allow
52663,443,53022,443,4416,1702,2714,19,126,9,10,allow
49571,443,40326,443,12258,5621,6637,52,286,25,27,allow
50260,53,44495,53,168,86,82,2,30,1,1,allow
53034,53,25305,53,238,94,144,2,30,1,1,allow
41458,443,29775,443,13059,5161,7898,34,84,19,15,allow
56804,33375,39167,33375,70,70,0,2,8,2,0,allow
56735,80,56735,80,2243,1548,695,11,46,7,4,allow
27005,27017,24115,27017,880,126,754,2,30,1,1,allow
12346,53,12346,53,216,98,118,2,30,1,1,allow
41462,443,16265,443,3467,2269,1198,21,82,11,10,allow
60911,53,60911,53,216,90,126,2,30,1,1,allow
49370,53,35451,53,430,85,345,4,54,2,2,allow
49300,53,25911,53,232,86,146,2,30,1,1,allow
27005,27016,26608,27016,880,126,754,2,30,1,1,allow
49192,53,8580,53,212,102,110,2,30,1,1,allow
60412,12965,23315,12965,70,70,0,2,8,2,0,allow
37644,443,35046,443,3886,2516,1370,22,95,12,10,allow
53120,49860,38739,49860,70,70,0,2,8,2,0,allow
57426,66,14765,66,70,70,0,2,8,2,0,allow
60411,58131,51349,58131,70,70,0,2,8,2,0,allow
55434,53,55434,53,198,90,108,2,30,1,1,allow
59859,53,1491,53,218,86,132,2,30,1,1,allow
55514,53,24000,53,216,94,122,2,30,1,1,allow
33534,443,30363,443,4640,1416,3224,18,121,9,9,allow
48018,443,52238,443,1429,1295,134,10,29,8,2,allow
38631,443,46548,443,6231,1151,5080,23,109,13,10,allow
51492,80,15284,80,1517,481,1036,11,15,6,5,allow
49719,443,56556,443,560073,155518,404555,923,110,411,512,allow
60358,443,56425,443,17547,2695,14852,30,76,14,16,allow
38630,443,20829,443,9277,3025,6252,32,109,17,15,allow
49665,53,62694,53,289,99,190,4,35,2,2,allow
53598,40326,59380,40326,70,70,0,1,4,1,0,allow
51788,35787,25759,35787,70,70,0,1,4,1,0,allow
53582,40872,7897,40872,492,306,186,8,16,5,3,allow
52703,443,1986,443,7843,2397,5446,23,256,12,11,allow
51411,443,26944,443,509,329,180,6,8,3,3,allow
56619,80,59686,80,234,234,0,4,12,4,0,allow
59760,53,48696,53,384,166,218,2,29,1,1,allow
59758,443,28743,443,384,166,218,2,29,1,1,allow
35738,80,42244,80,1151,711,440,10,16,5,5,allow
53790,53,7041,53,167,78,89,2,29,1,1,allow
50213,80,50213,80,1723391,21750,1701641,1450,16,326,1124,allow
49917,443,38114,443,7645,2967,4678,23,15,13,10,allow
53707,443,35739,443,7272,930,6342,19,75,9,10,allow
51694,80,56366,80,1307,649,658,8,75,5,3,allow
59748,53,27175,53,304,86,218,2,29,1,1,allow
65116,53,7436,53,220,94,126,2,29,1,1,allow
59759,53,55695,53,384,166,218,2,29,1,1,allow
59757,443,52007,443,384,166,218,2,29,1,1,allow
64065,53,29677,53,270,94,176,2,30,1,1,allow
59756,53,64652,53,571,166,405,2,29,1,1,allow
50877,443,13364,443,7984,2447,5537,41,2904,24,17,allow
27005,27035,7636,27035,891,126,765,2,30,1,1,allow
57326,443,3757,443,64382,9305,55077,101,123,41,60,allow
59747,443,7939,443,304,86,218,2,29,1,1,allow
63951,443,17963,443,6718,3582,3136,18,126,10,8,allow
57812,7635,57812,7635,138,78,60,3,6,2,1,allow
41460,443,23165,443,13890,5926,7964,36,84,20,16,allow
45658,443,10440,443,5359,3152,2207,51,2901,28,23,allow
50260,53,50381,53,196,86,110,2,30,1,1,allow
27005,27016,11664,27016,902,126,776,2,30,1,1,allow
64303,443,22839,443,3205,781,2424,17,135,8,9,allow
49985,443,2510,443,10737,3664,7073,20,137,10,10,allow
51413,443,55199,443,695,575,120,4,6,2,2,allow
58166,53,23423,53,224,94,130,2,30,1,1,allow
63950,443,48115,443,5844,2360,3484,25,127,12,13,allow
26791,443,23053,443,21391,16334,5057,38,20,21,17,allow
45567,443,10380,443,1473,988,485,12,25,7,5,allow
49791,53,7553,53,216,94,122,2,30,1,1,allow
64952,53,2309,53,232,94,138,2,30,1,1,allow
62061,53,49325,53,181,78,103,2,30,1,1,allow
49612,53,33123,53,234,94,140,2,31,1,1,allow
34758,5228,2453,5228,10206,2218,7988,36,4265,18,18,allow
50973,443,10208,443,9525,6135,3390,24,120,13,11,allow
51438,443,45079,443,42419,28515,13904,108,246,53,55,allow
64668,53,24152,53,211,102,109,2,30,1,1,allow
44691,53,43758,53,199,94,105,2,30,1,1,allow
1528,53,1528,53,193,90,103,2,30,1,1,allow
63679,443,51267,443,7987,2092,5895,18,119,8,10,allow
47673,443,27427,443,10372,4341,6031,28,319,15,13,allow
29744,53,29744,53,235,90,145,2,33,1,1,allow
57602,80,57602,80,4226,2910,1316,19,38,10,9,allow
64990,53,21080,53,323,94,229,2,30,1,1,allow
65372,53,52621,53,330,91,239,4,44,2,2,allow
54983,443,42126,443,865636,22536,843100,903,50,309,594,allow
36010,443,44715,443,5689,1505,4184,24,19,13,11,allow
55188,443,45668,443,6649,1556,5093,23,24,13,10,allow
57464,80,18705,80,78,78,0,1,5,1,0,allow
49898,443,53027,443,44110,4769,39341,90,108,46,44,allow
51072,80,39928,80,1299,793,506,12,16,6,6,allow
53532,445,0,0,70,70,0,1,0,1,0,drop
1030,44847,0,0,62,62,0,1,0,1,0,deny
46679,64147,0,0,62,62,0,1,0,1,0,deny
48676,53398,0,0,60,60,0,1,0,1,0,deny
62152,56205,0,0,66,66,0,1,0,1,0,deny
55032,62413,0,0,66,66,0,1,0,1,0,deny
53910,445,0,0,66,66,0,1,0,1,0,drop
16697,64147,0,0,145,145,0,1,0,1,0,deny
12537,28816,0,0,145,145,0,1,0,1,0,deny
53531,445,0,0,70,70,0,1,0,1,0,drop
58495,445,0,0,70,70,0,1,0,1,0,drop
22724,9822,0,0,62,62,0,1,0,1,0,deny
34897,50584,0,0,62,62,0,1,0,1,0,deny
22683,39210,0,0,60,60,0,1,0,1,0,deny
50280,57470,0,0,78,78,0,1,0,1,0,deny
53907,445,0,0,66,66,0,1,0,1,0,drop
1866,51505,0,0,66,66,0,1,0,1,0,deny
57676,64147,0,0,74,74,0,1,0,1,0,deny
53526,445,0,0,70,70,0,1,0,1,0,drop
62337,44847,0,0,66,66,0,1,0,1,0,deny
53901,445,0,0,66,66,0,1,0,1,0,drop
61912,17546,0,0,62,62,0,1,0,1,0,deny
50369,50584,0,0,66,66,0,1,0,1,0,deny
53897,445,0,0,66,66,0,1,0,1,0,drop
63263,57470,0,0,66,66,0,1,0,1,0,deny
1024,57470,0,0,62,62,0,1,0,1,0,deny
443,11266,0,0,124,124,0,1,0,1,0,deny
37008,42707,0,0,62,62,0,1,0,1,0,deny
51909,6881,0,0,66,66,0,1,0,1,0,deny
57289,31573,0,0,66,66,0,1,0,1,0,deny
40500,5618,0,0,146,146,0,1,0,1,0,reset-both
53513,445,0,0,70,70,0,1,0,1,0,drop
58481,445,0,0,70,70,0,1,0,1,0,drop
58477,445,0,0,70,70,0,1,0,1,0,drop
58478,445,0,0,70,70,0,1,0,1,0,drop
50360,35440,0,0,66,66,0,1,0,1,0,deny
53881,445,0,0,66,66,0,1,0,1,0,drop
53884,445,0,0,66,66,0,1,0,1,0,drop
53878,445,0,0,66,66,0,1,0,1,0,drop
53880,445,0,0,66,66,0,1,0,1,0,drop
53882,445,0,0,66,66,0,1,0,1,0,drop
53883,445,0,0,66,66,0,1,0,1,0,drop
53877,445,0,0,66,66,0,1,0,1,0,drop
53879,445,0,0,66,66,0,1,0,1,0,drop
5729,22114,0,0,66,66,0,1,0,1,0,deny
14070,62413,0,0,66,66,0,1,0,1,0,deny
53510,445,0,0,70,70,0,1,0,1,0,drop
17643,50584,0,0,146,146,0,1,0,1,0,deny
58470,445,0,0,70,70,0,1,0,1,0,drop
58468,445,0,0,70,70,0,1,0,1,0,drop
58464,445,0,0,70,70,0,1,0,1,0,drop
53505,445,0,0,70,70,0,1,0,1,0,drop
21534,42246,0,0,66,66,0,1,0,1,0,deny
53504,445,0,0,70,70,0,1,0,1,0,drop
28124,8497,0,0,148,148,0,1,0,1,0,deny
53864,445,0,0,66,66,0,1,0,1,0,drop
53865,445,0,0,66,66,0,1,0,1,0,drop
53862,445,0,0,66,66,0,1,0,1,0,drop
30109,5223,0,0,148,148,0,1,0,1,0,deny
53502,445,0,0,70,70,0,1,0,1,0,drop
443,48120,0,0,97,97,0,1,0,1,0,deny
5223,44091,0,0,220,220,0,1,0,1,0,deny
53105,42707,0,0,66,66,0,1,0,1,0,deny
6712,161,0,0,82,82,0,1,0,1,0,deny
58459,445,0,0,70,70,0,1,0,1,0,drop
80,5101,0,0,78,78,0,1,0,1,0,deny
45410,1,0,0,62,62,0,1,0,1,0,deny
58457,445,0,0,70,70,0,1,0,1,0,drop
49485,11392,0,0,66,66,0,1,0,1,0,deny
58447,445,0,0,70,70,0,1,0,1,0,drop
58449,445,0,0,70,70,0,1,0,1,0,drop
58445,445,0,0,70,70,0,1,0,1,0,drop
64379,37965,0,0,66,66,0,1,0,1,0,deny
45060,37965,0,0,62,62,0,1,0,1,0,deny
53495,445,0,0,70,70,0,1,0,1,0,drop
27446,30188,0,0,66,66,0,1,0,1,0,deny
53493,445,0,0,70,70,0,1,0,1,0,drop
28221,37965,0,0,62,62,0,1,0,1,0,deny
58681,36829,0,0,74,74,0,1,0,1,0,deny
63998,21247,0,0,66,66,0,1,0,1,0,deny
53779,37965,0,0,66,66,0,1,0,1,0,deny
40959,61903,0,0,145,145,0,1,0,1,0,deny
53492,445,0,0,70,70,0,1,0,1,0,drop
53491,445,0,0,70,70,0,1,0,1,0,drop
53490,445,0,0,70,70,0,1,0,1,0,drop
53487,445,0,0,70,70,0,1,0,1,0,drop
53488,445,0,0,70,70,0,1,0,1,0,drop
1660,8696,0,0,62,62,0,1,0,1,0,deny
56946,1,0,0,66,66,0,1,0,1,0,deny
28345,11392,0,0,66,66,0,1,0,1,0,deny
58440,445,0,0,70,70,0,1,0,1,0,drop
58438,445,0,0,70,70,0,1,0,1,0,drop
58435,445,0,0,70,70,0,1,0,1,0,drop
13285,29892,0,0,145,145,0,1,0,1,0,deny
29021,23,0,0,60,60,0,1,0,1,0,deny
57131,7774,0,0,145,145,0,1,0,1,0,deny
1092,57470,0,0,145,145,0,1,0,1,0,deny
14352,8055,0,0,148,148,0,1,0,1,0,deny
53472,445,0,0,70,70,0,1,0,1,0,drop
53470,445,0,0,70,70,0,1,0,1,0,drop
53466,445,0,0,70,70,0,1,0,1,0,drop
57982,64147,0,0,66,66,0,1,0,1,0,deny
53462,445,0,0,70,70,0,1,0,1,0,drop
53461,445,0,0,70,70,0,1,0,1,0,drop
65153,38303,0,0,62,62,0,1,0,1,0,deny
16330,50584,0,0,146,146,0,1,0,1,0,deny
57431,15503,0,0,66,66,0,1,0,1,0,deny
2697,28189,0,0,60,60,0,1,0,1,0,deny
43129,15503,0,0,62,62,0,1,0,1,0,deny
53841,445,0,0,66,66,0,1,0,1,0,drop
58432,445,0,0,70,70,0,1,0,1,0,drop
58430,445,0,0,70,70,0,1,0,1,0,drop
54188,6004,0,0,78,78,0,1,0,1,0,deny
60627,51050,0,0,66,66,0,1,0,1,0,deny
443,64347,0,0,131,131,0,1,0,1,0,deny
59136,50584,0,0,62,62,0,1,0,1,0,deny
53450,445,0,0,70,70,0,1,0,1,0,drop
13441,57470,0,0,62,62,0,1,0,1,0,deny
12471,48817,0,0,62,62,0,1,0,1,0,deny
61736,50584,0,0,66,66,0,1,0,1,0,deny
53835,445,0,0,66,66,0,1,0,1,0,drop
50227,57470,0,0,66,66,0,1,0,1,0,deny
10115,52700,0,0,62,62,0,1,0,1,0,deny
19875,30170,0,0,145,145,0,1,0,1,0,deny
53833,445,0,0,66,66,0,1,0,1,0,drop
42732,57470,0,0,62,62,0,1,0,1,0,deny
58419,445,0,0,70,70,0,1,0,1,0,drop
26528,51221,0,0,78,78,0,1,0,1,0,deny
58416,445,0,0,70,70,0,1,0,1,0,drop
58409,445,0,0,70,70,0,1,0,1,0,drop
58411,445,0,0,70,70,0,1,0,1,0,drop
57545,35440,0,0,66,66,0,1,0,1,0,deny
53829,445,0,0,66,66,0,1,0,1,0,drop
46495,4607,0,0,60,60,0,1,0,1,0,deny
53446,445,0,0,70,70,0,1,0,1,0,drop
10079,443,27678,443,7122,1766,5356,27,331,14,13,allow
59486,80,62432,80,2633,1151,1482,10,32,6,4,allow
47423,80,58553,80,1056,682,374,10,15,6,4,allow
40765,443,6306,443,1093,662,431,10,41,6,4,allow
58446,443,26245,443,111535,9830,101705,141,192,62,79,allow
52405,443,59113,443,10506,2063,8443,31,46,17,14,allow
59082,443,59082,443,6264,1435,4829,21,15,11,10,allow
51803,33973,12809,33973,70,70,0,2,8,2,0,allow
51519,443,51519,443,8680,2323,6357,31,173,13,18,allow
51516,443,51516,443,143921,6996,136925,152,174,42,110,allow
35078,53,22216,53,198,93,105,2,30,1,1,allow
38334,443,30322,443,1864,250,1614,8,121,4,4,allow
27005,27016,44876,27016,887,126,761,2,30,1,1,allow
2946,53,2946,53,240,96,144,2,30,1,1,allow
58151,443,48543,443,6563,1656,4907,22,318,13,9,allow
41597,53,41597,53,213,79,134,2,32,1,1,allow
44933,443,37036,443,8958,1683,7275,24,23,10,14,allow
40766,443,50985,443,1093,662,431,10,41,6,4,allow
61667,80,57155,80,21567,1666,19901,35,46,18,17,allow
5631,80,5631,80,16287,756,15531,23,16,9,14,allow
37661,53,37661,53,237,91,146,2,32,1,1,allow
12934,53,12934,53,237,91,146,2,33,1,1,allow
46785,53,46785,53,230,91,139,2,30,1,1,allow
51410,443,38178,443,13187,6736,6451,22,55,12,10,allow
49914,443,10717,443,10915,2554,8361,33,270,17,16,allow
27005,27019,28419,27019,880,126,754,2,30,1,1,allow
52108,443,27930,443,18735,3452,15283,42,52,22,20,allow
53615,867,16773,867,70,70,0,2,7,2,0,allow
13749,53,13749,53,237,91,146,2,32,1,1,allow
43563,80,9467,80,10597,2910,7687,24,47,14,10,allow
45334,443,8591,443,8798,1667,7131,25,22,14,11,allow
51203,443,62126,443,5737,1829,3908,22,18,13,9,allow
53616,44166,16410,44166,70,70,0,2,7,2,0,allow
65460,80,65460,80,48356,4069,44287,55,48,19,36,allow
65315,53,36671,53,300,99,201,4,30,2,2,allow
65315,53,56097,53,216,110,106,2,30,1,1,allow
60511,443,60511,443,4658,1751,2907,19,30,11,8,allow
57605,80,57605,80,36471,5174,31297,57,38,23,34,allow
57604,80,57604,80,16101,4026,12075,35,38,16,19,allow
57601,80,57601,80,25872,4400,21472,41,38,16,25,allow
57819,443,40837,443,6161,925,5236,18,28,10,8,allow
53611,58508,47899,58508,320,140,180,6,7,3,3,allow
62820,53,62820,53,237,91,146,2,33,1,1,allow
38364,15000,10224,15000,130,70,60,2,5,1,1,allow
35481,443,52517,443,6804,1473,5331,33,258,15,18,allow
54235,443,28529,443,4665,2167,2498,23,16,12,11,allow
9786,53,9786,53,230,91,139,2,30,1,1,allow
44823,53,0,0,82,82,0,1,30,1,0,allow
56351,53,9188,53,190,97,93,2,30,1,1,allow
60750,53,24428,53,198,93,105,2,30,1,1,allow
49751,53,48975,53,232,92,140,2,30,1,1,allow
51407,443,24262,443,22626,10213,12413,35,57,20,15,allow
17295,18242,0,0,66,66,0,1,90,1,0,allow
56274,443,23756,443,3093,868,2225,10,120,5,5,allow
34756,443,27102,443,100090,8304,91786,135,127,50,85,allow
50803,443,27237,443,25297,10467,14830,51,362,27,24,allow
64609,53,57916,53,146,75,71,2,31,1,1,allow
60039,53,37317,53,312,82,230,2,31,1,1,allow
38501,53,38501,53,233,91,142,2,31,1,1,allow
50435,80,14382,80,672,70,602,11,392,2,9,allow
50706,443,45520,443,13948,10445,3503,25,121,14,11,allow
30960,45694,42221,45694,330,330,0,6,3610,6,0,allow
34910,443,51247,443,18452,11429,7023,39,64,23,16,allow
47605,443,46505,443,12572,3471,9101,34,363,14,20,allow
9849,53,9849,53,219,87,132,2,31,1,1,allow
27005,27018,47282,27018,891,126,765,2,31,1,1,allow
27005,27017,53290,27017,881,126,755,2,31,1,1,allow
37330,53,37330,53,237,91,146,2,31,1,1,allow
57470,61803,17706,61803,792,792,0,13,1200,13,0,allow
10151,55051,56267,55051,468,149,319,2,1200,1,1,allow
51582,48817,0,0,66,66,0,1,0,1,0,deny
18357,51180,0,0,62,62,0,1,0,1,0,deny
34553,48637,0,0,60,60,0,1,0,1,0,deny
59481,41182,0,0,62,62,0,1,0,1,0,deny
53436,445,0,0,70,70,0,1,0,1,0,drop
53437,445,0,0,70,70,0,1,0,1,0,drop
53676,35974,0,0,60,60,0,1,0,1,0,deny
34677,51185,0,0,60,60,0,1,0,1,0,deny
58404,445,0,0,70,70,0,1,0,1,0,drop
53431,445,0,0,70,70,0,1,0,1,0,drop
53433,445,0,0,70,70,0,1,0,1,0,drop
11133,51505,0,0,66,66,0,1,0,1,0,deny
58402,445,0,0,70,70,0,1,0,1,0,drop
58401,445,0,0,70,70,0,1,0,1,0,drop
58398,445,0,0,70,70,0,1,0,1,0,drop
60480,57470,0,0,62,62,0,1,0,1,0,deny
53429,445,0,0,70,70,0,1,0,1,0,drop
9605,57470,0,0,62,62,0,1,0,1,0,deny
53823,445,0,0,66,66,0,1,0,1,0,drop
53650,64147,0,0,66,66,0,1,0,1,0,deny
53819,445,0,0,66,66,0,1,0,1,0,drop
53818,445,0,0,66,66,0,1,0,1,0,drop
53816,445,0,0,66,66,0,1,0,1,0,drop
3578,51505,0,0,66,66,0,1,0,1,0,deny
42379,443,23086,443,6598,1506,5092,22,305,12,10,allow
27005,27015,63716,27015,889,126,763,2,30,1,1,allow
63782,6969,48433,6969,70,70,0,1,5,1,0,allow
57603,80,57603,80,4373,2985,1388,21,37,11,10,allow
53118,56839,2314,56839,70,70,0,1,4,1,0,allow
49156,53,13189,53,199,94,105,2,29,1,1,allow
65234,5228,52749,5228,4149,2263,1886,46,708,23,23,allow
63996,53,49603,53,252,102,150,2,30,1,1,allow
47046,80,21371,80,1114,534,580,12,15,7,5,allow
57906,443,24320,443,2725,1564,1161,19,124,10,9,allow
60001,443,64771,443,10580,2487,8093,28,16,16,12,allow
57908,443,7958,443,1648,1017,631,18,124,10,8,allow
49916,443,14101,443,2970,1793,1177,20,15,12,8,allow
57139,443,39822,443,2162,1317,845,16,25,9,7,allow
57907,443,20224,443,1584,953,631,17,124,9,8,allow
41508,53,41508,53,244,98,146,2,32,1,1,allow
56351,53,4846,53,195,102,93,2,32,1,1,allow
57268,443,5467,443,1617,1073,544,16,15,9,7,allow
3591,53,3591,53,235,90,145,2,32,1,1,allow
50386,443,59778,443,1346,918,428,10,26,6,4,allow
33171,443,48753,443,6509,973,5536,17,25,10,7,allow
63793,48970,37925,48970,66,66,0,2,7,2,0,allow
53596,56732,3415,56732,70,70,0,1,4,1,0,allow
15164,53,15164,53,217,82,135,2,31,1,1,allow
53619,11513,10996,11513,320,140,180,6,6,3,3,allow
63463,53,56932,53,199,86,113,2,29,1,1,allow
51786,37832,29443,37832,70,70,0,1,5,1,0,allow
49708,53,19621,53,212,94,118,2,29,1,1,allow
49340,53,43709,53,94,94,0,1,30,1,0,allow
6881,33969,15980,33969,509,150,359,2,1200,1,1,allow
27005,27015,12555,27015,887,126,761,2,30,1,1,allow
27005,27017,49070,27017,883,126,757,2,30,1,1,allow
60900,53,31593,53,181,86,95,2,30,1,1,allow
51521,443,51521,443,138679,4142,134537,141,173,33,108,allow
51518,443,51518,443,15967,3046,12921,39,173,15,24,allow
60403,60092,40292,60092,70,70,0,1,5,1,0,allow
38759,443,24886,443,7878,1531,6347,36,257,16,20,allow
54984,443,11572,443,68519,3801,64718,93,31,40,53,allow
54979,443,32141,443,643217,29500,613717,787,53,338,449,allow
53788,53,27955,53,213,78,135,2,30,1,1,allow
61167,443,24525,443,27000,11646,15354,176,640,82,94,allow
27005,52013,16949,52013,901,126,775,2,30,1,1,allow
55921,443,55921,443,4510,1603,2907,19,27,11,8,allow
27005,27015,11118,27015,881,126,755,2,30,1,1,allow
38119,443,46487,443,1820,1101,719,18,16,10,8,allow
57253,443,15843,443,8613,2377,6236,41,17,23,18,allow
55826,53,63992,53,168,86,82,2,30,1,1,allow
6754,443,21695,443,13520,2288,11232,43,192,19,24,allow
51520,443,51520,443,53075,3609,49466,74,173,25,49,allow
64872,53,23783,53,323,94,229,2,30,1,1,allow
49915,443,34488,443,7648,2967,4681,23,15,13,10,allow
51573,53,28199,53,212,86,126,2,30,1,1,allow
27005,27018,42119,27018,881,126,755,2,30,1,1,allow
27005,27015,38522,27015,878,126,752,2,30,1,1,allow
2745,53,2745,53,244,98,146,2,32,1,1,allow
58610,53,58610,53,244,98,146,2,32,1,1,allow
56708,443,38081,443,9634,3110,6524,26,138,11,15,allow
40799,443,51690,443,21024,14637,6387,46,271,26,20,allow
63230,443,3094,443,1309,670,639,16,127,9,7,allow
51804,31012,6657,31012,70,70,0,2,8,2,0,allow
55616,42929,13566,42929,70,70,0,1,5,1,0,allow
61347,443,30207,443,5589,2260,3329,36,217,17,19,allow
45455,443,59423,443,17237,2632,14605,34,420,18,16,allow
63224,443,7611,443,1373,734,639,17,155,10,7,allow
57807,80,6054,80,1013,566,447,8,162,5,3,allow
57421,80,60577,80,4507,2978,1529,13,15,6,7,allow
50017,80,11643,80,827,687,140,6,32,4,2,allow
53586,44515,38182,44515,678,432,246,10,15,6,4,allow
36762,443,46444,443,560,280,280,9,25,5,4,allow
53592,23578,9676,23578,70,70,0,1,4,1,0,allow
51805,15298,11456,15298,70,70,0,2,8,2,0,allow
57606,80,57606,80,11536,3264,8272,29,37,15,14,allow
57909,443,27742,443,2653,1558,1095,18,124,10,8,allow
57590,443,26107,443,2614,1689,925,18,19,10,8,allow
49324,443,52610,443,6147,943,5204,17,16,9,8,allow
5588,5588,0,0,3354,1792,1562,46,194,23,23,allow
38285,443,16953,443,6872,1815,5057,22,318,13,9,allow
49377,443,17002,443,11627,4670,6957,37,155,16,21,allow
62049,443,63135,443,9526,1375,8151,24,125,12,12,allow
65043,53,7870,53,213,94,119,2,29,1,1,allow
44125,5222,56837,5222,6329,3447,2882,67,841,34,33,allow
60229,443,63035,443,8297,1280,7017,15,135,7,8,allow
57343,53,10133,53,214,86,128,2,29,1,1,allow
61879,53,34841,53,207,86,121,2,29,1,1,allow
65219,53,25255,53,229,102,127,2,29,1,1,allow
27005,27015,11891,27015,885,126,759,2,30,1,1,allow
8892,443,11185,443,8106,1626,6480,31,341,11,20,allow
53629,443,53629,443,4620,1713,2907,19,30,11,8,allow
51517,443,51517,443,153968,7663,146305,170,173,43,127,allow
55826,53,27290,53,86,86,0,2,34,2,0,allow
51785,33253,63010,33253,70,70,0,1,5,1,0,allow
65315,53,22076,53,216,110,106,2,30,1,1,allow
53581,12169,27472,12169,492,306,186,8,15,5,3,allow
62705,443,33676,443,178,118,60,2,15,1,1,allow
56007,53,0,0,86,86,0,1,30,1,0,allow
65315,53,30606,53,216,110,106,2,30,1,1,allow
65394,53,54686,53,230,94,136,2,30,1,1,allow
32299,40014,29367,40014,280,182,98,2,30,1,1,allow
44059,53,51061,53,199,94,105,2,30,1,1,allow
53585,43611,54963,43611,612,306,306,10,15,5,5,allow
62050,443,9772,443,2139,1140,999,15,124,9,6,allow
19629,53,19629,53,244,98,146,2,33,1,1,allow
50116,22,50116,22,66,66,0,1,5,1,0,allow
56807,18177,32535,18177,70,70,0,1,5,1,0,allow
51648,80,37574,80,974005,25912,948093,1003,32,361,642,allow
34527,443,29221,443,480624,56231,424393,860,196,427,433,allow
64755,53,11546,53,339,134,205,2,30,1,1,allow
55252,53,15058,53,212,102,110,2,30,1,1,allow
52784,443,37799,443,16022,3217,12805,25,138,11,14,allow
55966,443,15279,443,9006,2048,6958,36,121,18,18,allow
52403,443,54910,443,8811,3668,5143,26,126,13,13,allow
52170,443,6811,443,11716,7393,4323,47,146,21,26,allow
65157,53,24624,53,209,102,107,2,31,1,1,allow
56667,53,23608,53,168,86,82,2,31,1,1,allow
42309,443,23092,443,7295,1469,5826,30,360,9,21,allow
49815,443,13935,443,8614049,176366,8437683,7757,202,1608,6149,allow
62470,443,10717,443,38402253,1191239,37211014,39088,243,12126,26962,allow
58439,443,54279,443,2659,1417,1242,19,276,9,10,allow
57470,31112,14070,31112,132,132,0,3,1199,3,0,allow
57470,41315,64435,41315,792,792,0,13,1199,13,0,allow
6881,12388,2664,12388,216,118,98,2,1199,1,1,allow
33434,5228,15468,5228,12979,2808,10171,46,648,21,25,allow
6881,7005,9518,7005,118,118,0,1,1200,1,0,allow
63228,443,36281,443,3749,2597,1152,25,134,15,10,allow
60754,40010,30483,40010,316,136,180,6,6,3,3,allow
2138,53,2138,53,235,90,145,2,34,1,1,allow
34873,443,26122,443,236097,12185,223912,307,32,125,182,allow
36793,80,35918,80,156726,8626,148100,206,32,104,102,allow
36789,80,36658,80,129896,7448,122448,172,32,87,85,allow
58415,443,33034,443,560,280,280,9,30,5,4,allow
56934,80,1586,80,486,280,206,8,26,5,3,allow
26177,53,26177,53,220,90,130,2,30,1,1,allow
63963,53,44790,53,212,102,110,2,30,1,1,allow
63225,443,50090,443,4882,2412,2470,32,155,16,16,allow
53618,1025,19237,1025,320,140,180,6,7,3,3,allow
36792,80,39617,80,152694,8416,144278,200,32,101,99,allow
49923,53,15331,53,199,94,105,2,30,1,1,allow
53787,53,59844,53,224,86,138,2,30,1,1,allow
64255,53,2166,53,332,102,230,2,30,1,1,allow
56443,53,9982,53,168,86,82,2,31,1,1,allow
63233,443,64284,443,1373,734,639,17,125,10,7,allow
63229,443,6765,443,1373,734,639,17,134,10,7,allow
53607,51631,7980,51631,70,70,0,2,8,2,0,allow
56933,80,47498,80,486,280,206,8,26,5,3,allow
51173,443,13645,443,13772,1738,12034,26,31,12,14,allow
65153,53,10346,53,241,118,123,2,30,1,1,allow
53813,445,0,0,66,66,0,1,0,1,0,drop
53814,445,0,0,66,66,0,1,0,1,0,drop
53811,445,0,0,66,66,0,1,0,1,0,drop
9246,35440,0,0,62,62,0,1,0,1,0,deny
62386,37965,0,0,66,66,0,1,0,1,0,deny
11464,37965,0,0,62,62,0,1,0,1,0,deny
57860,51505,0,0,66,66,0,1,0,1,0,deny
7931,30170,0,0,146,146,0,1,0,1,0,deny
53423,445,0,0,70,70,0,1,0,1,0,drop
58397,445,0,0,70,70,0,1,0,1,0,drop
58395,445,0,0,70,70,0,1,0,1,0,drop
58393,445,0,0,70,70,0,1,0,1,0,drop
17009,53733,0,0,62,62,0,1,0,1,0,deny
53809,445,0,0,66,66,0,1,0,1,0,drop
51010,22114,0,0,146,146,0,1,0,1,0,deny
58389,445,0,0,70,70,0,1,0,1,0,drop
43260,41615,0,0,145,145,0,1,0,1,0,deny
57789,30188,0,0,62,62,0,1,0,1,0,deny
49174,50584,0,0,146,146,0,1,0,1,0,deny
53806,445,0,0,66,66,0,1,0,1,0,drop
53804,445,0,0,66,66,0,1,0,1,0,drop
53803,445,0,0,66,66,0,1,0,1,0,drop
6881,6881,0,0,146,146,0,1,0,1,0,deny
53800,445,0,0,66,66,0,1,0,1,0,drop
53416,445,0,0,70,70,0,1,0,1,0,drop
53415,445,0,0,70,70,0,1,0,1,0,drop
61808,18375,0,0,66,66,0,1,0,1,0,deny
2323,23117,0,0,62,62,0,1,0,1,0,deny
58382,445,0,0,70,70,0,1,0,1,0,drop
22587,30188,0,0,62,62,0,1,0,1,0,deny
32071,51221,0,0,66,66,0,1,0,1,0,deny
53409,445,0,0,70,70,0,1,0,1,0,drop
58376,445,0,0,70,70,0,1,0,1,0,drop
58374,445,0,0,70,70,0,1,0,1,0,drop
53408,445,0,0,70,70,0,1,0,1,0,drop
59696,57470,0,0,62,62,0,1,0,1,0,deny
50280,57470,0,0,78,78,0,1,0,1,0,deny
48676,53395,0,0,60,60,0,1,0,1,0,deny
53790,445,0,0,66,66,0,1,0,1,0,drop
52064,22114,0,0,66,66,0,1,0,1,0,deny
53404,445,0,0,70,70,0,1,0,1,0,drop
36586,5900,0,0,60,60,0,1,0,1,0,deny
59745,53635,0,0,66,66,0,1,0,1,0,deny
47910,7461,0,0,60,60,0,1,0,1,0,deny
53403,445,0,0,70,70,0,1,0,1,0,drop
13943,22,0,0,60,60,0,1,0,1,0,deny
53782,445,0,0,66,66,0,1,0,1,0,drop
58361,445,0,0,70,70,0,1,0,1,0,drop
30765,56205,0,0,66,66,0,1,0,1,0,deny
59781,56205,0,0,66,66,0,1,0,1,0,deny
56307,52700,0,0,66,66,0,1,0,1,0,deny
53779,445,0,0,66,66,0,1,0,1,0,drop
53398,445,0,0,70,70,0,1,0,1,0,drop
7308,50584,0,0,62,62,0,1,0,1,0,deny
60602,15503,0,0,66,66,0,1,0,1,0,deny
53928,15503,0,0,62,62,0,1,0,1,0,deny
51996,35440,0,0,66,66,0,1,0,1,0,deny
58305,51180,0,0,66,66,0,1,0,1,0,deny
53773,445,0,0,66,66,0,1,0,1,0,drop
12530,35440,0,0,62,62,0,1,0,1,0,deny
53768,445,0,0,66,66,0,1,0,1,0,drop
6416,22114,0,0,66,66,0,1,0,1,0,deny
26400,44847,0,0,146,146,0,1,0,1,0,deny
31112,50584,0,0,62,62,0,1,0,1,0,deny
60196,53,0,0,88,88,0,1,0,1,0,deny
17581,23,0,0,60,60,0,1,0,1,0,deny
42898,43890,0,0,62,62,0,1,0,1,0,deny
53385,445,0,0,70,70,0,1,0,1,0,drop
59378,50584,0,0,62,62,0,1,0,1,0,deny
6666,2222,0,0,60,60,0,1,0,1,0,deny
24534,50584,0,0,146,146,0,1,0,1,0,deny
58352,445,0,0,70,70,0,1,0,1,0,drop
58350,445,0,0,70,70,0,1,0,1,0,drop
58349,445,0,0,70,70,0,1,0,1,0,drop
53754,445,0,0,66,66,0,1,0,1,0,drop
53757,445,0,0,66,66,0,1,0,1,0,drop
53755,445,0,0,66,66,0,1,0,1,0,drop
53756,445,0,0,66,66,0,1,0,1,0,drop
53753,445,0,0,66,66,0,1,0,1,0,drop
53751,445,0,0,66,66,0,1,0,1,0,drop
53752,445,0,0,66,66,0,1,0,1,0,drop
53749,445,0,0,66,66,0,1,0,1,0,drop
53382,445,0,0,70,70,0,1,0,1,0,drop
65250,22114,0,0,62,62,0,1,0,1,0,deny
54155,64147,0,0,66,66,0,1,0,1,0,deny
52431,50265,0,0,62,62,0,1,0,1,0,deny
52973,23,0,0,60,60,0,1,0,1,0,deny
44121,23,0,0,60,60,0,1,0,1,0,deny
22357,6004,0,0,62,62,0,1,0,1,0,deny
63547,37965,0,0,66,66,0,1,0,1,0,deny
52741,24211,0,0,66,66,0,1,0,1,0,deny
26084,36237,0,0,66,66,0,1,0,1,0,deny
53377,445,0,0,70,70,0,1,0,1,0,drop
53376,445,0,0,70,70,0,1,0,1,0,drop
15530,49718,0,0,146,146,0,1,0,1,0,deny
58348,445,0,0,70,70,0,1,0,1,0,drop
58342,445,0,0,70,70,0,1,0,1,0,drop
58339,445,0,0,70,70,0,1,0,1,0,drop
53374,445,0,0,70,70,0,1,0,1,0,drop
57339,50584,0,0,66,66,0,1,0,1,0,deny
53737,445,0,0,66,66,0,1,0,1,0,drop
53736,445,0,0,66,66,0,1,0,1,0,drop
53734,445,0,0,66,66,0,1,0,1,0,drop
61701,44847,0,0,66,66,0,1,0,1,0,deny
58331,445,0,0,70,70,0,1,0,1,0,drop
8999,57470,0,0,146,146,0,1,0,1,0,deny
51725,56205,0,0,62,62,0,1,0,1,0,deny
58330,445,0,0,70,70,0,1,0,1,0,drop
55255,37965,0,0,146,146,0,1,0,1,0,deny
58327,445,0,0,70,70,0,1,0,1,0,drop
58328,445,0,0,70,70,0,1,0,1,0,drop
58321,445,0,0,70,70,0,1,0,1,0,drop
46478,64147,0,0,62,62,0,1,0,1,0,deny
53367,445,0,0,70,70,0,1,0,1,0,drop
0,0,0,0,98,98,0,1,0,1,0,deny
0,0,0,0,98,98,0,1,0,1,0,deny
0,0,0,0,98,98,0,1,0,1,0,deny
0,0,0,0,98,98,0,1,0,1,0,deny
0,0,0,0,134,64,70,2,0,1,1,allow
53365,445,0,0,70,70,0,1,0,1,0,drop
49690,50265,0,0,66,66,0,1,0,1,0,deny
61457,21247,0,0,66,66,0,1,0,1,0,deny
36908,26467,0,0,62,62,0,1,0,1,0,deny
53364,445,0,0,70,70,0,1,0,1,0,drop
51192,15503,0,0,66,66,0,1,0,1,0,deny
53363,445,0,0,70,70,0,1,0,1,0,drop
51413,25864,0,0,72,72,0,1,0,1,0,deny
53362,445,0,0,70,70,0,1,0,1,0,drop
53357,445,0,0,70,70,0,1,0,1,0,drop
53356,445,0,0,70,70,0,1,0,1,0,drop
51674,51505,0,0,66,66,0,1,0,1,0,deny
2697,28189,0,0,60,60,0,1,0,1,0,deny
26799,50584,0,0,62,62,0,1,0,1,0,deny
52103,53733,0,0,62,62,0,1,0,1,0,deny
58312,445,0,0,70,70,0,1,0,1,0,drop
58311,445,0,0,70,70,0,1,0,1,0,drop
58307,445,0,0,70,70,0,1,0,1,0,drop
53344,445,0,0,70,70,0,1,0,1,0,drop
53343,445,0,0,70,70,0,1,0,1,0,drop
53341,445,0,0,70,70,0,1,0,1,0,drop
53334,445,0,0,70,70,0,1,0,1,0,drop
53333,445,0,0,70,70,0,1,0,1,0,drop
61520,23718,0,0,66,66,0,1,0,1,0,deny
58396,22114,0,0,66,66,0,1,0,1,0,deny
27147,22114,0,0,62,62,0,1,0,1,0,deny
50027,21247,0,0,66,66,0,1,0,1,0,deny
54109,36829,0,0,66,66,0,1,0,1,0,deny
56119,46824,0,0,62,62,0,1,0,1,0,deny
53714,445,0,0,66,66,0,1,0,1,0,drop
58298,445,0,0,70,70,0,1,0,1,0,drop
58295,445,0,0,70,70,0,1,0,1,0,drop
52076,44847,0,0,66,66,0,1,0,1,0,deny
53322,445,0,0,70,70,0,1,0,1,0,drop
50804,1,0,0,62,62,0,1,0,1,0,deny
34553,48637,0,0,60,60,0,1,0,1,0,deny
4041,23,0,0,60,60,0,1,0,1,0,deny
43600,443,57317,443,172272,14401,157871,254,418,100,154,allow
54501,80,17667,80,254,128,126,5,16,3,2,allow
53899,443,60991,443,21288,10113,11175,107,31,51,56,allow
49468,443,51693,443,6940,1302,5638,20,119,10,10,allow
56169,53,17161,53,916,86,830,2,30,1,1,allow
57236,53,14592,53,748,95,653,2,30,1,1,allow
52016,80,31831,80,19693,1957,17736,49,32,23,26,allow
58145,1433,58145,1433,60,60,0,2,5,2,0,allow
31362,23,31362,23,60,60,0,1,5,1,0,allow
53608,1024,52758,1024,70,70,0,2,8,2,0,allow
33570,443,59571,443,81954,13611,68343,174,34,79,95,allow
49469,443,50617,443,6416,1302,5114,20,119,10,10,allow
34038,5222,46652,5222,2853,1289,1564,30,1555,12,18,allow
51317,443,51634,443,59889,7472,52417,83,145,32,51,allow
53617,1056,21327,1056,320,140,180,6,6,3,3,allow
42566,443,31210,443,10127,4193,5934,30,24,17,13,allow
55030,80,10323,80,2954,671,2283,12,15,7,5,allow
49629,53,19594,53,916,86,830,2,30,1,1,allow
60464,53,0,0,180,82,98,2,30,1,1,allow
48906,80,50980,80,2544,1681,863,12,185,7,5,allow
39292,80,43537,80,1655,1341,314,10,16,5,5,allow
36839,80,35799,80,10345,6823,3522,25,25,14,11,allow
39804,443,42042,443,56980,4095,52885,90,256,37,53,allow
42510,53,42510,53,237,91,146,2,32,1,1,allow
53609,38060,12354,38060,70,70,0,2,8,2,0,allow
56805,1,17140,1,70,70,0,1,5,1,0,allow
51784,34568,52434,34568,66,66,0,1,5,1,0,allow
36497,80,36497,80,7594,863,6731,18,21,8,10,allow
50438,53,48155,53,295,101,194,4,31,2,2,allow
27005,27016,9043,27016,881,126,755,2,30,1,1,allow
27005,27015,8409,27015,897,126,771,2,30,1,1,allow
56103,443,24314,443,22293,16437,5856,51,30,27,24,allow
59312,443,40068,443,233778,8502,225276,276,34,109,167,allow
49737,443,48877,443,35419,29471,5948,42,31,27,15,allow
34990,80,36946,80,1534,996,538,10,35,6,4,allow
57022,80,30750,80,77115,5003,72112,110,35,56,54,allow
52014,80,24294,80,30427,2131,28296,66,32,25,41,allow
33568,443,55064,443,9180,2197,6983,36,34,20,16,allow
36823,80,35585,80,3335,2735,600,12,30,7,5,allow
57392,443,57392,443,4729,1822,2907,19,27,11,8,allow
33569,443,28286,443,9032,2162,6870,34,34,18,16,allow
64572,443,16176,443,24918,2042,22876,40,16,19,21,allow
35149,53,35149,53,235,90,145,2,32,1,1,allow
34424,443,13536,443,8277,2394,5883,31,316,16,15,allow
56443,53,2207,53,168,86,82,2,30,1,1,allow
56667,53,46013,53,168,86,82,2,30,1,1,allow
53150,80,13371,80,2398,2024,374,12,15,6,6,allow
33576,443,52498,443,170319,23354,146965,283,34,121,162,allow
46492,443,13641,443,11163,3642,7521,25,30,14,11,allow
36810,80,28528,80,18460,3166,15294,34,32,18,16,allow
52694,80,51604,80,1960,1366,594,12,34,7,5,allow
60936,443,44472,443,4621,3079,1542,24,52,13,11,allow
56102,443,1329,443,8577,3450,5127,23,30,13,10,allow
58993,443,16211,443,1437,736,701,15,28,7,8,allow
51908,443,56072,443,8481,1976,6505,23,25,13,10,allow
35501,53,35501,53,213,79,134,2,33,1,1,allow
51949,80,39415,80,5106,766,4340,16,45,9,7,allow
45204,53,45204,53,237,91,146,2,33,1,1,allow
35554,443,35554,443,4378,1471,2907,19,28,11,8,allow
62791,443,22999,443,17411,8921,8490,98,291,41,57,allow
53860,443,53373,443,8712,2293,6419,26,315,13,13,allow
11826,53,11826,53,237,91,146,2,33,1,1,allow
52018,80,20950,80,1660,791,869,11,32,6,5,allow
56202,53,30224,53,916,86,830,2,30,1,1,allow
55736,53,0,0,338,70,268,2,30,1,1,allow
47722,80,12273,80,1720,1406,314,10,15,5,5,allow
43473,53,43473,53,220,100,120,2,30,1,1,allow
55736,53,0,0,623,70,553,2,30,1,1,allow
34111,53,34111,53,213,87,126,2,30,1,1,allow
27005,27015,8429,27015,882,126,756,2,30,1,1,allow
26900,27017,21825,27017,422,164,258,6,31,3,3,allow
56940,443,47279,443,5147,2613,2534,19,137,10,9,allow
26900,27017,60597,27017,422,164,258,6,31,3,3,allow
5938,18721,0,0,60,60,0,1,91,1,0,allow
42820,443,51976,443,25721,8999,16722,38,121,18,20,allow
51282,443,3652,443,4933,2248,2685,14,135,7,7,allow
64971,53,0,0,229,85,144,2,31,1,1,allow
50226,443,45230,443,7726,4613,3113,21,137,11,10,allow
45538,5228,21561,5228,2372,1452,920,16,3600,8,8,allow
62737,64147,0,0,66,66,0,1,0,1,0,deny
65454,61600,0,0,66,66,0,1,0,1,0,deny
49677,64147,0,0,62,62,0,1,0,1,0,deny
53676,35974,0,0,60,60,0,1,0,1,0,deny
34677,51185,0,0,60,60,0,1,0,1,0,deny
54693,30188,0,0,66,66,0,1,0,1,0,deny
53770,64147,0,0,66,66,0,1,0,1,0,deny
53707,445,0,0,66,66,0,1,0,1,0,drop
1049,54369,0,0,62,62,0,1,0,1,0,deny
4447,35440,0,0,66,66,0,1,0,1,0,deny
53705,445,0,0,66,66,0,1,0,1,0,drop
10006,64147,0,0,62,62,0,1,0,1,0,deny
27005,27015,48748,27015,894,126,768,2,30,1,1,allow
63967,53,11149,53,195,102,93,2,30,1,1,allow
41051,443,30990,443,37711,4074,33637,69,32,31,38,allow
45254,443,27475,443,8328,2592,5736,35,34,18,17,allow
36776,80,31947,80,16274,9170,7104,34,32,19,15,allow
34883,443,14501,443,51393,3538,47855,70,30,29,41,allow
48067,443,48553,443,12648,5285,7363,58,32,27,31,allow
49466,443,64942,443,4562,2466,2096,20,119,11,9,allow
58361,443,12659,443,7297,2046,5251,22,29,13,9,allow
36790,80,59682,80,191737,8302,183435,205,31,79,126,allow
49672,80,61052,80,3874260,98179,3776081,4003,1072,1479,2524,allow
49464,443,43565,443,4555,2472,2083,20,119,11,9,allow
36791,80,9992,80,196328,10952,185376,244,31,117,127,allow
52415,443,32301,443,2007,1152,855,14,15,8,6,allow
37738,443,1957,443,6470,1931,4539,27,32,14,13,allow
43675,80,34710,80,1676620,41953,1634667,1725,25,636,1089,allow
36765,80,13699,80,2272,1679,593,10,34,6,4,allow
36533,443,27150,443,10488,4495,5993,38,32,20,18,allow
34710,53,34710,53,244,98,146,2,33,1,1,allow
49467,443,18409,443,4564,2466,2098,20,119,11,9,allow
46641,8100,13057,8100,78,78,0,1,4,1,0,allow
63235,443,19696,443,1373,734,639,17,96,10,7,allow
63779,12226,30689,12226,70,70,0,1,4,1,0,allow
53605,13468,23024,13468,70,70,0,2,7,2,0,allow
45540,8100,31556,8100,78,78,0,1,4,1,0,allow
49639,53,29692,53,250,102,148,2,29,1,1,allow
49924,443,9177,443,13502,2331,11171,42,194,19,23,allow
62888,53,62888,53,240,98,142,2,29,1,1,allow
34173,53,34173,53,240,98,142,2,29,1,1,allow
56667,53,25410,53,250,86,164,4,29,2,2,allow
49447,53,25197,53,248,102,146,2,29,1,1,allow
64073,53,51133,53,361,86,275,2,30,1,1,allow
55158,53,42446,53,239,102,137,2,30,1,1,allow
59607,443,14075,443,2150,1280,870,18,832,10,8,allow
56543,443,26469,443,245527,10641,234886,322,405,136,186,allow
56663,53,28501,53,215,102,113,2,30,1,1,allow
50097,53,57646,53,199,94,105,2,30,1,1,allow
56997,53,45686,53,168,86,82,2,30,1,1,allow
34469,53,59263,53,226,78,148,2,30,1,1,allow
37918,443,25153,443,6123,860,5263,18,361,9,9,allow
57427,53,45535,53,363,94,269,2,30,1,1,allow
53577,53,0,0,82,82,0,2,40,2,0,allow
60409,44739,34320,44739,70,70,0,2,8,2,0,allow
51798,37020,11736,37020,70,70,0,2,8,2,0,allow
52413,443,50762,443,2114,1152,962,14,15,8,6,allow
54995,443,62942,443,23418,2454,20964,56,197,26,30,allow
41385,53,41385,53,244,98,146,2,34,1,1,allow
58055,80,49869,80,254,128,126,5,15,3,2,allow
41542,23,41542,23,66,66,0,1,5,1,0,allow
56618,80,46340,80,234,234,0,4,12,4,0,allow
51580,53,9399,53,199,94,105,2,30,1,1,allow
56742,53,0,0,82,82,0,2,40,2,0,allow
16224,443,3120,443,7525,1098,6427,22,16,12,10,allow
56048,53,3715,53,296,110,186,2,30,1,1,allow
63777,80,2556,80,314,192,122,6,15,4,2,allow
59723,80,4011,80,613,539,74,7,15,6,1,allow
59165,53,3627,53,320,94,226,2,30,1,1,allow
64609,53,7201,53,168,86,82,2,30,1,1,allow
50466,80,60136,80,1718,1247,471,9,15,5,4,allow
64609,53,19942,53,168,86,82,2,30,1,1,allow
64926,53,31198,53,309,118,191,2,30,1,1,allow
19473,14168,34740,14168,491,150,341,2,1200,1,1,allow
27005,27015,9469,27015,887,126,761,2,30,1,1,allow
55284,53,61340,53,193,102,91,2,30,1,1,allow
49205,80,50738,80,890,411,479,11,15,6,5,allow
54957,80,50979,80,416,210,206,7,15,4,3,allow
51800,63796,36885,63796,70,70,0,2,8,2,0,allow
13956,53,13956,53,244,98,146,2,34,1,1,allow
53117,37529,38733,37529,70,70,0,1,5,1,0,allow
57362,53,47817,53,183,86,97,2,30,1,1,allow
50595,443,32592,443,8981,4625,4356,22,135,11,11,allow
60012,443,58670,443,8127,1796,6331,21,79,12,9,allow
53119,58118,15448,58118,70,70,0,2,8,2,0,allow
45648,80,30446,80,130,70,60,2,15,1,1,allow
59574,443,1442,443,2582500,86854,2495646,2678,84,986,1692,allow
58413,443,5177,443,9371,1936,7435,26,29,14,12,allow
47020,443,34656,443,3545,1817,1728,22,95,11,11,allow
36068,80,51482,80,41269,2915,38354,62,33,32,30,allow
54672,443,53803,443,7210,2267,4943,22,15,12,10,allow
45067,443,54041,443,7794,2844,4950,26,29,16,10,allow
36788,80,9413,80,235873,12126,223747,306,31,154,152,allow
45257,443,55440,443,36062,4663,31399,87,33,41,46,allow
49465,443,16999,443,4555,2472,2083,20,119,11,9,allow
53358,443,35239,443,8626,2839,5787,47,27,24,23,allow
41421,443,56908,443,168930,11361,157569,252,31,101,151,allow
63232,443,26677,443,4496,2346,2150,28,124,15,13,allow
49073,443,18222,443,8960,2497,6463,35,32,19,16,allow
63231,443,12369,443,7124,3843,3281,42,126,20,22,allow
59538,80,28530,80,1895,755,1140,11,14,6,5,allow
56997,53,24700,53,337,107,230,4,34,2,2,allow
58705,80,29021,80,2543,1880,663,12,14,6,6,allow
51801,33531,27515,33531,70,70,0,2,8,2,0,allow
56680,8100,18544,8100,78,78,0,1,4,1,0,allow
48882,443,39008,443,8105,1902,6203,24,26,14,10,allow
14420,80,14420,80,4591,3155,1436,22,45,13,9,allow
40953,443,21244,443,4093,1595,2498,23,15,12,11,allow
55484,443,18380,443,782,428,354,12,25,7,5,allow
16223,443,54966,443,7461,1034,6427,21,16,11,10,allow
49954,443,61436,443,25995,13597,12398,53,186,28,25,allow
63234,443,45160,443,5846,3321,2525,34,96,19,15,allow
46414,80,41611,80,1155,781,374,10,15,6,4,allow
62408,3478,35393,3478,3548,1868,1680,57,87,29,28,allow
64005,53,59576,53,402,125,277,4,37,2,2,allow
64991,53,47067,53,625,192,433,6,46,3,3,allow
65364,53,50447,53,226,110,116,2,29,1,1,allow
55347,443,1685,443,116686,21822,94864,224,186,112,112,allow
64693,53,28781,53,248,102,146,2,30,1,1,allow
27005,27017,1737,27017,891,126,765,2,30,1,1,allow
56443,53,48417,53,250,86,164,4,29,2,2,allow
56667,53,35767,53,168,86,82,2,29,1,1,allow
53786,53,10105,53,260,86,174,2,30,1,1,allow
37916,443,12180,443,6202,872,5330,19,361,9,10,allow
56443,53,60191,53,168,86,82,2,30,1,1,allow
43361,80,14228,80,630,630,0,10,217,10,0,allow
60480,443,16166,443,6511,2810,3701,34,3665,12,22,allow
36886,443,32940,443,2907,1637,1270,20,364,11,9,allow
55427,443,18604,443,9255,2064,7191,43,78,18,25,allow
41631,123,31654,123,184,94,90,2,30,1,1,allow
57991,53,26816,53,220,78,142,2,30,1,1,allow
51176,53,44581,53,236,86,150,2,30,1,1,allow
27005,27015,41826,27015,868,126,742,2,30,1,1,allow
46865,443,9898,443,416,210,206,7,32,4,3,allow
27005,27018,40971,27018,882,126,756,2,30,1,1,allow
40893,443,32829,443,10450,3898,6552,20,135,11,9,allow
60644,5222,7350,5222,9852,2665,7187,60,360,25,35,allow
51764,443,51764,443,4632,1725,2907,19,27,11,8,allow
56800,1,6191,1,70,70,0,2,8,2,0,allow
58962,80,58962,80,22844,1529,21315,39,28,20,19,allow
62783,443,22003,443,28847,16957,11890,144,293,60,84,allow
43872,53,52878,53,199,94,105,2,30,1,1,allow
55072,53,52370,53,168,86,82,2,30,1,1,allow
64609,53,7620,53,250,86,164,4,30,2,2,allow
48458,53,30263,53,168,78,90,2,31,1,1,allow
37917,443,55165,443,6124,860,5264,18,361,9,9,allow
61762,443,14583,443,5975,2713,3262,24,125,12,12,allow
61305,443,56273,443,5399,2711,2688,13,120,7,6,allow
64072,53,31241,53,292,110,182,2,30,1,1,allow
60241,443,21837,443,4512,1810,2702,16,135,7,9,allow
50464,80,22574,80,8453,2011,6442,17,21,8,9,allow
57304,53,22240,53,292,110,182,2,30,1,1,allow
16980,53,16980,53,197,90,107,2,30,1,1,allow
61151,443,65420,443,121129,5559,115570,157,640,51,106,allow
49665,53,45405,53,197,102,95,2,30,1,1,allow
52508,53,51671,53,168,78,90,2,30,1,1,allow
50438,53,55322,53,199,102,97,2,31,1,1,allow
53578,34129,19410,34129,70,70,0,1,5,1,0,allow
25448,23,25448,23,66,66,0,1,5,1,0,allow
50452,80,41109,80,318,192,126,6,29,4,2,allow
39118,443,29645,443,5229,2388,2841,23,367,12,11,allow
64082,53,17005,53,356,97,259,4,58,2,2,allow
58289,445,0,0,70,70,0,1,0,1,0,drop
58305,18375,0,0,62,62,0,1,0,1,0,deny
53318,445,0,0,70,70,0,1,0,1,0,drop
58286,445,0,0,70,70,0,1,0,1,0,drop
58287,445,0,0,70,70,0,1,0,1,0,drop
58284,445,0,0,70,70,0,1,0,1,0,drop
51166,31573,0,0,66,66,0,1,0,1,0,deny
4961,62741,0,0,66,66,0,1,0,1,0,deny
53702,445,0,0,66,66,0,1,0,1,0,drop
53309,445,0,0,70,70,0,1,0,1,0,drop
53308,445,0,0,70,70,0,1,0,1,0,drop
53305,445,0,0,70,70,0,1,0,1,0,drop
53303,445,0,0,70,70,0,1,0,1,0,drop
33174,22,0,0,60,60,0,1,0,1,0,deny
53302,445,0,0,70,70,0,1,0,1,0,drop
46640,8880,0,0,60,60,0,1,0,1,0,deny
58278,445,0,0,70,70,0,1,0,1,0,drop
61221,35440,0,0,66,66,0,1,0,1,0,deny
58273,445,0,0,70,70,0,1,0,1,0,drop
58270,445,0,0,70,70,0,1,0,1,0,drop
58269,445,0,0,70,70,0,1,0,1,0,drop
53696,445,0,0,66,66,0,1,0,1,0,drop
58703,50584,0,0,66,66,0,1,0,1,0,deny
53692,445,0,0,66,66,0,1,0,1,0,drop
53691,445,0,0,66,66,0,1,0,1,0,drop
53687,445,0,0,66,66,0,1,0,1,0,drop
53686,445,0,0,66,66,0,1,0,1,0,drop
53685,445,0,0,66,66,0,1,0,1,0,drop
53683,445,0,0,66,66,0,1,0,1,0,drop
1024,64147,0,0,62,62,0,1,0,1,0,deny
7749,36237,0,0,66,66,0,1,0,1,0,deny
52860,9694,0,0,62,62,0,1,0,1,0,deny
53294,445,0,0,70,70,0,1,0,1,0,drop
60018,64147,0,0,62,62,0,1,0,1,0,deny
59377,9319,0,0,62,62,0,1,0,1,0,deny
58268,445,0,0,70,70,0,1,0,1,0,drop
58265,445,0,0,70,70,0,1,0,1,0,drop
58263,445,0,0,70,70,0,1,0,1,0,drop
56712,46824,0,0,62,62,0,1,0,1,0,deny
53682,445,0,0,66,66,0,1,0,1,0,drop
58260,445,0,0,70,70,0,1,0,1,0,drop
50254,44847,0,0,66,66,0,1,0,1,0,deny
53677,445,0,0,66,66,0,1,0,1,0,drop
53286,445,0,0,70,70,0,1,0,1,0,drop
56173,37807,0,0,66,66,0,1,0,1,0,deny
62071,22114,0,0,62,62,0,1,0,1,0,deny
53676,445,0,0,66,66,0,1,0,1,0,drop
53675,445,0,0,66,66,0,1,0,1,0,drop
53283,445,0,0,70,70,0,1,0,1,0,drop
53673,445,0,0,66,66,0,1,0,1,0,drop
53406,50584,0,0,66,66,0,1,0,1,0,deny
53178,26467,0,0,62,62,0,1,0,1,0,deny
17481,64097,0,0,146,146,0,1,0,1,0,deny
20576,37965,0,0,62,62,0,1,0,1,0,deny
53280,445,0,0,70,70,0,1,0,1,0,drop
49982,37965,0,0,66,66,0,1,0,1,0,deny
25797,30188,0,0,146,146,0,1,0,1,0,deny
62549,64147,0,0,62,62,0,1,0,1,0,deny
53278,445,0,0,70,70,0,1,0,1,0,drop
65203,30188,0,0,66,66,0,1,0,1,0,deny
58253,445,0,0,70,70,0,1,0,1,0,drop
58248,445,0,0,70,70,0,1,0,1,0,drop
58245,445,0,0,70,70,0,1,0,1,0,drop
41410,30188,0,0,146,146,0,1,0,1,0,deny
53274,445,0,0,70,70,0,1,0,1,0,drop
52361,23718,0,0,66,66,0,1,0,1,0,deny
53664,445,0,0,66,66,0,1,0,1,0,drop
5751,64147,0,0,66,66,0,1,0,1,0,deny
53273,445,0,0,70,70,0,1,0,1,0,drop
50535,51505,0,0,62,62,0,1,0,1,0,deny
32491,15503,0,0,66,66,0,1,0,1,0,deny
43688,22114,0,0,66,66,0,1,0,1,0,deny
53654,445,0,0,66,66,0,1,0,1,0,drop
57772,50584,0,0,66,66,0,1,0,1,0,deny
58234,445,0,0,70,70,0,1,0,1,0,drop
58751,9571,0,0,62,62,0,1,0,1,0,deny
25010,30188,0,0,62,62,0,1,0,1,0,deny
9377,56205,0,0,66,66,0,1,0,1,0,deny
53268,445,0,0,70,70,0,1,0,1,0,drop
64339,18375,0,0,66,66,0,1,0,1,0,deny
59728,5900,0,0,60,60,0,1,0,1,0,deny
55225,11392,0,0,66,66,0,1,0,1,0,deny
53652,445,0,0,66,66,0,1,0,1,0,drop
29049,23,0,0,60,60,0,1,0,1,0,deny
1054,15503,0,0,62,62,0,1,0,1,0,deny
63542,15503,0,0,66,66,0,1,0,1,0,deny
10265,64147,0,0,66,66,0,1,0,1,0,deny
52217,22114,0,0,66,66,0,1,0,1,0,deny
59790,44847,0,0,66,66,0,1,0,1,0,deny
52726,56205,0,0,66,66,0,1,0,1,0,deny
53645,445,0,0,66,66,0,1,0,1,0,drop
37902,23718,0,0,62,62,0,1,0,1,0,deny
53639,445,0,0,66,66,0,1,0,1,0,drop
42532,22114,0,0,62,62,0,1,0,1,0,deny
63205,9571,0,0,66,66,0,1,0,1,0,deny
52997,5900,0,0,60,60,0,1,0,1,0,deny
9412,7302,0,0,62,62,0,1,0,1,0,deny
53255,445,0,0,70,70,0,1,0,1,0,drop
63465,56205,0,0,66,66,0,1,0,1,0,deny
64877,37450,0,0,66,66,0,1,0,1,0,deny
63772,35440,0,0,66,66,0,1,0,1,0,deny
17411,43890,0,0,146,146,0,1,0,1,0,deny
15530,49718,0,0,146,146,0,1,0,1,0,deny
42241,11392,0,0,66,66,0,1,0,1,0,deny
58721,51505,0,0,66,66,0,1,0,1,0,deny
53252,445,0,0,70,70,0,1,0,1,0,drop
15005,32480,0,0,145,145,0,1,0,1,0,deny
45941,23386,0,0,60,60,0,1,0,1,0,deny
58224,445,0,0,70,70,0,1,0,1,0,drop
58220,445,0,0,70,70,0,1,0,1,0,drop
58221,445,0,0,70,70,0,1,0,1,0,drop
53628,445,0,0,66,66,0,1,0,1,0,drop
53629,445,0,0,66,66,0,1,0,1,0,drop
53626,445,0,0,66,66,0,1,0,1,0,drop
53623,445,0,0,66,66,0,1,0,1,0,drop
53625,445,0,0,66,66,0,1,0,1,0,drop
53627,445,0,0,66,66,0,1,0,1,0,drop
53624,445,0,0,66,66,0,1,0,1,0,drop
53621,445,0,0,66,66,0,1,0,1,0,drop
63716,23,0,0,60,60,0,1,0,1,0,deny
37597,50584,0,0,66,66,0,1,0,1,0,deny
58445,17500,0,0,66,66,0,1,0,1,0,deny
26921,37965,0,0,62,62,0,1,0,1,0,deny
51617,21247,0,0,66,66,0,1,0,1,0,deny
54343,50584,0,0,62,62,0,1,0,1,0,deny
56474,18375,0,0,62,62,0,1,0,1,0,deny
53247,445,0,0,70,70,0,1,0,1,0,drop
49805,64147,0,0,66,66,0,1,0,1,0,deny
33453,64147,0,0,62,62,0,1,0,1,0,deny
53246,445,0,0,70,70,0,1,0,1,0,drop
2935,64147,0,0,62,62,0,1,0,1,0,deny
12549,50265,0,0,146,146,0,1,0,1,0,deny
53244,445,0,0,70,70,0,1,0,1,0,drop
52643,36237,0,0,66,66,0,1,0,1,0,deny
37587,443,50576,443,499,425,74,4,0,3,1,allow
37586,443,60521,443,499,425,74,4,0,3,1,allow
37584,443,21310,443,499,425,74,4,0,3,1,allow
37581,443,35670,443,499,425,74,4,0,3,1,allow
37582,443,52781,443,499,425,74,4,0,3,1,allow
37583,443,36088,443,499,425,74,4,0,3,1,allow
58217,445,0,0,70,70,0,1,0,1,0,drop
58213,445,0,0,70,70,0,1,0,1,0,drop
58209,445,0,0,70,70,0,1,0,1,0,drop
38358,22300,0,0,60,60,0,1,0,1,0,deny
38320,51505,0,0,66,66,0,1,0,1,0,deny
55770,64147,0,0,66,66,0,1,0,1,0,deny
24471,32167,0,0,60,60,0,1,0,1,0,deny
53609,445,0,0,66,66,0,1,0,1,0,drop
53608,445,0,0,66,66,0,1,0,1,0,drop
53606,445,0,0,66,66,0,1,0,1,0,drop
58202,445,0,0,70,70,0,1,0,1,0,drop
45082,17,0,0,60,60,0,1,0,1,0,deny
2697,28189,0,0,60,60,0,1,0,1,0,deny
16027,22,0,0,60,60,0,1,0,1,0,deny
5222,7493,0,0,66,66,0,1,0,1,0,deny
6853,48543,0,0,148,148,0,1,0,1,0,deny
53237,445,0,0,70,70,0,1,0,1,0,drop
58200,445,0,0,70,70,0,1,0,1,0,drop
58196,445,0,0,70,70,0,1,0,1,0,drop
58198,445,0,0,70,70,0,1,0,1,0,drop
58191,445,0,0,70,70,0,1,0,1,0,drop
53235,445,0,0,70,70,0,1,0,1,0,drop
1024,6881,0,0,146,146,0,1,0,1,0,deny
57283,64147,0,0,66,66,0,1,0,1,0,deny
42252,33303,0,0,60,60,0,1,0,1,0,deny
5223,16383,0,0,66,66,0,1,0,1,0,deny
53234,445,0,0,70,70,0,1,0,1,0,drop
53233,445,0,0,70,70,0,1,0,1,0,drop
53232,445,0,0,70,70,0,1,0,1,0,drop
53226,445,0,0,70,70,0,1,0,1,0,drop
53229,445,0,0,70,70,0,1,0,1,0,drop
31021,35440,0,0,62,62,0,1,0,1,0,deny
5357,32468,0,0,66,66,0,1,0,1,0,deny
53214,445,0,0,70,70,0,1,0,1,0,drop
53212,445,0,0,70,70,0,1,0,1,0,drop
5208,63836,0,0,145,145,0,1,0,1,0,deny
58183,445,0,0,70,70,0,1,0,1,0,drop
58182,445,0,0,70,70,0,1,0,1,0,drop
58177,445,0,0,70,70,0,1,0,1,0,drop
53209,445,0,0,70,70,0,1,0,1,0,drop
57504,44847,0,0,66,66,0,1,0,1,0,deny
53204,445,0,0,70,70,0,1,0,1,0,drop
26900,27017,37776,27017,422,164,258,6,30,3,3,allow
60409,443,2686,443,7925,1878,6047,26,66,12,14,allow
37939,80,33562,80,1616,1302,314,10,15,5,5,allow
53587,32029,40143,32029,70,70,0,1,5,1,0,allow
50230,80,20217,80,2384,952,1432,15,75,8,7,allow
26900,27017,30659,27017,168,82,86,2,30,1,1,allow
55209,53,9446,53,98,98,0,1,30,1,0,allow
49835,53,4982,53,146,75,71,2,30,1,1,allow
56631,443,17729,443,7889,1900,5989,20,16,11,9,allow
53612,1032,47132,1032,130,70,60,3,5,2,1,allow
51782,10637,45950,10637,66,66,0,1,5,1,0,allow
49485,80,52074,80,1155,781,374,10,15,6,4,allow
36907,53,36907,53,237,91,146,2,33,1,1,allow
55207,80,45213,80,1979,1326,653,16,500,10,6,allow
65397,443,12248,443,2494,1643,851,17,25,9,8,allow
49663,53,18877,53,184,80,104,2,30,1,1,allow
55404,53,28730,53,711,87,624,2,30,1,1,allow
57842,53,57842,53,225,87,138,2,30,1,1,allow
14374,443,14374,443,1582,883,699,18,32,10,8,allow
9158,53,9158,53,237,91,146,2,33,1,1,allow
53579,59332,61782,59332,70,70,0,1,5,1,0,allow
26900,27017,15992,27017,422,164,258,6,30,3,3,allow
52010,80,42870,80,29838,2481,27357,56,31,24,32,allow
50227,80,3538,80,1935,895,1040,15,75,8,7,allow
53584,62974,57251,62974,70,70,0,1,5,1,0,allow
51781,43909,49326,43909,66,66,0,1,5,1,0,allow
11295,40002,59394,40002,209,85,124,4,34,2,2,allow
41981,80,51523,80,1556,1236,320,10,15,5,5,allow
26900,27017,35355,27017,422,164,258,6,30,3,3,allow
56632,443,5495,443,7941,1952,5989,20,15,11,9,allow
49665,53,12263,53,194,99,95,2,30,1,1,allow
53580,48066,12026,48066,70,70,0,1,5,1,0,allow
65384,53,58692,53,194,99,95,2,30,1,1,allow
57659,80,4317,80,742,140,602,12,409,3,9,allow
41052,443,41052,443,4596,1689,2907,19,27,11,8,allow
56633,443,38597,443,7889,1900,5989,20,15,11,9,allow
22602,53,22602,53,217,87,130,2,30,1,1,allow
17932,53,17932,53,213,87,126,2,30,1,1,allow
51780,21130,19007,21130,66,66,0,1,5,1,0,allow
51269,36983,59727,36983,70,70,0,1,5,1,0,allow
43884,80,63772,80,1774,1460,314,13,15,8,5,allow
58225,443,29188,443,2484,330,2154,12,135,5,7,allow
62184,443,42085,443,4283,2038,2245,14,135,7,7,allow
30188,1381,10671,1381,324,150,174,2,1200,1,1,allow
47445,443,40456,443,8710,2009,6701,30,395,10,20,allow
48303,53,44805,53,198,93,105,2,31,1,1,allow
57487,443,43988,443,1786,172,1614,7,121,3,4,allow
55028,443,55949,443,6015,3964,2051,32,361,18,14,allow
6882,43825,33329,43825,200,111,89,2,1200,1,1,allow
50265,45599,34078,45599,330,330,0,6,1200,6,0,allow
53203,445,0,0,70,70,0,1,0,1,0,drop
34553,48637,0,0,60,60,0,1,0,1,0,deny
26480,64147,0,0,62,62,0,1,0,1,0,deny
53676,35974,0,0,60,60,0,1,0,1,0,deny
34677,51185,0,0,60,60,0,1,0,1,0,deny
56679,51505,0,0,146,146,0,1,0,1,0,deny
28973,30188,0,0,66,66,0,1,0,1,0,deny
5223,22981,0,0,60,60,0,1,0,1,0,deny
53585,445,0,0,66,66,0,1,0,1,0,drop
53192,445,0,0,70,70,0,1,0,1,0,drop
58175,445,0,0,70,70,0,1,0,1,0,drop
58167,445,0,0,70,70,0,1,0,1,0,drop
32806,7275,9524,7275,1564,560,1004,23,38,9,14,allow
26900,27017,1315,27017,422,164,258,6,30,3,3,allow
64505,53,38734,53,373,126,247,2,30,1,1,allow
62486,53,59489,53,102,102,0,1,30,1,0,allow
56771,53,26360,53,193,102,91,2,31,1,1,allow
40707,443,1072,443,1969,1195,774,18,122,11,7,allow
49178,53,17300,53,348,105,243,4,45,2,2,allow
49178,2710,54926,2710,70,70,0,2,7,2,0,allow
55284,53,36720,53,193,102,91,2,29,1,1,allow
27005,27016,12661,27016,879,126,753,2,30,1,1,allow
65050,53,2914,53,264,102,162,2,30,1,1,allow
33043,443,36029,443,1788,968,820,20,15,11,9,allow
65376,443,34209,443,55500,40540,14960,137,131,72,65,allow
51802,21555,33946,21555,316,136,180,6,6,3,3,allow
65392,443,55705,443,5939,772,5167,17,27,9,8,allow
64849,53,57025,53,340,110,230,2,29,1,1,allow
50459,80,33223,80,1328,917,411,10,28,6,4,allow
64171,53,42919,53,211,102,109,2,29,1,1,allow
50451,80,26551,80,378,192,186,7,28,4,3,allow
49480,53,4215,53,168,78,90,2,29,1,1,allow
27005,27015,45770,27015,874,126,748,2,30,1,1,allow
56760,53,34251,53,216,102,114,2,30,1,1,allow
55593,53,53460,53,102,102,0,1,30,1,0,allow
49291,53,26536,53,277,110,167,2,30,1,1,allow
27005,27015,65142,27015,883,126,757,2,30,1,1,allow
26900,27017,64029,27017,422,164,258,6,30,3,3,allow
26900,27017,21436,27017,422,164,258,6,30,3,3,allow
65460,53,1825,53,177,94,83,2,30,1,1,allow
44443,80,37663,80,1114,534,580,12,16,7,5,allow
49395,53,16625,53,315,90,225,4,32,2,2,allow
52118,443,25040,443,22072,2166,19906,44,49,22,22,allow
27005,27015,60376,27015,878,126,752,2,30,1,1,allow
56426,80,33168,80,17008,1379,15629,22,25,7,15,allow
27005,27017,40278,27017,891,126,765,2,30,1,1,allow
49629,53,59085,53,216,102,114,2,30,1,1,allow
52385,53,0,0,139,70,69,2,30,1,1,allow
56417,53,7039,53,389,126,263,2,30,1,1,allow
51779,49525,20031,49525,70,70,0,1,5,1,0,allow
49865,443,26140,443,5708,1025,4683,16,35,9,7,allow
65384,53,41711,53,197,102,95,2,30,1,1,allow
49661,443,16392,443,9021,2548,6473,38,80,19,19,allow
65276,53,64809,53,195,86,109,2,30,1,1,allow
37581,53,0,0,86,86,0,1,30,1,0,allow
50958,53,61318,53,94,94,0,1,30,1,0,allow
26900,27017,57216,27017,422,164,258,6,30,3,3,allow
49835,53,4123,53,250,86,164,4,30,2,2,allow
50011,53,36525,53,94,94,0,1,30,1,0,allow
26900,27017,59839,27017,422,164,258,6,30,3,3,allow
64477,53,1968,53,272,94,178,2,30,1,1,allow
26900,27017,63924,27017,422,164,258,6,30,3,3,allow
56760,443,12877,443,7894,1671,6223,21,185,11,10,allow
62597,53,18771,53,102,102,0,1,30,1,0,allow
60683,443,28178,443,17071,1532,15539,17,147,3,14,allow
51796,48779,55326,48779,70,70,0,2,8,2,0,allow
56780,48298,2043,48298,264,70,194,4,19,1,3,allow
53482,53,51944,53,168,78,90,2,30,1,1,allow
26900,27017,20527,27017,422,164,258,6,30,3,3,allow
26900,27017,48615,27017,422,164,258,6,30,3,3,allow
57839,53,54040,53,78,78,0,1,30,1,0,allow
49844,53,62050,53,368,118,250,2,30,1,1,allow
44847,6881,46281,6881,150,150,0,1,1200,1,0,allow
50265,12348,24050,12348,858,858,0,14,1200,14,0,allow
50265,28520,23958,28520,132,132,0,3,1200,3,0,allow
27005,27017,59484,27017,882,126,756,2,30,1,1,allow
57028,8080,10225,8080,78,78,0,2,8,2,0,allow
42349,443,27589,443,90562,4227,86335,118,200,49,69,allow
64954,53,8799,53,94,94,0,1,30,1,0,allow
65136,53,1364,53,86,86,0,1,30,1,0,allow
64240,53,21453,53,256,110,146,2,30,1,1,allow
64122,53,64122,53,220,90,130,2,30,1,1,allow
49835,53,23738,53,168,86,82,2,30,1,1,allow
65515,53,35838,53,718,94,624,2,30,1,1,allow
64803,53,39873,53,102,102,0,1,30,1,0,allow
26900,27017,40342,27017,422,164,258,6,30,3,3,allow
55721,53,4903,53,212,94,118,2,30,1,1,allow
37965,32305,6845,32305,1650,1650,0,26,1537,26,0,allow
27005,27016,48371,27016,887,126,761,2,30,1,1,allow
57118,443,64702,443,5133,631,4502,14,15,8,6,allow
53589,40281,44450,40281,70,70,0,1,4,1,0,allow
52641,6881,46429,6881,1162,856,306,10,14,5,5,allow
61158,443,55712,443,12854,2237,10617,47,638,19,28,allow
53606,54476,23615,54476,320,140,180,6,6,3,3,allow
57382,2258,57382,2258,156,156,0,3,8,3,0,allow
53583,15354,45877,15354,70,70,0,1,4,1,0,allow
26900,27017,43419,27017,422,164,258,6,30,3,3,allow
50438,53,8831,53,199,102,97,2,29,1,1,allow
64884,53,48287,53,239,110,129,2,30,1,1,allow
26900,27017,31665,27017,254,82,172,4,30,2,2,allow
59488,443,37367,443,6100,580,5520,17,53,5,12,allow
46864,443,31788,443,5349,1090,4259,18,31,10,8,allow
65460,53,48122,53,177,94,83,2,30,1,1,allow
56568,53,34489,53,102,102,0,1,30,1,0,allow
64146,53,33411,53,273,94,179,2,30,1,1,allow
51646,80,63912,80,1038219,43977,994242,1734,30,616,1118,allow
61580,53,48820,53,275,94,181,2,29,1,1,allow
50438,53,42985,53,199,102,97,2,29,1,1,allow
51467,443,43898,443,186117,12962,173155,249,143,83,166,allow
50639,443,28987,443,15714,2748,12966,58,21,23,35,allow
55209,53,7531,53,196,102,94,2,33,1,1,allow
65472,443,58915,443,460338,13340,446998,472,16,165,307,allow
49855,53,19600,53,916,86,830,2,30,1,1,allow
49706,53,34348,53,258,110,148,2,30,1,1,allow
57398,53,44535,53,202,86,116,2,30,1,1,allow
58472,53,5380,53,86,86,0,1,30,1,0,allow
56463,53,28170,53,368,118,250,2,30,1,1,allow
26900,27017,25587,27017,422,164,258,6,30,3,3,allow
26900,27017,26989,27017,422,164,258,6,30,3,3,allow
26900,27017,65080,27017,422,164,258,6,30,3,3,allow
27005,27015,36150,27015,889,126,763,2,30,1,1,allow
59677,443,25449,443,13551,5488,8063,33,95,16,17,allow
49650,443,63033,443,93063,2948,90115,107,80,30,77,allow
49914,443,22293,443,12190,2075,10115,28,16,14,14,allow
65393,443,57467,443,5121,936,4185,17,27,9,8,allow
54980,443,53564,443,1541965,48559,1493406,1663,51,623,1040,allow
53986,53,15974,53,102,102,0,1,30,1,0,allow
65349,53,10010,53,275,110,165,2,30,1,1,allow
27005,27018,42247,27018,881,126,755,2,30,1,1,allow
27005,27016,2145,27016,883,126,757,2,30,1,1,allow
47147,443,41911,443,5789,952,4837,19,150,10,9,allow
50265,57121,42011,57121,132,132,0,3,1200,3,0,allow
40226,443,40694,443,13853,4638,9215,42,387,21,21,allow
53707,443,35476,443,350,210,140,6,25,4,2,allow
57109,443,58630,443,7170,1436,5734,35,261,19,16,allow
65384,53,35279,53,197,102,95,2,33,1,1,allow
51797,30712,39713,30712,70,70,0,2,8,2,0,allow
51778,60565,33068,60565,70,70,0,1,5,1,0,allow
26900,27017,49635,27017,422,164,258,6,30,3,3,allow
59487,443,5005,443,8702,580,8122,17,53,5,12,allow
49835,53,35014,53,168,86,82,2,30,1,1,allow
26900,27017,34490,27017,422,164,258,6,30,3,3,allow
49501,53,50538,53,229,110,119,2,30,1,1,allow
21133,27613,37990,27613,481,150,331,2,1199,1,1,allow
56192,53,60489,53,177,94,83,2,31,1,1,allow
57470,48096,60784,48096,132,132,0,3,1200,3,0,allow
61744,443,1594,443,3743,1654,2089,10,121,5,5,allow
57470,44822,45311,44822,132,132,0,3,1200,3,0,allow
27761,53,27761,53,832,106,726,2,30,1,1,allow
60546,53,37684,53,199,94,105,2,30,1,1,allow
56801,21916,14491,21916,316,136,180,6,7,3,3,allow
64110,443,18222,443,5060,3367,1693,21,102,12,9,allow
50725,443,41613,443,6593,3522,3071,56,76,33,23,allow
34351,443,4638,443,402051,17714,384337,520,83,228,292,allow
56448,53,42442,53,177,94,83,2,30,1,1,allow
55056,53,32343,53,177,94,83,2,31,1,1,allow
49438,443,63285,443,18773,1492,17281,38,94,11,27,allow
64380,53,9655,53,196,102,94,2,33,1,1,allow
50904,80,18118,80,12289218,202774,12086444,11470,149,2789,8681,allow
61345,21247,0,0,62,62,0,1,0,1,0,deny
45964,5333,0,0,60,60,0,1,0,1,0,deny
25179,62609,0,0,148,148,0,1,0,1,0,deny
53580,445,0,0,66,66,0,1,0,1,0,drop
23795,44847,0,0,146,146,0,1,0,1,0,deny
53188,445,0,0,70,70,0,1,0,1,0,drop
53577,445,0,0,66,66,0,1,0,1,0,drop
58162,445,0,0,70,70,0,1,0,1,0,drop
58154,445,0,0,70,70,0,1,0,1,0,drop
58152,445,0,0,70,70,0,1,0,1,0,drop
58153,445,0,0,70,70,0,1,0,1,0,drop
65115,50584,0,0,66,66,0,1,0,1,0,deny
21173,37965,0,0,62,62,0,1,0,1,0,deny
11816,50584,0,0,62,62,0,1,0,1,0,deny
1030,44847,0,0,62,62,0,1,0,1,0,deny
53575,445,0,0,66,66,0,1,0,1,0,drop
58326,50584,0,0,62,62,0,1,0,1,0,deny
53178,445,0,0,70,70,0,1,0,1,0,drop
53176,445,0,0,70,70,0,1,0,1,0,drop
53173,445,0,0,70,70,0,1,0,1,0,drop
53419,28189,0,0,60,60,0,1,0,1,0,deny
53171,445,0,0,70,70,0,1,0,1,0,drop
55157,7302,0,0,66,66,0,1,0,1,0,deny
34897,50584,0,0,62,62,0,1,0,1,0,deny
58149,445,0,0,70,70,0,1,0,1,0,drop
53207,50265,0,0,66,66,0,1,0,1,0,deny
58145,445,0,0,70,70,0,1,0,1,0,drop
58143,445,0,0,70,70,0,1,0,1,0,drop
58142,445,0,0,70,70,0,1,0,1,0,drop
1866,51505,0,0,66,66,0,1,0,1,0,deny
57676,64147,0,0,74,74,0,1,0,1,0,deny
46679,64147,0,0,62,62,0,1,0,1,0,deny
53568,445,0,0,66,66,0,1,0,1,0,drop
6881,64910,0,0,146,146,0,1,0,1,0,deny
53565,445,0,0,66,66,0,1,0,1,0,drop
53560,445,0,0,66,66,0,1,0,1,0,drop
53559,445,0,0,66,66,0,1,0,1,0,drop
59201,51221,0,0,66,66,0,1,0,1,0,deny
8191,51221,0,0,62,62,0,1,0,1,0,deny
57131,26296,0,0,145,145,0,1,0,1,0,deny
53558,445,0,0,66,66,0,1,0,1,0,drop
53555,445,0,0,66,66,0,1,0,1,0,drop
53557,445,0,0,66,66,0,1,0,1,0,drop
34930,20005,0,0,60,60,0,1,0,1,0,deny
53165,445,0,0,70,70,0,1,0,1,0,drop
53355,23117,0,0,62,62,0,1,0,1,0,deny
50031,44847,0,0,74,74,0,1,0,1,0,deny
443,64347,0,0,131,131,0,1,0,1,0,deny
50369,50584,0,0,66,66,0,1,0,1,0,deny
50562,37965,0,0,66,66,0,1,0,1,0,deny
5223,7851,0,0,66,66,0,1,0,1,0,deny
58137,445,0,0,70,70,0,1,0,1,0,drop
58139,445,0,0,70,70,0,1,0,1,0,drop
58134,445,0,0,70,70,0,1,0,1,0,drop
53551,445,0,0,66,66,0,1,0,1,0,drop
53157,445,0,0,70,70,0,1,0,1,0,drop
58132,445,0,0,70,70,0,1,0,1,0,drop
53156,445,0,0,70,70,0,1,0,1,0,drop
53550,445,0,0,66,66,0,1,0,1,0,drop
51909,6881,0,0,66,66,0,1,0,1,0,deny
57289,31573,0,0,66,66,0,1,0,1,0,deny
54773,50584,0,0,62,62,0,1,0,1,0,deny
62678,57470,0,0,62,62,0,1,0,1,0,deny
53548,445,0,0,66,66,0,1,0,1,0,drop
53547,445,0,0,66,66,0,1,0,1,0,drop
42951,44847,0,0,66,66,0,1,0,1,0,deny
53545,445,0,0,66,66,0,1,0,1,0,drop
50360,35440,0,0,66,66,0,1,0,1,0,deny
53150,445,0,0,70,70,0,1,0,1,0,drop
53166,61600,0,0,62,62,0,1,0,1,0,deny
14070,62413,0,0,66,66,0,1,0,1,0,deny
14260,36829,0,0,62,62,0,1,0,1,0,deny
7285,51221,0,0,66,66,0,1,0,1,0,deny
53149,445,0,0,70,70,0,1,0,1,0,drop
64175,56502,0,0,66,66,0,1,0,1,0,deny
7992,64147,0,0,62,62,0,1,0,1,0,deny
58125,445,0,0,70,70,0,1,0,1,0,drop
58116,445,0,0,70,70,0,1,0,1,0,drop
58117,445,0,0,70,70,0,1,0,1,0,drop
53145,445,0,0,70,70,0,1,0,1,0,drop
55254,50584,0,0,66,66,0,1,0,1,0,deny
17640,55442,0,0,66,66,0,1,0,1,0,deny
53144,445,0,0,70,70,0,1,0,1,0,drop
54991,36829,0,0,66,66,0,1,0,1,0,deny
53536,445,0,0,66,66,0,1,0,1,0,drop
21534,42246,0,0,66,66,0,1,0,1,0,deny
25015,64147,0,0,66,66,0,1,0,1,0,deny
30365,45991,0,0,60,60,0,1,0,1,0,deny
60875,56205,0,0,66,66,0,1,0,1,0,deny
34822,31573,0,0,62,62,0,1,0,1,0,deny
53526,445,0,0,66,66,0,1,0,1,0,drop
53139,445,0,0,70,70,0,1,0,1,0,drop
58108,445,0,0,70,70,0,1,0,1,0,drop
53523,445,0,0,66,66,0,1,0,1,0,drop
49485,11392,0,0,66,66,0,1,0,1,0,deny
51559,26467,0,0,66,66,0,1,0,1,0,deny
53517,445,0,0,66,66,0,1,0,1,0,drop
53506,445,0,0,66,66,0,1,0,1,0,drop
53126,445,0,0,70,70,0,1,0,1,0,drop
3521,6881,0,0,62,62,0,1,0,1,0,deny
28345,11392,0,0,66,66,0,1,0,1,0,deny
53123,445,0,0,70,70,0,1,0,1,0,drop
0,0,0,0,98,98,0,1,0,1,0,deny
0,0,0,0,60,60,0,1,0,1,0,deny
0,0,0,0,156,156,0,2,0,2,0,allow
0,0,0,0,98,98,0,1,0,1,0,deny
0,0,0,0,98,98,0,1,0,1,0,deny
0,0,0,0,244,244,0,2,0,2,0,allow
0,0,0,0,98,98,0,1,0,1,0,deny
42034,28189,0,0,62,62,0,1,0,1,0,deny
64324,37807,0,0,62,62,0,1,0,1,0,deny
58095,445,0,0,70,70,0,1,0,1,0,drop
58092,445,0,0,70,70,0,1,0,1,0,drop
58093,445,0,0,70,70,0,1,0,1,0,drop
5195,64147,0,0,66,66,0,1,0,1,0,deny
53494,445,0,0,66,66,0,1,0,1,0,drop
53496,445,0,0,66,66,0,1,0,1,0,drop
53499,445,0,0,66,66,0,1,0,1,0,drop
53501,445,0,0,66,66,0,1,0,1,0,drop
53497,445,0,0,66,66,0,1,0,1,0,drop
53498,445,0,0,66,66,0,1,0,1,0,drop
53500,445,0,0,66,66,0,1,0,1,0,drop
53495,445,0,0,66,66,0,1,0,1,0,drop
63670,64097,0,0,66,66,0,1,0,1,0,deny
43129,15503,0,0,62,62,0,1,0,1,0,deny
60550,50584,0,0,62,62,0,1,0,1,0,deny
57431,15503,0,0,66,66,0,1,0,1,0,deny
48298,2043,0,0,60,60,0,1,0,1,0,deny
53118,445,0,0,70,70,0,1,0,1,0,drop
52749,64147,0,0,66,66,0,1,0,1,0,deny
53117,445,0,0,70,70,0,1,0,1,0,drop
1025,35447,0,0,62,62,0,1,0,1,0,deny
20057,44847,0,0,62,62,0,1,0,1,0,deny
53115,445,0,0,70,70,0,1,0,1,0,drop
65501,26467,0,0,66,66,0,1,0,1,0,deny
60875,50584,0,0,66,66,0,1,0,1,0,deny
58086,445,0,0,70,70,0,1,0,1,0,drop
58087,445,0,0,70,70,0,1,0,1,0,drop
58082,445,0,0,70,70,0,1,0,1,0,drop
64406,50584,0,0,62,62,0,1,0,1,0,deny
57452,57470,0,0,62,62,0,1,0,1,0,deny
53481,445,0,0,66,66,0,1,0,1,0,drop
53480,445,0,0,66,66,0,1,0,1,0,drop
53479,445,0,0,66,66,0,1,0,1,0,drop
60384,64147,0,0,62,62,0,1,0,1,0,deny
58074,445,0,0,70,70,0,1,0,1,0,drop
53108,445,0,0,70,70,0,1,0,1,0,drop
57545,35440,0,0,66,66,0,1,0,1,0,deny
53106,445,0,0,70,70,0,1,0,1,0,drop
58072,445,0,0,70,70,0,1,0,1,0,drop
26528,51221,0,0,78,78,0,1,0,1,0,deny
58064,445,0,0,70,70,0,1,0,1,0,drop
58063,445,0,0,70,70,0,1,0,1,0,drop
58060,445,0,0,70,70,0,1,0,1,0,drop
53097,443,17057,443,7013,1718,5295,18,326,9,9,allow
53092,443,57966,443,8071,1789,6282,20,326,10,10,allow
53101,443,37557,443,8071,1789,6282,20,326,10,10,allow
47080,80,47080,80,276453,7832,268621,287,165,92,195,allow
56192,53,2949,53,170,87,83,2,30,1,1,allow
55056,53,8605,53,170,87,83,2,30,1,1,allow
58283,443,44449,443,42792,12402,30390,98,370,45,53,allow
51799,58416,38209,58416,316,136,180,6,6,3,3,allow
41328,53,51462,53,198,93,105,2,30,1,1,allow
53100,443,46629,443,8571,1789,6782,20,326,10,10,allow
53130,443,27794,443,7169,1715,5454,18,325,9,9,allow
56630,443,6016,443,7941,1952,5989,20,15,11,9,allow
57205,53,27220,53,711,87,624,2,30,1,1,allow
41520,53,0,0,82,82,0,1,30,1,0,allow
27005,27015,31409,27015,891,126,765,2,31,1,1,allow
53166,80,34843,80,1487,838,649,10,323,6,4,allow
53126,443,9290,443,5604,2738,2866,20,325,10,10,allow
53102,443,30366,443,7149,1719,5430,18,326,9,9,allow
53140,443,26358,443,6401,1225,5176,18,324,9,9,allow
53168,80,46007,80,1501,958,543,10,323,6,4,allow
58974,443,58974,443,6792,1521,5271,18,28,11,7,allow
55618,45341,55864,45341,70,70,0,2,8,2,0,allow
37961,443,21395,443,153,93,60,2,5,1,1,allow
28316,3389,28316,3389,4695,2520,2175,22,19,13,9,allow
37805,443,65176,443,5577,1977,3600,29,56,16,13,allow
45540,443,45540,443,4702,1795,2907,19,28,11,8,allow
64380,53,44055,53,98,98,0,1,30,1,0,allow
58970,80,38149,80,1521,967,554,10,75,6,4,allow
54823,53,13813,53,198,93,105,2,30,1,1,allow
57162,53,0,0,198,91,107,2,30,1,1,allow
29805,53,29805,53,226,89,137,2,30,1,1,allow
52728,80,55587,80,13372,7598,5774,29,555,18,11,allow
35601,80,28025,80,1151,711,440,10,15,5,5,allow
53138,443,15464,443,6760,1346,5414,18,325,9,9,allow
52652,443,14258,443,14511,4628,9883,29,559,15,14,allow
53158,443,6890,443,7427,1517,5910,22,323,11,11,allow
53095,443,22543,443,7014,1719,5295,18,326,9,9,allow
56803,52421,20663,52421,164,70,94,2,5,1,1,allow
39328,80,62636,80,234,234,0,4,12,4,0,allow
41518,443,53815,443,25342,17809,7533,56,80,28,28,allow
51775,57887,37993,57887,66,66,0,1,5,1,0,allow
56628,443,49515,443,7941,1952,5989,20,15,11,9,allow
3669,53,3669,53,825,99,726,2,30,1,1,allow
53085,53,0,0,82,82,0,1,30,1,0,allow
56629,443,57154,443,7889,1900,5989,20,15,11,9,allow
37233,53,50033,53,198,93,105,2,30,1,1,allow
60405,64722,47645,64722,70,70,0,2,8,2,0,allow
20892,53,20892,53,825,99,726,2,30,1,1,allow
53597,53,0,0,233,85,148,2,30,1,1,allow
56750,53,56750,53,217,87,130,2,30,1,1,allow
41772,80,18406,80,738,70,668,12,394,2,10,allow
52335,443,49316,443,5670,2739,2931,18,129,9,9,allow
8933,56205,0,0,62,62,0,1,0,1,0,deny
53105,445,0,0,70,70,0,1,0,1,0,drop
53104,445,0,0,70,70,0,1,0,1,0,drop
60294,30188,0,0,66,66,0,1,0,1,0,deny
53103,445,0,0,70,70,0,1,0,1,0,drop
27010,64147,0,0,62,62,0,1,0,1,0,deny
53097,445,0,0,70,70,0,1,0,1,0,drop
53100,445,0,0,70,70,0,1,0,1,0,drop
9605,57470,0,0,62,62,0,1,0,1,0,deny
11133,51505,0,0,66,66,0,1,0,1,0,deny
13441,57470,0,0,62,62,0,1,0,1,0,deny
12895,37965,0,0,62,62,0,1,0,1,0,deny
58074,11392,0,0,66,66,0,1,0,1,0,deny
48706,23393,0,0,60,60,0,1,0,1,0,deny
53650,64147,0,0,66,66,0,1,0,1,0,deny
43671,37965,0,0,62,62,0,1,0,1,0,deny
52356,55442,0,0,66,66,0,1,0,1,0,deny
3564,57470,0,0,62,62,0,1,0,1,0,deny
42783,53,31772,53,199,94,105,2,30,1,1,allow
39834,53,46672,53,199,94,105,2,30,1,1,allow
51270,48061,59473,48061,70,70,0,2,8,2,0,allow
41295,443,9928,443,1482,988,494,12,26,7,5,allow
3578,51505,0,0,66,66,0,1,0,1,0,deny
53085,445,0,0,70,70,0,1,0,1,0,drop
53083,445,0,0,70,70,0,1,0,1,0,drop
53080,445,0,0,70,70,0,1,0,1,0,drop
53075,445,0,0,70,70,0,1,0,1,0,drop
53074,445,0,0,70,70,0,1,0,1,0,drop
50143,35253,0,0,62,62,0,1,0,1,0,deny
58054,445,0,0,70,70,0,1,0,1,0,drop
58053,445,0,0,70,70,0,1,0,1,0,drop
58049,445,0,0,70,70,0,1,0,1,0,drop
64051,36829,0,0,62,62,0,1,0,1,0,deny
28221,37965,0,0,62,62,0,1,0,1,0,deny
62386,37965,0,0,66,66,0,1,0,1,0,deny
47173,35440,0,0,146,146,0,1,0,1,0,deny
16322,57470,0,0,62,62,0,1,0,1,0,deny
53063,445,0,0,70,70,0,1,0,1,0,drop
58468,37965,0,0,66,66,0,1,0,1,0,deny
53454,445,0,0,66,66,0,1,0,1,0,drop
37646,53,37646,53,832,106,726,2,30,1,1,allow
37066,443,21003,443,2386,1423,963,18,169,10,8,allow
58780,443,38855,443,8661,1687,6974,30,244,16,14,allow
65471,443,32170,443,92569,4939,87630,111,15,45,66,allow
65118,53,14399,53,539,91,448,4,43,2,2,allow
55613,56511,52356,56511,504,318,186,8,15,5,3,allow
63971,53,59567,53,358,94,264,4,45,2,2,allow
55889,53,31264,53,177,94,83,2,29,1,1,allow
56448,53,60650,53,177,94,83,2,29,1,1,allow
52957,80,46330,80,156378,5406,150972,165,383,60,105,allow
64540,53,44077,53,352,107,245,4,37,2,2,allow
60404,37869,39714,37869,258,70,188,4,8,2,2,allow
56799,1,48991,1,316,136,180,6,6,3,3,allow
64407,53,18646,53,232,110,122,2,29,1,1,allow
53115,40693,57479,40693,70,70,0,1,5,1,0,allow
51513,443,33339,443,75323,6054,69269,110,38,52,58,allow
35515,53,6694,53,199,94,105,2,29,1,1,allow
65111,53,60409,53,198,94,104,2,29,1,1,allow
26900,27017,25827,27017,172,86,86,2,29,1,1,allow
49360,53,44969,53,263,102,161,2,29,1,1,allow
49818,53,22415,53,211,102,109,2,29,1,1,allow
52922,443,7305,443,5583,1390,4193,19,15,9,10,allow
19872,53,19872,53,235,90,145,2,32,1,1,allow
51773,23728,8041,23728,70,70,0,1,5,1,0,allow
5588,5588,0,0,3354,1792,1562,46,193,23,23,allow
65064,53,64961,53,197,94,103,2,30,1,1,allow
29606,53,29606,53,216,90,126,2,30,1,1,allow
27005,27015,58465,27015,881,126,755,2,30,1,1,allow
57867,27019,34880,27019,468,390,78,5,30,4,1,allow
64365,53,32131,53,234,94,140,2,30,1,1,allow
53160,80,36074,80,1213,725,488,10,323,6,4,allow
51776,14645,62934,14645,70,70,0,1,5,1,0,allow
60753,40010,14923,40010,316,136,180,6,6,3,3,allow
46263,7700,25323,7700,1440,956,484,15,35,8,7,allow
51793,12210,40752,12210,70,70,0,2,8,2,0,allow
50648,80,8370,80,62,62,0,1,5,1,0,allow
59975,443,17092,443,7875,3100,4775,42,24,22,20,allow
49913,443,1275,443,4275,2222,2053,24,15,14,10,allow
53577,8999,47694,8999,372,186,186,6,15,3,3,allow
56792,42155,2470,42155,70,70,0,2,8,2,0,allow
49662,443,39223,443,2690,1342,1348,23,19,12,11,allow
55056,53,24229,53,177,94,83,2,30,1,1,allow
44498,53,11053,53,168,78,90,2,30,1,1,allow
63966,53,6914,53,214,102,112,2,30,1,1,allow
48165,53,17622,53,199,94,105,2,30,1,1,allow
50838,53,8440,53,70,70,0,1,30,1,0,allow
27005,27015,14961,27015,884,126,758,2,30,1,1,allow
56266,53,6584,53,245,102,143,2,30,1,1,allow
51505,443,46771,443,645662,22326,623336,743,41,299,444,allow
49202,80,38617,80,3223,605,2618,13,15,7,6,allow
33254,443,31595,443,4838,2974,1864,21,17,13,8,allow
27005,27016,2493,27016,895,126,769,2,30,1,1,allow
52932,80,19505,80,4214,1921,2293,18,383,10,8,allow
13514,53,13514,53,244,98,146,2,32,1,1,allow
7447,53,7447,53,244,98,146,2,32,1,1,allow
51791,56116,1472,56116,70,70,0,2,8,2,0,allow
60406,64337,47861,64337,70,70,0,2,8,2,0,allow
42165,443,38543,443,7583,607,6976,18,119,7,11,allow
57790,443,14547,443,6321,3341,2980,19,135,9,10,allow
46762,443,18994,443,565251,13665,551586,542,30,173,369,allow
56405,443,34557,443,6202,1212,4990,27,1197,8,19,allow
27005,27025,44976,27025,893,126,767,2,30,1,1,allow
53490,80,9100,80,2577,1278,1299,14,267,8,6,allow
52732,80,5693,80,23509,14666,8843,70,553,38,32,allow
56791,11500,39420,11500,70,70,0,2,8,2,0,allow
55611,58049,54667,58049,504,318,186,8,15,5,3,allow
28004,443,21121,443,5517,1390,4127,18,15,9,9,allow
26900,27017,23576,27017,340,82,258,5,29,2,3,allow
59756,53,24009,53,211,78,133,2,29,1,1,allow
56970,80,14502,80,1783,841,942,10,20,6,4,allow
27005,27015,4886,27015,876,126,750,2,30,1,1,allow
64481,53,22915,53,386,106,280,4,51,2,2,allow
26900,27017,12614,27017,422,164,258,6,29,3,3,allow
42956,443,56970,443,11435,2668,8767,38,233,14,24,allow
55889,53,19175,53,177,94,83,2,29,1,1,allow
57788,443,31761,443,6400,1327,5073,21,21,13,8,allow
44389,53,44389,53,235,90,145,2,32,1,1,allow
56745,53,50042,53,900,110,790,2,30,1,1,allow
34988,53,12799,53,199,94,105,2,30,1,1,allow
60469,53,22418,53,78,78,0,1,30,1,0,allow
51217,443,21771,443,126,60,66,3,5,2,1,allow
51774,16930,9118,16930,70,70,0,1,5,1,0,allow
49686,443,60868,443,8475,1661,6814,32,76,14,18,allow
46262,123,34977,123,184,94,90,2,30,1,1,allow
49986,53,35150,53,209,94,115,2,30,1,1,allow
60752,28080,38222,28080,70,70,0,2,8,2,0,allow
51268,47662,19145,47662,70,70,0,1,5,1,0,allow
49798,53,59765,53,365,97,268,4,40,2,2,allow
42917,53,23421,53,168,78,90,2,30,1,1,allow
52318,443,6808,443,9453,2797,6656,46,32,25,21,allow
27005,27015,56758,27015,869,126,743,2,30,1,1,allow
27005,27015,46152,27015,875,126,749,2,30,1,1,allow
60281,443,39585,443,63696,4774,58922,83,125,32,51,allow
41476,53,41476,53,235,90,145,2,33,1,1,allow
51794,53911,31763,53911,70,70,0,2,8,2,0,allow
51795,60258,12488,60258,70,70,0,2,8,2,0,allow
56617,80,63909,80,234,234,0,4,12,4,0,allow
49556,443,13898,443,6440,1844,4596,22,141,11,11,allow
8180,53,8180,53,220,90,130,2,30,1,1,allow
64415,53,14789,53,228,102,126,2,30,1,1,allow
56192,53,54480,53,177,94,83,2,30,1,1,allow
64678,53,21797,53,229,110,119,2,30,1,1,allow
27005,27015,19285,27015,892,126,766,2,30,1,1,allow
58805,443,39224,443,9030,2311,6719,24,362,13,11,allow
60408,55557,44331,55557,70,70,0,2,8,2,0,allow
57470,24874,7043,24874,132,132,0,3,1199,3,0,allow
50265,55243,25034,55243,481,150,331,2,1200,1,1,allow
50186,443,39007,443,6440,1603,4837,23,361,11,12,allow
17750,1024,34469,1024,323,150,173,2,1200,1,1,allow
49657,443,29231,443,9039,2175,6864,32,20,17,15,allow
56192,53,12282,53,282,87,195,4,45,2,2,allow
59974,443,48312,443,200862,57949,142913,361,24,172,189,allow
56140,53,23511,53,195,86,109,2,30,1,1,allow
63787,18318,40020,18318,66,66,0,2,8,2,0,allow
53601,30160,44927,30160,70,70,0,2,8,2,0,allow
59980,443,52666,443,345468,18536,326932,432,22,200,232,allow
52763,443,13803,443,256711,14141,242570,367,96,152,215,allow
36025,443,36025,443,4585,1678,2907,19,29,11,8,allow
64973,53,36407,53,257,102,155,2,30,1,1,allow
57096,53,51826,53,177,94,83,2,30,1,1,allow
52921,443,13055,443,5581,1388,4193,19,15,9,10,allow
28003,443,64020,443,5515,1388,4127,18,15,9,9,allow
52412,443,22141,443,11565,5557,6008,52,16,27,25,allow
49743,53,12081,53,636,202,434,6,47,3,3,allow
65511,53,22579,53,545,136,409,4,56,2,2,allow
56363,53,52930,53,212,102,110,2,30,1,1,allow
65209,57866,0,0,62,62,0,1,0,1,0,deny
58043,445,0,0,70,70,0,1,0,1,0,drop
53419,28189,0,0,60,60,0,1,0,1,0,deny
2323,23117,0,0,62,62,0,1,0,1,0,deny
18091,23,0,0,60,60,0,1,0,1,0,deny
6889,40740,0,0,143,143,0,1,0,1,0,deny
58787,23,0,0,60,60,0,1,0,1,0,deny
64940,36237,0,0,62,62,0,1,0,1,0,deny
53059,445,0,0,70,70,0,1,0,1,0,drop
1024,57470,0,0,62,62,0,1,0,1,0,deny
53449,445,0,0,66,66,0,1,0,1,0,drop
53448,445,0,0,66,66,0,1,0,1,0,drop
52064,22114,0,0,66,66,0,1,0,1,0,deny
58036,445,0,0,70,70,0,1,0,1,0,drop
53049,445,0,0,70,70,0,1,0,1,0,drop
53050,445,0,0,70,70,0,1,0,1,0,drop
2923,57470,0,0,66,66,0,1,0,1,0,deny
4127,26467,0,0,66,66,0,1,0,1,0,deny
53044,445,0,0,70,70,0,1,0,1,0,drop
53045,445,0,0,70,70,0,1,0,1,0,drop
58030,445,0,0,70,70,0,1,0,1,0,drop
58027,445,0,0,70,70,0,1,0,1,0,drop
58023,445,0,0,70,70,0,1,0,1,0,drop
53043,445,0,0,70,70,0,1,0,1,0,drop
53447,445,0,0,66,66,0,1,0,1,0,drop
80,37649,0,0,60,60,0,1,0,1,0,deny
59781,56205,0,0,66,66,0,1,0,1,0,deny
6881,59353,0,0,146,146,0,1,0,1,0,deny
6881,29517,0,0,146,146,0,1,0,1,0,deny
58020,445,0,0,70,70,0,1,0,1,0,drop
58017,445,0,0,70,70,0,1,0,1,0,drop
58015,445,0,0,70,70,0,1,0,1,0,drop
58013,445,0,0,70,70,0,1,0,1,0,drop
53439,445,0,0,66,66,0,1,0,1,0,drop
53037,445,0,0,70,70,0,1,0,1,0,drop
53242,37965,0,0,66,66,0,1,0,1,0,deny
53433,445,0,0,66,66,0,1,0,1,0,drop
53432,445,0,0,66,66,0,1,0,1,0,drop
53431,445,0,0,66,66,0,1,0,1,0,drop
80,53945,0,0,60,60,0,1,0,1,0,deny
19747,37965,0,0,62,62,0,1,0,1,0,deny
53427,445,0,0,66,66,0,1,0,1,0,drop
53428,445,0,0,66,66,0,1,0,1,0,drop
53429,445,0,0,66,66,0,1,0,1,0,drop
50067,64147,0,0,66,66,0,1,0,1,0,deny
29203,26467,0,0,62,62,0,1,0,1,0,deny
6416,22114,0,0,66,66,0,1,0,1,0,deny
53029,445,0,0,70,70,0,1,0,1,0,drop
36930,22,36930,22,293,126,167,4,0,2,2,deny
5222,48709,0,0,66,66,0,1,0,1,0,deny
53027,445,0,0,70,70,0,1,0,1,0,drop
58011,445,0,0,70,70,0,1,0,1,0,drop
58010,445,0,0,70,70,0,1,0,1,0,drop
58008,445,0,0,70,70,0,1,0,1,0,drop
53425,445,0,0,66,66,0,1,0,1,0,drop
58004,445,0,0,70,70,0,1,0,1,0,drop
49842,7302,0,0,66,66,0,1,0,1,0,deny
53421,445,0,0,66,66,0,1,0,1,0,drop
57478,7302,0,0,66,66,0,1,0,1,0,deny
50820,57470,0,0,66,66,0,1,0,1,0,deny
17837,62609,0,0,148,148,0,1,0,1,0,deny
53418,445,0,0,66,66,0,1,0,1,0,drop
53419,445,0,0,66,66,0,1,0,1,0,drop
53023,445,0,0,70,70,0,1,0,1,0,drop
63305,62413,0,0,62,62,0,1,0,1,0,deny
53415,445,0,0,66,66,0,1,0,1,0,drop
53021,445,0,0,70,70,0,1,0,1,0,drop
443,64347,0,0,131,131,0,1,0,1,0,deny
3541,22114,0,0,62,62,0,1,0,1,0,deny
53017,445,0,0,70,70,0,1,0,1,0,drop
57996,445,0,0,70,70,0,1,0,1,0,drop
26722,11446,0,0,62,62,0,1,0,1,0,deny
57995,445,0,0,70,70,0,1,0,1,0,drop
57990,445,0,0,70,70,0,1,0,1,0,drop
26084,36237,0,0,66,66,0,1,0,1,0,deny
58468,57587,0,0,66,66,0,1,0,1,0,deny
53016,445,0,0,70,70,0,1,0,1,0,drop
57789,30188,0,0,62,62,0,1,0,1,0,deny
19534,26467,0,0,66,66,0,1,0,1,0,deny
53405,445,0,0,66,66,0,1,0,1,0,drop
50878,53733,0,0,66,66,0,1,0,1,0,deny
27064,51221,0,0,72,72,0,1,0,1,0,deny
61701,44847,0,0,66,66,0,1,0,1,0,deny
49628,35440,0,0,66,66,0,1,0,1,0,deny
19610,9571,0,0,62,62,0,1,0,1,0,deny
443,9986,0,0,66,66,0,1,0,1,0,deny
443,9986,0,0,152,152,0,1,0,1,0,deny
57060,50584,0,0,62,62,0,1,0,1,0,deny
53011,445,0,0,70,70,0,1,0,1,0,drop
53397,445,0,0,66,66,0,1,0,1,0,drop
51725,56205,0,0,62,62,0,1,0,1,0,deny
0,0,0,0,98,98,0,1,0,1,0,deny
0,0,0,0,98,98,0,1,0,1,0,deny
53395,445,0,0,66,66,0,1,0,1,0,drop
1888,51505,0,0,62,62,0,1,0,1,0,deny
52431,50265,0,0,62,62,0,1,0,1,0,deny
25565,30367,0,0,60,60,0,1,0,1,0,deny
65512,44847,0,0,62,62,0,1,0,1,0,deny
53388,445,0,0,66,66,0,1,0,1,0,drop
52998,445,0,0,70,70,0,1,0,1,0,drop
51760,50584,0,0,62,62,0,1,0,1,0,deny
53377,445,0,0,66,66,0,1,0,1,0,drop
51674,51505,0,0,66,66,0,1,0,1,0,deny
23274,50584,0,0,62,62,0,1,0,1,0,deny
59055,11392,0,0,62,62,0,1,0,1,0,deny
54062,49813,0,0,62,62,0,1,0,1,0,deny
52447,43890,0,0,66,66,0,1,0,1,0,deny
52995,445,0,0,70,70,0,1,0,1,0,drop
80,9918,0,0,60,60,0,1,0,1,0,deny
49976,22114,0,0,62,62,0,1,0,1,0,deny
443,52365,0,0,97,97,0,1,0,1,0,deny
36908,26467,0,0,62,62,0,1,0,1,0,deny
57965,445,0,0,70,70,0,1,0,1,0,drop
57967,445,0,0,70,70,0,1,0,1,0,drop
57964,445,0,0,70,70,0,1,0,1,0,drop
53371,445,0,0,66,66,0,1,0,1,0,drop
53372,445,0,0,66,66,0,1,0,1,0,drop
53370,445,0,0,66,66,0,1,0,1,0,drop
53369,445,0,0,66,66,0,1,0,1,0,drop
53368,445,0,0,66,66,0,1,0,1,0,drop
53367,445,0,0,66,66,0,1,0,1,0,drop
53366,445,0,0,66,66,0,1,0,1,0,drop
53365,445,0,0,66,66,0,1,0,1,0,drop
23776,57354,0,0,145,145,0,1,0,1,0,deny
45079,31573,0,0,62,62,0,1,0,1,0,deny
52990,445,0,0,70,70,0,1,0,1,0,drop
57654,35440,0,0,66,66,0,1,0,1,0,deny
52989,445,0,0,70,70,0,1,0,1,0,drop
61520,23718,0,0,66,66,0,1,0,1,0,deny
27147,22114,0,0,62,62,0,1,0,1,0,deny
26528,51221,0,0,78,78,0,1,0,1,0,deny
62776,62413,0,0,62,62,0,1,0,1,0,deny
52987,445,0,0,70,70,0,1,0,1,0,drop
54600,6881,0,0,66,66,0,1,0,1,0,deny
65454,61600,0,0,66,66,0,1,0,1,0,deny
46478,64147,0,0,62,62,0,1,0,1,0,deny
62737,64147,0,0,66,66,0,1,0,1,0,deny
53460,443,38830,443,25079,5739,19340,39,337,18,21,allow
11592,80,11592,80,6967,765,6202,15,16,7,8,allow
55021,443,3999,443,5987,1556,4431,19,47,12,7,allow
57194,53,31354,53,2198,193,2005,6,90,3,3,allow
53009,80,53009,80,378,180,198,7,17,4,3,allow
41625,15000,38798,15000,130,70,60,2,5,1,1,allow
59420,443,62141,443,2854,1732,1122,16,15,8,8,allow
54135,443,36564,443,11065,1394,9671,23,75,13,10,allow
57140,53,16030,53,170,87,83,2,30,1,1,allow
51772,59814,9968,59814,66,66,0,1,5,1,0,allow
52107,443,6381,443,12091,3135,8956,30,49,16,14,allow
58885,15000,9072,15000,138,78,60,2,5,1,1,allow
55584,53,31260,53,184,80,104,2,30,1,1,allow
37444,53,37444,53,213,79,134,2,32,1,1,allow
60017,443,51690,443,134,60,74,3,10,2,1,allow
61467,443,56685,443,130792,4916,125876,161,89,69,92,allow
39336,443,55309,443,7759,4000,3759,23,96,11,12,allow
58259,53,21594,53,578,286,292,9,15,5,4,allow
55540,443,32830,443,10458,5272,5186,24,76,13,11,allow
55786,53,21732,53,170,87,83,2,30,1,1,allow
39611,443,2531,443,78,78,0,1,5,1,0,allow
61469,443,16667,443,6204,1125,5079,23,89,13,10,allow
54137,443,45668,443,10046,1394,8652,22,75,13,9,allow
61493,443,44435,443,5325,1242,4083,23,27,13,10,allow
54134,443,5561,443,10425,1383,9042,23,75,13,10,allow
61494,443,60069,443,14558,2653,11905,33,27,18,15,allow
59419,443,5544,443,2854,1732,1122,16,15,8,8,allow
61462,443,27750,443,6271,1191,5080,24,94,14,10,allow
56360,53,64885,53,711,87,624,2,30,1,1,allow
55800,53,53999,53,711,87,624,2,30,1,1,allow
49685,443,41646,443,8435,1687,6748,30,76,14,16,allow
50564,443,64623,443,1894028,31411,1862617,1579,122,209,1370,allow
54136,443,41489,443,10109,1394,8715,22,75,13,9,allow
2084,7000,2084,7000,3566,1999,1567,16,15,8,8,allow
56626,443,26601,443,7941,1952,5989,20,15,11,9,allow
61465,80,64777,80,17320,9430,7890,67,93,35,32,allow
35053,80,19912,80,71843,2833,69010,83,15,36,47,allow
61468,443,50536,443,6265,1185,5080,24,89,14,10,allow
61464,80,54948,80,366,180,186,7,93,4,3,allow
56627,443,11832,443,7889,1900,5989,20,15,11,9,allow
61461,443,31107,443,9073,2899,6174,36,94,19,17,allow
61466,443,43127,443,6205,1125,5080,23,89,13,10,allow
63793,53,63793,53,237,91,146,2,33,1,1,allow
58994,443,24369,443,204,70,134,4,25,2,2,allow
56625,443,59240,443,7888,1899,5989,20,15,11,9,allow
59418,443,6727,443,2946,1812,1134,16,15,8,8,allow
56624,443,34630,443,7940,1951,5989,20,16,11,9,allow
41335,53,41335,53,825,99,726,2,30,1,1,allow
48720,53,0,0,82,82,0,1,30,1,0,allow
56472,53,0,0,371,77,294,2,30,1,1,allow
65386,443,29589,443,5405,4034,1371,25,43,10,15,allow
48533,443,47218,443,160,69,91,2,121,1,1,allow
13262,53,13262,53,208,94,114,2,31,1,1,allow
36986,53,36986,53,234,93,141,2,31,1,1,allow
5431,53,5431,53,224,88,136,2,31,1,1,allow
7176,53,7176,53,233,91,142,2,31,1,1,allow
5938,47512,0,0,60,60,0,1,90,1,0,allow
55542,53,5269,53,711,87,624,2,31,1,1,allow
52151,53,52151,53,198,89,109,2,31,1,1,allow
11835,53,11835,53,216,88,128,2,31,1,1,allow
27386,53,27386,53,194,87,107,2,31,1,1,allow
52677,53,52677,53,233,91,142,2,31,1,1,allow
56282,53,56282,53,194,87,107,2,31,1,1,allow
55128,53,34503,53,711,87,624,2,31,1,1,allow
50038,53,0,0,275,85,190,2,31,1,1,allow
50038,53,0,0,275,85,190,2,31,1,1,allow
57470,32177,25835,32177,480,149,331,2,1200,1,1,allow
30960,45692,4911,45692,330,330,0,6,3609,6,0,allow
61896,34021,0,0,66,66,0,1,91,1,0,allow
32618,53,32618,53,231,90,141,2,31,1,1,allow
47063,53,47063,53,221,89,132,2,31,1,1,allow
58178,53,58178,53,237,93,144,2,31,1,1,allow
8762,53,8762,53,233,91,142,2,31,1,1,allow
63755,53,63755,53,223,92,131,2,31,1,1,allow
41199,443,15931,443,30604,3050,27554,45,122,18,27,allow
59267,53,59267,53,222,87,135,2,31,1,1,allow
55072,53,31850,53,168,86,82,2,31,1,1,allow
49432,5228,59843,5228,10635,3087,7548,41,3661,22,19,allow
54693,30188,0,0,66,66,0,1,0,1,0,deny
57963,445,0,0,70,70,0,1,0,1,0,drop
57961,445,0,0,70,70,0,1,0,1,0,drop
57956,445,0,0,70,70,0,1,0,1,0,drop
8239,37965,0,0,146,146,0,1,0,1,0,deny
53352,445,0,0,66,66,0,1,0,1,0,drop
53351,445,0,0,66,66,0,1,0,1,0,drop
53349,445,0,0,66,66,0,1,0,1,0,drop
52980,445,0,0,70,70,0,1,0,1,0,drop
4447,35440,0,0,66,66,0,1,0,1,0,deny
57946,445,0,0,70,70,0,1,0,1,0,drop
51192,15503,0,0,66,66,0,1,0,1,0,deny
60751,20010,54269,20010,70,70,0,2,8,2,0,allow
55786,53,23026,53,177,94,83,2,30,1,1,allow
59984,443,19518,443,1527,940,587,14,21,8,6,allow
59982,443,1995,443,1467,880,587,13,21,7,6,allow
53603,53796,63183,53796,70,70,0,2,7,2,0,allow
52978,445,0,0,70,70,0,1,0,1,0,drop
21892,15503,0,0,62,62,0,1,0,1,0,deny
4961,62741,0,0,66,66,0,1,0,1,0,deny
39895,26467,0,0,62,62,0,1,0,1,0,deny
52977,445,0,0,70,70,0,1,0,1,0,drop
57944,445,0,0,70,70,0,1,0,1,0,drop
26800,22,0,0,60,60,0,1,0,1,0,deny
52976,445,0,0,70,70,0,1,0,1,0,drop
52975,445,0,0,70,70,0,1,0,1,0,drop
57943,445,0,0,70,70,0,1,0,1,0,drop
57934,445,0,0,70,70,0,1,0,1,0,drop
57936,445,0,0,70,70,0,1,0,1,0,drop
52971,445,0,0,70,70,0,1,0,1,0,drop
52970,445,0,0,70,70,0,1,0,1,0,drop
61426,64910,0,0,66,66,0,1,0,1,0,deny
50717,9571,0,0,62,62,0,1,0,1,0,deny
21420,44847,0,0,66,66,0,1,0,1,0,deny
42252,33303,0,0,60,60,0,1,0,1,0,deny
52957,445,0,0,70,70,0,1,0,1,0,drop
52956,445,0,0,70,70,0,1,0,1,0,drop
52953,445,0,0,70,70,0,1,0,1,0,drop
443,64347,0,0,60,60,0,1,0,1,0,deny
52945,445,0,0,70,70,0,1,0,1,0,drop
52946,445,0,0,70,70,0,1,0,1,0,drop
55056,53,38233,53,177,94,83,2,29,1,1,allow
49940,53,29743,53,197,94,103,2,29,1,1,allow
56646,53,30377,53,177,94,83,2,30,1,1,allow
51103,80,39889,80,2792,2073,719,15,30,9,6,allow
63786,50091,30767,50091,66,66,0,2,7,2,0,allow
59608,443,1997,443,2149,1277,872,18,829,10,8,allow
53602,12395,26422,12395,70,70,0,2,7,2,0,allow
59981,443,57380,443,180817,9921,170896,241,21,116,125,allow
55462,53,41879,53,194,102,92,2,33,1,1,allow
55417,53,62498,53,198,102,96,2,32,1,1,allow
51975,443,14807,443,29510,15378,14132,76,216,35,41,allow
123,123,55557,123,184,94,90,2,29,1,1,allow
56646,53,16936,53,177,94,83,2,29,1,1,allow
54427,443,64059,443,2878,1252,1626,16,361,9,7,allow
51100,80,29611,80,12300,4454,7846,26,30,13,13,allow
55615,13826,16730,13826,70,70,0,1,5,1,0,allow
27490,53,27490,53,214,82,132,2,33,1,1,allow
49176,443,60169,443,533295,14310,518985,552,18,201,351,allow
61472,443,58092,443,6211,1132,5079,23,88,13,10,allow
58557,443,4317,443,114852,43911,70941,248,69,132,116,allow
42106,443,29417,443,5361,973,4388,18,15,10,8,allow
49752,53,64105,53,193,102,91,2,30,1,1,allow
52407,443,29892,443,1043,556,487,10,16,6,4,allow
60455,443,23230,443,25055,5440,19615,65,84,35,30,allow
2083,7000,2083,7000,3374,1535,1839,16,15,8,8,allow
61833,443,61833,443,80743,4724,76019,101,89,37,64,allow
55041,53,58764,53,234,94,140,2,30,1,1,allow
43677,443,54935,443,30090,19982,10108,77,543,41,36,allow
55614,29731,26252,29731,70,70,0,1,5,1,0,allow
57140,53,49557,53,177,94,83,2,30,1,1,allow
37697,443,26341,443,2071929,56793,2015136,2088,179,685,1403,allow
51771,19103,1964,19103,70,70,0,1,5,1,0,allow
55254,443,12972,443,3257,782,2475,17,140,8,9,allow
50151,53,24855,53,177,94,83,2,30,1,1,allow
61470,443,10942,443,12420,4900,7520,47,88,24,23,allow
52408,443,37575,443,1043,556,487,10,16,6,4,allow
56798,40759,43301,40759,70,70,0,1,5,1,0,allow
61463,443,9374,443,11355,3474,7881,45,93,22,23,allow
42599,443,19054,443,215284,28807,186477,346,129,151,195,allow
55607,17820,29778,17820,504,318,186,8,16,5,3,allow
56569,53,52915,53,94,94,0,1,30,1,0,allow
64537,53,63183,53,718,94,624,2,30,1,1,allow
55610,23383,13424,23383,70,70,0,1,5,1,0,allow
43205,22,43205,22,6957,2330,4627,35,27,17,18,allow
55429,443,25959,443,6292,4834,1458,18,129,11,7,allow
46695,443,28304,443,12787534,288179,12499355,12299,64,4036,8263,allow
44836,443,51394,443,34881,6721,28160,62,46,30,32,allow
2085,7010,2085,7010,3342,1983,1359,16,15,8,8,allow
49724,443,21055,443,4139,511,3628,12,15,6,6,allow
37310,443,2394,443,3950,2949,1001,26,69,15,11,allow
51102,80,31602,80,2794,2075,719,15,30,9,6,allow
50638,443,62460,443,14401,2712,11689,52,19,23,29,allow
55836,53,41454,53,181,94,87,2,33,1,1,allow
49374,53,26610,53,307,102,205,4,35,2,2,allow
49658,443,50327,443,14121,2299,11822,37,19,19,18,allow
56783,21279,24337,21279,70,70,0,1,5,1,0,allow
59983,443,57676,443,158230,9208,149022,214,21,105,109,allow
1462,41599,48660,41599,70,70,0,2,8,2,0,allow
50202,443,56858,443,8415,3119,5296,26,73,9,17,allow
64779,53,46294,53,497,102,395,4,40,2,2,allow
39570,443,58125,443,127970,4968,123002,144,30,53,91,allow
61471,443,26685,443,18168,2973,15195,46,88,21,25,allow
42963,443,15595,443,7681,4711,2970,36,28,17,19,allow
52112,443,29903,443,59796,4486,55310,92,48,45,47,allow
58302,443,37691,443,4611,3176,1435,26,30,15,11,allow
26865,443,47610,443,20959,15902,5057,38,20,21,17,allow
64636,53,42647,53,727,223,504,6,70,3,3,allow
27005,23010,35544,23010,881,126,755,2,29,1,1,allow
49284,53,32626,53,245,102,143,2,29,1,1,allow
49163,36069,48102,36069,5990,5698,292,17,51,14,3,allow
57096,53,50734,53,177,94,83,2,29,1,1,allow
49844,53,30878,53,755,102,653,2,30,1,1,allow
55777,53,11730,53,200,94,106,2,30,1,1,allow
55699,53,21219,53,211,102,109,2,29,1,1,allow
35546,443,6886,443,5198,973,4225,16,17,10,6,allow
49203,53,26385,53,240,94,146,2,29,1,1,allow
55669,53,15322,53,94,94,0,1,29,1,0,allow
55786,53,33325,53,177,94,83,2,30,1,1,allow
57397,53,56026,53,177,94,83,2,31,1,1,allow
65269,53,55640,53,273,134,139,2,30,1,1,allow
65291,53,62097,53,247,118,129,2,30,1,1,allow
49234,53,59585,53,177,94,83,2,30,1,1,allow
23514,53,23514,53,245,98,147,2,30,1,1,allow
49792,443,37527,443,9841,3185,6656,25,186,14,11,allow
40985,443,29028,443,3166,2097,1069,24,46,12,12,allow
60401,30046,40405,30046,70,70,0,1,5,1,0,allow
55609,39869,60499,39869,70,70,0,1,5,1,0,allow
39571,443,44587,443,580560,15724,564836,583,30,187,396,allow
39573,443,27028,443,29226,2150,27076,44,30,19,25,allow
39569,443,5001,443,1784075,46752,1737323,1812,47,606,1206,allow
57004,53,12740,53,195,78,117,2,30,1,1,allow
56551,53,25599,53,225,102,123,2,30,1,1,allow
45816,443,14384,443,21950,3632,18318,46,140,20,26,allow
49160,14387,38901,14387,854,150,704,4,1200,2,2,allow
1609,53,1609,53,197,90,107,2,30,1,1,allow
63526,3389,63526,3389,4365,2581,1784,20,33,11,9,allow
32811,443,18226,443,16652,13777,2875,48,44,27,21,allow
39572,443,50194,443,64247,3857,60390,94,30,43,51,allow
58056,443,35080,443,10493,2658,7835,50,1469,26,24,allow
60400,56243,17811,56243,70,70,0,1,5,1,0,allow
60822,443,12029,443,7839,2697,5142,21,137,10,11,allow
63967,53,22995,53,195,102,93,2,33,1,1,allow
51790,46839,55080,46839,70,70,0,2,8,2,0,allow
57140,53,49322,53,177,94,83,2,30,1,1,allow
63972,53,28656,53,325,94,231,2,30,1,1,allow
50151,53,38506,53,177,94,83,2,30,1,1,allow
57397,53,60967,53,177,94,83,2,30,1,1,allow
55539,53,25818,53,249,94,155,2,31,1,1,allow
37965,14259,39595,14259,150,150,0,1,1199,1,0,allow
52048,443,14008,443,3182,1568,1614,8,120,4,4,allow
49919,53,2531,53,225,102,123,2,30,1,1,allow
27005,1102,9620,1102,867,126,741,2,30,1,1,allow
49672,53,36807,53,718,94,624,2,30,1,1,allow
49509,53,2190,53,339,110,229,2,30,1,1,allow
49757,53,31813,53,177,94,83,2,31,1,1,allow
53521,443,20457,443,280,140,140,5,129,3,2,allow
6881,37957,48141,37957,509,150,359,2,1199,1,1,allow
51221,9869,40891,9869,870,330,540,12,1298,6,6,allow
37272,443,58616,443,10809,2465,8344,45,121,21,24,allow
37989,49152,16381,49152,156,156,0,3,8,3,0,allow
58969,80,39801,80,1431,783,648,10,75,6,4,allow
51247,443,62660,443,5747,1892,3855,19,16,11,8,allow
57117,443,28755,443,8997,1155,7842,19,76,11,8,allow
50905,80,47395,80,11749346,149441,11599905,10089,147,2116,7973,allow
41210,443,59857,443,78,78,0,1,5,1,0,allow
58796,443,14867,443,7402,2429,4973,40,139,22,18,allow
58802,443,37884,443,8591,2275,6316,37,137,21,16,allow
51237,443,50232,443,9668,4698,4970,42,16,25,17,allow
55113,53,62810,53,198,102,96,2,33,1,1,allow
49665,53,6360,53,779,298,481,8,67,4,4,allow
27005,1108,19358,1108,873,126,747,2,30,1,1,allow
49628,443,14591,443,12843,3808,9035,26,81,13,13,allow
63783,1375,0,0,109,109,0,1,0,1,0,deny
19698,502,0,0,60,60,0,1,0,1,0,deny
18415,37965,0,0,62,62,0,1,0,1,0,deny
53419,28189,0,0,60,60,0,1,0,1,0,deny
21145,11392,0,0,62,62,0,1,0,1,0,deny
57925,445,0,0,70,70,0,1,0,1,0,drop
57927,445,0,0,70,70,0,1,0,1,0,drop
57921,445,0,0,70,70,0,1,0,1,0,drop
16393,22114,0,0,62,62,0,1,0,1,0,deny
30922,22,0,0,60,60,0,1,0,1,0,deny
41482,23,0,0,60,60,0,1,0,1,0,deny
52934,445,0,0,70,70,0,1,0,1,0,drop
80,56289,0,0,1090,1090,0,1,0,1,0,deny
53469,44847,0,0,66,66,0,1,0,1,0,deny
16660,55783,0,0,62,62,0,1,0,1,0,deny
16361,60888,0,0,146,146,0,1,0,1,0,deny
54062,31573,0,0,66,66,0,1,0,1,0,deny
53328,445,0,0,66,66,0,1,0,1,0,drop
57918,445,0,0,70,70,0,1,0,1,0,drop
57915,445,0,0,70,70,0,1,0,1,0,drop
62827,1,0,0,66,66,0,1,0,1,0,deny
50804,1,0,0,62,62,0,1,0,1,0,deny
3270,35440,0,0,62,62,0,1,0,1,0,deny
52930,445,0,0,70,70,0,1,0,1,0,drop
59592,37965,0,0,62,62,0,1,0,1,0,deny
53321,445,0,0,66,66,0,1,0,1,0,drop
52921,445,0,0,70,70,0,1,0,1,0,drop
52919,445,0,0,70,70,0,1,0,1,0,drop
37903,23,0,0,60,60,0,1,0,1,0,deny
52918,445,0,0,70,70,0,1,0,1,0,drop
52917,445,0,0,70,70,0,1,0,1,0,drop
36903,56205,0,0,146,146,0,1,0,1,0,deny
53320,445,0,0,66,66,0,1,0,1,0,drop
8999,32480,0,0,146,146,0,1,0,1,0,deny
57904,445,0,0,70,70,0,1,0,1,0,drop
52914,445,0,0,70,70,0,1,0,1,0,drop
57901,445,0,0,70,70,0,1,0,1,0,drop
57897,445,0,0,70,70,0,1,0,1,0,drop
12608,21247,0,0,66,66,0,1,0,1,0,deny
53317,445,0,0,66,66,0,1,0,1,0,drop
17008,35440,0,0,62,62,0,1,0,1,0,deny
43688,22114,0,0,66,66,0,1,0,1,0,deny
54214,443,38557,443,499,425,74,4,0,3,1,allow
54215,443,45620,443,499,425,74,4,0,3,1,allow
53817,443,41947,443,499,425,74,4,0,3,1,allow
53816,443,52923,443,499,425,74,4,0,3,1,allow
26053,33720,0,0,160,160,0,1,0,1,0,deny
26053,33720,0,0,160,160,0,1,0,1,0,deny
9095,22114,0,0,146,146,0,1,0,1,0,deny
24480,35440,0,0,62,62,0,1,0,1,0,deny
1024,64147,0,0,62,62,0,1,0,1,0,deny
29424,37807,0,0,66,66,0,1,0,1,0,deny
60196,53,0,0,88,88,0,1,0,1,0,deny
57892,445,0,0,70,70,0,1,0,1,0,drop
10006,64147,0,0,62,62,0,1,0,1,0,deny
52907,445,0,0,70,70,0,1,0,1,0,drop
10265,64147,0,0,66,66,0,1,0,1,0,deny
52726,56205,0,0,66,66,0,1,0,1,0,deny
57889,445,0,0,70,70,0,1,0,1,0,drop
57888,445,0,0,70,70,0,1,0,1,0,drop
57885,445,0,0,70,70,0,1,0,1,0,drop
53309,445,0,0,66,66,0,1,0,1,0,drop
34176,51505,0,0,62,62,0,1,0,1,0,deny
53308,445,0,0,66,66,0,1,0,1,0,drop
53304,445,0,0,66,66,0,1,0,1,0,drop
53302,445,0,0,66,66,0,1,0,1,0,drop
10006,64147,0,0,145,145,0,1,0,1,0,deny
55225,11392,0,0,66,66,0,1,0,1,0,deny
53300,445,0,0,66,66,0,1,0,1,0,drop
53301,445,0,0,66,66,0,1,0,1,0,drop
53298,445,0,0,66,66,0,1,0,1,0,drop
21833,22114,0,0,62,62,0,1,0,1,0,deny
30046,15503,0,0,62,62,0,1,0,1,0,deny
1176,64147,0,0,62,62,0,1,0,1,0,deny
52900,445,0,0,70,70,0,1,0,1,0,drop
52898,445,0,0,70,70,0,1,0,1,0,drop
1024,9319,0,0,62,62,0,1,0,1,0,deny
59377,9319,0,0,62,62,0,1,0,1,0,deny
443,51160,0,0,102,102,0,1,0,1,0,deny
63205,9571,0,0,66,66,0,1,0,1,0,deny
58751,9571,0,0,62,62,0,1,0,1,0,deny
54339,23117,0,0,66,66,0,1,0,1,0,deny
57884,445,0,0,70,70,0,1,0,1,0,drop
57882,445,0,0,70,70,0,1,0,1,0,drop
57878,445,0,0,70,70,0,1,0,1,0,drop
6828,64322,0,0,60,60,0,1,0,1,0,deny
443,64347,0,0,60,60,0,1,0,1,0,deny
443,64347,0,0,85,85,0,1,0,1,0,deny
443,64347,0,0,100,100,0,1,0,1,0,deny
53294,445,0,0,66,66,0,1,0,1,0,drop
36966,10387,0,0,159,159,0,1,0,1,0,deny
52893,445,0,0,70,70,0,1,0,1,0,drop
53293,445,0,0,66,66,0,1,0,1,0,drop
52892,445,0,0,70,70,0,1,0,1,0,drop
42241,11392,0,0,66,66,0,1,0,1,0,deny
53290,445,0,0,66,66,0,1,0,1,0,drop
53289,445,0,0,66,66,0,1,0,1,0,drop
53287,445,0,0,66,66,0,1,0,1,0,drop
26053,33720,0,0,160,160,0,1,0,1,0,deny
26053,33720,0,0,160,160,0,1,0,1,0,deny
52888,445,0,0,70,70,0,1,0,1,0,drop
6881,21162,0,0,146,146,0,1,0,1,0,deny
56474,18375,0,0,62,62,0,1,0,1,0,deny
26053,33720,0,0,160,160,0,1,0,1,0,deny
26053,33720,0,0,160,160,0,1,0,1,0,deny
57870,445,0,0,70,70,0,1,0,1,0,drop
26053,33720,0,0,160,160,0,1,0,1,0,deny
52887,445,0,0,70,70,0,1,0,1,0,drop
63852,35440,0,0,62,62,0,1,0,1,0,deny
57864,445,0,0,70,70,0,1,0,1,0,drop
57862,445,0,0,70,70,0,1,0,1,0,drop
22927,48817,0,0,143,143,0,1,0,1,0,deny
0,0,0,0,320,320,0,5,0,5,0,allow
0,0,0,0,274,274,0,2,0,2,0,allow
17640,55442,0,0,66,66,0,1,0,1,0,deny
59168,39004,0,0,62,62,0,1,0,1,0,deny
53278,445,0,0,66,66,0,1,0,1,0,drop
37008,42707,0,0,62,62,0,1,0,1,0,deny
58022,5601,0,0,60,60,0,1,0,1,0,deny
38320,51505,0,0,66,66,0,1,0,1,0,deny
16059,22114,0,0,62,62,0,1,0,1,0,deny
52882,445,0,0,70,70,0,1,0,1,0,drop
50439,64147,0,0,62,62,0,1,0,1,0,deny
53105,42707,0,0,66,66,0,1,0,1,0,deny
53269,445,0,0,66,66,0,1,0,1,0,drop
15959,56205,0,0,66,66,0,1,0,1,0,deny
57850,445,0,0,70,70,0,1,0,1,0,drop
53267,445,0,0,66,66,0,1,0,1,0,drop
64087,50265,0,0,145,145,0,1,0,1,0,deny
22583,9822,0,0,62,62,0,1,0,1,0,deny
38723,15503,0,0,146,146,0,1,0,1,0,deny
52869,445,0,0,70,70,0,1,0,1,0,drop
31021,35440,0,0,62,62,0,1,0,1,0,deny
5357,32468,0,0,66,66,0,1,0,1,0,deny
53258,445,0,0,66,66,0,1,0,1,0,drop
53252,445,0,0,66,66,0,1,0,1,0,drop
443,37338,0,0,118,118,0,1,0,1,0,deny
52866,445,0,0,70,70,0,1,0,1,0,drop
8976,44847,0,0,62,62,0,1,0,1,0,deny
50710,50584,0,0,146,146,0,1,0,1,0,deny
57504,44847,0,0,66,66,0,1,0,1,0,deny
25010,30188,0,0,62,62,0,1,0,1,0,deny
61420,64097,0,0,66,66,0,1,0,1,0,deny
9095,22114,0,0,62,62,0,1,0,1,0,deny
54575,11392,0,0,66,66,0,1,0,1,0,deny
11983,57470,0,0,62,62,0,1,0,1,0,deny
49805,6881,0,0,66,66,0,1,0,1,0,deny
44594,64147,0,0,66,66,0,1,0,1,0,deny
49906,443,16050,443,6754,2219,4535,21,77,11,10,allow
49873,80,19431,80,9540,2954,6586,18,88,8,10,allow
49860,80,9156,80,6892,2154,4738,22,89,12,10,allow
49857,80,39166,80,7800,1743,6057,20,89,11,9,allow
56620,443,7502,443,8033,2013,6020,20,16,11,9,allow
49884,443,34007,443,5265,1647,3618,16,88,9,7,allow
49880,80,21728,80,2087,1215,872,8,88,5,3,allow
38643,443,16669,443,2540,1317,1223,17,28,9,8,allow
56622,443,13170,443,8034,2014,6020,20,15,11,9,allow
56887,53,15975,53,170,87,83,3,56,2,1,allow
49876,80,23793,80,24764,4454,20310,30,88,12,18,allow
49887,443,18602,443,977,590,387,10,87,6,4,allow
38645,443,41278,443,2535,1177,1358,16,28,7,9,allow
38647,443,59827,443,2634,1411,1223,18,28,10,8,allow
50693,443,1637,443,306,120,186,6,23,3,3,allow
62423,443,31493,443,28031,7016,21015,51,45,23,28,allow
36445,443,44215,443,234,234,0,4,12,4,0,allow
49905,443,56801,443,4712,908,3804,18,77,9,9,allow
49874,80,9513,80,9921,2945,6976,19,88,8,11,allow
36500,3142,36500,3142,138,78,60,2,6,1,1,allow
2081,7000,2081,7000,5914,4395,1519,19,15,10,9,allow
30188,53,30188,53,238,95,143,2,30,1,1,allow
49895,80,46026,80,2781,1400,1381,11,87,6,5,allow
38644,443,1255,443,2622,1399,1223,18,28,10,8,allow
2080,7000,2080,7000,754151,15395,738756,762,16,239,523,allow
49858,80,51229,80,1539,674,865,11,89,6,5,allow
49854,80,32743,80,14603,5117,9486,24,89,12,12,allow
49845,80,64041,80,31466,852,30614,32,89,9,23,allow
49913,443,65032,443,976,589,387,10,76,6,4,allow
38646,443,44799,443,2335,1247,1088,15,28,8,7,allow
49861,80,57112,80,4892,1157,3735,16,89,8,8,allow
56623,443,54121,443,7982,1962,6020,20,15,11,9,allow
26843,53,26843,53,209,77,132,2,33,1,1,allow
49852,80,47954,80,8868,3774,5094,20,89,10,10,allow
49850,443,7132,443,7371,1564,5807,18,89,9,9,allow
49879,80,2147,80,2087,1215,872,8,88,5,3,allow
55521,53,35090,53,701,88,613,2,30,1,1,allow
49853,80,30133,80,15055,6439,8616,26,89,14,12,allow
58793,443,33855,443,40456,12307,28149,114,140,58,56,allow
49855,80,46269,80,41720,6568,35152,47,89,17,30,allow
49234,53,38404,53,170,87,83,2,30,1,1,allow
36661,53,36661,53,237,93,144,2,30,1,1,allow
56785,28902,1768,28902,70,70,0,2,8,2,0,allow
53063,443,53063,443,6793,3206,3587,25,52,15,10,allow
56997,53,44658,53,168,86,82,2,30,1,1,allow
40030,80,62413,80,1286,403,883,16,393,4,12,allow
6881,35766,64668,35766,221,111,110,2,1200,1,1,allow
64539,53,5433,53,170,87,83,2,31,1,1,allow
49875,80,61335,80,35824,4558,31266,39,88,13,26,allow
51174,443,5740,443,12037,3531,8506,35,271,18,17,allow
49872,80,54932,80,31938,3363,28575,38,88,15,23,allow
49859,80,31286,80,1529,677,852,11,89,6,5,allow
54269,443,49860,443,5768,3426,2342,22,135,11,11,allow
49856,80,12008,80,13992,1645,12347,23,89,10,13,allow
2082,7000,2082,7000,3022,1567,1455,16,15,8,8,allow
49877,80,36716,80,28450,4547,23903,34,88,13,21,allow
55594,42459,54770,42459,1253,716,537,12,23,7,5,allow
57118,80,7804,80,2404,568,1836,10,75,6,4,allow
37090,443,37090,443,4637,1730,2907,19,30,11,8,allow
60398,443,6115,443,8060,1868,6192,28,16,15,13,allow
44558,443,44558,443,5480,2503,2977,20,15,11,9,allow
49878,80,42487,80,2086,1214,872,8,88,5,3,allow
56621,443,45506,443,7981,1961,6020,20,15,11,9,allow
49863,443,52855,443,7280,1441,5839,17,89,9,8,allow
49844,80,65486,80,18950,788,18162,23,89,8,15,allow
44546,53,44546,53,204,92,112,2,30,1,1,allow
63513,53,63513,53,236,94,142,2,30,1,1,allow
51202,53,51202,53,221,89,132,2,30,1,1,allow
34517,80,7727,80,1056,682,374,10,16,6,4,allow
39119,53,39119,53,221,89,132,2,30,1,1,allow
50107,53,50107,53,216,89,127,2,30,1,1,allow
6881,6881,55325,6881,853,355,498,4,1200,2,2,allow
56876,53,55574,53,711,87,624,2,31,1,1,allow
3382,53,3382,53,220,100,120,2,31,1,1,allow
52795,443,61686,443,7203,2188,5015,23,186,11,12,allow
30960,45691,5004,45691,330,330,0,6,3609,6,0,allow
52862,445,0,0,70,70,0,1,0,1,0,drop
57839,445,0,0,70,70,0,1,0,1,0,drop
57837,445,0,0,70,70,0,1,0,1,0,drop
57836,445,0,0,70,70,0,1,0,1,0,drop
52860,445,0,0,70,70,0,1,0,1,0,drop
53239,445,0,0,66,66,0,1,0,1,0,drop
53241,445,0,0,66,66,0,1,0,1,0,drop
53240,445,0,0,66,66,0,1,0,1,0,drop
53244,445,0,0,66,66,0,1,0,1,0,drop
53243,445,0,0,66,66,0,1,0,1,0,drop
53238,445,0,0,66,66,0,1,0,1,0,drop
53237,445,0,0,66,66,0,1,0,1,0,drop
53236,445,0,0,66,66,0,1,0,1,0,drop
52858,445,0,0,70,70,0,1,0,1,0,drop
43333,50584,0,0,146,146,0,1,0,1,0,deny
24144,57470,0,0,62,62,0,1,0,1,0,deny
30114,65151,0,0,60,60,0,1,0,1,0,deny
53987,57470,0,0,66,66,0,1,0,1,0,deny
12614,22,0,0,60,60,0,1,0,1,0,deny
28498,36237,0,0,62,62,0,1,0,1,0,deny
52913,2767,0,0,66,66,0,1,0,1,0,deny
57828,445,0,0,70,70,0,1,0,1,0,drop
57827,445,0,0,70,70,0,1,0,1,0,drop
57825,445,0,0,70,70,0,1,0,1,0,drop
57500,23,0,0,60,60,0,1,0,1,0,deny
52851,445,0,0,70,70,0,1,0,1,0,drop
59879,55783,0,0,62,62,0,1,0,1,0,deny
52849,445,0,0,70,70,0,1,0,1,0,drop
53223,445,0,0,66,66,0,1,0,1,0,drop
53224,445,0,0,66,66,0,1,0,1,0,drop
53221,445,0,0,66,66,0,1,0,1,0,drop
52848,445,0,0,70,70,0,1,0,1,0,drop
20726,2767,0,0,62,62,0,1,0,1,0,deny
52847,445,0,0,70,70,0,1,0,1,0,drop
52846,445,0,0,70,70,0,1,0,1,0,drop
52843,445,0,0,70,70,0,1,0,1,0,drop
52842,445,0,0,70,70,0,1,0,1,0,drop
53419,28189,0,0,60,60,0,1,0,1,0,deny
57816,445,0,0,70,70,0,1,0,1,0,drop
22724,9822,0,0,66,66,0,1,0,1,0,deny
57810,445,0,0,70,70,0,1,0,1,0,drop
57808,445,0,0,70,70,0,1,0,1,0,drop
57804,445,0,0,70,70,0,1,0,1,0,drop
25360,51505,0,0,62,62,0,1,0,1,0,deny
55157,7302,0,0,66,66,0,1,0,1,0,deny
54617,64147,0,0,62,62,0,1,0,1,0,deny
54276,39004,0,0,62,62,0,1,0,1,0,deny
45941,23388,0,0,60,60,0,1,0,1,0,deny
52828,445,0,0,70,70,0,1,0,1,0,drop
52827,445,0,0,70,70,0,1,0,1,0,drop
32215,22114,0,0,62,62,0,1,0,1,0,deny
52817,445,0,0,70,70,0,1,0,1,0,drop
52818,445,0,0,70,70,0,1,0,1,0,drop
62767,57470,0,0,74,74,0,1,0,1,0,deny
59201,51221,0,0,66,66,0,1,0,1,0,deny
52743,15503,0,0,66,66,0,1,0,1,0,deny
1067,51221,0,0,62,62,0,1,0,1,0,deny
16387,26193,0,0,60,60,0,1,0,1,0,deny
1067,51221,0,0,145,145,0,1,0,1,0,deny
16387,35308,0,0,60,60,0,1,0,1,0,deny
60217,80,16783,80,4050,2838,1212,14,16,7,7,allow
50628,80,65125,80,4349,647,3702,16,22,7,9,allow
59754,53,11671,53,260,86,174,2,30,1,1,allow
40180,443,53378,443,1310,649,661,13,184,7,6,allow
53201,28513,16417,28513,862,562,300,13,145,8,5,allow
46332,443,57498,443,3132,1697,1435,17,15,10,7,allow
56813,53,9920,53,516,136,380,4,40,2,2,allow
50692,443,32817,443,180,60,120,4,15,2,2,allow
65080,53,49569,53,193,102,91,2,29,1,1,allow
27005,1305,58083,1305,855,126,729,2,29,1,1,allow
27005,1308,10914,1308,855,126,729,2,29,1,1,allow
49281,53,58920,53,345,110,235,2,29,1,1,allow
50689,443,64099,443,180,60,120,4,15,2,2,allow
27005,1202,29779,1202,865,126,739,2,29,1,1,allow
27005,1103,52058,1103,822,126,696,2,29,1,1,allow
45935,25,35960,25,511,191,320,9,60,4,5,allow
35377,443,51737,443,15771,2037,13734,39,187,20,19,allow
57140,53,58402,53,177,94,83,2,29,1,1,allow
53113,8372,13040,8372,758,320,438,11,17,6,5,allow
58794,443,45135,443,20298,11977,8321,85,139,45,40,allow
34737,443,45602,443,5586,1338,4248,17,109,9,8,allow
49632,53,31125,53,288,94,194,2,30,1,1,allow
27005,1105,65392,1105,855,126,729,2,29,1,1,allow
56795,35465,29402,35465,70,70,0,1,5,1,0,allow
55653,53,52726,53,94,94,0,1,29,1,0,allow
15111,53,15111,53,210,98,112,2,29,1,1,allow
64212,53,41326,53,215,102,113,2,30,1,1,allow
49234,53,14008,53,177,94,83,2,30,1,1,allow
59755,53,7532,53,211,78,133,2,30,1,1,allow
27005,1106,25259,1106,903,126,777,2,29,1,1,allow
49752,53,10768,53,193,102,91,2,29,1,1,allow
38194,53,38194,53,210,98,112,2,29,1,1,allow
51802,443,19479,443,4426,1518,2908,12,120,6,6,allow
49868,443,36753,443,6251,1706,4545,16,88,9,7,allow
49893,80,42792,80,1376,946,430,8,86,5,3,allow
65384,53,46519,53,197,102,95,2,33,1,1,allow
53666,80,3658,80,3741,3008,733,16,15,10,6,allow
65378,53,49018,53,212,102,110,2,30,1,1,allow
56972,53,28054,53,177,94,83,2,30,1,1,allow
51004,53,15547,53,194,94,100,2,30,1,1,allow
65135,53,23354,53,312,102,210,2,30,1,1,allow
49900,443,38776,443,8417,1173,7244,18,86,9,9,allow
57371,443,2707,443,5619,927,4692,17,15,10,7,allow
36225,443,18751,443,638,350,288,10,26,6,4,allow
56616,80,15252,80,234,234,0,4,12,4,0,allow
36327,80,6199,80,1348,844,504,13,255,8,5,allow
49886,443,58788,443,77867,2411,75456,82,87,27,55,allow
55022,443,12848,443,14634,1801,12833,28,46,14,14,allow
49888,443,29885,443,117085,3435,113650,123,87,43,80,allow
60196,80,43098,80,70,70,0,2,8,2,0,allow
50823,443,51509,443,6601,1120,5481,17,115,9,8,allow
49898,80,5457,80,1550,1157,393,8,86,5,3,allow
51503,443,42971,443,9239,4472,4767,37,39,21,16,allow
65452,53,31972,53,365,102,263,2,30,1,1,allow
43817,443,47281,443,5911,1666,4245,27,18,15,12,allow
51788,35787,52462,35787,70,70,0,2,8,2,0,allow
56972,53,24503,53,177,94,83,2,30,1,1,allow
21859,53,21859,53,242,98,144,2,30,1,1,allow
57272,53,3406,53,373,107,266,4,45,2,2,allow
34670,53,34670,53,257,106,151,2,30,1,1,allow
56997,53,62280,53,86,86,0,1,30,1,0,allow
50568,443,63503,443,15702,3473,12229,50,70,23,27,allow
54167,53,54167,53,242,98,144,2,30,1,1,allow
49891,53,6545,53,375,126,249,2,30,1,1,allow
44242,5228,42163,5228,10823,1636,9187,32,591,11,21,allow
49882,443,5946,443,5019,1424,3595,15,87,9,6,allow
51769,19165,52583,19165,70,70,0,1,5,1,0,allow
56613,443,6770,443,6016,1284,4732,18,984,8,10,allow
53665,80,59537,80,4417,3685,732,16,15,10,6,allow
55072,53,38583,53,86,86,0,1,30,1,0,allow
49757,53,9163,53,177,94,83,2,30,1,1,allow
49234,53,56023,53,177,94,83,2,30,1,1,allow
49647,53,18676,53,361,102,259,2,30,1,1,allow
48817,14888,48817,14888,481,150,331,2,1200,1,1,allow
56796,41431,54757,41431,70,70,0,1,5,1,0,allow
62424,443,60409,443,4650,3116,1534,19,44,10,9,allow
49349,80,23734,80,185645,6753,178892,213,81,89,124,allow
53437,6057,38097,6057,245,245,0,2,30,2,0,allow
56227,53,50602,53,278,102,176,2,30,1,1,allow
40182,443,24953,443,1312,651,661,13,184,7,6,allow
58724,443,33462,443,10179,4285,5894,60,272,31,29,allow
56887,53,8046,53,250,87,163,4,57,2,2,allow
49211,53,35833,53,484,100,384,4,56,2,2,allow
39980,443,30240,443,2674,1386,1288,17,120,8,9,allow
57425,443,33540,443,130,70,60,2,15,1,1,allow
53598,40326,41639,40326,70,70,0,2,7,2,0,allow
55601,44049,44869,44049,504,318,186,8,15,5,3,allow
64448,53,46885,53,353,92,261,4,38,2,2,allow
41193,443,45935,443,6035,782,5253,16,109,8,8,allow
43785,443,28083,443,6017,1285,4732,18,984,8,10,allow
52881,443,3297,443,130,70,60,2,15,1,1,allow
37145,443,8419,443,4578,2334,2244,21,16,12,9,allow
55604,44235,60786,44235,504,318,186,8,15,5,3,allow
51858,443,51858,443,12505,3792,8713,48,255,24,24,allow
37990,49152,47344,49152,156,156,0,3,7,3,0,allow
51236,443,52300,443,7950,2502,5448,38,15,22,16,allow
60394,80,52231,80,2047,701,1346,16,26,5,11,allow
55847,443,25138,443,8443,1430,7013,17,141,8,9,allow
55462,53,36387,53,579,88,491,4,35,2,2,allow
56782,49135,53247,49135,70,70,0,1,5,1,0,allow
62422,443,30175,443,16258,11067,5191,37,45,21,16,allow
49846,80,53092,80,2644,1918,726,11,89,7,4,allow
49881,80,7229,80,1965,1450,515,7,87,5,2,allow
49901,443,33276,443,5583,1567,4016,16,85,9,7,allow
47694,443,24366,443,23751,3197,20554,42,170,19,23,allow
49889,80,51133,80,1376,946,430,8,87,5,3,allow
27005,1306,35061,1306,858,126,732,2,29,1,1,allow
49650,53,14821,53,821,102,719,2,29,1,1,allow
45159,443,45159,443,5329,2082,3247,22,40,13,9,allow
55786,53,63117,53,177,94,83,2,29,1,1,allow
27005,1104,28939,1104,870,126,744,2,29,1,1,allow
65080,53,41733,53,193,102,91,2,29,1,1,allow
49842,80,44778,80,70094,1629,68465,63,89,16,47,allow
64374,53,64374,53,240,98,142,2,30,1,1,allow
64204,53,27061,53,264,102,162,2,31,1,1,allow
34910,443,46197,443,16227,7159,9068,40,524,21,19,allow
58936,80,60272,80,10003,5095,4908,21,76,12,9,allow
52097,443,1702,443,11181,7329,3852,39,53,20,19,allow
54262,53,54262,53,216,82,134,2,33,1,1,allow
49864,80,42240,80,5205,1474,3731,9,88,5,4,allow
63997,53,40711,53,676,192,484,6,84,3,3,allow
40340,53,40340,53,217,90,127,2,30,1,1,allow
56887,53,51812,53,177,94,83,2,30,1,1,allow
34616,53,34616,53,197,90,107,2,30,1,1,allow
55072,53,58133,53,168,86,82,2,30,1,1,allow
51789,40800,21058,40800,70,70,0,2,8,2,0,allow
35945,8080,16769,8080,170,110,60,2,5,1,1,allow
51687,80,38806,80,1517,481,1036,11,15,6,5,allow
55602,22005,13936,22005,504,318,186,8,15,5,3,allow
49847,80,28928,80,4135,2587,1548,10,89,7,3,allow
49849,80,56031,80,9581,2352,7229,14,89,7,7,allow
65195,53,58646,53,249,94,155,2,30,1,1,allow
64944,443,63703,443,48856,4158,44698,65,120,26,39,allow
53667,80,16085,80,5090,4357,733,17,15,11,6,allow
34597,80,9526,80,1540,553,987,10,15,6,4,allow
51787,35661,32624,35661,70,70,0,2,8,2,0,allow
56794,1,30345,1,70,70,0,1,5,1,0,allow
49891,80,47196,80,1376,946,430,8,86,5,3,allow
35371,443,55003,443,304294,8535,295759,302,132,90,212,allow
49907,53,31143,53,363,98,265,4,54,2,2,allow
56880,53,14600,53,216,102,114,2,30,1,1,allow
49626,53,57027,53,226,110,116,2,30,1,1,allow
53325,443,60728,443,6988,1214,5774,29,315,13,16,allow
65489,53,22228,53,242,102,140,2,30,1,1,allow
45852,53,58364,53,164,78,86,2,30,1,1,allow
64539,53,12093,53,177,94,83,2,30,1,1,allow
55232,53,4973,53,177,94,83,2,30,1,1,allow
46904,443,22687,443,1314,653,661,13,184,7,6,allow
57470,1337,11046,1337,132,132,0,3,1199,3,0,allow
57470,51413,20990,51413,132,132,0,3,1199,3,0,allow
46902,443,9815,443,1312,651,661,13,184,7,6,allow
57470,32554,26489,32554,726,726,0,12,1199,12,0,allow
55877,51413,55340,51413,460,150,310,2,1200,1,1,allow
51221,20864,10145,20864,7308,6812,496,71,3243,63,8,allow
49892,443,33274,443,5737,1602,4135,23,86,13,10,allow
49862,443,6856,443,17924,7867,10057,45,88,24,21,allow
57447,443,54490,443,12192,3788,8404,36,18,18,18,allow
59890,443,21509,443,9801,2337,7464,25,47,13,12,allow
54420,443,57977,443,5809,1552,4257,19,74,11,8,allow
52277,443,12555,443,13832,4868,8964,91,364,37,54,allow
64569,443,62686,443,9157,2109,7048,27,32,15,12,allow
49907,443,5295,443,6754,2219,4535,21,76,11,10,allow
49894,443,43523,443,5597,1462,4135,21,86,11,10,allow
59888,443,25489,443,4350,2061,2289,18,47,10,8,allow
52140,80,9768,80,3476,1433,2043,26,418,14,12,allow
49901,53,27916,53,349,108,241,4,35,2,2,allow
41024,443,41024,443,4639,1732,2907,19,30,11,8,allow
40729,123,44305,123,184,94,90,2,30,1,1,allow
59023,64097,0,0,62,62,0,1,0,1,0,deny
16387,56995,0,0,60,60,0,1,0,1,0,deny
22683,39210,0,0,60,60,0,1,0,1,0,deny
50031,44847,0,0,74,74,0,1,0,1,0,deny
53053,64147,0,0,62,62,0,1,0,1,0,deny
50562,37965,0,0,66,66,0,1,0,1,0,deny
21173,37965,0,0,62,62,0,1,0,1,0,deny
57797,445,0,0,70,70,0,1,0,1,0,drop
57798,445,0,0,70,70,0,1,0,1,0,drop
57794,445,0,0,70,70,0,1,0,1,0,drop
52806,445,0,0,70,70,0,1,0,1,0,drop
20083,6881,0,0,62,62,0,1,0,1,0,deny
8191,51221,0,0,62,62,0,1,0,1,0,deny
43584,24748,0,0,156,156,0,1,0,1,0,deny
7285,51221,0,0,66,66,0,1,0,1,0,deny
64279,23718,0,0,62,62,0,1,0,1,0,deny
14260,36829,0,0,62,62,0,1,0,1,0,deny
26480,64147,0,0,62,62,0,1,0,1,0,deny
53201,445,0,0,66,66,0,1,0,1,0,drop
57791,445,0,0,70,70,0,1,0,1,0,drop
57788,445,0,0,70,70,0,1,0,1,0,drop
52802,445,0,0,70,70,0,1,0,1,0,drop
52793,445,0,0,70,70,0,1,0,1,0,drop
52792,445,0,0,70,70,0,1,0,1,0,drop
53815,443,57260,443,499,425,74,4,0,3,1,allow
53799,443,27170,443,499,425,74,4,0,3,1,allow
53814,443,6695,443,499,425,74,4,0,3,1,allow
61804,51505,0,0,66,66,0,1,0,1,0,deny
32395,30188,0,0,62,62,0,1,0,1,0,deny
52790,445,0,0,70,70,0,1,0,1,0,drop
52789,445,0,0,70,70,0,1,0,1,0,drop
64175,56502,0,0,66,66,0,1,0,1,0,deny
53196,445,0,0,66,66,0,1,0,1,0,drop
52785,445,0,0,70,70,0,1,0,1,0,drop
54991,36829,0,0,66,66,0,1,0,1,0,deny
32185,47807,0,0,159,159,0,1,0,1,0,deny
53192,445,0,0,66,66,0,1,0,1,0,drop
57776,445,0,0,70,70,0,1,0,1,0,drop
25015,64147,0,0,66,66,0,1,0,1,0,deny
28668,8696,0,0,60,60,0,1,0,1,0,deny
57774,445,0,0,70,70,0,1,0,1,0,drop
57772,445,0,0,70,70,0,1,0,1,0,drop
57767,445,0,0,70,70,0,1,0,1,0,drop
53189,445,0,0,66,66,0,1,0,1,0,drop
52779,445,0,0,70,70,0,1,0,1,0,drop
45410,1,0,0,62,62,0,1,0,1,0,deny
50321,40284,0,0,348,348,0,1,0,1,0,deny
57763,445,0,0,70,70,0,1,0,1,0,drop
34822,31573,0,0,62,62,0,1,0,1,0,deny
57761,445,0,0,70,70,0,1,0,1,0,drop
57758,445,0,0,70,70,0,1,0,1,0,drop
57757,445,0,0,70,70,0,1,0,1,0,drop
53183,445,0,0,66,66,0,1,0,1,0,drop
26082,26296,0,0,159,159,0,1,0,1,0,deny
27446,30188,0,0,66,66,0,1,0,1,0,deny
53176,445,0,0,66,66,0,1,0,1,0,drop
53179,445,0,0,66,66,0,1,0,1,0,drop
53175,445,0,0,66,66,0,1,0,1,0,drop
40547,24051,0,0,74,74,0,1,0,1,0,deny
52772,445,0,0,70,70,0,1,0,1,0,drop
53173,445,0,0,66,66,0,1,0,1,0,drop
53172,445,0,0,66,66,0,1,0,1,0,drop
53171,445,0,0,66,66,0,1,0,1,0,drop
52769,445,0,0,70,70,0,1,0,1,0,drop
58326,50584,0,0,62,62,0,1,0,1,0,deny
53779,37965,0,0,66,66,0,1,0,1,0,deny
56946,1,0,0,66,66,0,1,0,1,0,deny
18357,51180,0,0,62,62,0,1,0,1,0,deny
57755,445,0,0,70,70,0,1,0,1,0,drop
57753,445,0,0,70,70,0,1,0,1,0,drop
57752,445,0,0,70,70,0,1,0,1,0,drop
52765,445,0,0,70,70,0,1,0,1,0,drop
53169,445,0,0,66,66,0,1,0,1,0,drop
52764,445,0,0,70,70,0,1,0,1,0,drop
57748,445,0,0,70,70,0,1,0,1,0,drop
53807,443,54173,443,499,425,74,4,0,3,1,allow
53796,443,58960,443,499,425,74,4,0,3,1,allow
53804,443,53478,443,499,425,74,4,0,3,1,allow
53802,443,44070,443,499,425,74,4,0,3,1,allow
53812,443,19260,443,499,425,74,4,0,3,1,allow
53805,443,64828,443,499,425,74,4,0,3,1,allow
53801,443,63448,443,499,425,74,4,0,3,1,allow
53810,443,43179,443,499,425,74,4,0,3,1,allow
53813,443,59809,443,499,425,74,4,0,3,1,allow
53806,443,13248,443,499,425,74,4,0,3,1,allow
53809,443,5069,443,499,425,74,4,0,3,1,allow
53798,443,32162,443,499,425,74,4,0,3,1,allow
53811,443,28685,443,499,425,74,4,0,3,1,allow
53800,443,21628,443,499,425,74,4,0,3,1,allow
53797,443,48154,443,499,425,74,4,0,3,1,allow
53808,443,30751,443,499,425,74,4,0,3,1,allow
53795,443,29582,443,499,425,74,4,0,3,1,allow
53791,443,9232,443,499,425,74,4,0,3,1,allow
53803,443,59546,443,499,425,74,4,0,3,1,allow
53794,443,48669,443,499,425,74,4,0,3,1,allow
53793,443,25367,443,499,425,74,4,0,3,1,allow
53790,443,36167,443,499,425,74,4,0,3,1,allow
53789,443,10563,443,499,425,74,4,0,3,1,allow
53792,443,8707,443,499,425,74,4,0,3,1,allow
0,0,0,0,70,70,0,1,0,1,0,deny
53164,445,0,0,66,66,0,1,0,1,0,drop
46093,32661,0,0,74,74,0,1,0,1,0,deny
64324,37807,0,0,62,62,0,1,0,1,0,deny
65153,38303,0,0,66,66,0,1,0,1,0,deny
53163,445,0,0,66,66,0,1,0,1,0,drop
53161,445,0,0,66,66,0,1,0,1,0,drop
53159,445,0,0,66,66,0,1,0,1,0,drop
48676,53395,0,0,60,60,0,1,0,1,0,deny
52760,445,0,0,70,70,0,1,0,1,0,drop
64889,26467,0,0,66,66,0,1,0,1,0,deny
1660,8696,0,0,62,62,0,1,0,1,0,deny
60550,50584,0,0,62,62,0,1,0,1,0,deny
52758,445,0,0,70,70,0,1,0,1,0,drop
1040,6004,0,0,72,72,0,1,0,1,0,deny
57741,445,0,0,70,70,0,1,0,1,0,drop
443,9986,0,0,297,297,0,1,0,1,0,deny
12605,57470,0,0,62,62,0,1,0,1,0,deny
65501,26467,0,0,66,66,0,1,0,1,0,deny
57734,445,0,0,70,70,0,1,0,1,0,drop
57732,445,0,0,70,70,0,1,0,1,0,drop
59136,50584,0,0,66,66,0,1,0,1,0,deny
60875,50584,0,0,66,66,0,1,0,1,0,deny
52754,445,0,0,70,70,0,1,0,1,0,drop
53151,445,0,0,66,66,0,1,0,1,0,drop
61736,50584,0,0,66,66,0,1,0,1,0,deny
443,5920,0,0,66,66,0,1,0,1,0,deny
42034,28189,0,0,62,62,0,1,0,1,0,deny
12471,48817,0,0,62,62,0,1,0,1,0,deny
45964,2225,0,0,60,60,0,1,0,1,0,deny
53141,445,0,0,66,66,0,1,0,1,0,drop
57720,445,0,0,70,70,0,1,0,1,0,drop
51582,48817,0,0,66,66,0,1,0,1,0,deny
46495,4607,0,0,60,60,0,1,0,1,0,deny
26528,51221,0,0,78,78,0,1,0,1,0,deny
48980,15000,3233,15000,130,70,60,2,5,1,1,allow
56618,443,57435,443,8034,2014,6020,20,15,11,9,allow
64568,443,63585,443,25404,2462,22942,47,32,25,22,allow
55232,53,45264,53,170,87,83,2,30,1,1,allow
59880,443,7834,443,16776,7513,9263,42,47,24,18,allow
27350,80,31798,80,3943,1809,2134,21,82,11,10,allow
43112,443,7009,443,3197,1931,1266,19,15,9,10,allow
56619,443,13830,443,7982,1962,6020,20,15,11,9,allow
26457,80,26457,80,17147,1829,15318,28,17,15,13,allow
50122,443,28442,443,130,70,60,2,15,1,1,allow
43111,443,29874,443,3117,1867,1250,19,15,9,10,allow
51768,61765,15043,61765,66,66,0,1,5,1,0,allow
45587,443,45587,443,5523,2276,3247,22,28,13,9,allow
44695,53,44695,53,198,89,109,2,30,1,1,allow
64979,53,23009,53,188,96,92,2,31,1,1,allow
55917,53,56529,53,170,87,83,2,31,1,1,allow
59343,53,0,0,627,72,555,2,30,1,1,allow
51862,22,51862,22,7902,3301,4601,56,40,26,30,allow
52205,5222,24221,5222,684,280,404,11,26,5,6,allow
52375,80,50220,80,234,234,0,4,12,4,0,allow
43601,443,18392,443,10274,3806,6468,26,413,14,12,allow
50239,443,44236,443,9418,2681,6737,39,256,18,21,allow
38329,80,52994,80,350,210,140,6,16,4,2,allow
37271,443,4038,443,51402,5964,45438,86,153,32,54,allow
56295,443,26147,443,8550,1880,6670,22,376,12,10,allow
56617,443,25954,443,7981,1961,6020,20,16,11,9,allow
37536,80,9440,80,3565,1020,2545,16,15,9,7,allow
58454,443,58454,443,4593,1616,2977,19,76,10,9,allow
59270,53,59270,53,825,99,726,2,30,1,1,allow
56813,53,39428,53,711,87,624,2,30,1,1,allow
8888,53,8888,53,214,97,117,2,30,1,1,allow
55106,53,55106,53,200,90,110,2,30,1,1,allow
53035,5228,40515,5228,2725,1610,1115,20,3600,10,10,allow
56366,53,46809,53,754,94,660,2,31,1,1,allow
53713,443,37609,443,4931,957,3974,17,15,10,7,allow
59487,80,24242,80,350,210,140,6,26,4,2,allow
53714,443,10907,443,4933,957,3976,17,15,10,7,allow
57312,53,57312,53,208,94,114,2,30,1,1,allow
49591,53,51142,53,168,86,82,2,30,1,1,allow
3424,53,3424,53,216,88,128,2,30,1,1,allow
2079,7000,2079,7000,3102,1551,1551,16,16,8,8,allow
56775,53,34626,53,763,101,662,2,30,1,1,allow
50328,53,20316,53,783,96,687,2,30,1,1,allow
56268,53,11800,53,711,87,624,2,31,1,1,allow
49353,53,30816,53,738,86,652,2,31,1,1,allow
30960,45690,12118,45690,330,330,0,6,3609,6,0,allow
49597,53,33201,53,168,86,82,2,31,1,1,allow
55836,53,32275,53,178,91,87,2,31,1,1,allow
65366,53,60695,53,198,101,97,2,31,1,1,allow
55040,53,40859,53,762,98,664,2,31,1,1,allow
56620,53,33976,53,216,110,106,2,31,1,1,allow
49883,53,18157,53,170,87,83,2,30,1,1,allow
55011,53,15618,53,760,96,664,2,31,1,1,allow
56373,53,29361,53,200,102,98,2,31,1,1,allow
65153,53,43651,53,168,86,82,2,31,1,1,allow
65177,53,32886,53,256,93,163,2,31,1,1,allow
30960,45689,37422,45689,330,330,0,6,3609,6,0,allow
56091,53,32743,53,738,86,652,2,31,1,1,allow
50475,53,26369,53,772,100,672,2,31,1,1,allow
55698,53,13157,53,742,88,654,2,31,1,1,allow
55656,53,48878,53,212,108,104,2,31,1,1,allow
57397,53,42342,53,256,93,163,2,31,1,1,allow
64980,53,5647,53,200,102,98,2,31,1,1,allow
61041,443,15332,443,77650,64697,12953,148,902,81,67,allow
10115,52700,0,0,62,62,0,1,0,1,0,deny
8933,56205,0,0,62,62,0,1,0,1,0,deny
60294,30188,0,0,66,66,0,1,0,1,0,deny
52459,5555,0,0,60,60,0,1,0,1,0,deny
53139,445,0,0,66,66,0,1,0,1,0,drop
52741,445,0,0,70,70,0,1,0,1,0,drop
59481,41182,0,0,66,66,0,1,0,1,0,deny
1027,11392,0,0,62,62,0,1,0,1,0,deny
59784,42246,0,0,62,62,0,1,0,1,0,deny
58074,11392,0,0,66,66,0,1,0,1,0,deny
51685,57470,0,0,62,62,0,1,0,1,0,deny
52356,55442,0,0,66,66,0,1,0,1,0,deny
64841,53,24677,53,165,86,79,2,30,1,1,allow
55386,53,14835,53,199,102,97,2,30,1,1,allow
49890,443,15513,443,5597,1462,4135,21,86,11,10,allow
52738,445,0,0,70,70,0,1,0,1,0,drop
53132,445,0,0,66,66,0,1,0,1,0,drop
9246,35440,0,0,66,66,0,1,0,1,0,deny
443,20982,0,0,97,97,0,1,0,1,0,deny
53123,445,0,0,66,66,0,1,0,1,0,drop
62859,35440,0,0,66,66,0,1,0,1,0,deny
53371,26467,0,0,66,66,0,1,0,1,0,deny
14715,56205,0,0,62,62,0,1,0,1,0,deny
30496,57470,0,0,62,62,0,1,0,1,0,deny
59235,52700,0,0,145,145,0,1,0,1,0,deny
52734,445,0,0,70,70,0,1,0,1,0,drop
52732,445,0,0,70,70,0,1,0,1,0,drop
44258,25,0,0,74,74,0,1,0,1,0,deny
64756,11392,0,0,62,62,0,1,0,1,0,deny
57711,445,0,0,70,70,0,1,0,1,0,drop
57708,445,0,0,70,70,0,1,0,1,0,drop
57709,445,0,0,70,70,0,1,0,1,0,drop
52728,445,0,0,70,70,0,1,0,1,0,drop
53113,445,0,0,66,66,0,1,0,1,0,drop
53114,445,0,0,66,66,0,1,0,1,0,drop
53108,445,0,0,66,66,0,1,0,1,0,drop
53115,445,0,0,66,66,0,1,0,1,0,drop
53112,445,0,0,66,66,0,1,0,1,0,drop
53110,445,0,0,66,66,0,1,0,1,0,drop
53111,445,0,0,66,66,0,1,0,1,0,drop
53109,445,0,0,66,66,0,1,0,1,0,drop
17009,53733,0,0,66,66,0,1,0,1,0,deny
14459,11848,0,0,148,148,0,1,0,1,0,reset-both
11464,37965,0,0,62,62,0,1,0,1,0,deny
443,28417,0,0,82,82,0,1,0,1,0,deny
26332,57470,0,0,62,62,0,1,0,1,0,deny
52721,445,0,0,70,70,0,1,0,1,0,drop
64940,36237,0,0,62,62,0,1,0,1,0,deny
57706,445,0,0,70,70,0,1,0,1,0,drop
57701,445,0,0,70,70,0,1,0,1,0,drop
57694,445,0,0,70,70,0,1,0,1,0,drop
52719,445,0,0,70,70,0,1,0,1,0,drop
22587,30188,0,0,66,66,0,1,0,1,0,deny
38645,51221,0,0,62,62,0,1,0,1,0,deny
2923,57470,0,0,66,66,0,1,0,1,0,deny
53096,445,0,0,66,66,0,1,0,1,0,drop
53094,445,0,0,66,66,0,1,0,1,0,drop
53093,445,0,0,66,66,0,1,0,1,0,drop
1227,56205,0,0,66,66,0,1,0,1,0,deny
6712,44818,0,0,66,66,0,1,0,1,0,deny
3564,57470,0,0,62,62,0,1,0,1,0,deny
52718,445,0,0,70,70,0,1,0,1,0,drop
20057,44847,0,0,62,62,0,1,0,1,0,deny
39824,51505,0,0,62,62,0,1,0,1,0,deny
52717,445,0,0,70,70,0,1,0,1,0,drop
52716,445,0,0,70,70,0,1,0,1,0,drop
57691,445,0,0,70,70,0,1,0,1,0,drop
4127,26467,0,0,66,66,0,1,0,1,0,deny
52714,445,0,0,70,70,0,1,0,1,0,drop
49865,443,1213,443,8535,1936,6599,22,87,12,10,allow
49848,443,28970,443,33314,1722,31592,40,88,14,26,allow
49885,443,26423,443,10216,2749,7467,27,86,14,13,allow
64539,53,18826,53,177,94,83,2,29,1,1,allow
49851,80,9497,80,11936,2198,9738,22,88,9,13,allow
53592,23578,40087,23578,70,70,0,2,7,2,0,allow
52118,80,62172,80,3158,1309,1849,28,418,15,13,allow
52126,80,5898,80,3592,2098,1494,26,417,14,12,allow
48220,443,48220,443,4627,1720,2907,18,26,10,8,allow
53664,80,23809,80,3741,3008,733,16,15,10,6,allow
49909,443,16969,443,6754,2219,4535,21,75,11,10,allow
49866,443,6704,443,7128,865,6263,19,87,9,10,allow
49908,443,25535,443,4712,908,3804,18,75,9,9,allow
64380,53,30464,53,196,102,94,2,32,1,1,allow
49342,443,54046,443,10075,6346,3729,48,84,25,23,allow
53604,1046,44060,1046,320,140,180,6,5,3,3,allow
51651,53,58120,53,237,86,151,2,29,1,1,allow
3195,53,3195,53,197,90,107,2,29,1,1,allow
64586,53,31352,53,257,102,155,2,30,1,1,allow
55383,53,13927,53,177,94,83,2,30,1,1,allow
64716,53,5161,53,718,94,624,2,30,1,1,allow
55232,53,8300,53,177,94,83,2,30,1,1,allow
65492,53,43623,53,199,102,97,2,30,1,1,allow
51786,37832,38503,37832,70,70,0,2,8,2,0,allow
51986,80,3605,80,1274,694,580,13,16,6,7,allow
43475,443,10490,443,5578,1646,3932,23,16,13,10,allow
55386,53,64239,53,822,102,720,2,30,1,1,allow
56828,53,33245,53,211,102,109,2,30,1,1,allow
53490,5228,31385,5228,7188,2098,5090,38,113,22,16,allow
46746,443,17806,443,9506,4029,5477,30,330,17,13,allow
35197,443,30510,443,12481,2743,9738,53,20,26,27,allow
50375,80,22563,80,350,210,140,6,15,4,2,allow
51403,443,43951,443,334,70,264,5,17,1,4,allow
49603,53,64849,53,733,94,639,2,30,1,1,allow
59883,443,34270,443,8031,2957,5074,27,46,16,11,allow
65294,53,43260,53,173,94,79,2,30,1,1,allow
65236,53,21854,53,177,94,83,2,30,1,1,allow
65507,53,17701,53,211,102,109,2,30,1,1,allow
65294,53,10566,53,165,86,79,2,30,1,1,allow
65236,53,45022,53,177,94,83,2,30,1,1,allow
51580,80,9107,80,1752,786,966,16,17,9,7,allow
49432,53,25699,53,309,94,215,4,32,2,2,allow
64791,443,54264,443,8580,5765,2815,46,82,22,24,allow
58904,123,61821,123,184,94,90,2,30,1,1,allow
50864,53,14255,53,199,94,105,2,30,1,1,allow
65309,53,31055,53,764,102,662,2,30,1,1,allow
55005,53,64586,53,211,102,109,2,30,1,1,allow
62490,443,60258,443,7206,4320,2886,16,120,8,8,allow
53118,56839,5832,56839,70,70,0,2,8,2,0,allow
49206,80,5739,80,57497,913,56584,52,75,11,41,allow
64967,53,21374,53,389,134,255,2,30,1,1,allow
65492,53,44506,53,822,102,720,2,30,1,1,allow
64113,53,6414,53,216,102,114,2,30,1,1,allow
51832,443,21428,443,2831,740,2091,11,120,5,6,allow
56887,53,53946,53,250,87,163,4,60,2,2,allow
59889,443,40054,443,8305,2325,5980,24,46,13,11,allow
59891,443,64677,443,7718,1947,5771,25,46,14,11,allow
55616,42929,18894,42929,70,70,0,2,8,2,0,allow
55719,8060,46962,8060,70,70,0,1,4,1,0,allow
63782,6969,33183,6969,66,66,0,2,8,2,0,allow
51785,33253,14709,33253,70,70,0,2,8,2,0,allow
53114,32975,63232,32975,70,70,0,1,5,1,0,allow
51792,22318,43615,22318,316,136,180,6,5,3,3,allow
53596,56732,58606,56732,70,70,0,2,7,2,0,allow
55232,53,12562,53,177,94,83,2,29,1,1,allow
60378,11385,17333,11385,1218,774,444,17,26,10,7,allow
52122,80,30528,80,4137,1236,2901,27,418,14,13,allow
49591,53,21458,53,86,86,0,1,29,1,0,allow
49910,443,39120,443,4712,908,3804,18,75,9,9,allow
49869,80,37142,80,2125,1041,1084,11,87,6,5,allow
60403,60092,47131,60092,70,70,0,2,8,2,0,allow
40604,443,31639,443,130,70,60,3,5,2,1,allow
54583,443,25809,443,11307,7633,3674,25,163,18,7,allow
38968,80,48567,80,1280,586,694,10,15,5,5,allow
36535,443,10367,443,416,210,206,7,27,4,3,allow
40511,80,1880,80,1680,950,730,12,15,6,6,allow
46529,80,23858,80,1119,388,731,9,223,5,4,allow
33237,443,28944,443,31065,6730,24335,68,18,37,31,allow
63742,443,58789,443,7444,1915,5529,28,16,16,12,allow
55383,53,49153,53,177,94,83,2,29,1,1,allow
57351,53,48992,53,177,94,83,2,30,1,1,allow
64642,53,40634,53,265,94,171,2,30,1,1,allow
55917,53,40255,53,177,94,83,2,30,1,1,allow
49883,53,14693,53,177,94,83,2,30,1,1,allow
33388,53,33388,53,229,98,131,2,30,1,1,allow
63617,53,24659,53,299,102,197,2,30,1,1,allow
43018,443,63361,443,4664,962,3702,15,120,7,8,allow
65220,53,42472,53,245,94,151,2,30,1,1,allow
59534,53,0,0,627,72,555,2,30,1,1,allow
65396,53,32966,53,178,94,84,2,30,1,1,allow
46730,443,28358,443,7648,1671,5977,25,31,13,12,allow
55917,53,22277,53,177,94,83,2,30,1,1,allow
49597,53,40368,53,86,86,0,1,30,1,0,allow
57351,53,50583,53,177,94,83,2,30,1,1,allow
49890,53,63142,53,767,102,665,2,30,1,1,allow
57152,53,41610,53,733,94,639,2,30,1,1,allow
49591,53,36017,53,168,86,82,2,31,1,1,allow
41816,443,14209,443,88503,3914,84589,114,80,44,70,allow
57589,443,3632,443,2614,1689,925,18,23,10,8,allow
56229,53,12969,53,165,86,79,2,30,1,1,allow
63766,80,33525,80,314,192,122,6,15,4,2,allow
51767,59158,56330,59158,70,70,0,1,5,1,0,allow
26386,53,26386,53,231,90,141,2,30,1,1,allow
64404,53,48455,53,224,94,130,2,30,1,1,allow
64557,53,9245,53,766,102,664,2,30,1,1,allow
57095,53,7010,53,177,94,83,2,30,1,1,allow
39145,443,40241,443,4602,1305,3297,27,183,12,15,allow
56355,53,52899,53,184,94,90,2,31,1,1,allow
6881,6881,44146,6881,502,150,352,2,1199,1,1,allow
52121,443,41012,443,199757,7497,192260,216,45,80,136,allow
64052,53,64052,53,198,90,108,2,30,1,1,allow
59534,53,0,0,216,72,144,2,30,1,1,allow
64841,53,21377,53,173,94,79,2,30,1,1,allow
49883,53,42017,53,177,94,83,2,30,1,1,allow
50233,53,42089,53,748,94,654,2,30,1,1,allow
56196,53,24743,53,498,204,294,6,31,3,3,allow
64979,53,4667,53,194,102,92,2,31,1,1,allow
54967,53,43919,53,178,94,84,2,31,1,1,allow
55617,53,37518,53,194,102,92,2,31,1,1,allow
50594,80,17201,80,3116,452,2664,18,394,5,13,allow
55002,443,31651,443,469783,461079,8704,444,167,329,115,allow
41440,5228,57433,5228,8866,2015,6851,29,4793,14,15,allow
39920,443,36288,443,4552,1255,3297,27,183,12,15,allow
54898,443,38797,443,4559,2054,2505,11,120,6,5,allow
57470,61768,42520,61768,330,330,0,6,1199,6,0,allow
6882,6881,62031,6881,238,118,120,2,1200,1,1,allow
38387,80,17970,80,2008,810,1198,20,394,7,13,allow
15503,26886,1778,26886,481,150,331,2,1200,1,1,allow
44847,31381,18131,31381,150,150,0,1,1200,1,0,allow
57418,443,37526,443,29994,1927,28067,50,20,17,33,allow
52282,80,3560,80,7603,1651,5952,24,16,13,11,allow
34358,80,63755,80,350,210,140,6,16,4,2,allow
29964,53,52267,53,200,86,114,2,30,1,1,allow
53566,8999,11689,8999,3428,1820,1608,21,17,12,9,allow
53576,23505,46519,23505,70,70,0,1,5,1,0,allow
63769,47661,26406,47661,70,70,0,1,5,1,0,allow
59884,443,44531,443,6622,2246,4376,21,46,12,9,allow
51075,80,51075,80,450,246,204,8,26,5,3,allow
52131,443,17836,443,6565,1251,5314,27,31,14,13,allow
33087,443,44739,443,13265,1924,11341,33,201,17,16,allow
63771,7426,20150,7426,70,70,0,1,5,1,0,allow
14431,443,44094,443,2601,1455,1146,18,16,8,10,allow
55089,53,1796,53,199,102,97,2,30,1,1,allow
64308,53,43760,53,181,86,95,2,30,1,1,allow
55089,53,56950,53,199,102,97,2,30,1,1,allow
64599,53,12199,53,767,102,665,2,30,1,1,allow
2362,53,2362,53,225,90,135,2,30,1,1,allow
57095,53,10011,53,177,94,83,2,30,1,1,allow
36255,53,36255,53,197,90,107,2,30,1,1,allow
55346,53,62620,53,177,94,83,2,31,1,1,allow
52710,445,0,0,70,70,0,1,0,1,0,drop
43890,123,0,0,234,234,0,1,0,1,0,deny
17315,11392,0,0,62,62,0,1,0,1,0,deny
57689,445,0,0,70,70,0,1,0,1,0,drop
57679,445,0,0,70,70,0,1,0,1,0,drop
57680,445,0,0,70,70,0,1,0,1,0,drop
57678,445,0,0,70,70,0,1,0,1,0,drop
57441,57470,0,0,66,66,0,1,0,1,0,deny
45941,23386,0,0,60,60,0,1,0,1,0,deny
45941,23386,0,0,60,60,0,1,0,1,0,deny
52698,445,0,0,70,70,0,1,0,1,0,drop
52697,445,0,0,70,70,0,1,0,1,0,drop
52693,445,0,0,70,70,0,1,0,1,0,drop
60480,57470,0,0,62,62,0,1,0,1,0,deny
52687,445,0,0,70,70,0,1,0,1,0,drop
52688,445,0,0,70,70,0,1,0,1,0,drop
56307,52700,0,0,66,66,0,1,0,1,0,deny
52472,7302,0,0,62,62,0,1,0,1,0,deny
61983,50432,0,0,62,62,0,1,0,1,0,deny
46936,35440,0,0,62,62,0,1,0,1,0,deny
53447,44847,0,0,62,62,0,1,0,1,0,deny
7308,50584,0,0,66,66,0,1,0,1,0,deny
38633,51221,0,0,62,62,0,1,0,1,0,deny
58305,51180,0,0,66,66,0,1,0,1,0,deny
12530,35440,0,0,66,66,0,1,0,1,0,deny
57671,445,0,0,70,70,0,1,0,1,0,drop
57669,445,0,0,70,70,0,1,0,1,0,drop
57664,445,0,0,70,70,0,1,0,1,0,drop
54140,43890,0,0,62,62,0,1,0,1,0,deny
52676,445,0,0,70,70,0,1,0,1,0,drop
50820,57470,0,0,66,66,0,1,0,1,0,deny
1024,57470,0,0,62,62,0,1,0,1,0,deny
50067,64147,0,0,66,66,0,1,0,1,0,deny
31112,50584,0,0,66,66,0,1,0,1,0,deny
60196,53,0,0,88,88,0,1,0,1,0,deny
49842,7302,0,0,66,66,0,1,0,1,0,deny
57478,7302,0,0,66,66,0,1,0,1,0,deny
59378,50584,0,0,66,66,0,1,0,1,0,deny
46587,57470,0,0,62,62,0,1,0,1,0,deny
443,10010,0,0,60,60,0,1,0,1,0,deny
3541,22114,0,0,62,62,0,1,0,1,0,deny
61218,22114,0,0,66,66,0,1,0,1,0,deny
44933,23,0,0,60,60,0,1,0,1,0,deny
59701,44847,0,0,62,62,0,1,0,1,0,deny
28668,8696,0,0,60,60,0,1,0,1,0,deny
38976,46824,0,0,62,62,0,1,0,1,0,deny
52671,445,0,0,70,70,0,1,0,1,0,drop
53072,445,0,0,66,66,0,1,0,1,0,drop
57662,445,0,0,70,70,0,1,0,1,0,drop
57661,445,0,0,70,70,0,1,0,1,0,drop
52662,445,0,0,70,70,0,1,0,1,0,drop
52663,445,0,0,70,70,0,1,0,1,0,drop
63547,37965,0,0,66,66,0,1,0,1,0,deny
52658,445,0,0,70,70,0,1,0,1,0,drop
52657,445,0,0,70,70,0,1,0,1,0,drop
1026,30188,0,0,146,146,0,1,0,1,0,deny
63314,57470,0,0,66,66,0,1,0,1,0,deny
51900,48817,0,0,146,146,0,1,0,1,0,deny
52655,445,0,0,70,70,0,1,0,1,0,drop
53065,445,0,0,66,66,0,1,0,1,0,drop
21087,80,21087,80,159790,4676,155114,177,128,67,110,allow
50878,53733,0,0,66,66,0,1,0,1,0,deny
57060,50584,0,0,62,62,0,1,0,1,0,deny
53064,445,0,0,66,66,0,1,0,1,0,drop
56494,15503,0,0,146,146,0,1,0,1,0,deny
57653,445,0,0,70,70,0,1,0,1,0,drop
58468,57587,0,0,66,66,0,1,0,1,0,deny
57645,445,0,0,70,70,0,1,0,1,0,drop
57644,445,0,0,70,70,0,1,0,1,0,drop
57639,445,0,0,70,70,0,1,0,1,0,drop
53062,445,0,0,66,66,0,1,0,1,0,drop
59940,50584,0,0,62,62,0,1,0,1,0,deny
65060,35440,0,0,62,62,0,1,0,1,0,deny
52649,445,0,0,70,70,0,1,0,1,0,drop
9957,32480,0,0,62,62,0,1,0,1,0,deny
53437,44847,0,0,62,62,0,1,0,1,0,deny
8211,28793,0,0,62,62,0,1,0,1,0,deny
57636,445,0,0,70,70,0,1,0,1,0,drop
62804,37965,0,0,62,62,0,1,0,1,0,deny
0,0,0,0,124,64,60,2,0,1,1,allow
57633,445,0,0,70,70,0,1,0,1,0,drop
57632,445,0,0,70,70,0,1,0,1,0,drop
57629,445,0,0,70,70,0,1,0,1,0,drop
53055,445,0,0,66,66,0,1,0,1,0,drop
52642,445,0,0,70,70,0,1,0,1,0,drop
1888,51505,0,0,62,62,0,1,0,1,0,deny
60188,15503,0,0,62,62,0,1,0,1,0,deny
52641,445,0,0,70,70,0,1,0,1,0,drop
53047,445,0,0,66,66,0,1,0,1,0,drop
53048,445,0,0,66,66,0,1,0,1,0,drop
53046,445,0,0,66,66,0,1,0,1,0,drop
63701,46824,0,0,66,66,0,1,0,1,0,deny
53045,445,0,0,66,66,0,1,0,1,0,drop
53043,445,0,0,66,66,0,1,0,1,0,drop
53042,445,0,0,66,66,0,1,0,1,0,drop
50084,26672,0,0,62,62,0,1,0,1,0,deny
52635,445,0,0,70,70,0,1,0,1,0,drop
23274,50584,0,0,62,62,0,1,0,1,0,deny
52103,53733,0,0,66,66,0,1,0,1,0,deny
54062,49813,0,0,62,62,0,1,0,1,0,deny
52634,445,0,0,70,70,0,1,0,1,0,drop
52447,43890,0,0,66,66,0,1,0,1,0,deny
21733,56205,0,0,66,66,0,1,0,1,0,deny
57628,445,0,0,70,70,0,1,0,1,0,drop
57625,445,0,0,70,70,0,1,0,1,0,drop
57621,445,0,0,70,70,0,1,0,1,0,drop
53038,445,0,0,66,66,0,1,0,1,0,drop
57620,445,0,0,70,70,0,1,0,1,0,drop
13654,50584,0,0,146,146,0,1,0,1,0,deny
53037,445,0,0,66,66,0,1,0,1,0,drop
52630,445,0,0,70,70,0,1,0,1,0,drop
59128,44847,0,0,62,62,0,1,0,1,0,deny
53033,445,0,0,66,66,0,1,0,1,0,drop
53035,445,0,0,66,66,0,1,0,1,0,drop
53031,445,0,0,66,66,0,1,0,1,0,drop
52629,445,0,0,70,70,0,1,0,1,0,drop
58396,22114,0,0,66,66,0,1,0,1,0,deny
63615,23,0,0,60,60,0,1,0,1,0,deny
46275,64147,0,0,62,62,0,1,0,1,0,deny
56119,46824,0,0,62,62,0,1,0,1,0,deny
57614,445,0,0,70,70,0,1,0,1,0,drop
29203,26467,0,0,62,62,0,1,0,1,0,deny
54910,32480,0,0,66,66,0,1,0,1,0,deny
50418,80,62798,80,12920,6875,6045,25,27,13,12,allow
50431,80,44826,80,318,192,126,6,27,4,2,allow
50435,80,28947,80,318,192,126,6,27,4,2,allow
2075,7000,2075,7000,5850,4395,1455,18,15,10,8,allow
65287,3389,65287,3389,3409,1454,1955,16,16,8,8,allow
50446,80,5062,80,318,192,126,6,27,4,2,allow
34539,80,34539,80,22098,1602,20496,24,57,6,18,allow
56613,443,29986,443,7981,1961,6020,20,16,11,9,allow
56614,443,40071,443,8034,2014,6020,20,15,11,9,allow
49914,443,44270,443,5895,728,5167,16,27,8,8,allow
52324,443,52324,443,6727,762,5965,15,26,8,7,allow
55089,53,42866,53,198,101,97,2,30,1,1,allow
57257,53,11711,53,764,99,665,2,30,1,1,allow
11295,40040,23656,40040,213,89,124,4,31,2,2,allow
55735,53,17069,53,772,100,672,2,30,1,1,allow
50432,80,29144,80,318,192,126,6,27,4,2,allow
2076,7000,2076,7000,5194,3739,1455,18,15,10,8,allow
51541,3389,51541,3389,3609,1654,1955,19,18,11,8,allow
56615,443,31008,443,7982,1962,6020,20,15,11,9,allow
52322,443,52322,443,6926,828,6098,17,26,9,8,allow
2074,7010,2074,7010,4279,2090,2189,16,15,8,8,allow
57115,53,57910,53,788,108,680,2,30,1,1,allow
57095,53,44244,53,170,87,83,2,30,1,1,allow
56741,53,9430,53,814,110,704,2,30,1,1,allow
50181,80,60161,80,2149,1165,984,15,77,8,7,allow
56357,53,52220,53,172,88,84,2,30,1,1,allow
56616,443,54486,443,8033,2013,6020,20,15,11,9,allow
63760,37264,26706,37264,504,382,122,8,16,6,2,allow
60334,7080,60334,7080,2960,432,2528,11,15,6,5,allow
50427,80,43709,80,312,192,120,6,27,4,2,allow
2078,7000,2078,7000,3006,1615,1391,15,15,8,7,allow
64633,53,4250,53,762,98,664,2,30,1,1,allow
57855,443,34807,443,4370,3370,1000,19,187,10,9,allow
55552,53,38672,53,767,102,665,2,30,1,1,allow
58819,1433,58819,1433,124,60,64,2,5,1,1,allow
55462,53,13103,53,188,96,92,2,30,1,1,allow
56567,53,56060,53,188,96,92,2,31,1,1,allow
58488,3389,58488,3389,3428,1714,1714,16,31,8,8,allow
56771,53,7291,53,270,95,175,4,60,2,2,allow
50755,80,50755,80,450,246,204,8,25,5,3,allow
58054,25,23956,25,1370,496,874,16,16,8,8,allow
65290,3389,65290,3389,3327,1438,1889,15,16,8,7,allow
51784,34568,29870,34568,70,70,0,2,8,2,0,allow
50948,80,50948,80,520,246,274,9,25,5,4,allow
53572,22754,17581,22754,70,70,0,1,5,1,0,allow
2077,7000,2077,7000,3054,1599,1455,16,15,8,8,allow
58509,80,60586,80,1666,1130,536,12,16,7,5,allow
2073,7000,2073,7000,3566,1999,1567,16,15,8,8,allow
55617,18319,24832,18319,320,140,180,6,7,3,3,allow
50966,443,44457,443,7975,3304,4671,19,86,11,8,allow
50428,80,50756,80,312,192,120,6,27,4,2,allow
51765,52862,65009,52862,66,66,0,1,5,1,0,allow
63205,443,63205,443,9324,4240,5084,24,16,13,11,allow
2072,7000,2072,7000,3164,783,2381,15,16,7,8,allow
44805,3389,44805,3389,4870,2631,2239,23,19,13,10,allow
50445,80,48799,80,318,192,126,6,27,4,2,allow
63525,53,0,0,174,77,97,2,30,1,1,allow
55417,53,30758,53,196,100,96,2,30,1,1,allow
56620,53,51991,53,322,110,212,4,30,2,2,allow
65192,53,4438,53,172,88,84,2,30,1,1,allow
55514,53,44502,53,783,96,687,2,30,1,1,allow
55113,53,29716,53,196,100,96,2,31,1,1,allow
56355,53,30971,53,184,94,90,2,31,1,1,allow
56724,53,15012,53,749,89,660,2,31,1,1,allow
55336,53,13699,53,295,101,194,4,31,2,2,allow
56569,53,65375,53,91,91,0,1,31,1,0,allow
55990,53,40258,53,182,93,89,2,30,1,1,allow
52544,19000,32388,19000,492,216,276,2,31,1,1,allow
56386,53,13942,53,170,87,83,2,31,1,1,allow
57040,53,4133,53,810,108,702,2,31,1,1,allow
55282,53,18223,53,771,101,670,2,31,1,1,allow
65188,53,51573,53,731,91,640,2,31,1,1,allow
49432,53,56971,53,170,87,83,2,31,1,1,allow
55582,53,11114,53,778,103,675,2,31,1,1,allow
57350,53,19217,53,771,101,670,2,31,1,1,allow
55826,53,30050,53,86,86,0,1,31,1,0,allow
51221,51413,20920,51413,459,149,310,2,1200,1,1,allow
50584,11830,62858,11830,2118,900,1218,14,4232,7,7,allow
63978,53,11123,53,212,108,104,2,31,1,1,allow
56220,53,22417,53,772,103,669,2,31,1,1,allow
5938,49414,0,0,60,60,0,1,90,1,0,allow
64637,53,20905,53,810,108,702,2,30,1,1,allow
50584,53,43253,53,174,89,85,2,31,1,1,allow
65149,53,43485,53,760,97,663,2,31,1,1,allow
56743,53,42878,53,816,97,719,2,30,1,1,allow
55746,53,61389,53,216,110,106,2,31,1,1,allow
56995,53,58865,53,168,86,82,2,31,1,1,allow
55809,53,62877,53,731,85,646,2,31,1,1,allow
55735,53,65479,53,184,94,90,2,31,1,1,allow
49263,53,10892,53,731,85,646,2,31,1,1,allow
56935,53,37247,53,174,89,85,2,31,1,1,allow
51951,443,56049,443,6633,3485,3148,34,197,19,15,allow
55454,53,60200,53,202,103,99,2,31,1,1,allow
15341,23,0,0,60,60,0,1,90,1,0,allow
10151,19083,54566,19083,489,149,340,2,1200,1,1,allow
55081,53,2837,53,711,87,624,2,31,1,1,allow
56186,53,1999,53,196,100,96,2,31,1,1,allow
55273,53,51928,53,166,85,81,2,31,1,1,allow
56282,53,64449,53,751,95,656,2,31,1,1,allow
56072,53,60907,53,198,101,97,2,31,1,1,allow
57094,53,64941,53,192,98,94,2,31,1,1,allow
45944,443,12806,443,4715,1935,2780,24,183,11,13,allow
57608,445,0,0,70,70,0,1,0,1,0,drop
57604,445,0,0,70,70,0,1,0,1,0,drop
65384,57470,0,0,66,66,0,1,0,1,0,deny
54600,6881,0,0,66,66,0,1,0,1,0,deny
52624,445,0,0,70,70,0,1,0,1,0,drop
26528,51221,0,0,78,78,0,1,0,1,0,deny
63183,64147,0,0,66,66,0,1,0,1,0,deny
443,28417,0,0,82,82,0,1,0,1,0,deny
6881,6881,0,0,146,146,0,1,0,1,0,deny
53023,445,0,0,66,66,0,1,0,1,0,drop
1534,54369,0,0,66,66,0,1,0,1,0,deny
51999,37965,0,0,62,62,0,1,0,1,0,deny
64847,53,37930,53,211,102,109,2,30,1,1,allow
55990,53,28837,53,183,94,89,2,30,1,1,allow
50448,443,40818,443,1119,595,524,12,26,6,6,allow
34489,35440,0,0,62,62,0,1,0,1,0,deny
53013,445,0,0,66,66,0,1,0,1,0,drop
33292,50584,0,0,62,62,0,1,0,1,0,deny
57594,445,0,0,70,70,0,1,0,1,0,drop
48430,22,0,0,60,60,0,1,0,1,0,deny
62189,64147,0,0,145,145,0,1,0,1,0,deny
52611,445,0,0,70,70,0,1,0,1,0,drop
58305,18375,0,0,66,66,0,1,0,1,0,deny
53010,445,0,0,66,66,0,1,0,1,0,drop
61221,35440,0,0,66,66,0,1,0,1,0,deny
52608,445,0,0,70,70,0,1,0,1,0,drop
21420,44847,0,0,66,66,0,1,0,1,0,deny
53591,35889,63951,35889,320,140,180,6,6,3,3,allow
50307,53,50594,53,1370,89,1281,4,33,2,2,allow
27416,53,27416,53,214,82,132,2,32,1,1,allow
56620,53,31427,53,216,110,106,2,30,1,1,allow
64979,53,10691,53,194,102,92,2,30,1,1,allow
50280,53,42526,53,794,102,692,2,30,1,1,allow
51196,443,64591,443,346,140,206,6,130,3,3,allow
49524,443,52573,443,52864,3584,49280,86,95,39,47,allow
56546,443,24280,443,134,60,74,3,5,2,1,allow
55052,80,37545,80,11677266,314362,11362904,12711,129,5174,7537,allow
64776,53,33019,53,935,334,601,8,62,4,4,allow
49202,53,22068,53,498,204,294,6,29,3,3,allow
65357,53,38110,53,194,102,92,2,29,1,1,allow
49229,53,54866,53,178,94,84,2,29,1,1,allow
49320,53,59903,53,177,94,83,2,30,1,1,allow
55417,53,60973,53,198,102,96,2,30,1,1,allow
57201,53,46716,53,214,110,104,2,30,1,1,allow
56229,53,1556,53,173,94,79,2,30,1,1,allow
34360,80,12302,80,494,280,214,8,14,5,3,allow
51009,80,51009,80,450,246,204,8,25,5,3,allow
60750,40010,25363,40010,316,136,180,6,6,3,3,allow
38872,443,38872,443,4480,1573,2907,19,29,11,8,allow
49919,80,50897,80,2821387,64706,2756681,2277,183,418,1859,allow
63779,12226,36658,12226,66,66,0,2,7,2,0,allow
48913,443,1076,443,6922,1618,5304,23,35,12,11,allow
49449,80,49449,80,416,198,218,7,29,4,3,allow
47402,443,25875,443,6118,1180,4938,22,16,11,11,allow
59882,443,38875,443,10017,3031,6986,30,45,17,13,allow
65357,53,40859,53,194,102,92,2,29,1,1,allow
59343,53,0,0,178,72,106,2,29,1,1,allow
50689,80,50689,80,450,246,204,8,25,5,3,allow
50362,53,58174,53,214,110,104,2,29,1,1,allow
38671,443,7350,443,7897,3562,4335,19,16,10,9,allow
49883,53,5470,53,177,94,83,2,29,1,1,allow
65396,53,55502,53,186,102,84,2,29,1,1,allow
55080,53,11951,53,173,94,79,2,29,1,1,allow
52120,443,51831,443,305183,9715,295468,312,44,107,205,allow
40923,53,40923,53,200,90,110,2,29,1,1,allow
4702,53,4702,53,220,90,130,2,29,1,1,allow
53571,19636,6508,19636,70,70,0,1,4,1,0,allow
55089,53,6638,53,199,102,97,2,30,1,1,allow
55346,53,65324,53,177,94,83,2,29,1,1,allow
65192,53,33207,53,178,94,84,2,30,1,1,allow
26447,80,26447,80,12599,1479,11120,28,16,15,13,allow
63630,53,44818,53,278,94,184,2,30,1,1,allow
33243,443,3619,443,35991,3996,31995,58,17,26,32,allow
50450,80,49757,80,26924,4418,22506,34,25,13,21,allow
61364,443,41959,443,8492,2950,5542,27,16,15,12,allow
50437,80,64833,80,314,192,122,6,26,4,2,allow
64730,53,5756,53,261,94,167,2,30,1,1,allow
64836,53,53586,53,241,94,147,2,30,1,1,allow
50440,53,45707,53,216,110,106,2,30,1,1,allow
49597,53,32706,53,168,86,82,2,31,1,1,allow
65030,53,52927,53,785,110,675,2,30,1,1,allow
51406,443,38367,443,8186,2146,6040,29,33,16,13,allow
33242,443,38172,443,14244,2907,11337,33,17,17,16,allow
50426,443,9963,443,5713,1079,4634,15,26,8,7,allow
50421,80,60680,80,7162,3201,3961,19,27,11,8,allow
50462,80,58102,80,4603,2152,2451,14,22,8,6,allow
55836,53,17150,53,181,94,87,2,33,1,1,allow
50438,80,13874,80,314,192,122,6,26,4,2,allow
57095,53,33152,53,177,94,83,2,30,1,1,allow
55735,53,28047,53,184,94,90,2,30,1,1,allow
55101,53,47277,53,197,102,95,2,30,1,1,allow
56719,53,59269,53,185,102,83,2,30,1,1,allow
56719,53,51859,53,185,102,83,2,30,1,1,allow
50440,53,39485,53,216,110,106,2,30,1,1,allow
56567,53,21156,53,194,102,92,2,30,1,1,allow
56373,53,9472,53,200,102,98,2,30,1,1,allow
49422,53,52820,53,719,208,511,6,32,3,3,allow
50449,443,5504,443,7588,1850,5738,19,25,10,9,allow
49353,53,9997,53,237,94,143,2,30,1,1,allow
48409,443,36994,443,5993,1261,4732,18,982,8,10,allow
34355,80,5779,80,416,210,206,7,15,4,3,allow
55746,53,40664,53,216,110,106,2,30,1,1,allow
56386,53,3694,53,177,94,83,2,30,1,1,allow
51487,443,18707,443,10453,3977,6476,27,54,15,12,allow
49432,53,51069,53,177,94,83,2,30,1,1,allow
64980,53,3433,53,200,102,98,2,30,1,1,allow
55990,53,30769,53,183,94,89,2,30,1,1,allow
49564,53,7876,53,168,78,90,2,30,1,1,allow
56995,53,18611,53,168,86,82,2,30,1,1,allow
64840,53,24107,53,356,118,238,2,30,1,1,allow
44587,443,26672,443,16341,3306,13035,42,17,24,18,allow
55077,53,19465,53,277,90,187,4,32,2,2,allow
50439,80,32782,80,318,192,126,6,26,4,2,allow
65291,53,53725,53,889,404,485,10,30,5,5,allow
52704,53,49844,53,168,78,90,2,30,1,1,allow
63067,443,13404,443,2570995,60656,2510339,2538,34,844,1694,allow
34354,80,61619,80,350,210,140,6,15,4,2,allow
51766,48169,32212,48169,70,70,0,1,5,1,0,allow
60038,80,60038,80,12881,767,12114,21,21,9,12,allow
50434,80,31890,80,318,192,126,6,26,4,2,allow
52380,443,20377,443,8659,3601,5058,34,80,18,16,allow
65496,53,6299,53,210,86,124,2,30,1,1,allow
56620,53,63507,53,216,110,106,2,30,1,1,allow
60760,53,0,0,86,86,0,1,30,1,0,allow
56658,53,12429,53,229,94,135,2,30,1,1,allow
49971,53,55758,53,198,102,96,2,30,1,1,allow
57090,53,28237,53,198,102,96,2,30,1,1,allow
34529,443,32303,443,77395,64623,12772,206,188,116,90,allow
37277,80,37277,80,52625,3140,49485,55,52,14,41,allow
49913,443,31997,443,5570,901,4669,16,27,8,8,allow
34359,80,6984,80,350,210,140,6,14,4,2,allow
51764,33432,6081,33432,70,70,0,1,5,1,0,allow
53570,24874,57819,24874,70,70,0,1,4,1,0,allow
53372,443,36591,443,214,140,74,4,20,3,1,allow
63768,55755,10523,55755,70,70,0,1,4,1,0,allow
55417,53,34497,53,198,102,96,2,33,1,1,allow
60402,47094,53695,47094,320,140,180,6,7,3,3,allow
53575,1025,61617,1025,70,70,0,1,4,1,0,allow
50441,80,60802,80,318,192,126,6,26,4,2,allow
50433,80,24726,80,318,192,126,6,26,4,2,allow
65470,443,40363,443,372361,11310,361051,385,16,136,249,allow
50122,443,55695,443,6407,1101,5306,18,26,10,8,allow
49623,53,34250,53,790,110,680,2,29,1,1,allow
50424,443,50613,443,5713,1079,4634,15,26,8,7,allow
53070,53,0,0,168,74,94,2,29,1,1,allow
55080,53,13972,53,165,86,79,2,29,1,1,allow
57201,53,40982,53,214,110,104,2,29,1,1,allow
33246,443,57032,443,8340,2896,5444,28,16,16,12,allow
50362,53,33305,53,214,110,104,2,29,1,1,allow
46159,443,12485,443,124567,6787,117780,175,263,82,93,allow
59321,53,33396,53,209,70,139,2,30,1,1,allow
49320,53,28326,53,185,102,83,2,30,1,1,allow
65130,53,25428,53,646,200,446,6,62,3,3,allow
63942,53,65464,53,214,102,112,2,30,1,1,allow
49405,53,14474,53,94,94,0,1,30,1,0,allow
50106,53,61175,53,209,110,99,2,30,1,1,allow
60375,53,25105,53,226,94,132,2,31,1,1,allow
56386,53,9835,53,177,94,83,2,31,1,1,allow
49068,443,40796,443,8664,2567,6097,20,120,10,10,allow
55439,53,52898,53,209,110,99,2,30,1,1,allow
55776,53,52683,53,216,110,106,2,30,1,1,allow
17481,53,17481,53,198,90,108,2,30,1,1,allow
56567,53,28811,53,194,102,92,2,31,1,1,allow
36157,53,43020,53,164,78,86,2,31,1,1,allow
65366,53,59432,53,199,102,97,2,31,1,1,allow
56186,53,13478,53,198,102,96,2,31,1,1,allow
57094,53,10369,53,196,102,94,2,30,1,1,allow
49591,53,7578,53,168,86,82,2,32,1,1,allow
53117,37529,25510,37529,70,70,0,2,8,2,0,allow
50463,80,9327,80,1718,1247,471,9,15,5,4,allow
50496,443,27297,443,90570,3437,87133,103,90,34,69,allow
50148,80,44851,80,17314,6865,10449,50,79,24,26,allow
33245,443,3684,443,7279,2884,4395,28,16,16,12,allow
63764,12343,45903,12343,504,382,122,8,15,6,2,allow
55462,53,6708,53,194,102,92,2,30,1,1,allow
65366,53,11375,53,199,102,97,2,30,1,1,allow
55107,53,52328,53,214,102,112,2,30,1,1,allow
56373,53,63287,53,200,102,98,2,30,1,1,allow
50613,53,60735,53,814,110,704,2,30,1,1,allow
56373,53,59936,53,200,102,98,2,30,1,1,allow
41886,53,43611,53,168,78,90,2,30,1,1,allow
50440,53,43767,53,216,110,106,2,30,1,1,allow
49971,53,63730,53,198,102,96,2,30,1,1,allow
30188,14432,60719,14432,868,150,718,4,1200,2,2,allow
49433,53,38840,53,167,86,81,2,30,1,1,allow
50922,443,21315,443,6180,1241,4939,18,982,8,10,allow
52321,443,52321,443,6727,762,5965,15,25,8,7,allow
58889,443,61172,443,3956,2519,1437,18,80,10,8,allow
50440,80,41548,80,318,192,126,6,26,4,2,allow
50429,80,32057,80,318,192,126,6,26,4,2,allow
50430,80,29932,80,318,192,126,6,26,4,2,allow
50150,80,7592,80,73454,5461,67993,74,79,22,52,allow
50312,80,40765,80,2699,1007,1692,14,64,7,7,allow
50425,443,34304,443,5653,1079,4574,14,26,8,6,allow
50374,443,61017,443,8485,1804,6681,30,316,14,16,allow
33238,443,21628,443,21538,3952,17586,48,17,27,21,allow
55836,53,27528,53,181,94,87,2,30,1,1,allow
55656,53,37585,53,214,110,104,2,30,1,1,allow
55656,53,7470,53,214,110,104,2,30,1,1,allow
54967,53,27983,53,178,94,84,2,30,1,1,allow
55617,53,59978,53,194,102,92,2,30,1,1,allow
37637,53,37222,53,168,78,90,2,30,1,1,allow
52221,53,10859,53,177,86,91,2,30,1,1,allow
40507,53,2072,53,86,86,0,1,30,1,0,allow
50455,443,11561,443,107749,6262,101487,142,138,58,84,allow
38523,53,38523,53,214,82,132,2,32,1,1,allow
33664,80,55691,80,70,70,0,1,5,1,0,allow
50436,80,19701,80,314,192,122,6,26,4,2,allow
55990,53,6469,53,183,94,89,2,30,1,1,allow
55735,53,52965,53,184,94,90,2,30,1,1,allow
56771,53,2287,53,270,95,175,4,60,2,2,allow
65153,53,29688,53,168,86,82,2,30,1,1,allow
50106,53,26028,53,209,110,99,2,30,1,1,allow
63978,53,60357,53,214,110,104,2,30,1,1,allow
64980,53,54616,53,200,102,98,2,30,1,1,allow
50584,53,20103,53,179,94,85,2,30,1,1,allow
63978,53,35344,53,214,110,104,2,30,1,1,allow
58263,443,17697,443,12494,5331,7163,48,122,21,27,allow
33067,53,0,0,86,86,0,1,30,1,0,allow
55336,53,26759,53,199,102,97,2,31,1,1,allow
50103,53,41648,53,168,86,82,2,31,1,1,allow
56809,53,41798,53,178,94,84,2,31,1,1,allow
64413,443,46827,443,5660875,75934,5584941,4719,141,686,4033,allow
55746,53,54887,53,216,110,106,2,30,1,1,allow
64001,53,4323,53,183,94,89,2,30,1,1,allow
65036,53,40667,53,214,110,104,2,30,1,1,allow
50105,53,29739,53,969,86,883,2,30,1,1,allow
57090,53,19646,53,198,102,96,2,30,1,1,allow
55656,53,44214,53,214,110,104,2,30,1,1,allow
64001,53,1260,53,183,94,89,2,30,1,1,allow
65036,53,28927,53,214,110,104,2,30,1,1,allow
65366,53,12473,53,199,102,97,2,30,1,1,allow
56355,53,13355,53,184,94,90,2,30,1,1,allow
55454,53,12071,53,209,110,99,2,31,1,1,allow
40942,123,62465,123,184,94,90,2,30,1,1,allow
56386,53,21142,53,177,94,83,2,30,1,1,allow
49543,53,11834,53,779,110,669,2,30,1,1,allow
56357,53,34112,53,178,94,84,2,30,1,1,allow
64995,53,33043,53,199,102,97,2,30,1,1,allow
57259,53,43312,53,199,102,97,2,31,1,1,allow
50103,53,21620,53,168,86,82,2,30,1,1,allow
54956,53,56541,53,194,102,92,2,30,1,1,allow
64995,53,32093,53,199,102,97,2,30,1,1,allow
55372,53,55372,53,216,90,126,2,30,1,1,allow
56501,53,9977,53,216,94,122,2,31,1,1,allow
57094,53,18443,53,196,102,94,2,31,1,1,allow
55364,53,26181,53,168,86,82,2,31,1,1,allow
65300,53,9182,53,195,102,93,2,31,1,1,allow
56355,53,43280,53,184,94,90,2,31,1,1,allow
52251,443,26101,443,23328780,730794,22597986,24754,320,8113,16641,allow
35745,443,18614,443,7634,4417,3217,35,197,19,16,allow
55101,53,52227,53,197,102,95,2,31,1,1,allow
49608,53,63046,53,198,110,88,2,31,1,1,allow
49432,53,5253,53,177,94,83,2,31,1,1,allow
56072,53,35892,53,199,102,97,2,31,1,1,allow
8861,443,39985,443,42890,30849,12041,214,420,106,108,allow
39500,443,7473,443,6517,2048,4469,21,90,12,9,allow
50523,443,53596,443,6676,1074,5602,22,84,12,10,allow
38535,443,55811,443,910,358,552,14,47,6,8,allow
43368,80,43368,80,232198,9152,223046,290,21,134,156,allow
50512,443,55722,443,6945,1842,5103,25,87,14,11,allow
54956,53,60675,53,194,102,92,2,31,1,1,allow
63761,25933,42159,25933,436,254,182,7,15,4,3,allow
53593,32022,37169,32022,320,140,180,6,6,3,3,allow
65338,53,10255,53,314,88,226,4,44,2,2,allow
51509,443,60240,443,1307,688,619,14,37,8,6,allow
50586,443,6357,443,2756,1594,1162,20,27,11,9,allow
58703,50584,0,0,66,66,0,1,0,1,0,deny
53004,445,0,0,66,66,0,1,0,1,0,drop
53000,445,0,0,66,66,0,1,0,1,0,drop
21892,15503,0,0,62,62,0,1,0,1,0,deny
21145,11392,0,0,62,62,0,1,0,1,0,deny
39895,26467,0,0,62,62,0,1,0,1,0,deny
52604,445,0,0,70,70,0,1,0,1,0,drop
52602,445,0,0,70,70,0,1,0,1,0,drop
17320,14914,0,0,148,148,0,1,0,1,0,deny
52600,445,0,0,70,70,0,1,0,1,0,drop
62071,22114,0,0,62,62,0,1,0,1,0,deny
56712,46824,0,0,66,66,0,1,0,1,0,deny
60018,64147,0,0,62,62,0,1,0,1,0,deny
57583,445,0,0,70,70,0,1,0,1,0,drop
57581,445,0,0,70,70,0,1,0,1,0,drop
52980,445,0,0,66,66,0,1,0,1,0,drop
52986,445,0,0,66,66,0,1,0,1,0,drop
52983,445,0,0,66,66,0,1,0,1,0,drop
52981,445,0,0,66,66,0,1,0,1,0,drop
52987,445,0,0,66,66,0,1,0,1,0,drop
52988,445,0,0,66,66,0,1,0,1,0,drop
52985,445,0,0,66,66,0,1,0,1,0,drop
52984,445,0,0,66,66,0,1,0,1,0,drop
53469,44847,0,0,66,66,0,1,0,1,0,deny
10533,23,0,0,60,60,0,1,0,1,0,deny
47962,16069,0,0,62,62,0,1,0,1,0,deny
52593,445,0,0,70,70,0,1,0,1,0,drop
52591,445,0,0,70,70,0,1,0,1,0,drop
7905,48817,0,0,146,146,0,1,0,1,0,deny
36906,50584,0,0,62,62,0,1,0,1,0,deny
57579,445,0,0,70,70,0,1,0,1,0,drop
57569,445,0,0,70,70,0,1,0,1,0,drop
57566,445,0,0,70,70,0,1,0,1,0,drop
52590,445,0,0,70,70,0,1,0,1,0,drop
52589,445,0,0,70,70,0,1,0,1,0,drop
52588,445,0,0,70,70,0,1,0,1,0,drop
52968,445,0,0,66,66,0,1,0,1,0,drop
52966,445,0,0,66,66,0,1,0,1,0,drop
52965,445,0,0,66,66,0,1,0,1,0,drop
52586,445,0,0,70,70,0,1,0,1,0,drop
52583,445,0,0,70,70,0,1,0,1,0,drop
62549,64147,0,0,62,62,0,1,0,1,0,deny
58598,50584,0,0,62,62,0,1,0,1,0,deny
443,28417,0,0,82,82,0,1,0,1,0,deny
57562,445,0,0,70,70,0,1,0,1,0,drop
50535,51505,0,0,66,66,0,1,0,1,0,deny
62776,62413,0,0,62,62,0,1,0,1,0,deny
32491,15503,0,0,66,66,0,1,0,1,0,deny
49699,64147,0,0,62,62,0,1,0,1,0,deny
17008,35440,0,0,62,62,0,1,0,1,0,deny
54111,62609,0,0,148,148,0,1,0,1,0,deny
64482,64147,0,0,62,62,0,1,0,1,0,deny
57560,445,0,0,70,70,0,1,0,1,0,drop
24411,12809,0,0,60,60,0,1,0,1,0,deny
52570,445,0,0,70,70,0,1,0,1,0,drop
52569,445,0,0,70,70,0,1,0,1,0,drop
52565,445,0,0,70,70,0,1,0,1,0,drop
57552,445,0,0,70,70,0,1,0,1,0,drop
57550,445,0,0,70,70,0,1,0,1,0,drop
57548,445,0,0,70,70,0,1,0,1,0,drop
52559,445,0,0,70,70,0,1,0,1,0,drop
52560,445,0,0,70,70,0,1,0,1,0,drop
49664,37965,0,0,66,66,0,1,0,1,0,deny
60196,53,0,0,88,88,0,1,0,1,0,deny
55296,23718,0,0,66,66,0,1,0,1,0,deny
12608,21247,0,0,66,66,0,1,0,1,0,deny
57772,50584,0,0,66,66,0,1,0,1,0,deny
29424,37807,0,0,66,66,0,1,0,1,0,deny
60196,53,0,0,88,88,0,1,0,1,0,deny
15274,81,0,0,60,60,0,1,0,1,0,deny
58445,17500,0,0,66,66,0,1,0,1,0,deny
31469,23,0,0,60,60,0,1,0,1,0,deny
40971,1433,0,0,60,60,0,1,0,1,0,deny
28668,8696,0,0,60,60,0,1,0,1,0,deny
21833,22114,0,0,62,62,0,1,0,1,0,deny
52548,445,0,0,70,70,0,1,0,1,0,drop
37902,23718,0,0,146,146,0,1,0,1,0,deny
57543,445,0,0,70,70,0,1,0,1,0,drop
57540,445,0,0,70,70,0,1,0,1,0,drop
57537,445,0,0,70,70,0,1,0,1,0,drop
1176,64147,0,0,62,62,0,1,0,1,0,deny
59592,37965,0,0,62,62,0,1,0,1,0,deny
9412,7302,0,0,66,66,0,1,0,1,0,deny
47910,7454,0,0,60,60,0,1,0,1,0,deny
47910,7454,0,0,60,60,0,1,0,1,0,deny
443,28417,0,0,82,82,0,1,0,1,0,deny
63465,56205,0,0,66,66,0,1,0,1,0,deny
42685,51180,0,0,62,62,0,1,0,1,0,deny
18415,37965,0,0,62,62,0,1,0,1,0,deny
52544,445,0,0,70,70,0,1,0,1,0,drop
58995,443,49054,443,8826,2860,5966,21,9,10,11,allow
26921,37965,0,0,62,62,0,1,0,1,0,deny
37597,50584,0,0,66,66,0,1,0,1,0,deny
51617,21247,0,0,66,66,0,1,0,1,0,deny
59918,44847,0,0,66,66,0,1,0,1,0,deny
36656,64147,0,0,62,62,0,1,0,1,0,deny
52944,445,0,0,66,66,0,1,0,1,0,drop
54343,50584,0,0,66,66,0,1,0,1,0,deny
57533,445,0,0,70,70,0,1,0,1,0,drop
57534,445,0,0,70,70,0,1,0,1,0,drop
80,54605,0,0,66,66,0,1,0,1,0,deny
54471,36237,0,0,66,66,0,1,0,1,0,deny
52533,445,0,0,70,70,0,1,0,1,0,drop
52535,445,0,0,70,70,0,1,0,1,0,drop
52532,445,0,0,70,70,0,1,0,1,0,drop
52531,445,0,0,70,70,0,1,0,1,0,drop
52527,445,0,0,70,70,0,1,0,1,0,drop
1323,64147,0,0,66,66,0,1,0,1,0,deny
443,28417,0,0,82,82,0,1,0,1,0,deny
0,0,0,0,70,70,0,1,0,1,0,deny
0,0,0,0,480,244,236,4,0,2,2,allow
0,0,0,0,182,182,0,1,0,1,0,deny
48087,16069,0,0,62,62,0,1,0,1,0,deny
52940,445,0,0,66,66,0,1,0,1,0,drop
45941,23388,0,0,60,60,0,1,0,1,0,deny
52936,445,0,0,66,66,0,1,0,1,0,drop
16059,22114,0,0,62,62,0,1,0,1,0,deny
57523,445,0,0,70,70,0,1,0,1,0,drop
57515,445,0,0,70,70,0,1,0,1,0,drop
57514,445,0,0,70,70,0,1,0,1,0,drop
57511,445,0,0,70,70,0,1,0,1,0,drop
52522,445,0,0,70,70,0,1,0,1,0,drop
52933,445,0,0,66,66,0,1,0,1,0,drop
61315,48817,0,0,62,62,0,1,0,1,0,deny
57508,445,0,0,70,70,0,1,0,1,0,drop
52514,445,0,0,70,70,0,1,0,1,0,drop
57283,64147,0,0,66,66,0,1,0,1,0,deny
52511,445,0,0,70,70,0,1,0,1,0,drop
57505,445,0,0,70,70,0,1,0,1,0,drop
57504,445,0,0,70,70,0,1,0,1,0,drop
57501,445,0,0,70,70,0,1,0,1,0,drop
20378,23,0,0,60,60,0,1,0,1,0,deny
52926,445,0,0,66,66,0,1,0,1,0,drop
39359,15503,0,0,74,74,0,1,0,1,0,deny
52920,445,0,0,66,66,0,1,0,1,0,drop
52923,445,0,0,66,66,0,1,0,1,0,drop
52919,445,0,0,66,66,0,1,0,1,0,drop
64890,51180,0,0,62,62,0,1,0,1,0,deny
52916,445,0,0,66,66,0,1,0,1,0,drop
52917,445,0,0,66,66,0,1,0,1,0,drop
52915,445,0,0,66,66,0,1,0,1,0,drop
52508,445,0,0,70,70,0,1,0,1,0,drop
31521,57470,0,0,145,145,0,1,0,1,0,deny
52506,445,0,0,70,70,0,1,0,1,0,drop
45908,33330,0,0,60,60,0,1,0,1,0,deny
443,28417,0,0,82,82,0,1,0,1,0,deny
52743,15503,0,0,66,66,0,1,0,1,0,deny
30046,15503,0,0,62,62,0,1,0,1,0,deny
61420,64097,0,0,66,66,0,1,0,1,0,deny
11252,23,0,0,60,60,0,1,0,1,0,deny
57498,445,0,0,70,70,0,1,0,1,0,drop
57499,445,0,0,70,70,0,1,0,1,0,drop
57496,445,0,0,70,70,0,1,0,1,0,drop
52910,445,0,0,66,66,0,1,0,1,0,drop
52502,445,0,0,70,70,0,1,0,1,0,drop
64516,53,13798,53,216,110,106,2,30,1,1,allow
37133,80,37133,80,12799,979,11820,20,17,9,11,allow
57896,443,11349,443,7332,3746,3586,37,176,19,18,allow
51269,36983,55294,36983,70,70,0,2,8,2,0,allow
59819,443,17243,443,1401,864,537,12,29,6,6,allow
63204,443,63204,443,9340,4256,5084,24,16,13,11,allow
40791,443,54664,443,7236,2069,5167,25,25,12,13,allow
57893,443,16617,443,1867,1228,639,18,176,11,7,allow
55943,53,5113,53,1415,94,1321,4,31,2,2,allow
53584,62974,25990,62974,70,70,0,2,8,2,0,allow
49217,53,12085,53,202,103,99,2,31,1,1,allow
49374,53,54400,53,186,95,91,2,31,1,1,allow
55101,53,27553,53,194,99,95,2,30,1,1,allow
35048,80,62136,80,15867,2466,13401,29,33,16,13,allow
53587,32029,60710,32029,70,70,0,2,8,2,0,allow
51780,21130,9712,21130,70,70,0,2,8,2,0,allow
53567,43167,28309,43167,492,306,186,8,16,5,3,allow
65300,53,37068,53,190,97,93,2,31,1,1,allow
59823,443,61551,443,306,180,126,6,29,4,2,allow
51782,10637,37366,10637,70,70,0,2,8,2,0,allow
34166,443,49916,443,8290,2156,6134,24,81,14,10,allow
56611,443,45204,443,7983,1963,6020,20,15,11,9,allow
57884,443,2033,443,3981,1811,2170,26,177,14,12,allow
56809,53,64424,53,172,88,84,2,31,1,1,allow
55364,53,1221,53,168,86,82,2,31,1,1,allow
53564,63344,20702,63344,1721,971,750,15,16,8,7,allow
56610,443,4585,443,8035,2015,6020,20,16,11,9,allow
35567,443,35567,443,5413,2166,3247,22,39,13,9,allow
64680,53,32256,53,768,99,669,2,30,1,1,allow
44913,443,18458,443,414,140,274,7,27,3,4,allow
56612,443,41735,443,8033,2013,6020,20,15,11,9,allow
58992,443,6436,443,3049,1857,1192,20,21,9,11,allow
46684,80,18811,80,4294,1112,3182,15,199,4,11,allow
46982,443,35062,443,3847,2650,1197,22,35,13,9,allow
59817,443,40958,443,1401,864,537,12,29,6,6,allow
59836,443,19606,443,1587,924,663,15,27,7,8,allow
51781,43909,29947,43909,70,70,0,2,8,2,0,allow
53580,48066,41215,48066,70,70,0,2,8,2,0,allow
55655,53,48004,53,304,110,194,4,35,2,2,allow
49888,53,54251,53,196,100,96,2,30,1,1,allow
43597,443,44647,443,47048,9293,37755,63,412,28,35,allow
53246,443,15204,443,134,60,74,3,11,2,1,allow
57901,443,18752,443,3924,1906,2018,26,170,14,12,allow
57892,443,36599,443,6394,3923,2471,42,176,22,20,allow
57905,443,45669,443,1851,1152,699,18,169,10,8,allow
57900,443,44556,443,1798,1159,639,17,170,10,7,allow
50376,53,65518,53,164,84,80,2,31,1,1,allow
64417,53,46438,53,184,94,90,2,31,1,1,allow
55675,53,52778,53,764,99,665,2,31,1,1,allow
54956,53,34992,53,188,96,92,2,31,1,1,allow
44482,443,27809,443,16517,3254,13263,37,271,18,19,allow
34165,443,5648,443,8208,2080,6128,24,81,14,10,allow
45273,53,45273,53,213,79,134,2,32,1,1,allow
39207,80,25613,80,78,78,0,1,5,1,0,allow
57885,443,33287,443,1792,1153,639,17,177,10,7,allow
57904,443,36166,443,4042,2515,1527,28,169,14,14,allow
59818,443,31542,443,1401,864,537,12,29,6,6,allow
57877,443,6198,443,9256443,112898,9143545,7609,178,1428,6181,allow
53579,59332,37605,59332,70,70,0,2,8,2,0,allow
65411,53,35148,53,771,101,670,2,30,1,1,allow
49841,53,53641,53,751,95,656,2,30,1,1,allow
57897,443,36818,443,1865,1226,639,18,176,11,7,allow
64815,53,23371,53,755,94,661,2,30,1,1,allow
56601,53,60579,53,168,78,90,2,30,1,1,allow
64001,53,5288,53,182,93,89,2,30,1,1,allow
56391,53,63935,53,758,93,665,2,31,1,1,allow
55171,53,26173,53,762,97,665,2,31,1,1,allow
65334,443,56103,443,3182,1568,1614,8,120,4,4,allow
43585,443,18767,443,6636,3565,3071,22,187,13,9,allow
64595,53,64819,53,166,85,81,2,31,1,1,allow
55147,53,27402,53,184,94,90,2,31,1,1,allow
64903,53,49771,53,777,87,690,2,31,1,1,allow
52169,443,53007,443,7905,4819,3086,27,139,13,14,allow
56919,53,19863,53,186,95,91,2,31,1,1,allow
5938,51883,0,0,60,60,0,1,91,1,0,allow
5938,16167,0,0,60,60,0,1,91,1,0,allow
55802,443,44281,443,30007,2755,27252,41,136,16,25,allow
56557,53,31623,53,212,108,104,2,31,1,1,allow
56312,53,44683,53,756,95,661,2,31,1,1,allow
55077,53,1629,53,174,89,85,2,31,1,1,allow
64287,53,20763,53,178,91,87,2,31,1,1,allow
55217,53,15991,53,744,89,655,2,31,1,1,allow
57252,53,46137,53,182,93,89,2,31,1,1,allow
56926,53,49989,53,747,93,654,2,31,1,1,allow
21594,22448,0,0,62,62,0,1,61,1,0,allow
5938,39160,0,0,60,60,0,1,91,1,0,allow
54993,53,53914,53,751,95,656,2,31,1,1,allow
5938,35844,0,0,60,60,0,1,91,1,0,allow
64924,53,58224,53,747,93,654,2,31,1,1,allow
56227,53,18236,53,174,89,85,2,31,1,1,allow
64715,53,60812,53,202,103,99,2,31,1,1,allow
65246,53,4675,53,182,93,89,2,31,1,1,allow
65246,53,34223,53,182,93,89,2,31,1,1,allow
49901,53,35015,53,186,95,91,2,31,1,1,allow
55604,53,44456,53,758,93,665,2,31,1,1,allow
43472,5228,13384,5228,2531,1416,1115,17,3600,8,9,allow
57492,445,0,0,70,70,0,1,0,1,0,drop
52909,445,0,0,66,66,0,1,0,1,0,drop
49805,6881,0,0,66,66,0,1,0,1,0,deny
34176,51505,0,0,62,62,0,1,0,1,0,deny
46478,64147,0,0,145,145,0,1,0,1,0,deny
51837,37965,0,0,66,66,0,1,0,1,0,deny
58022,8800,0,0,60,60,0,1,0,1,0,deny
52905,445,0,0,66,66,0,1,0,1,0,drop
52907,445,0,0,66,66,0,1,0,1,0,drop
44594,64147,0,0,66,66,0,1,0,1,0,deny
11648,37965,0,0,145,145,0,1,0,1,0,deny
52501,445,0,0,70,70,0,1,0,1,0,drop
58338,3369,0,0,60,60,0,1,0,1,0,deny
54575,11392,0,0,66,66,0,1,0,1,0,deny
52903,445,0,0,66,66,0,1,0,1,0,drop
42252,33303,0,0,60,60,0,1,0,1,0,deny
28973,30188,0,0,66,66,0,1,0,1,0,deny
57484,445,0,0,70,70,0,1,0,1,0,drop
56609,53,42819,53,199,102,97,2,31,1,1,allow
49573,53,10183,53,770,102,668,2,30,1,1,allow
51763,34121,50527,34121,70,70,0,1,5,1,0,allow
25629,28678,25311,28678,1806,1806,0,22,225,22,0,allow
61345,21247,0,0,66,66,0,1,0,1,0,deny
52496,445,0,0,70,70,0,1,0,1,0,drop
29109,11392,0,0,146,146,0,1,0,1,0,deny
57482,445,0,0,70,70,0,1,0,1,0,drop
57477,445,0,0,70,70,0,1,0,1,0,drop
28498,36237,0,0,62,62,0,1,0,1,0,deny
443,56117,0,0,97,97,0,1,0,1,0,deny
7222,57470,0,0,62,62,0,1,0,1,0,deny
50788,48817,0,0,62,62,0,1,0,1,0,deny
52895,445,0,0,66,66,0,1,0,1,0,drop
11816,50584,0,0,66,66,0,1,0,1,0,deny
52885,445,0,0,66,66,0,1,0,1,0,drop
53553,443,31063,443,3708,1988,1720,20,255,10,10,allow
57898,443,41076,443,240332,6623,233709,258,170,92,166,allow
41699,443,36765,443,40273,3243,37030,60,77,28,32,allow
41689,443,36583,443,1307513,51701,1255812,1486,148,576,910,allow
56344,53,55607,53,167,86,81,2,30,1,1,allow
56430,53,61403,53,193,102,91,2,30,1,1,allow
62880,53,59831,53,248,78,170,2,30,1,1,allow
55336,53,49932,53,199,102,97,2,30,1,1,allow
55273,53,29396,53,167,86,81,2,30,1,1,allow
56082,53,4620,53,182,94,88,2,30,1,1,allow
64945,53,44242,53,243,94,149,2,30,1,1,allow
51342,53,21697,53,199,94,105,2,30,1,1,allow
56609,53,65200,53,199,102,97,2,30,1,1,allow
51512,443,52808,443,626132,21332,604800,730,33,294,436,allow
48304,443,22064,443,6606,2153,4453,22,95,13,9,allow
37695,443,3343,443,1134364,30994,1103370,1170,175,403,767,allow
55113,53,62881,53,198,102,96,2,33,1,1,allow
12945,53,12945,53,233,90,143,2,32,1,1,allow
49176,53,50257,53,528,178,350,6,43,3,3,allow
57890,443,58945,443,3588,1991,1597,27,176,14,13,allow
49433,53,5828,53,167,86,81,2,29,1,1,allow
55776,53,11863,53,216,110,106,2,29,1,1,allow
65138,53,38637,53,765,102,663,2,30,1,1,allow
55988,443,19724,443,14754,7879,6875,37,231,20,17,allow
61363,80,43167,80,1931,752,1179,15,16,8,7,allow
52212,80,6091,80,366,246,120,6,34,4,2,allow
51506,443,52823,443,584947,21842,563105,678,36,286,392,allow
60045,443,35524,443,17161,1619,15542,18,151,4,14,allow
53578,34129,11045,34129,70,70,0,2,7,2,0,allow
56615,80,9225,80,234,234,0,4,11,4,0,allow
51759,55308,19017,55308,70,70,0,1,5,1,0,allow
50531,80,18243,80,1704,799,905,11,83,6,5,allow
50519,443,37665,443,7967,1647,6320,25,85,14,11,allow
64551,53,37333,53,495,127,368,4,33,2,2,allow
50513,443,44199,443,9766,1810,7956,30,86,16,14,allow
51758,31009,29940,31009,70,70,0,1,5,1,0,allow
50604,443,64927,443,1385,783,602,14,23,8,6,allow
51761,19136,25240,19136,70,70,0,1,5,1,0,allow
50602,443,61178,443,3901,1858,2043,19,23,11,8,allow
55615,53,40819,53,225,110,115,2,30,1,1,allow
57257,53,4922,53,173,94,79,2,30,1,1,allow
65285,53,31109,53,294,102,192,2,30,1,1,allow
53017,443,37363,443,15038,4142,10896,48,108,24,24,allow
49456,443,44613,443,939,547,392,11,27,5,6,allow
50022,443,50896,443,70,70,0,2,5,2,0,allow
53028,80,62533,80,70,70,0,1,5,1,0,allow
51760,36558,34247,36558,70,70,0,1,5,1,0,allow
36464,443,36464,443,4373,1466,2907,19,29,11,8,allow
57903,443,52416,443,5465,2653,2812,28,169,14,14,allow
51925,443,7342,443,16797,8530,8267,53,82,30,23,allow
57883,443,47068,443,1786,1147,639,17,177,10,7,allow
50459,53,40007,53,811,94,717,2,30,1,1,allow
49993,53,48809,53,212,102,110,2,30,1,1,allow
55293,53,0,0,166,73,93,2,30,1,1,allow
56186,53,36968,53,198,102,96,2,30,1,1,allow
56809,53,35484,53,178,94,84,2,30,1,1,allow
65246,53,13640,53,767,102,665,2,30,1,1,allow
50542,443,1665,443,5779,1472,4307,22,78,12,10,allow
59828,443,44871,443,306,180,126,6,29,4,2,allow
49851,53,2859,53,306,88,218,4,32,2,2,allow
55480,53,36431,53,378,97,281,4,33,2,2,allow
57872,443,43316,443,183325,10358,172967,289,227,95,194,allow
60397,43129,42698,43129,70,70,0,1,5,1,0,allow
53092,443,13048,443,97276,2756,94520,96,96,21,75,allow
57889,443,40826,443,1851,1212,639,18,177,11,7,allow
56344,53,18094,53,167,86,81,2,30,1,1,allow
56673,443,49966,443,5726,1474,4252,22,81,13,9,allow
50831,443,11343,443,721741,131746,589995,1518,322,787,731,allow
62034,53,62034,53,216,90,126,2,30,1,1,allow
57259,53,43508,53,199,102,97,2,30,1,1,allow
59832,443,5609,443,302,120,182,6,28,3,3,allow
55336,53,7329,53,199,102,97,2,30,1,1,allow
65484,53,31170,53,195,102,93,2,30,1,1,allow
55655,53,10525,53,304,110,194,4,34,2,2,allow
57186,53,41154,53,177,94,83,2,30,1,1,allow
56962,53,9664,53,177,94,83,2,30,1,1,allow
55600,80,5814,80,70,70,0,1,5,1,0,allow
65484,53,32858,53,195,102,93,2,30,1,1,allow
57891,443,65008,443,1856,1217,639,18,176,11,7,allow
55240,53,36394,53,816,102,714,2,30,1,1,allow
64936,53,3056,53,193,102,91,2,30,1,1,allow
41700,443,15367,443,167721,6935,160786,185,77,68,117,allow
49217,53,36290,53,209,110,99,2,30,1,1,allow
53053,443,10274,443,9303,2569,6734,39,106,20,19,allow
53036,443,40328,443,249145,4184,244961,218,107,40,178,allow
51466,4545,51466,4545,156,156,0,3,8,3,0,allow
57888,443,55452,443,113115,8327,104788,184,177,77,107,allow
55454,53,25468,53,209,110,99,2,30,1,1,allow
55273,53,29948,53,167,86,81,2,30,1,1,allow
57186,53,42967,53,177,94,83,2,30,1,1,allow
64516,53,8350,53,216,110,106,2,30,1,1,allow
64652,53,53769,53,198,94,104,2,30,1,1,allow
55077,53,42307,53,179,94,85,2,30,1,1,allow
57369,16881,7618,16881,564,318,246,9,15,5,4,allow
56569,53,5839,53,181,94,87,2,32,1,1,allow
57894,443,52904,443,4544,1112,3432,21,176,12,9,allow
49492,80,50602,80,1680,1210,470,9,15,5,4,allow
49449,443,30580,443,1574,921,653,14,15,7,7,allow
12136,53,12136,53,198,90,108,2,30,1,1,allow
41674,443,45032,443,14424911,433341,13991570,15454,320,5482,9972,allow
53240,443,16717,443,1296713,27754,1268959,1253,118,366,887,allow
55375,53,8307,53,214,110,104,2,30,1,1,allow
55375,53,30516,53,214,110,104,2,30,1,1,allow
36405,53,36515,53,199,94,105,2,30,1,1,allow
49888,53,39344,53,198,102,96,2,30,1,1,allow
55240,53,47282,53,193,102,91,2,30,1,1,allow
50039,53,19771,53,261,110,151,2,30,1,1,allow
64595,53,62622,53,167,86,81,2,30,1,1,allow
60280,443,7130,443,46713,2661,44052,55,120,21,34,allow
45871,443,58048,443,275011,235921,39090,651,350,363,288,allow
56557,53,41528,53,214,110,104,2,30,1,1,allow
37815,443,28606,443,6226,4834,1392,17,125,11,6,allow
64002,53,17468,53,796,105,691,4,59,2,2,allow
55273,53,49246,53,317,85,232,4,60,2,2,allow
49374,53,36144,53,193,102,91,2,30,1,1,allow
51507,443,1531,443,584465,23057,561408,694,36,303,391,allow
40453,443,6651,443,5655,1614,4041,22,30,11,11,allow
35965,443,31855,443,3821,2814,1007,22,17,12,10,allow
52188,443,37924,443,1768,1034,734,16,65,8,8,allow
50511,443,12647,443,6352,1073,5279,22,85,12,10,allow
51516,443,35060,443,1195,634,561,12,21,7,5,allow
51511,443,55401,443,213140,10321,202819,260,33,108,152,allow
50518,443,9409,443,7117,1288,5829,22,84,12,10,allow
53589,40281,13610,40281,70,70,0,2,7,2,0,allow
65469,443,41637,443,92958,4869,88089,109,15,44,65,allow
50514,443,24194,443,11554,3028,8526,34,86,19,15,allow
51498,443,13741,443,134,60,74,3,4,2,1,allow
49345,443,4175,443,61954,10029,51925,114,82,50,64,allow
55655,53,55322,53,304,110,194,4,34,2,2,allow
58027,80,53632,80,1225,711,514,11,15,5,6,allow
55113,53,41095,53,198,102,96,2,29,1,1,allow
55981,53,55529,53,168,78,90,2,30,1,1,allow
51778,60565,25061,60565,70,70,0,2,8,2,0,allow
64980,53,10354,53,200,102,98,2,29,1,1,allow
56935,53,38764,53,179,94,85,2,30,1,1,allow
55375,53,47639,53,214,110,104,2,30,1,1,allow
53016,443,45563,443,50403,2032,48371,66,108,21,45,allow
53583,15354,6378,15354,70,70,0,2,7,2,0,allow
57464,80,36285,80,234,234,0,4,11,4,0,allow
55776,53,40395,53,216,110,106,2,29,1,1,allow
50023,443,17571,443,70,70,0,2,5,2,0,allow
56186,53,3994,53,198,102,96,2,29,1,1,allow
51762,12747,31596,12747,70,70,0,1,5,1,0,allow
64001,53,52493,53,183,94,89,2,29,1,1,allow
64936,53,55896,53,816,102,714,2,30,1,1,allow
65036,53,38858,53,214,110,104,2,29,1,1,allow
49608,53,63386,53,198,110,88,2,29,1,1,allow
64309,53,10386,53,308,94,214,2,30,1,1,allow
55439,53,53595,53,209,110,99,2,29,1,1,allow
57895,443,60971,443,10639,4680,5959,53,176,24,29,allow
64516,53,41634,53,216,110,106,2,30,1,1,allow
63978,53,35845,53,214,110,104,2,30,1,1,allow
56919,53,23336,53,193,102,91,2,30,1,1,allow
45637,443,46378,443,6701,3487,3214,35,196,19,16,allow
55826,53,22161,53,168,86,82,2,30,1,1,allow
55735,53,20718,53,184,94,90,2,30,1,1,allow
64714,53,62163,53,289,134,155,2,30,1,1,allow
58754,53,0,0,258,80,178,2,30,1,1,allow
50458,53,16491,53,458,188,270,6,30,3,3,allow
51543,53,3333,53,78,78,0,1,30,1,0,allow
64839,53,30697,53,443,182,261,6,30,3,3,allow
49259,53,28989,53,168,86,82,2,30,1,1,allow
56246,53,33774,53,209,110,99,2,30,1,1,allow
50121,53,5203,53,152,78,74,2,30,1,1,allow
64287,53,8601,53,181,94,87,2,31,1,1,allow
65420,53,28650,53,166,86,80,2,31,1,1,allow
41690,443,19019,443,1478937,62961,1415976,1678,148,649,1029,allow
54085,443,49010,443,4128,1929,2199,38,48,21,17,allow
64780,443,53095,443,70785,3306,67479,99,80,34,65,allow
51779,49525,24742,49525,70,70,0,2,8,2,0,allow
56779,43137,15198,43137,70,70,0,1,5,1,0,allow
64085,53,10076,53,351,102,249,4,43,2,2,allow
57899,443,40248,443,6115,1035,5080,21,170,11,10,allow
49448,443,34233,443,1574,921,653,14,15,7,7,allow
56430,53,37979,53,193,102,91,2,30,1,1,allow
65429,53,14191,53,200,94,106,2,30,1,1,allow
65265,53,37973,53,821,102,719,2,30,1,1,allow
56072,53,56771,53,199,102,97,2,30,1,1,allow
49693,443,16419,443,12060,4857,7203,25,71,14,11,allow
65192,53,25403,53,249,102,147,2,30,1,1,allow
55364,53,12032,53,168,86,82,2,30,1,1,allow
56962,53,9303,53,177,94,83,2,30,1,1,allow
56252,443,19925,443,6728,1775,4953,25,275,13,12,allow
55918,53,38281,53,184,94,90,2,31,1,1,allow
36826,443,2632,443,6040,1612,4428,21,255,12,9,allow
50636,443,49176,443,7332,1611,5721,17,15,9,8,allow
57902,443,7313,443,1912,1213,699,19,169,11,8,allow
57881,443,48213,443,3486,2064,1422,26,177,14,12,allow
39921,80,15019,80,1151,711,440,10,15,5,5,allow
50420,80,36435,80,5048,4344,704,11,26,6,5,allow
50076,80,31297,80,1052,612,440,10,15,5,5,allow
56072,53,61103,53,199,102,97,2,30,1,1,allow
46827,443,46276,443,8277,1368,6909,31,120,14,17,allow
57882,443,30006,443,22342,1787,20555,38,177,16,22,allow
57880,443,33669,443,1868,1229,639,18,177,11,7,allow
61362,443,33042,443,8167,2671,5496,22,69,11,11,allow
43735,53,12080,53,168,78,90,2,30,1,1,allow
58754,53,0,0,627,80,547,2,30,1,1,allow
56082,53,27828,53,182,94,88,2,30,1,1,allow
64417,53,4241,53,184,94,90,2,30,1,1,allow
59237,53,43242,53,164,78,86,2,30,1,1,allow
49246,53,24337,53,779,86,693,2,30,1,1,allow
55101,53,1606,53,197,102,95,2,30,1,1,allow
56033,443,32455,443,3250,1058,2192,13,136,6,7,allow
49439,53,56004,53,197,102,95,2,31,1,1,allow
49972,53,23300,53,184,94,90,2,30,1,1,allow
55100,53,1559,53,178,94,84,2,30,1,1,allow
56246,53,1913,53,209,110,99,2,30,1,1,allow
49217,53,2129,53,209,110,99,2,31,1,1,allow
54956,53,14576,53,194,102,92,2,31,1,1,allow
49597,53,63650,53,168,86,82,2,31,1,1,allow
56765,53,27082,53,194,102,92,2,31,1,1,allow
49667,53,65196,53,183,94,89,2,30,1,1,allow
49374,53,45816,53,193,102,91,2,30,1,1,allow
41002,53,33121,53,164,78,86,2,30,1,1,allow
49365,53,39023,53,195,102,93,2,30,1,1,allow
64041,53,58555,53,200,102,98,2,31,1,1,allow
49794,53,12589,53,197,102,95,2,30,1,1,allow
56026,53,4908,53,183,94,89,2,31,1,1,allow
50376,53,23494,53,166,86,80,2,31,1,1,allow
55100,53,26652,53,178,94,84,2,31,1,1,allow
65300,53,18303,53,195,102,93,2,31,1,1,allow
58856,443,16403,443,4005,1421,2584,14,136,7,7,allow
45493,5223,26430,5223,4196,1378,2818,21,3002,12,9,allow
19473,32332,63968,32332,481,150,331,2,1200,1,1,allow
48894,53,34771,53,164,78,86,2,31,1,1,allow
50121,53,43532,53,152,78,74,2,31,1,1,allow
56223,53,58545,53,185,102,83,2,31,1,1,allow
64323,53,30451,53,195,102,93,2,31,1,1,allow
44076,443,35127,443,202384,47621,154763,307,198,112,195,allow
15503,37512,24044,37512,528,528,0,9,1199,9,0,allow
64417,53,37642,53,184,94,90,2,31,1,1,allow
60016,443,40510,443,134,60,74,3,6,2,1,allow
64732,53,52596,53,189,102,87,2,30,1,1,allow
57015,53,61760,53,279,94,185,2,30,1,1,allow
51090,53,42988,53,164,78,86,2,30,1,1,allow
57094,53,61596,53,196,102,94,2,30,1,1,allow
55364,53,21776,53,168,86,82,2,31,1,1,allow
56962,53,40705,53,177,94,83,2,31,1,1,allow
59816,443,30172,443,622,310,312,11,29,6,5,allow
51955,443,64636,443,8390,1525,6865,24,26,11,13,allow
50862,443,14909,443,9930,2085,7845,21,318,11,10,allow
33244,443,30372,443,4239,2487,1752,19,16,11,8,allow
49399,80,18487,80,4382,2084,2298,18,66,10,8,allow
49397,80,15765,80,4382,2084,2298,18,66,10,8,allow
57906,443,49224,443,9316,3279,6037,39,186,20,19,allow
60194,80,35341,80,70,70,0,2,8,2,0,allow
33240,443,43731,443,7375,4769,2606,24,16,14,10,allow
49794,53,1835,53,197,102,95,2,30,1,1,allow
64516,53,9042,53,216,110,106,2,30,1,1,allow
49259,53,59958,53,184,102,82,2,30,1,1,allow
49183,53,24061,53,209,110,99,2,31,1,1,allow
57466,445,0,0,70,70,0,1,0,1,0,drop
52483,445,0,0,70,70,0,1,0,1,0,drop
19570,50584,0,0,62,62,0,1,0,1,0,deny
51693,22114,0,0,62,62,0,1,0,1,0,deny
22583,9822,0,0,62,62,0,1,0,1,0,deny
22724,9822,0,0,66,66,0,1,0,1,0,deny
52480,445,0,0,70,70,0,1,0,1,0,drop
52883,445,0,0,66,66,0,1,0,1,0,drop
52459,33890,0,0,60,60,0,1,0,1,0,deny
52876,445,0,0,66,66,0,1,0,1,0,drop
53355,23117,0,0,66,66,0,1,0,1,0,deny
52870,445,0,0,66,66,0,1,0,1,0,drop
52475,445,0,0,70,70,0,1,0,1,0,drop
62767,57470,0,0,74,74,0,1,0,1,0,deny
11983,57470,0,0,62,62,0,1,0,1,0,deny
54631,44847,0,0,70,70,0,1,0,1,0,deny
52474,445,0,0,70,70,0,1,0,1,0,drop
49160,31652,0,0,146,146,0,1,0,1,0,reset-both
18172,23,0,0,60,60,0,1,0,1,0,deny
52472,445,0,0,70,70,0,1,0,1,0,drop
25101,50584,0,0,146,146,0,1,0,1,0,deny
27442,44847,0,0,62,62,0,1,0,1,0,deny
56778,35440,0,0,62,62,0,1,0,1,0,deny
14872,23,0,0,60,60,0,1,0,1,0,deny
57455,445,0,0,70,70,0,1,0,1,0,drop
57452,445,0,0,70,70,0,1,0,1,0,drop
57453,445,0,0,70,70,0,1,0,1,0,drop
25565,62778,0,0,60,60,0,1,0,1,0,deny
52854,445,0,0,66,66,0,1,0,1,0,drop
52860,445,0,0,66,66,0,1,0,1,0,drop
52855,445,0,0,66,66,0,1,0,1,0,drop
52856,445,0,0,66,66,0,1,0,1,0,drop
52857,445,0,0,66,66,0,1,0,1,0,drop
52859,445,0,0,66,66,0,1,0,1,0,drop
52852,445,0,0,66,66,0,1,0,1,0,drop
52853,445,0,0,66,66,0,1,0,1,0,drop
42951,44847,0,0,66,66,0,1,0,1,0,deny
54773,50584,0,0,66,66,0,1,0,1,0,deny
6980,48543,0,0,139,139,0,1,0,1,0,deny
54684,37965,0,0,62,62,0,1,0,1,0,deny
64279,23718,0,0,62,62,0,1,0,1,0,deny
52465,445,0,0,70,70,0,1,0,1,0,drop
53166,61600,0,0,66,66,0,1,0,1,0,deny
52463,445,0,0,70,70,0,1,0,1,0,drop
45964,2666,0,0,60,60,0,1,0,1,0,deny
9095,22114,0,0,62,62,0,1,0,1,0,deny
7444,57470,0,0,66,66,0,1,0,1,0,deny
48180,143,0,0,60,60,0,1,0,1,0,deny
53783,443,19626,443,499,425,74,4,0,3,1,allow
53782,443,62733,443,499,425,74,4,0,3,1,allow
62678,57470,0,0,62,62,0,1,0,1,0,deny
52462,445,0,0,70,70,0,1,0,1,0,drop
52461,445,0,0,70,70,0,1,0,1,0,drop
32395,30188,0,0,62,62,0,1,0,1,0,deny
57447,445,0,0,70,70,0,1,0,1,0,drop
57442,445,0,0,70,70,0,1,0,1,0,drop
57441,445,0,0,70,70,0,1,0,1,0,drop
52460,445,0,0,70,70,0,1,0,1,0,drop
52454,445,0,0,70,70,0,1,0,1,0,drop
52457,445,0,0,70,70,0,1,0,1,0,drop
14082,50584,0,0,62,62,0,1,0,1,0,deny
6712,5632,0,0,60,60,0,1,0,1,0,deny
52838,445,0,0,66,66,0,1,0,1,0,drop
52840,445,0,0,66,66,0,1,0,1,0,drop
52837,445,0,0,66,66,0,1,0,1,0,drop
48706,23393,0,0,60,60,0,1,0,1,0,deny
55254,50584,0,0,66,66,0,1,0,1,0,deny
28668,8696,0,0,60,60,0,1,0,1,0,deny
57434,445,0,0,70,70,0,1,0,1,0,drop
60875,56205,0,0,66,66,0,1,0,1,0,deny
52442,445,0,0,70,70,0,1,0,1,0,drop
52441,445,0,0,70,70,0,1,0,1,0,drop
52439,445,0,0,70,70,0,1,0,1,0,drop
80,37649,0,0,60,60,0,1,0,1,0,deny
53105,42707,0,0,66,66,0,1,0,1,0,deny
52432,445,0,0,70,70,0,1,0,1,0,drop
52431,445,0,0,70,70,0,1,0,1,0,drop
57432,445,0,0,70,70,0,1,0,1,0,drop
20,17095,0,0,554,554,0,1,0,1,0,deny
37008,42707,0,0,62,62,0,1,0,1,0,deny
57427,445,0,0,70,70,0,1,0,1,0,drop
57426,445,0,0,70,70,0,1,0,1,0,drop
57421,445,0,0,70,70,0,1,0,1,0,drop
27446,30188,0,0,66,66,0,1,0,1,0,deny
80,53945,0,0,60,60,0,1,0,1,0,deny
61241,22114,0,0,66,66,0,1,0,1,0,deny
56453,37965,0,0,62,62,0,1,0,1,0,deny
52420,445,0,0,70,70,0,1,0,1,0,drop
47413,23,0,0,60,60,0,1,0,1,0,deny
46349,51505,0,0,70,70,0,1,0,1,0,deny
57415,445,0,0,70,70,0,1,0,1,0,drop
57413,445,0,0,70,70,0,1,0,1,0,drop
57409,445,0,0,70,70,0,1,0,1,0,drop
3521,6881,0,0,66,66,0,1,0,1,0,deny
53779,37965,0,0,66,66,0,1,0,1,0,deny
45410,1,0,0,62,62,0,1,0,1,0,deny
56946,1,0,0,66,66,0,1,0,1,0,deny
17177,64147,0,0,62,62,0,1,0,1,0,deny
52416,445,0,0,70,70,0,1,0,1,0,drop
34129,11045,0,0,62,62,0,1,0,1,0,deny
65153,38303,0,0,66,66,0,1,0,1,0,deny
63670,64097,0,0,66,66,0,1,0,1,0,deny
52407,445,0,0,70,70,0,1,0,1,0,drop
52405,445,0,0,70,70,0,1,0,1,0,drop
50355,43890,0,0,62,62,0,1,0,1,0,deny
52401,445,0,0,70,70,0,1,0,1,0,drop
52402,445,0,0,70,70,0,1,0,1,0,drop
52816,445,0,0,66,66,0,1,0,1,0,drop
6666,8443,0,0,60,60,0,1,0,1,0,deny
57407,445,0,0,70,70,0,1,0,1,0,drop
57404,445,0,0,70,70,0,1,0,1,0,drop
58022,3000,0,0,60,60,0,1,0,1,0,deny
52399,445,0,0,70,70,0,1,0,1,0,drop
38926,37965,0,0,62,62,0,1,0,1,0,deny
80,9918,0,0,60,60,0,1,0,1,0,deny
5379,37965,0,0,62,62,0,1,0,1,0,deny
59136,50584,0,0,66,66,0,1,0,1,0,deny
33908,48983,0,0,145,145,0,1,0,1,0,deny
1040,6004,0,0,72,72,0,1,0,1,0,deny
52812,445,0,0,66,66,0,1,0,1,0,drop
61736,50584,0,0,66,66,0,1,0,1,0,deny
64406,50584,0,0,66,66,0,1,0,1,0,deny
57452,57470,0,0,62,62,0,1,0,1,0,deny
52808,445,0,0,66,66,0,1,0,1,0,drop
52394,445,0,0,70,70,0,1,0,1,0,drop
57393,445,0,0,70,70,0,1,0,1,0,drop
52749,64147,0,0,66,66,0,1,0,1,0,deny
57390,445,0,0,70,70,0,1,0,1,0,drop
57387,445,0,0,70,70,0,1,0,1,0,drop
57383,445,0,0,70,70,0,1,0,1,0,drop
1660,8696,0,0,62,62,0,1,0,1,0,deny
52807,445,0,0,66,66,0,1,0,1,0,drop
1660,8696,0,0,145,145,0,1,0,1,0,deny
12471,48817,0,0,62,62,0,1,0,1,0,deny
51582,48817,0,0,66,66,0,1,0,1,0,deny
52386,445,0,0,70,70,0,1,0,1,0,drop
59481,41182,0,0,66,66,0,1,0,1,0,deny
52385,445,0,0,70,70,0,1,0,1,0,drop
57379,445,0,0,70,70,0,1,0,1,0,drop
21892,15503,0,0,62,62,0,1,0,1,0,deny
1025,35447,0,0,62,62,0,1,0,1,0,deny
55072,53,57853,53,701,88,613,2,30,1,1,allow
56246,53,65270,53,202,103,99,2,30,1,1,allow
50319,53,28862,53,756,95,661,2,30,1,1,allow
45373,443,33904,443,33357,26315,7042,65,273,38,27,allow
57745,15000,1994,15000,130,70,60,2,5,1,1,allow
55974,53,19851,53,762,98,664,2,30,1,1,allow
55605,53,8941,53,711,87,624,2,30,1,1,allow
49445,53,33858,53,770,101,669,2,30,1,1,allow
45118,15000,63789,15000,130,70,60,2,6,1,1,allow
64311,53,1855,53,198,101,97,2,31,1,1,allow
56406,53,47759,53,749,89,660,2,30,1,1,allow
51757,54657,24157,54657,66,66,0,1,5,1,0,allow
51267,38070,5566,38070,210,140,70,4,14,3,1,allow
55427,53,28517,53,772,103,669,2,30,1,1,allow
65359,53,29324,53,186,95,91,2,30,1,1,allow
65060,53,36666,53,761,100,661,2,30,1,1,allow
56609,53,56720,53,198,101,97,2,30,1,1,allow
59888,80,59888,80,55739,967,54772,53,15,13,40,allow
59417,443,49153,443,2898,1700,1198,16,15,8,8,allow
56607,443,1098,443,7862,1873,5989,20,15,11,9,allow
55918,53,15697,53,184,94,90,2,31,1,1,allow
55117,53,60693,53,756,95,661,2,31,1,1,allow
49851,53,28608,53,164,84,80,2,30,1,1,allow
65283,53,18469,53,732,89,643,2,30,1,1,allow
64831,53,59275,53,216,110,106,2,30,1,1,allow
49439,53,62852,53,194,99,95,2,31,1,1,allow
49197,53,27457,53,751,95,656,2,30,1,1,allow
51775,57887,60310,57887,70,70,0,2,8,2,0,allow
50422,443,13716,443,1389,868,521,12,25,6,6,allow
35047,80,8306,80,7891,2035,5856,17,32,10,7,allow
43033,443,43033,443,10239,2017,8222,23,18,14,9,allow
53834,15000,23428,15000,130,70,60,2,6,1,1,allow
62185,53,27701,53,578,286,292,9,15,5,4,allow
21870,53,21870,53,209,77,132,2,32,1,1,allow
64323,53,38959,53,190,97,93,2,31,1,1,allow
2941,7000,2941,7000,3398,947,2451,18,27,9,9,allow
51783,12296,8284,12296,316,136,180,6,6,3,3,allow
63763,17368,8449,17368,66,66,0,1,5,1,0,allow
49537,53,46669,53,269,96,173,4,59,2,2,allow
56608,443,64637,443,8034,2014,6020,20,15,11,9,allow
35049,80,15791,80,5773,1197,4576,14,32,8,6,allow
50347,53,8937,53,756,95,661,2,30,1,1,allow
5588,5588,0,0,3354,1792,1562,46,194,23,23,allow
56609,443,31583,443,7982,1962,6020,20,15,11,9,allow
56818,53,44106,53,755,94,661,2,30,1,1,allow
64900,53,55374,53,778,103,675,2,30,1,1,allow
56962,53,51903,53,170,87,83,2,30,1,1,allow
50240,53,16161,53,733,93,640,2,30,1,1,allow
55008,53,25566,53,762,98,664,2,30,1,1,allow
49972,53,21304,53,184,94,90,2,30,1,1,allow
64618,53,46697,53,196,100,96,2,31,1,1,allow
64653,53,37901,53,755,93,662,2,31,1,1,allow
64041,53,17809,53,200,102,98,2,30,1,1,allow
49687,53,24599,53,775,103,672,2,31,1,1,allow
44588,443,64745,443,8850,2551,6299,32,369,16,16,allow
49978,53,47119,53,774,101,673,2,31,1,1,allow
64438,53,41293,53,184,94,90,2,31,1,1,allow
49670,53,15548,53,168,86,82,2,31,1,1,allow
49539,53,44717,53,170,87,83,2,31,1,1,allow
65131,53,39663,53,168,86,82,2,31,1,1,allow
65189,27216,23592,27216,226,71,155,2,31,1,1,allow
65514,53,6429,53,212,108,104,2,31,1,1,allow
57306,53,11858,53,170,87,83,2,31,1,1,allow
55049,53,52659,53,733,86,647,2,31,1,1,allow
56987,53,30832,53,192,98,94,2,31,1,1,allow
65380,53,11853,53,176,90,86,2,31,1,1,allow
5938,58817,0,0,60,60,0,1,90,1,0,allow
49997,53,52835,53,418,75,343,2,31,1,1,allow
49290,53,15607,53,760,97,663,2,31,1,1,allow
65189,27241,23433,27241,235,71,164,2,31,1,1,allow
49429,53,19123,53,204,104,100,2,31,1,1,allow
49361,53,45475,53,184,94,90,2,31,1,1,allow
56111,53,53180,53,174,89,85,2,31,1,1,allow
37961,443,30943,443,10229,2777,7452,30,361,15,15,allow
56765,53,13979,53,188,96,92,2,31,1,1,allow
56104,53,20610,53,194,99,95,2,31,1,1,allow
65014,53,3896,53,186,95,91,2,31,1,1,allow
65516,53,26116,53,202,103,99,2,31,1,1,allow
50460,53,61853,53,753,96,657,2,31,1,1,allow
56878,53,21554,53,168,86,82,2,31,1,1,allow
64913,53,27699,53,182,93,89,2,31,1,1,allow
57258,53,12137,53,757,98,659,2,31,1,1,allow
65063,53,62698,53,176,90,86,2,31,1,1,allow
49384,53,31275,53,178,91,87,2,31,1,1,allow
47054,443,53511,443,6803,2164,4639,14,121,7,7,allow
6881,6881,2620,6881,150,150,0,1,1200,1,0,allow
62864,443,56821,443,86513,10300,76213,131,137,54,77,allow
55594,53,11300,53,753,96,657,2,31,1,1,allow
52233,443,57646,443,5479,929,4550,20,360,10,10,allow
65336,53,13952,53,782,105,677,2,31,1,1,allow
33000,53,0,0,82,82,0,1,31,1,0,allow
56332,53,13726,53,202,103,99,2,31,1,1,allow
56494,53,64995,53,793,101,692,2,31,1,1,allow
49861,53,49122,53,196,100,96,2,31,1,1,allow
55517,53,21431,53,174,89,85,2,31,1,1,allow
49785,53,38466,53,206,105,101,2,31,1,1,allow
56071,53,41864,53,186,95,91,2,31,1,1,allow
56552,53,11395,53,190,97,93,2,31,1,1,allow
57251,53,30748,53,780,104,676,2,31,1,1,allow
56477,53,34733,53,198,101,97,2,31,1,1,allow
21133,26760,14164,26760,480,149,331,2,1200,1,1,allow
57377,445,0,0,70,70,0,1,0,1,0,drop
57375,445,0,0,70,70,0,1,0,1,0,drop
57373,445,0,0,70,70,0,1,0,1,0,drop
59020,9600,0,0,60,60,0,1,0,1,0,deny
52799,445,0,0,66,66,0,1,0,1,0,drop
43671,37965,0,0,62,62,0,1,0,1,0,deny
29623,37807,0,0,62,62,0,1,0,1,0,deny
1027,11392,0,0,62,62,0,1,0,1,0,deny
12821,37965,0,0,66,66,0,1,0,1,0,deny
21274,30188,0,0,62,62,0,1,0,1,0,deny
52795,445,0,0,66,66,0,1,0,1,0,drop
52791,445,0,0,66,66,0,1,0,1,0,drop
52790,445,0,0,66,66,0,1,0,1,0,drop
52379,445,0,0,70,70,0,1,0,1,0,drop
52378,445,0,0,70,70,0,1,0,1,0,drop
52789,445,0,0,66,66,0,1,0,1,0,drop
52788,445,0,0,66,66,0,1,0,1,0,drop
52786,445,0,0,66,66,0,1,0,1,0,drop
56100,53,41303,53,177,94,83,2,30,1,1,allow
56705,53,17593,53,168,78,90,2,30,1,1,allow
9246,35440,0,0,66,66,0,1,0,1,0,deny
51829,36134,0,0,66,66,0,1,0,1,0,deny
50143,35253,0,0,66,66,0,1,0,1,0,deny
52374,445,0,0,70,70,0,1,0,1,0,drop
64051,36829,0,0,66,66,0,1,0,1,0,deny
57370,445,0,0,70,70,0,1,0,1,0,drop
57371,445,0,0,70,70,0,1,0,1,0,drop
57366,445,0,0,70,70,0,1,0,1,0,drop
49160,34021,0,0,146,146,0,1,0,1,0,reset-both
52782,445,0,0,66,66,0,1,0,1,0,drop
57364,445,0,0,70,70,0,1,0,1,0,drop
52373,445,0,0,70,70,0,1,0,1,0,drop
443,14315,0,0,158,158,0,1,0,1,0,deny
52781,445,0,0,66,66,0,1,0,1,0,drop
53298,26467,0,0,62,62,0,1,0,1,0,deny
58468,37965,0,0,66,66,0,1,0,1,0,deny
52779,445,0,0,66,66,0,1,0,1,0,drop
52777,445,0,0,66,66,0,1,0,1,0,drop
52775,445,0,0,66,66,0,1,0,1,0,drop
443,15564,0,0,85,85,0,1,0,1,0,deny
17009,53733,0,0,66,66,0,1,0,1,0,deny
52368,445,0,0,70,70,0,1,0,1,0,drop
65209,57866,0,0,66,66,0,1,0,1,0,deny
59315,35440,0,0,62,62,0,1,0,1,0,deny
64771,53,10938,53,228,110,118,2,30,1,1,allow
55989,443,55989,443,4378,1471,2907,19,29,11,8,allow
55147,53,9806,53,184,94,90,2,30,1,1,allow
64243,53,24679,53,244,94,150,2,30,1,1,allow
55147,53,22954,53,184,94,90,2,30,1,1,allow
49266,53,16843,53,199,102,97,2,30,1,1,allow
39047,443,36034,443,10831,1381,9450,22,19,12,10,allow
49398,80,11997,80,3651,2020,1631,16,65,9,7,allow
50457,443,62733,443,3091,1708,1383,15,21,9,6,allow
55599,80,22870,80,1165,473,692,10,14,5,5,allow
63762,41373,27152,41373,70,70,0,1,4,1,0,allow
50393,53,2809,53,759,94,665,2,29,1,1,allow
49667,53,34670,53,183,94,89,2,29,1,1,allow
11295,40018,57800,40018,213,89,124,4,31,2,2,allow
56883,53,10133,53,184,94,90,2,30,1,1,allow
49400,80,44770,80,3651,2020,1631,16,65,9,7,allow
50384,443,60892,443,7723,2591,5132,23,49,12,11,allow
54168,80,20934,80,1582,1003,579,12,360,6,6,allow
49424,53,45939,53,198,102,96,2,32,1,1,allow
64613,53,15938,53,179,94,85,2,30,1,1,allow
63757,51413,50296,51413,70,70,0,1,4,1,0,allow
25061,53,25061,53,214,82,132,2,32,1,1,allow
33241,443,5641,443,37452,28136,9316,56,15,33,23,allow
59815,443,31852,443,4586,955,3631,17,28,9,8,allow
56765,53,64406,53,194,102,92,2,29,1,1,allow
57257,53,41032,53,173,94,79,2,29,1,1,allow
55605,27274,9607,27274,130,70,60,2,4,1,1,allow
49888,53,1710,53,198,102,96,2,29,1,1,allow
55077,53,32952,53,179,94,85,2,29,1,1,allow
49872,53,49872,53,218,90,128,2,29,1,1,allow
55739,53,37345,53,458,188,270,6,29,3,3,allow
55429,53,62139,53,182,102,80,2,30,1,1,allow
49817,53,35154,53,286,110,176,2,30,1,1,allow
56100,53,9631,53,177,94,83,2,30,1,1,allow
49896,443,39739,443,151170,17408,133762,256,130,118,138,allow
65211,53,54701,53,183,94,89,2,30,1,1,allow
64685,53,15480,53,199,102,97,2,30,1,1,allow
56335,53,48756,53,816,102,714,2,30,1,1,allow
49972,53,40776,53,184,94,90,2,30,1,1,allow
56987,53,21347,53,196,102,94,2,30,1,1,allow
64093,53,8656,53,225,110,115,2,30,1,1,allow
64715,53,47413,53,209,110,99,2,30,1,1,allow
57252,53,53751,53,183,94,89,2,30,1,1,allow
49539,53,50465,53,177,94,83,2,30,1,1,allow
49167,53,55909,53,193,102,91,2,30,1,1,allow
51776,14645,41362,14645,70,70,0,2,8,2,0,allow
51752,7000,51752,7000,3638,2087,1551,17,16,10,7,allow
34079,80,3796,80,5053,4178,875,17,15,9,8,allow
64643,53,40117,53,177,94,83,2,30,1,1,allow
50575,53,5901,53,766,102,664,2,30,1,1,allow
51953,443,64481,443,8900,2020,6880,28,25,15,13,allow
65246,53,37552,53,183,94,89,2,30,1,1,allow
56456,53,8981,53,195,102,93,2,30,1,1,allow
56456,53,17169,53,195,102,93,2,30,1,1,allow
64685,53,31549,53,199,102,97,2,30,1,1,allow
64585,53,51194,53,210,110,100,2,30,1,1,allow
64874,53,28911,53,808,110,698,2,30,1,1,allow
49433,53,41471,53,165,86,79,2,30,1,1,allow
55918,53,24727,53,184,94,90,2,30,1,1,allow
56223,53,26337,53,177,94,83,2,30,1,1,allow
65249,53,5221,53,166,86,80,2,30,1,1,allow
55429,53,31053,53,182,102,80,2,30,1,1,allow
44690,443,54599,443,1648,813,835,17,185,9,8,allow
64585,53,55669,53,210,110,100,2,30,1,1,allow
65189,27015,29892,27015,295,78,217,2,30,1,1,allow
64417,53,47310,53,369,94,275,4,49,2,2,allow
49968,53,46436,53,285,94,191,2,30,1,1,allow
64715,53,35107,53,209,110,99,2,30,1,1,allow
64831,53,56461,53,216,110,106,2,30,1,1,allow
56335,53,52497,53,193,102,91,2,30,1,1,allow
49622,53,47185,53,185,102,83,2,30,1,1,allow
49634,443,60698,443,20860,1618,19242,35,122,15,20,allow
49537,53,59309,53,269,96,173,4,59,2,2,allow
65091,80,65091,80,18499242,314733,18184509,19253,37,4700,14553,allow
50648,80,55586,80,132,132,0,2,8,2,0,allow
51773,23728,42323,23728,70,70,0,2,8,2,0,allow
63366,30365,45991,30365,738,318,420,12,163,5,7,allow
49851,53,3240,53,166,86,80,2,30,1,1,allow
56649,53,35726,53,152,78,74,2,30,1,1,allow
51468,80,31366,80,3389,2054,1335,19,25,11,8,allow
34275,443,58408,443,4880,3216,1664,29,79,15,14,allow
42358,80,63133,80,1081,641,440,9,14,4,5,allow
26833,443,13799,443,21487,16430,5057,39,21,22,17,allow
51774,16930,45672,16930,70,70,0,2,8,2,0,allow
58924,443,13598,443,7783,2690,5093,24,255,13,11,allow
63759,64509,61744,64509,70,70,0,1,4,1,0,allow
57257,80,32555,80,1369,495,874,12,361,6,6,allow
56919,53,23059,53,423,95,328,4,34,2,2,allow
64700,53,51210,53,458,188,270,6,29,3,3,allow
64595,53,24899,53,167,86,81,2,29,1,1,allow
49739,443,63017,443,3085,1404,1681,15,15,7,8,allow
64732,53,44138,53,189,102,87,2,29,1,1,allow
49888,53,17695,53,198,102,96,2,29,1,1,allow
49217,53,20500,53,209,110,99,2,29,1,1,allow
54287,443,51264,443,8603,853,7750,27,92,9,18,allow
51268,47662,5610,47662,70,70,0,2,8,2,0,allow
55596,14795,19064,14795,630,444,186,9,16,6,3,allow
56919,53,16423,53,193,102,91,2,29,1,1,allow
64936,53,18480,53,749,94,655,2,29,1,1,allow
49365,53,27288,53,195,102,93,2,29,1,1,allow
55147,53,48564,53,184,94,90,2,30,1,1,allow
64552,53,41507,53,754,94,660,2,30,1,1,allow
49530,53,54763,53,265,102,163,2,30,1,1,allow
49622,53,45379,53,185,102,83,2,30,1,1,allow
56557,53,49880,53,214,110,104,2,29,1,1,allow
49399,53,15486,53,775,102,673,2,30,1,1,allow
65211,53,44478,53,183,94,89,2,30,1,1,allow
49901,53,39046,53,193,102,91,2,29,1,1,allow
64595,53,55733,53,167,86,81,2,30,1,1,allow
64311,53,39516,53,199,102,97,2,30,1,1,allow
65189,27237,9524,27237,234,78,156,2,30,1,1,allow
56111,53,49193,53,179,94,85,2,31,1,1,allow
64403,53,2532,53,199,102,97,2,31,1,1,allow
56552,53,3851,53,195,102,93,2,31,1,1,allow
51637,443,21678,443,3110,1049,2061,14,136,7,7,allow
49167,53,5532,53,816,102,714,2,30,1,1,allow
56121,53,17284,53,207,86,121,2,30,1,1,allow
56552,53,34046,53,195,102,93,2,30,1,1,allow
1927,53,62865,53,210,78,132,2,30,1,1,allow
65189,27015,61124,27015,250,78,172,2,30,1,1,allow
65189,27015,46211,27015,267,78,189,2,30,1,1,allow
55461,53,35895,53,198,110,88,2,30,1,1,allow
49917,53,18720,53,209,110,99,2,30,1,1,allow
65189,27017,19229,27017,239,78,161,2,30,1,1,allow
65189,27015,18038,27015,257,78,179,2,30,1,1,allow
65189,27207,3306,27207,230,78,152,2,30,1,1,allow
65189,27015,25952,27015,281,78,203,2,30,1,1,allow
55918,53,15262,53,184,94,90,2,31,1,1,allow
65189,27015,36838,27015,257,78,179,2,30,1,1,allow
10089,80,55892,80,130,70,60,2,15,1,1,allow
3303,80,51748,80,2338,1419,919,10,15,5,5,allow
51756,41471,58464,41471,70,70,0,1,5,1,0,allow
51158,443,53566,443,3155111,84086,3071025,3163,75,1072,2091,allow
46438,443,46438,443,5337,2090,3247,22,39,13,9,allow
56026,53,28063,53,183,94,89,2,30,1,1,allow
57252,53,53666,53,183,94,89,2,30,1,1,allow
49433,53,27774,53,173,94,79,2,30,1,1,allow
56104,53,22926,53,197,102,95,2,30,1,1,allow
34947,53,51809,53,168,78,90,2,30,1,1,allow
49860,53,63227,53,184,102,82,2,30,1,1,allow
64026,53,1792,53,211,102,109,2,30,1,1,allow
43693,53,25103,53,164,78,86,2,30,1,1,allow
56649,53,31076,53,168,94,74,2,30,1,1,allow
57252,53,37679,53,183,94,89,2,30,1,1,allow
55512,53,3521,53,458,188,270,6,30,3,3,allow
56809,53,37761,53,178,94,84,2,30,1,1,allow
64311,53,19538,53,199,102,97,2,30,1,1,allow
64585,53,40349,53,210,110,100,2,30,1,1,allow
56246,53,30677,53,209,110,99,2,30,1,1,allow
65359,53,28420,53,193,102,91,2,30,1,1,allow
65249,53,21680,53,182,102,80,2,30,1,1,allow
65529,53,50654,53,821,102,719,2,30,1,1,allow
64715,53,61600,53,209,110,99,2,30,1,1,allow
56227,53,28291,53,179,94,85,2,30,1,1,allow
40193,443,57432,443,1462,735,727,15,185,8,7,allow
45109,443,1117,443,11156,3899,7257,31,234,17,14,allow
64913,53,27503,53,183,94,89,2,30,1,1,allow
53115,40693,38172,40693,70,70,0,2,8,2,0,allow
49728,443,15564,443,7626,1676,5950,29,63,10,19,allow
57249,443,12847,443,7965,2643,5322,42,15,24,18,allow
49183,53,29477,53,209,110,99,2,30,1,1,allow
65420,53,11720,53,166,86,80,2,30,1,1,allow
64643,53,62127,53,177,94,83,2,30,1,1,allow
56557,53,47692,53,214,110,104,2,30,1,1,allow
64287,53,53632,53,181,94,87,2,30,1,1,allow
56004,53,34719,53,177,94,83,2,30,1,1,allow
57152,53,2032,53,183,94,89,2,30,1,1,allow
56126,53,43934,53,183,94,89,2,30,1,1,allow
65189,27015,44891,27015,255,78,177,2,30,1,1,allow
56126,53,32815,53,183,94,89,2,30,1,1,allow
65189,30015,16566,30015,276,78,198,2,30,1,1,allow
49696,53,30519,53,178,94,84,2,30,1,1,allow
56609,53,37814,53,199,102,97,2,30,1,1,allow
56987,53,59227,53,196,102,94,2,30,1,1,allow
65516,53,16518,53,209,110,99,2,31,1,1,allow
57306,53,15056,53,177,94,83,2,31,1,1,allow
55688,53,48185,53,183,94,89,2,31,1,1,allow
57007,53,19153,53,183,94,89,2,31,1,1,allow
64618,53,21647,53,198,102,96,2,30,1,1,allow
56104,53,63968,53,197,102,95,2,30,1,1,allow
64438,53,59049,53,184,94,90,2,30,1,1,allow
56111,53,45505,53,179,94,85,2,30,1,1,allow
55467,53,34377,53,193,102,91,2,30,1,1,allow
65189,28515,39536,28515,266,78,188,2,30,1,1,allow
56883,53,20999,53,184,94,90,2,30,1,1,allow
56071,53,13568,53,193,102,91,2,30,1,1,allow
49361,53,51044,53,184,94,90,2,31,1,1,allow
55517,53,14797,53,179,94,85,2,31,1,1,allow
37965,16153,40075,16153,1320,1320,0,21,1682,21,0,allow
65189,27015,1984,27015,260,78,182,2,30,1,1,allow
56332,53,1947,53,209,110,99,2,31,1,1,allow
65469,53,29881,53,195,102,93,2,31,1,1,allow
54990,53,46533,53,166,86,80,2,31,1,1,allow
64618,53,55916,53,198,102,96,2,31,1,1,allow
57172,53,10868,53,196,102,94,2,31,1,1,allow
49174,53,1263,53,166,86,80,2,31,1,1,allow
59103,443,51275,443,4209,2056,2153,50,277,24,26,allow
38444,443,18273,443,3547,955,2592,13,120,6,7,allow
49204,443,40475,443,1786,172,1614,7,120,3,4,allow
64041,53,11407,53,200,102,98,2,31,1,1,allow
53430,443,50940,443,4383,2064,2319,11,120,6,5,allow
56071,53,32735,53,193,102,91,2,31,1,1,allow
58427,5223,31205,5223,13841,6601,7240,42,622,19,23,allow
61146,443,19937,443,8580941,269463,8311478,9202,122,3016,6186,allow
49160,1025,14161,1025,868,150,718,4,1200,2,2,allow
37965,48782,19115,48782,132,132,0,3,1199,3,0,allow
56601,53,16656,53,239,94,145,2,31,1,1,allow
44839,443,23952,443,3188,2056,1132,23,121,13,10,allow
56033,53,58148,53,213,102,111,2,31,1,1,allow
49861,53,27236,53,198,102,96,2,31,1,1,allow
50326,53,27014,53,720,94,626,2,31,1,1,allow
65359,53,19133,53,193,102,91,2,31,1,1,allow
55461,53,48907,53,198,110,88,2,31,1,1,allow
49384,53,17338,53,181,94,87,2,31,1,1,allow
55857,53,56112,53,199,102,97,2,31,1,1,allow
49901,53,59612,53,193,102,91,2,31,1,1,allow
56783,53,24430,53,199,102,97,2,31,1,1,allow
64831,53,30238,53,216,110,106,2,31,1,1,allow
49860,53,48565,53,168,86,82,2,31,1,1,allow
57172,53,34011,53,196,102,94,2,31,1,1,allow
49972,53,6023,53,314,94,220,4,31,2,2,allow
64288,443,27448,443,252,70,182,3,120,1,2,allow
55688,53,29682,53,183,94,89,2,31,1,1,allow
36366,443,13851,443,6147,910,5237,18,16,10,8,allow
53237,443,53237,443,1210,637,573,14,34,7,7,allow
46167,80,10521,80,78,78,0,1,5,1,0,allow
57007,53,36349,53,183,94,89,2,31,1,1,allow
64403,53,9122,53,199,102,97,2,31,1,1,allow
49537,53,25046,53,269,96,173,4,59,2,2,allow
46052,443,47336,443,9815,5382,4433,51,237,20,31,allow
43357,443,59688,443,1053,566,487,10,15,6,4,allow
53236,443,53236,443,1210,637,573,14,34,7,7,allow
45169,443,45169,443,282,140,142,5,152,3,2,allow
65131,53,4831,53,168,86,82,2,30,1,1,allow
57357,445,0,0,70,70,0,1,0,1,0,drop
33822,57470,0,0,66,66,0,1,0,1,0,deny
57353,445,0,0,70,70,0,1,0,1,0,drop
57349,445,0,0,70,70,0,1,0,1,0,drop
11716,37965,0,0,62,62,0,1,0,1,0,deny
4910,2149,0,0,62,62,0,1,0,1,0,deny
52766,445,0,0,66,66,0,1,0,1,0,drop
51745,30188,0,0,62,62,0,1,0,1,0,deny
52355,445,0,0,70,70,0,1,0,1,0,drop
31845,55777,0,0,62,62,0,1,0,1,0,deny
16293,57470,0,0,62,62,0,1,0,1,0,deny
52757,445,0,0,66,66,0,1,0,1,0,drop
22587,30188,0,0,66,66,0,1,0,1,0,deny
57336,445,0,0,70,70,0,1,0,1,0,drop
19747,37965,0,0,62,62,0,1,0,1,0,deny
9448,57866,0,0,146,146,0,1,0,1,0,deny
52352,445,0,0,70,70,0,1,0,1,0,drop
64341,57470,0,0,62,62,0,1,0,1,0,deny
52755,445,0,0,66,66,0,1,0,1,0,drop
2522,64147,0,0,62,62,0,1,0,1,0,deny
56307,52700,0,0,66,66,0,1,0,1,0,deny
10003,64147,0,0,62,62,0,1,0,1,0,deny
10115,52700,0,0,62,62,0,1,0,1,0,deny
52247,51505,0,0,146,146,0,1,0,1,0,deny
6712,44818,0,0,66,66,0,1,0,1,0,deny
63379,36237,0,0,62,62,0,1,0,1,0,deny
52747,445,0,0,66,66,0,1,0,1,0,drop
52348,445,0,0,70,70,0,1,0,1,0,drop
18357,51180,0,0,62,62,0,1,0,1,0,deny
58305,51180,0,0,66,66,0,1,0,1,0,deny
52346,445,0,0,70,70,0,1,0,1,0,drop
52740,445,0,0,66,66,0,1,0,1,0,drop
12530,35440,0,0,66,66,0,1,0,1,0,deny
7308,50584,0,0,66,66,0,1,0,1,0,deny
52344,445,0,0,70,70,0,1,0,1,0,drop
10586,37965,0,0,62,62,0,1,0,1,0,deny
53777,443,29327,443,495,421,74,4,0,3,1,allow
53769,443,28627,443,499,425,74,4,0,3,1,allow
4540,23,0,0,60,60,0,1,0,1,0,deny
31112,50584,0,0,66,66,0,1,0,1,0,deny
47103,55378,0,0,146,146,0,1,0,1,0,deny
57329,445,0,0,70,70,0,1,0,1,0,drop
57325,445,0,0,70,70,0,1,0,1,0,drop
57324,445,0,0,70,70,0,1,0,1,0,drop
59378,50584,0,0,66,66,0,1,0,1,0,deny
63305,62413,0,0,66,66,0,1,0,1,0,deny
52732,445,0,0,66,66,0,1,0,1,0,drop
52731,445,0,0,66,66,0,1,0,1,0,drop
52730,445,0,0,66,66,0,1,0,1,0,drop
52726,445,0,0,66,66,0,1,0,1,0,drop
52724,445,0,0,66,66,0,1,0,1,0,drop
52729,445,0,0,66,66,0,1,0,1,0,drop
52725,445,0,0,66,66,0,1,0,1,0,drop
52727,445,0,0,66,66,0,1,0,1,0,drop
65250,22114,0,0,66,66,0,1,0,1,0,deny
52337,445,0,0,70,70,0,1,0,1,0,drop
56217,5900,0,0,60,60,0,1,0,1,0,deny
43129,20220,0,0,62,62,0,1,0,1,0,deny
14715,56205,0,0,62,62,0,1,0,1,0,deny
52335,445,0,0,70,70,0,1,0,1,0,drop
58950,5900,0,0,60,60,0,1,0,1,0,deny
64024,57470,0,0,62,62,0,1,0,1,0,deny
52334,445,0,0,70,70,0,1,0,1,0,drop
6881,55108,0,0,143,143,0,1,0,1,0,deny
45941,23386,0,0,60,60,0,1,0,1,0,deny
52333,445,0,0,70,70,0,1,0,1,0,drop
26722,11446,0,0,66,66,0,1,0,1,0,deny
52332,445,0,0,70,70,0,1,0,1,0,drop
63547,37965,0,0,66,66,0,1,0,1,0,deny
52330,445,0,0,70,70,0,1,0,1,0,drop
52328,445,0,0,70,70,0,1,0,1,0,drop
11464,37965,0,0,62,62,0,1,0,1,0,deny
53015,64147,0,0,145,145,0,1,0,1,0,deny
50052,65008,0,0,60,60,0,1,0,1,0,deny
57321,445,0,0,70,70,0,1,0,1,0,drop
57319,445,0,0,70,70,0,1,0,1,0,drop
57317,445,0,0,70,70,0,1,0,1,0,drop
64756,11392,0,0,62,62,0,1,0,1,0,deny
3802,55777,0,0,66,66,0,1,0,1,0,deny
52709,445,0,0,66,66,0,1,0,1,0,drop
52710,445,0,0,66,66,0,1,0,1,0,drop
52712,445,0,0,66,66,0,1,0,1,0,drop
1028,62609,0,0,148,148,0,1,0,1,0,deny
52314,445,0,0,70,70,0,1,0,1,0,drop
52313,445,0,0,70,70,0,1,0,1,0,drop
52309,445,0,0,70,70,0,1,0,1,0,drop
61912,17546,0,0,66,66,0,1,0,1,0,deny
57306,445,0,0,70,70,0,1,0,1,0,drop
52303,445,0,0,70,70,0,1,0,1,0,drop
52304,445,0,0,70,70,0,1,0,1,0,drop
40547,24051,0,0,74,74,0,1,0,1,0,deny
57304,445,0,0,70,70,0,1,0,1,0,drop
50734,37965,0,0,62,62,0,1,0,1,0,deny
57301,445,0,0,70,70,0,1,0,1,0,drop
57294,445,0,0,70,70,0,1,0,1,0,drop
57293,445,0,0,70,70,0,1,0,1,0,drop
43235,23,0,0,60,60,0,1,0,1,0,deny
42745,50011,0,0,62,62,0,1,0,1,0,deny
60480,57470,0,0,62,62,0,1,0,1,0,deny
19610,9571,0,0,62,62,0,1,0,1,0,deny
22541,64147,0,0,62,62,0,1,0,1,0,deny
30598,46824,0,0,62,62,0,1,0,1,0,deny
39810,48817,0,0,148,148,0,1,0,1,0,deny
46093,32661,0,0,74,74,0,1,0,1,0,deny
52292,445,0,0,70,70,0,1,0,1,0,drop
39824,51505,0,0,62,62,0,1,0,1,0,deny
65512,44847,0,0,66,66,0,1,0,1,0,deny
13372,50584,0,0,66,66,0,1,0,1,0,deny
59055,11392,0,0,66,66,0,1,0,1,0,deny
57286,445,0,0,70,70,0,1,0,1,0,drop
57284,445,0,0,70,70,0,1,0,1,0,drop
57281,445,0,0,70,70,0,1,0,1,0,drop
52103,53733,0,0,66,66,0,1,0,1,0,deny
61185,54532,0,0,62,62,0,1,0,1,0,deny
52288,445,0,0,70,70,0,1,0,1,0,drop
49628,35440,0,0,66,66,0,1,0,1,0,deny
52519,44847,0,0,62,62,0,1,0,1,0,deny
1749,64147,0,0,62,62,0,1,0,1,0,deny
25772,7302,0,0,62,62,0,1,0,1,0,deny
52278,445,0,0,70,70,0,1,0,1,0,drop
52277,445,0,0,70,70,0,1,0,1,0,drop
49976,22114,0,0,66,66,0,1,0,1,0,deny
52275,445,0,0,70,70,0,1,0,1,0,drop
52273,445,0,0,70,70,0,1,0,1,0,drop
45079,31573,0,0,66,66,0,1,0,1,0,deny
55413,37965,0,0,62,62,0,1,0,1,0,deny
52271,445,0,0,70,70,0,1,0,1,0,drop
46774,64147,0,0,145,145,0,1,0,1,0,deny
35036,26296,0,0,159,159,0,1,0,1,0,deny
57654,35440,0,0,66,66,0,1,0,1,0,deny
52690,445,0,0,66,66,0,1,0,1,0,drop
57278,445,0,0,70,70,0,1,0,1,0,drop
57276,445,0,0,70,70,0,1,0,1,0,drop
51151,64147,0,0,62,62,0,1,0,1,0,deny
6881,6881,0,0,62,62,0,1,0,1,0,deny
63183,64147,0,0,66,66,0,1,0,1,0,deny
52266,445,0,0,70,70,0,1,0,1,0,drop
52683,445,0,0,66,66,0,1,0,1,0,drop
64252,53,36702,53,198,101,97,2,31,1,1,allow
49696,53,54642,53,172,88,84,2,30,1,1,allow
34114,443,15852,443,6206,1695,4511,25,16,13,12,allow
53560,42459,25720,42459,552,306,246,9,17,5,4,allow
47510,443,50202,443,5149,852,4297,16,15,9,7,allow
64403,53,60359,53,198,101,97,2,30,1,1,allow
47087,15000,40073,15000,138,78,60,2,5,1,1,allow
50930,443,54294,443,134,60,74,3,10,2,1,allow
60395,6890,18737,6890,70,70,0,1,5,1,0,allow
49945,53,48312,53,281,97,184,4,58,2,2,allow
56750,53,47077,53,711,87,624,2,30,1,1,allow
49175,53,59846,53,186,95,91,2,30,1,1,allow
65469,53,59478,53,190,97,93,2,30,1,1,allow
50391,8080,50391,8080,1614,785,829,11,54,6,5,allow
50387,8080,50387,8080,7241,3224,4017,23,61,14,9,allow
49421,443,54717,443,5422,801,4621,21,173,9,12,allow
51614,15000,49065,15000,130,70,60,2,5,1,1,allow
48271,15000,29989,15000,130,70,60,2,5,1,1,allow
56604,443,5643,443,7915,1926,5989,20,15,11,9,allow
65498,53,36093,53,202,103,99,2,31,1,1,allow
57010,53,20752,53,198,101,97,2,30,1,1,allow
56603,443,20013,443,7890,1901,5989,20,16,11,9,allow
53565,58695,4400,58695,70,70,0,1,5,1,0,allow
45554,443,45554,443,4617,1710,2907,19,26,11,8,allow
55317,443,24510,443,5692,1239,4453,23,16,13,10,allow
50388,8080,50388,8080,4417,2499,1918,18,56,10,8,allow
55353,53,50744,53,168,86,82,2,30,1,1,allow
53229,443,53229,443,1402,856,546,12,34,6,6,allow
53232,443,53232,443,1270,697,573,15,33,8,7,allow
15629,53,15629,53,209,77,132,2,32,1,1,allow
56606,443,12642,443,7914,1925,5989,20,15,11,9,allow
40103,443,24820,443,161,101,60,2,5,1,1,allow
55467,53,15072,53,186,95,91,2,30,1,1,allow
55670,53,52397,53,774,101,673,2,30,1,1,allow
65357,53,15221,53,176,90,86,2,30,1,1,allow
57051,443,6628,443,594793,518081,76712,1350,1004,781,569,allow
65231,53,23789,53,200,102,98,2,31,1,1,allow
57007,53,22184,53,182,93,89,2,31,1,1,allow
53165,443,53165,443,208,66,142,4,148,2,2,allow
56605,443,61768,443,7863,1874,5989,20,15,11,9,allow
53234,443,53234,443,1276,703,573,15,33,8,7,allow
65258,53,4624,53,186,95,91,2,31,1,1,allow
59031,80,8208,80,4119,611,3508,12,18,4,8,allow
47164,15000,48096,15000,130,70,60,2,5,1,1,allow
25803,53,25803,53,231,88,143,2,33,1,1,allow
51753,15038,53015,15038,66,66,0,1,5,1,0,allow
19876,53,19876,53,209,77,132,2,33,1,1,allow
51772,59814,12241,59814,70,70,0,2,8,2,0,allow
56918,53,41255,53,778,103,675,2,30,1,1,allow
5588,5588,0,0,3354,1792,1562,46,195,23,23,allow
65131,53,35643,53,168,86,82,2,30,1,1,allow
56883,53,62227,53,184,94,90,2,30,1,1,allow
49676,53,36174,53,733,86,647,2,30,1,1,allow
65189,27015,25924,27015,233,71,162,2,30,1,1,allow
56425,53,17413,53,760,97,663,2,30,1,1,allow
55688,53,32958,53,182,93,89,2,30,1,1,allow
65189,27255,47951,27255,278,71,207,2,30,1,1,allow
59948,443,41928,443,349197,16542,332655,411,129,150,261,allow
49229,53,8820,53,88,88,0,1,31,1,0,allow
57416,53,62592,53,186,95,91,2,31,1,1,allow
49632,443,26348,443,3618,961,2657,13,121,6,7,allow
49486,53,33759,53,170,87,83,2,31,1,1,allow
65040,53,62726,53,176,90,86,2,31,1,1,allow
50604,53,2592,53,752,93,659,2,31,1,1,allow
64885,53,64870,53,753,93,660,2,31,1,1,allow
65048,53,26939,53,188,96,92,2,31,1,1,allow
55634,53,60487,53,204,104,100,2,31,1,1,allow
64216,53,11505,53,182,93,89,2,30,1,1,allow
57172,53,55364,53,192,98,94,2,31,1,1,allow
55796,53,45006,53,192,98,94,2,31,1,1,allow
49777,53,59395,53,164,84,80,2,31,1,1,allow
64986,53,47302,53,176,90,86,2,31,1,1,allow
55705,53,57706,53,202,103,99,2,31,1,1,allow
56802,53,9464,53,753,93,660,2,31,1,1,allow
49917,53,47966,53,752,93,659,2,31,1,1,allow
49369,53,3787,53,182,93,89,2,31,1,1,allow
65179,53,5745,53,184,94,90,2,31,1,1,allow
56901,53,23977,53,710,89,621,2,31,1,1,allow
56167,53,36482,53,172,88,84,2,31,1,1,allow
50265,41071,33048,41071,1716,1716,0,27,2188,27,0,allow
57139,53,1323,53,164,84,80,2,31,1,1,allow
58034,443,61141,443,4553,856,3697,17,362,9,8,allow
49983,53,22293,53,206,105,101,2,31,1,1,allow
65424,53,25204,53,204,104,100,2,31,1,1,allow
55743,53,6640,53,748,106,642,2,31,1,1,allow
64949,53,23952,53,208,106,102,2,31,1,1,allow
34734,443,41689,443,7974,2716,5258,50,7261,26,24,allow
52680,445,0,0,66,66,0,1,0,1,0,drop
1534,54369,0,0,66,66,0,1,0,1,0,deny
57266,445,0,0,70,70,0,1,0,1,0,drop
51105,50584,0,0,62,62,0,1,0,1,0,deny
57262,445,0,0,70,70,0,1,0,1,0,drop
57255,445,0,0,70,70,0,1,0,1,0,drop
54836,443,5754,443,119863,100823,19040,322,229,183,139,allow
50166,53,40117,53,211,78,133,2,30,1,1,allow
50583,53,37919,53,819,102,717,2,30,1,1,allow
56878,53,41614,53,168,86,82,2,30,1,1,allow
49429,53,36318,53,210,110,100,2,30,1,1,allow
56445,53,29245,53,199,102,97,2,30,1,1,allow
56354,53,51631,53,200,94,106,2,30,1,1,allow
53230,443,53230,443,1462,916,546,13,34,7,6,allow
44879,443,44879,443,7123,1020,6103,19,151,11,8,allow
49738,443,52506,443,3085,1404,1681,15,15,7,8,allow
19371,53,19371,53,214,82,132,2,31,1,1,allow
53235,443,53235,443,1270,697,573,15,33,8,7,allow
44368,443,44368,443,7123,1020,6103,19,151,11,8,allow
37109,80,41807,80,763,434,329,8,14,5,3,allow
63672,443,63672,443,4398,1491,2907,19,27,11,8,allow
63203,443,63203,443,9324,4240,5084,24,16,13,11,allow
43218,443,21139,443,7375,2087,5288,24,255,12,12,allow
51413,443,36557,443,202,70,132,3,11,1,2,allow
55609,39869,9261,39869,70,70,0,2,8,2,0,allow
65529,53,6825,53,198,102,96,2,29,1,1,allow
49670,53,58566,53,168,86,82,2,29,1,1,allow
59882,53,29947,53,244,86,158,2,29,1,1,allow
65131,53,1840,53,168,86,82,2,29,1,1,allow
57152,53,61515,53,183,94,89,2,29,1,1,allow
57306,53,25248,53,177,94,83,2,29,1,1,allow
52957,53,50377,53,168,78,90,2,29,1,1,allow
55215,53,18031,53,315,126,189,2,29,1,1,allow
56441,53,35817,53,209,110,99,2,29,1,1,allow
64041,53,24835,53,200,102,98,2,29,1,1,allow
44603,53,44603,53,229,98,131,2,29,1,1,allow
65189,27212,4653,27212,254,78,176,2,29,1,1,allow
55688,53,38445,53,183,94,89,2,29,1,1,allow
49266,53,6643,53,199,102,97,2,29,1,1,allow
65189,28115,45956,28115,284,78,206,2,29,1,1,allow
49917,53,29420,53,209,110,99,2,29,1,1,allow
65189,27015,11223,27015,275,78,197,2,29,1,1,allow
65488,53,4906,53,232,110,122,2,29,1,1,allow
65189,27015,42181,27015,262,78,184,2,29,1,1,allow
56004,53,27325,53,177,94,83,2,29,1,1,allow
65189,27268,56111,27268,232,78,154,2,29,1,1,allow
55857,53,40207,53,199,102,97,2,29,1,1,allow
65189,27016,20619,27016,249,78,171,2,29,1,1,allow
49439,53,40925,53,197,102,95,2,30,1,1,allow
65189,27015,60711,27015,278,78,200,2,29,1,1,allow
65189,28015,14178,28015,240,78,162,2,29,1,1,allow
64011,53,63004,53,228,110,118,2,29,1,1,allow
65189,27202,50060,27202,230,78,152,2,29,1,1,allow
55346,53,11251,53,396,102,294,2,30,1,1,allow
49945,53,50921,53,281,97,184,4,58,2,2,allow
50966,443,34957,443,6350,1072,5278,18,40,10,8,allow
55614,29731,2636,29731,70,70,0,2,8,2,0,allow
55615,13826,16063,13826,70,70,0,2,8,2,0,allow
58053,25,49850,25,1316,442,874,15,16,7,8,allow
65504,53,33205,53,193,102,91,2,30,1,1,allow
56332,53,27865,53,209,110,99,2,30,1,1,allow
49730,53,24529,53,211,110,101,2,30,1,1,allow
50238,53,50499,53,438,180,258,6,30,3,3,allow
56987,53,64863,53,196,102,94,2,30,1,1,allow
65063,53,50094,53,180,94,86,2,30,1,1,allow
57077,53,61276,53,166,86,80,2,30,1,1,allow
55469,443,55469,443,4579,1672,2907,19,29,11,8,allow
57010,53,26340,53,199,102,97,2,30,1,1,allow
57306,53,20608,53,573,186,387,6,71,3,3,allow
56477,53,13759,53,199,102,97,2,30,1,1,allow
65380,53,10002,53,180,94,86,2,30,1,1,allow
41343,443,31271,443,7601,1595,6006,25,35,12,13,allow
56144,53,15210,53,177,94,83,2,30,1,1,allow
49539,53,64502,53,340,87,253,4,50,2,2,allow
56783,53,42766,53,199,102,97,2,30,1,1,allow
56783,21279,18481,21279,70,70,0,2,8,2,0,allow
65357,53,23805,53,180,94,86,2,30,1,1,allow
6040,53,41772,53,323,94,229,2,30,1,1,allow
49968,53,43611,53,751,94,657,2,30,1,1,allow
37889,53,32762,53,199,94,105,2,30,1,1,allow
57331,53,38724,53,166,86,80,2,30,1,1,allow
50583,53,45479,53,196,102,94,2,30,1,1,allow
55502,53,15110,53,194,102,92,2,30,1,1,allow
65014,53,57511,53,193,102,91,2,30,1,1,allow
65380,53,23186,53,180,94,86,2,30,1,1,allow
57010,53,46777,53,199,102,97,2,30,1,1,allow
56357,53,47293,53,196,102,94,2,30,1,1,allow
65516,53,21286,53,209,110,99,2,30,1,1,allow
65063,53,22032,53,180,94,86,2,30,1,1,allow
49486,53,9984,53,177,94,83,2,30,1,1,allow
42936,53,47625,53,199,94,105,2,30,1,1,allow
56006,53,47168,53,210,102,108,2,30,1,1,allow
55353,53,65240,53,168,86,82,2,30,1,1,allow
55705,53,14171,53,209,110,99,2,30,1,1,allow
59424,443,18512,443,252,70,182,3,120,1,2,allow
46451,443,47700,443,350492,17722,332770,449,125,169,280,allow
56477,53,54398,53,199,102,97,2,30,1,1,allow
49384,53,27649,53,181,94,87,2,30,1,1,allow
51771,19103,40132,19103,70,70,0,2,8,2,0,allow
51411,443,11555,443,202,70,132,3,11,1,2,allow
41972,5222,18449,5222,5709,2977,2732,62,621,31,31,allow
37694,443,63637,443,234688,15158,219530,324,173,157,167,allow
64913,53,26175,53,555,195,360,6,62,3,3,allow
57010,53,64390,53,199,102,97,2,30,1,1,allow
65417,53,53892,53,183,94,89,2,30,1,1,allow
54984,53,62420,53,994,86,908,2,30,1,1,allow
49439,53,11369,53,197,102,95,2,30,1,1,allow
59614,53,24145,53,417,78,339,2,30,1,1,allow
56899,53,4081,53,258,102,156,2,30,1,1,allow
56375,53,53548,53,184,102,82,2,30,1,1,allow
55057,53,28179,53,889,404,485,10,30,5,5,allow
65231,53,56850,53,200,102,98,2,30,1,1,allow
51755,24236,52970,24236,136,136,0,3,13,3,0,allow
51754,1182,24029,1182,70,70,0,1,5,1,0,allow
49478,53,32475,53,551,114,437,4,37,2,2,allow
65295,53,41511,53,944,205,739,6,45,3,3,allow
51715,443,35378,443,4175264,89546,4085718,4141,532,1111,3030,allow
49730,53,46996,53,211,110,101,2,30,1,1,allow
55722,53,19688,53,226,110,116,2,30,1,1,allow
41780,53,0,0,86,86,0,1,30,1,0,allow
65131,53,31647,53,168,86,82,2,30,1,1,allow
49183,53,46145,53,817,102,715,2,30,1,1,allow
55502,53,12440,53,817,102,715,2,30,1,1,allow
64913,53,45899,53,183,94,89,2,30,1,1,allow
49885,53,57862,53,786,110,676,2,30,1,1,allow
57416,53,21354,53,193,102,91,2,30,1,1,allow
55706,53,9851,53,258,102,156,2,30,1,1,allow
49638,53,6600,53,210,110,100,2,30,1,1,allow
49638,53,20349,53,210,110,100,2,30,1,1,allow
65014,53,36571,53,193,102,91,2,30,1,1,allow
50017,53,65009,53,741,94,647,2,30,1,1,allow
38317,443,31937,443,9834,4297,5537,26,326,12,14,allow
51322,443,58671,443,6250,1422,4828,20,17,10,10,allow
50716,80,11421,80,1106,326,780,12,140,6,6,allow
35866,80,8550,80,1114,534,580,12,15,7,5,allow
35353,443,65162,443,1833,991,842,14,224,7,7,allow
58362,443,29130,443,13272,2360,10912,37,208,19,18,allow
35354,443,9498,443,2392,917,1475,16,224,8,8,allow
42597,443,21561,443,6131,1399,4732,20,979,10,10,allow
49420,443,10802,443,4932,1046,3886,21,173,10,11,allow
33521,80,30889,80,3429,1679,1750,14,22,8,6,allow
56614,80,65163,80,234,234,0,4,11,4,0,allow
39358,443,53461,443,9115,6806,2309,37,80,20,17,allow
53231,443,53231,443,1402,856,546,12,34,6,6,allow
49288,443,9666,443,7846,2369,5477,23,385,10,13,allow
12162,53,12162,53,233,90,143,2,33,1,1,allow
64287,53,8913,53,280,91,189,4,33,2,2,allow
60400,56243,28136,56243,70,70,0,2,8,2,0,allow
51295,443,27138,443,7448,1737,5711,24,201,13,11,allow
55467,53,6293,53,320,95,225,4,41,2,2,allow
64618,53,41913,53,305,100,205,4,54,2,2,allow
59418,443,19462,443,7222,1633,5589,24,201,13,11,allow
35267,80,35004,80,613,539,74,7,15,6,1,allow
49235,53,43539,53,164,78,86,2,29,1,1,allow
56441,53,4935,53,209,110,99,2,29,1,1,allow
1928,53,30597,53,210,78,132,2,29,1,1,allow
65189,28215,62292,28215,259,78,181,2,29,1,1,allow
56883,53,30894,53,184,94,90,2,29,1,1,allow
65189,27016,36079,27016,78,78,0,1,29,1,0,allow
65189,27257,41492,27257,252,78,174,2,29,1,1,allow
65189,27214,42310,27214,231,78,153,2,29,1,1,allow
50006,53,41506,53,994,86,908,2,29,1,1,allow
64323,53,18965,53,195,102,93,2,30,1,1,allow
55467,53,17631,53,193,102,91,2,29,1,1,allow
61858,10443,43005,10443,10747,2507,8240,26,48,14,12,allow
65514,53,14703,53,214,110,104,2,29,1,1,allow
65056,53,34239,53,199,102,97,2,29,1,1,allow
65189,28125,44608,28125,78,78,0,1,29,1,0,allow
55517,53,26427,53,179,94,85,2,29,1,1,allow
54990,53,62190,53,166,86,80,2,29,1,1,allow
65056,53,26315,53,199,102,97,2,29,1,1,allow
49429,53,17254,53,210,110,100,2,29,1,1,allow
64311,53,4229,53,199,102,97,2,29,1,1,allow
49539,53,25645,53,177,94,83,2,30,1,1,allow
65131,53,44924,53,168,86,82,2,30,1,1,allow
49851,53,9637,53,166,86,80,2,29,1,1,allow
49183,53,53469,53,194,102,92,2,30,1,1,allow
55634,53,8065,53,210,110,100,2,30,1,1,allow
42151,53,3505,53,168,78,90,2,30,1,1,allow
49341,53,47990,53,199,102,97,2,31,1,1,allow
56375,53,4600,53,184,102,82,2,30,1,1,allow
49785,53,52317,53,211,110,101,2,30,1,1,allow
65380,53,28417,53,180,94,86,2,30,1,1,allow
56963,53,26493,53,210,110,100,2,30,1,1,allow
55796,53,36094,53,196,102,94,2,30,1,1,allow
56111,53,5335,53,179,94,85,2,30,1,1,allow
65258,53,48935,53,193,102,91,2,30,1,1,allow
54031,53,23447,53,168,78,90,2,30,1,1,allow
64739,53,35789,53,164,86,78,2,31,1,1,allow
56477,53,18413,53,386,101,285,4,31,2,2,allow
64831,53,42481,53,216,110,106,2,30,1,1,allow
57570,443,58853,443,6226,4213,2013,30,79,18,12,allow
27464,53,27464,53,233,90,143,2,32,1,1,allow
50390,8080,50390,8080,378,180,198,7,54,4,3,allow
64403,53,16361,53,783,197,586,6,70,3,3,allow
65014,53,29342,53,193,102,91,2,30,1,1,allow
65063,53,52560,53,180,94,86,2,30,1,1,allow
49785,53,47696,53,211,110,101,2,30,1,1,allow
65359,53,55689,53,193,102,91,2,30,1,1,allow
56104,53,24374,53,197,102,95,2,30,1,1,allow
64216,53,1409,53,183,94,89,2,30,1,1,allow
49229,53,18433,53,178,94,84,2,31,1,1,allow
49361,53,25462,53,184,94,90,2,30,1,1,allow
50885,80,41376,80,291594,13131,278463,312,159,116,196,allow
60401,30046,28995,30046,70,70,0,2,8,2,0,allow
35790,443,59845,443,6777,1527,5250,24,201,13,11,allow
52404,443,21006,443,132575,6675,125900,206,94,91,115,allow
50389,8080,50389,8080,5724,1509,4215,18,55,10,8,allow
49812,53,36103,53,1411,98,1313,4,52,2,2,allow
65504,53,23026,53,193,102,91,2,30,1,1,allow
65417,53,31307,53,183,94,89,2,30,1,1,allow
60601,53,19741,53,451,86,365,2,30,1,1,allow
56144,53,34369,53,177,94,83,2,30,1,1,allow
64121,53,21027,53,365,102,263,2,31,1,1,allow
55199,443,3846,443,18132,8636,9496,40,176,23,17,allow
48673,443,24154,443,18147,9173,8974,42,175,24,18,allow
51467,443,7148,443,20313,6637,13676,45,24,23,22,allow
55610,23383,23402,23383,70,70,0,2,8,2,0,allow
49562,443,58637,443,9908,4692,5216,30,92,16,14,allow
49361,53,49782,53,166,86,80,2,30,1,1,allow
64323,53,64062,53,195,102,93,2,30,1,1,allow
56357,53,43441,53,819,102,717,2,30,1,1,allow
49175,53,18016,53,193,102,91,2,30,1,1,allow
59645,53,23128,53,263,94,169,2,30,1,1,allow
64438,53,4120,53,184,94,90,2,30,1,1,allow
56332,53,16709,53,209,110,99,2,30,1,1,allow
65514,53,43311,53,214,110,104,2,30,1,1,allow
64216,53,16244,53,183,94,89,2,30,1,1,allow
43326,443,42679,443,10063,2126,7937,36,120,18,18,allow
55353,53,1525,53,168,86,82,2,30,1,1,allow
56605,53,38242,53,341,110,231,2,30,1,1,allow
64252,53,2072,53,199,102,97,2,30,1,1,allow
65258,53,25267,53,193,102,91,2,30,1,1,allow
65469,53,49560,53,195,102,93,2,30,1,1,allow
64235,53,40648,53,197,102,95,2,30,1,1,allow
56963,53,63248,53,210,110,100,2,30,1,1,allow
49983,53,2734,53,211,110,101,2,30,1,1,allow
65448,53,6069,53,264,110,154,2,30,1,1,allow
65498,53,57439,53,209,110,99,2,30,1,1,allow
64216,53,45002,53,295,93,202,4,30,2,2,allow
65040,53,10817,53,180,94,86,2,31,1,1,allow
56326,53,47935,53,177,94,83,2,31,1,1,allow
49670,53,59914,53,168,86,82,2,31,1,1,allow
57470,2710,46091,2710,124,124,0,3,1199,3,0,allow
49732,53,17684,53,178,94,84,2,30,1,1,allow
64986,53,8227,53,180,94,86,2,30,1,1,allow
55958,53,25725,53,209,102,107,2,30,1,1,allow
56765,53,52447,53,194,102,92,2,30,1,1,allow
64254,53,19864,53,197,94,103,2,30,1,1,allow
65498,53,39980,53,209,110,99,2,30,1,1,allow
65424,53,39053,53,210,110,100,2,31,1,1,allow
56953,53,15670,53,421,78,343,2,31,1,1,allow
49486,53,40876,53,177,94,83,2,31,1,1,allow
65514,53,32610,53,214,110,104,2,31,1,1,allow
57172,53,27478,53,196,102,94,2,31,1,1,allow
55145,443,65048,443,13231,6169,7062,38,120,19,19,allow
65498,53,26410,53,209,110,99,2,30,1,1,allow
49785,53,63638,53,211,110,101,2,30,1,1,allow
49777,53,14014,53,166,86,80,2,30,1,1,allow
49429,53,19279,53,210,110,100,2,30,1,1,allow
55796,53,53720,53,196,102,94,2,30,1,1,allow
55975,53,28209,53,195,102,93,2,30,1,1,allow
57007,53,62995,53,183,94,89,2,31,1,1,allow
49670,53,37029,53,168,86,82,2,30,1,1,allow
64420,53,18764,53,386,102,284,2,30,1,1,allow
49831,53,24463,53,364,102,262,2,30,1,1,allow
65024,53,10602,53,196,94,102,2,30,1,1,allow
49696,53,9591,53,178,94,84,2,30,1,1,allow
49862,53,52956,53,715,94,621,2,31,1,1,allow
49861,53,56690,53,198,102,96,2,31,1,1,allow
55975,53,44915,53,195,102,93,2,31,1,1,allow
64677,53,13173,53,195,102,93,2,31,1,1,allow
49175,53,45258,53,193,102,91,2,31,1,1,allow
55286,53,22334,53,194,102,92,2,31,1,1,allow
64517,53,18639,53,194,102,92,2,31,1,1,allow
65231,53,37315,53,200,102,98,2,31,1,1,allow
49696,53,25941,53,178,94,84,2,31,1,1,allow
6881,30096,6963,30096,509,150,359,2,1199,1,1,allow
39402,443,48958,443,6417,1255,5162,24,360,12,12,allow
17750,14132,3203,14132,150,150,0,1,1200,1,0,allow
6881,20326,20950,20326,509,150,359,2,1200,1,1,allow
49478,53,58294,53,164,86,78,2,31,1,1,allow
56279,443,57070,443,97608,4852,92756,108,121,37,71,allow
56445,53,26251,53,199,102,97,2,30,1,1,allow
49861,53,42147,53,198,102,96,2,30,1,1,allow
49486,53,16915,53,177,94,83,2,30,1,1,allow
49369,53,54778,53,183,94,89,2,30,1,1,allow
64531,53,60188,53,183,94,89,2,30,1,1,allow
49983,53,17295,53,211,110,101,2,31,1,1,allow
65258,53,31384,53,193,102,91,2,31,1,1,allow
55796,53,15761,53,196,102,94,2,31,1,1,allow
64873,53,31946,53,195,94,101,2,31,1,1,allow
50022,53,5739,53,179,94,85,2,31,1,1,allow
49777,53,45833,53,166,86,80,2,31,1,1,allow
60384,443,37407,443,39385,3771,35614,67,129,27,40,allow
49803,443,21959,443,9506,1461,8045,20,158,9,11,allow
48847,443,1416,443,2523,1483,1040,19,276,10,9,allow
37965,25180,40858,25180,858,858,0,14,1199,14,0,allow
64408,53,9592,53,257,126,131,2,31,1,1,allow
53558,30815,59383,30815,492,306,186,8,16,5,3,allow
51676,443,25301,443,90135,76061,14074,251,247,132,119,allow
64949,53,48447,53,212,110,102,2,31,1,1,allow
55353,53,50896,53,311,86,225,4,55,2,2,allow
41833,443,22584,443,50425,3972,46453,63,122,25,38,allow
47884,443,47884,443,4672,1765,2907,18,28,10,8,allow
53561,35885,5770,35885,70,70,0,1,5,1,0,allow
57267,443,26309,443,126,60,66,3,6,2,1,allow
57257,445,0,0,70,70,0,1,0,1,0,drop
52678,445,0,0,66,66,0,1,0,1,0,drop
52258,445,0,0,70,70,0,1,0,1,0,drop
52257,445,0,0,70,70,0,1,0,1,0,drop
13747,8887,13747,8887,500,500,0,1,0,1,0,deny
33289,50584,0,0,146,146,0,1,0,1,0,deny
61221,35440,0,0,66,66,0,1,0,1,0,deny
57251,445,0,0,70,70,0,1,0,1,0,drop
58305,18375,0,0,66,66,0,1,0,1,0,deny
62338,50011,0,0,62,62,0,1,0,1,0,deny
57249,445,0,0,70,70,0,1,0,1,0,drop
57248,445,0,0,70,70,0,1,0,1,0,drop
57246,445,0,0,70,70,0,1,0,1,0,drop
52251,445,0,0,70,70,0,1,0,1,0,drop
52671,445,0,0,66,66,0,1,0,1,0,drop
48676,53398,0,0,60,60,0,1,0,1,0,deny
52250,445,0,0,70,70,0,1,0,1,0,drop
52665,445,0,0,66,66,0,1,0,1,0,drop
52666,445,0,0,66,66,0,1,0,1,0,drop
52664,445,0,0,66,66,0,1,0,1,0,drop
58703,50584,0,0,66,66,0,1,0,1,0,deny
26324,30188,0,0,62,62,0,1,0,1,0,deny
52660,445,0,0,66,66,0,1,0,1,0,drop
52661,445,0,0,66,66,0,1,0,1,0,drop
52658,445,0,0,66,66,0,1,0,1,0,drop
52246,445,0,0,70,70,0,1,0,1,0,drop
56703,50584,0,0,62,62,0,1,0,1,0,deny
51191,26467,0,0,66,66,0,1,0,1,0,deny
63583,37965,0,0,62,62,0,1,0,1,0,deny
16393,22114,0,0,66,66,0,1,0,1,0,deny
52245,445,0,0,70,70,0,1,0,1,0,drop
61426,64910,0,0,66,66,0,1,0,1,0,deny
57244,445,0,0,70,70,0,1,0,1,0,drop
57241,445,0,0,70,70,0,1,0,1,0,drop
57240,445,0,0,70,70,0,1,0,1,0,drop
5223,59023,0,0,66,66,0,1,0,1,0,deny
52657,445,0,0,66,66,0,1,0,1,0,drop
30599,46824,0,0,66,66,0,1,0,1,0,deny
57236,445,0,0,70,70,0,1,0,1,0,drop
443,46382,0,0,66,66,0,1,0,1,0,deny
52652,445,0,0,66,66,0,1,0,1,0,drop
52651,445,0,0,66,66,0,1,0,1,0,drop
53772,443,49684,443,499,425,74,4,0,3,1,allow
53770,443,15341,443,499,425,74,4,0,3,1,allow
53768,443,3588,443,499,425,74,4,0,3,1,allow
53755,443,8268,443,499,425,74,4,0,3,1,allow
53771,443,40823,443,499,425,74,4,0,3,1,allow
53760,443,44529,443,499,425,74,4,0,3,1,allow
53765,443,33408,443,499,425,74,4,0,3,1,allow
53759,443,57982,443,499,425,74,4,0,3,1,allow
53763,443,53593,443,499,425,74,4,0,3,1,allow
53773,443,19967,443,499,425,74,4,0,3,1,allow
53766,443,46858,443,499,425,74,4,0,3,1,allow
53774,443,4137,443,499,425,74,4,0,3,1,allow
53761,443,39818,443,499,425,74,4,0,3,1,allow
53762,443,60750,443,499,425,74,4,0,3,1,allow
53750,443,4212,443,499,425,74,4,0,3,1,allow
53757,443,15611,443,499,425,74,4,0,3,1,allow
53767,443,6984,443,499,425,74,4,0,3,1,allow
53764,443,56074,443,499,425,74,4,0,3,1,allow
53752,443,21616,443,499,425,74,4,0,3,1,allow
53753,443,5988,443,499,425,74,4,0,3,1,allow
53758,443,30147,443,499,425,74,4,0,3,1,allow
53754,443,24588,443,499,425,74,4,0,3,1,allow
53756,443,48419,443,499,425,74,4,0,3,1,allow
53751,443,44095,443,499,425,74,4,0,3,1,allow
52649,445,0,0,66,66,0,1,0,1,0,drop
56712,46824,0,0,66,66,0,1,0,1,0,deny
56119,46824,0,0,62,62,0,1,0,1,0,deny
39823,36237,0,0,62,62,0,1,0,1,0,deny
52647,445,0,0,66,66,0,1,0,1,0,drop
64219,51050,0,0,66,66,0,1,0,1,0,deny
52240,445,0,0,70,70,0,1,0,1,0,drop
54062,31573,0,0,66,66,0,1,0,1,0,deny
62071,22114,0,0,62,62,0,1,0,1,0,deny
57232,445,0,0,70,70,0,1,0,1,0,drop
32511,23,0,0,60,60,0,1,0,1,0,deny
3270,35440,0,0,66,66,0,1,0,1,0,deny
57225,445,0,0,70,70,0,1,0,1,0,drop
57224,445,0,0,70,70,0,1,0,1,0,drop
36906,50584,0,0,62,62,0,1,0,1,0,deny
13654,50584,0,0,62,62,0,1,0,1,0,deny
52638,445,0,0,66,66,0,1,0,1,0,drop
40834,50584,0,0,62,62,0,1,0,1,0,deny
52227,445,0,0,70,70,0,1,0,1,0,drop
58486,57470,0,0,66,66,0,1,0,1,0,deny
32491,15503,0,0,66,66,0,1,0,1,0,deny
50535,51505,0,0,66,66,0,1,0,1,0,deny
52224,445,0,0,70,70,0,1,0,1,0,drop
52629,445,0,0,66,66,0,1,0,1,0,drop
42252,33303,0,0,60,60,0,1,0,1,0,deny
57210,445,0,0,70,70,0,1,0,1,0,drop
24480,35440,0,0,66,66,0,1,0,1,0,deny
52497,47967,0,0,143,143,0,1,0,1,0,deny
52626,445,0,0,66,66,0,1,0,1,0,drop
16660,55783,0,0,62,62,0,1,0,1,0,deny
52220,445,0,0,70,70,0,1,0,1,0,drop
52218,445,0,0,70,70,0,1,0,1,0,drop
52618,445,0,0,66,66,0,1,0,1,0,drop
26110,2310,0,0,148,148,0,1,0,1,0,deny
52216,445,0,0,70,70,0,1,0,1,0,drop
52615,445,0,0,66,66,0,1,0,1,0,drop
51265,31652,0,0,72,72,0,1,0,1,0,reset-both
19156,3846,0,0,145,145,0,1,0,1,0,deny
54339,23117,0,0,66,66,0,1,0,1,0,deny
9412,7302,0,0,66,66,0,1,0,1,0,deny
63465,56205,0,0,66,66,0,1,0,1,0,deny
52209,445,0,0,70,70,0,1,0,1,0,drop
57199,445,0,0,70,70,0,1,0,1,0,drop
57196,445,0,0,70,70,0,1,0,1,0,drop
57197,445,0,0,70,70,0,1,0,1,0,drop
52596,445,0,0,66,66,0,1,0,1,0,drop
52600,445,0,0,66,66,0,1,0,1,0,drop
52603,445,0,0,66,66,0,1,0,1,0,drop
52602,445,0,0,66,66,0,1,0,1,0,drop
52598,445,0,0,66,66,0,1,0,1,0,drop
52601,445,0,0,66,66,0,1,0,1,0,drop
52604,445,0,0,66,66,0,1,0,1,0,drop
52599,445,0,0,66,66,0,1,0,1,0,drop
1024,64147,0,0,62,62,0,1,0,1,0,deny
52207,445,0,0,70,70,0,1,0,1,0,drop
37597,50584,0,0,66,66,0,1,0,1,0,deny
443,31353,0,0,97,97,0,1,0,1,0,deny
443,49313,0,0,97,97,0,1,0,1,0,deny
51617,21247,0,0,66,66,0,1,0,1,0,deny
58445,17500,0,0,66,66,0,1,0,1,0,deny
52206,445,0,0,70,70,0,1,0,1,0,drop
57772,50584,0,0,66,66,0,1,0,1,0,deny
52205,445,0,0,70,70,0,1,0,1,0,drop
52204,445,0,0,70,70,0,1,0,1,0,drop
52200,445,0,0,70,70,0,1,0,1,0,drop
52201,445,0,0,70,70,0,1,0,1,0,drop
44546,32468,0,0,146,146,0,1,0,1,0,deny
62549,64147,0,0,62,62,0,1,0,1,0,deny
54343,50584,0,0,66,66,0,1,0,1,0,deny
1323,64147,0,0,66,66,0,1,0,1,0,deny
60018,64147,0,0,62,62,0,1,0,1,0,deny
63852,35440,0,0,66,66,0,1,0,1,0,deny
0,0,0,0,320,320,0,5,0,5,0,allow
57194,445,0,0,70,70,0,1,0,1,0,drop
57189,445,0,0,70,70,0,1,0,1,0,drop
57181,445,0,0,70,70,0,1,0,1,0,drop
16716,57470,0,0,145,145,0,1,0,1,0,deny
52186,445,0,0,70,70,0,1,0,1,0,drop
52185,445,0,0,70,70,0,1,0,1,0,drop
52179,445,0,0,70,70,0,1,0,1,0,drop
52583,445,0,0,66,66,0,1,0,1,0,drop
52584,445,0,0,66,66,0,1,0,1,0,drop
52582,445,0,0,66,66,0,1,0,1,0,drop
52175,445,0,0,70,70,0,1,0,1,0,drop
52176,445,0,0,70,70,0,1,0,1,0,drop
24375,12809,0,0,60,60,0,1,0,1,0,deny
57179,445,0,0,70,70,0,1,0,1,0,drop
26921,37965,0,0,62,62,0,1,0,1,0,deny
50439,64147,0,0,66,66,0,1,0,1,0,deny
26924,37965,0,0,66,66,0,1,0,1,0,deny
57176,445,0,0,70,70,0,1,0,1,0,drop
57164,445,0,0,70,70,0,1,0,1,0,drop
57168,445,0,0,70,70,0,1,0,1,0,drop
57167,445,0,0,70,70,0,1,0,1,0,drop
11410,36237,0,0,146,146,0,1,0,1,0,deny
52164,445,0,0,70,70,0,1,0,1,0,drop
34756,8055,0,0,159,159,0,1,0,1,0,deny
57283,64147,0,0,66,66,0,1,0,1,0,deny
65384,57470,0,0,66,66,0,1,0,1,0,deny
47910,7454,0,0,60,60,0,1,0,1,0,deny
13864,30718,0,0,60,60,0,1,0,1,0,deny
49831,30188,0,0,62,62,0,1,0,1,0,deny
63667,57470,0,0,145,145,0,1,0,1,0,deny
59168,39004,0,0,62,62,0,1,0,1,0,deny
51815,51221,0,0,74,74,0,1,0,1,0,deny
24592,50584,0,0,62,62,0,1,0,1,0,deny
57157,445,0,0,70,70,0,1,0,1,0,drop
57156,445,0,0,70,70,0,1,0,1,0,drop
57153,445,0,0,70,70,0,1,0,1,0,drop
8976,44847,0,0,66,66,0,1,0,1,0,deny
52160,445,0,0,70,70,0,1,0,1,0,drop
47888,2310,0,0,145,145,0,1,0,1,0,deny
52150,445,0,0,70,70,0,1,0,1,0,drop
52151,445,0,0,70,70,0,1,0,1,0,drop
52146,445,0,0,70,70,0,1,0,1,0,drop
52147,445,0,0,70,70,0,1,0,1,0,drop
52144,445,0,0,70,70,0,1,0,1,0,drop
56445,53,52720,53,198,101,97,2,30,1,1,allow
42135,443,55299,443,6531,1249,5282,24,286,13,11,allow
62228,443,62228,443,296688,57600,239088,332,96,141,191,allow
34366,443,43232,443,1053,566,487,10,16,6,4,allow
42699,5222,6919,5222,420,156,264,7,18,3,4,allow
35052,80,38624,80,350,210,140,6,30,4,2,allow
49341,53,42621,53,198,101,97,2,30,1,1,allow
50022,53,39220,53,174,89,85,2,30,1,1,allow
64631,443,8739,443,8701,3408,5293,48,256,22,26,allow
49332,53,40502,53,281,98,183,4,57,2,2,allow
55046,80,55074,80,1056,682,374,10,16,6,4,allow
11073,3389,11073,3389,4085,1916,2169,21,18,12,9,allow
65115,53,24765,53,186,95,91,2,30,1,1,allow
55975,53,65159,53,190,97,93,2,30,1,1,allow
56326,53,54656,53,170,87,83,2,30,1,1,allow
56830,53,35063,53,752,93,659,2,30,1,1,allow
50881,80,50881,80,13503,1052,12451,23,21,10,13,allow
49699,53,40136,53,266,89,177,4,58,2,2,allow
43108,443,11094,443,3117,1867,1250,19,16,9,10,allow
59416,443,46812,443,2834,1700,1134,16,15,8,8,allow
55598,41565,5694,41565,70,70,0,1,5,1,0,allow
49643,443,30041,443,1640,1089,551,14,15,8,6,allow
56602,443,27563,443,7942,1953,5989,20,15,11,9,allow
31123,53,31123,53,231,88,143,2,34,1,1,allow
35050,80,51635,80,350,210,140,6,30,4,2,allow
63749,13219,47890,13219,504,382,122,8,15,6,2,allow
50566,443,50394,443,11116,4583,6533,39,256,19,20,allow
56774,39553,19722,39553,66,66,0,1,5,1,0,allow
58508,443,23694,443,3386,1894,1492,20,25,10,10,allow
55286,53,55062,53,188,96,92,2,30,1,1,allow
64235,53,36798,53,194,99,95,2,30,1,1,allow
62229,443,62229,443,211574,21152,190422,236,96,92,144,allow
35051,80,55027,80,350,210,140,6,30,4,2,allow
64850,53,42650,53,192,98,94,2,31,1,1,allow
24608,53,24608,53,209,77,132,2,33,1,1,allow
45202,443,49520,443,15153,8118,7035,45,271,22,23,allow
59415,443,30552,443,2854,1700,1154,16,16,8,8,allow
60884,443,11637,443,7411,3022,4389,26,46,15,11,allow
56601,443,9573,443,7889,1900,5989,20,15,11,9,allow
59829,443,18743,443,182,60,122,4,26,2,2,allow
49644,80,17566,80,2950,601,2349,12,15,6,6,allow
38599,443,40890,443,3605,1648,1957,20,255,10,10,allow
57367,443,24702,443,7498,2799,4699,24,17,13,11,allow
56773,53,6473,53,735,88,647,2,30,1,1,allow
56600,443,35329,443,7941,1952,5989,20,15,11,9,allow
52346,5222,7493,5222,3983,1663,2320,40,151,19,21,allow
56868,53,63238,53,752,93,659,2,30,1,1,allow
64531,53,46731,53,182,93,89,2,30,1,1,allow
63943,53,51755,53,274,90,184,4,56,2,2,allow
50069,53,5416,53,174,89,85,2,30,1,1,allow
34070,53,34070,53,250,108,142,2,30,1,1,allow
65451,53,43825,53,172,88,84,2,31,1,1,allow
64997,53,9569,53,164,84,80,2,31,1,1,allow
64517,53,41007,53,188,96,92,2,31,1,1,allow
57470,55000,8797,55000,726,726,0,12,1200,12,0,allow
64677,53,35002,53,190,97,93,2,31,1,1,allow
56744,53,44320,53,740,93,647,2,31,1,1,allow
60366,443,31619,443,14484,7411,7073,26,60,15,11,allow
56066,53,46856,53,208,106,102,2,30,1,1,allow
49635,53,55370,53,204,104,100,2,30,1,1,allow
54998,53,35657,53,174,89,85,2,31,1,1,allow
49297,53,13905,53,182,93,89,2,31,1,1,allow
64914,53,32177,53,168,86,82,2,31,1,1,allow
56320,53,39261,53,182,93,89,2,31,1,1,allow
64546,53,12738,53,182,93,89,2,31,1,1,allow
64608,53,13914,53,208,106,102,2,31,1,1,allow
57102,53,62083,53,761,100,661,2,31,1,1,allow
64689,53,18910,53,182,93,89,2,31,1,1,allow
54943,60038,0,0,66,66,0,1,90,1,0,allow
64982,53,19403,53,190,97,93,2,31,1,1,allow
57470,35667,24783,35667,132,132,0,3,1200,3,0,allow
65098,53,21613,53,740,93,647,2,31,1,1,allow
65371,53,39965,53,198,101,97,2,31,1,1,allow
64726,53,62108,53,172,88,84,2,31,1,1,allow
55964,443,21962,443,4455,798,3657,17,136,7,10,allow
65513,53,35186,53,190,97,93,2,31,1,1,allow
57470,54154,42196,54154,480,149,331,2,1200,1,1,allow
6881,6881,0,0,62,62,0,1,0,1,0,deny
18655,50584,0,0,62,62,0,1,0,1,0,deny
28973,30188,0,0,66,66,0,1,0,1,0,deny
42237,36237,0,0,66,66,0,1,0,1,0,deny
57414,57470,0,0,146,146,0,1,0,1,0,deny
52560,445,0,0,66,66,0,1,0,1,0,drop
51172,443,45149,443,1472,965,507,13,20,7,6,allow
50153,80,50079,80,41846,1261,40585,45,75,13,32,allow
49332,53,38516,53,281,98,183,4,57,2,2,allow
51413,443,51090,443,63766,32148,31618,103,42,51,52,allow
57150,445,0,0,70,70,0,1,0,1,0,drop
57149,445,0,0,70,70,0,1,0,1,0,drop
26531,37965,0,0,62,62,0,1,0,1,0,deny
24144,57470,0,0,62,62,0,1,0,1,0,deny
61345,21247,0,0,66,66,0,1,0,1,0,deny
53987,57470,0,0,66,66,0,1,0,1,0,deny
52137,445,0,0,70,70,0,1,0,1,0,drop
50784,52952,0,0,62,62,0,1,0,1,0,deny
52913,2767,0,0,66,66,0,1,0,1,0,deny
30114,65151,0,0,60,60,0,1,0,1,0,deny
59879,55783,0,0,66,66,0,1,0,1,0,deny
52555,445,0,0,66,66,0,1,0,1,0,drop
64158,53,28086,53,211,102,109,2,30,1,1,allow
55705,53,50083,53,209,110,99,2,30,1,1,allow
54998,53,11974,53,179,94,85,2,30,1,1,allow
49635,53,17449,53,210,110,100,2,30,1,1,allow
49940,443,15585,443,4363,1298,3065,17,127,8,9,allow
49260,53,30297,53,791,85,706,4,57,2,2,allow
65266,53,28016,53,536,113,423,4,56,2,2,allow
62230,443,62230,443,119850,11021,108829,134,95,50,84,allow
50901,80,56736,80,11091,2772,8319,22,154,12,10,allow
51777,63497,24893,63497,316,136,180,6,6,3,3,allow
51177,443,18641,443,154,94,60,2,4,1,1,allow
64252,53,63394,53,381,101,280,4,43,2,2,allow
65040,53,46633,53,180,94,86,2,29,1,1,allow
64999,53,64999,53,230,90,140,2,30,1,1,allow
49228,443,49228,443,32952,11546,21406,60,71,36,24,allow
60775,443,60775,443,4652,1745,2907,19,29,11,8,allow
59978,443,59552,443,10132,5161,4971,42,15,25,17,allow
49175,53,11847,53,193,102,91,2,29,1,1,allow
60749,40010,57224,40010,316,136,180,6,5,3,3,allow
64711,53,52164,53,178,94,84,2,29,1,1,allow
35370,443,45689,443,87183,4177,83006,104,126,34,70,allow
57139,53,34151,53,166,86,80,2,29,1,1,allow
55747,53,57229,53,215,102,113,2,29,1,1,allow
65040,53,64566,53,180,94,86,2,29,1,1,allow
65469,53,34501,53,195,102,93,2,29,1,1,allow
64956,53,13763,53,565,92,473,4,38,2,2,allow
55705,53,38579,53,209,110,99,2,29,1,1,allow
55634,53,37153,53,210,110,100,2,30,1,1,allow
53555,57861,41718,57861,492,306,186,8,15,5,3,allow
55286,53,58993,53,194,102,92,2,29,1,1,allow
57139,53,51563,53,166,86,80,2,30,1,1,allow
55517,53,64032,53,179,94,85,2,29,1,1,allow
49341,53,19411,53,199,102,97,2,29,1,1,allow
51779,3389,21341,3389,62242217,4119315,58122902,123738,4772,43917,79821,allow
2070,53,2070,53,233,90,143,2,32,1,1,allow
36074,80,23733,80,1158,792,366,10,17,6,4,allow
59977,443,64573,443,7971,2647,5324,38,15,24,14,allow
50203,80,15124,80,4020,1978,2042,16,66,9,7,allow
64079,53,36707,53,232,94,138,2,30,1,1,allow
49332,53,50877,53,281,98,183,4,57,2,2,allow
46590,443,20776,443,6665,1130,5535,24,287,13,11,allow
50307,443,50307,443,4378,1471,2907,19,30,11,8,allow
57127,53,41259,53,195,102,93,2,30,1,1,allow
60886,443,34294,443,3855,2679,1176,28,45,15,13,allow
39821,443,37984,443,11179,7205,3974,47,136,26,21,allow
51171,443,60392,443,1532,965,567,14,20,7,7,allow
49367,53,7025,53,548,112,436,4,36,2,2,allow
34239,80,12111,80,1056,682,374,10,15,6,4,allow
63226,443,50931,443,4462,2023,2439,33,125,17,16,allow
64986,53,27800,53,180,94,86,2,30,1,1,allow
55597,7485,34248,7485,70,70,0,1,5,1,0,allow
8984,443,5920,443,13750,4934,8816,64,167,31,33,allow
25776,53,25776,53,233,90,143,2,32,1,1,allow
56167,53,17314,53,178,94,84,2,30,1,1,allow
60405,443,60867,443,6570,1988,4582,19,57,10,9,allow
45564,443,3708,443,69614,5520,64094,100,21,52,48,allow
64739,53,12107,53,172,94,78,2,30,1,1,allow
50149,80,19755,80,78701,4331,74370,77,75,21,56,allow
49920,80,51045,80,3649288,78688,3570600,2923,179,528,2395,allow
57416,53,2716,53,193,102,91,2,30,1,1,allow
65048,53,32798,53,194,102,92,2,30,1,1,allow
63998,53,51868,53,263,126,137,2,30,1,1,allow
64531,53,41084,53,183,94,89,2,30,1,1,allow
49983,53,57759,53,211,110,101,2,30,1,1,allow
64388,53,48927,53,248,102,146,2,30,1,1,allow
49820,53,40891,53,211,102,109,2,30,1,1,allow
64126,53,25754,53,255,102,153,2,30,1,1,allow
60887,443,40935,443,3795,2679,1116,27,45,15,12,allow
45174,443,32047,443,6196,1417,4779,21,665,11,10,allow
43120,80,4226,80,1151,711,440,10,15,5,5,allow
50419,80,40888,80,3664,1440,2224,12,23,6,6,allow
50193,443,31534,443,2404,1121,1283,14,115,7,7,allow
63943,53,16297,53,258,90,168,4,56,2,2,allow
49777,53,60241,53,272,84,188,4,60,2,2,allow
50069,53,27415,53,179,94,85,2,30,1,1,allow
49369,53,21146,53,183,94,89,2,30,1,1,allow
49297,53,2852,53,183,94,89,2,30,1,1,allow
57139,53,32218,53,166,86,80,2,30,1,1,allow
54998,53,33990,53,179,94,85,2,30,1,1,allow
60875,443,9147,443,45373,35377,9996,88,72,48,40,allow
56782,49135,47020,49135,70,70,0,2,8,2,0,allow
60278,80,27803,80,1422,734,688,7,99,4,3,allow
55563,53,20716,53,290,118,172,2,30,1,1,allow
65140,53,14760,53,752,110,642,2,30,1,1,allow
56167,53,49116,53,178,94,84,2,30,1,1,allow
59717,443,16330,443,303966,26201,277765,521,167,208,313,allow
61592,443,6581,443,19544,8237,11307,29,121,13,16,allow
47817,443,11040,443,18158,2080,16078,34,122,19,15,allow
51414,443,43551,443,78740,40216,38524,126,42,66,60,allow
45633,80,23400,80,1573,702,871,12,45,7,5,allow
46341,443,54451,443,9172,3518,5654,39,103,21,18,allow
56521,443,48766,443,8760,3693,5067,20,90,12,8,allow
49699,53,32857,53,266,89,177,4,58,2,2,allow
46974,443,29237,443,5861,1151,4710,18,34,10,8,allow
56552,53,47161,53,195,102,93,2,29,1,1,allow
50016,80,57935,80,827,687,140,6,32,4,2,allow
56071,53,60998,53,193,102,91,2,29,1,1,allow
64986,53,30082,53,180,94,86,2,30,1,1,allow
53447,80,56181,80,1517,481,1036,11,15,6,5,allow
57134,53,48452,53,178,94,84,2,30,1,1,allow
51769,19165,28138,19165,70,70,0,2,8,2,0,allow
65179,53,52575,53,184,94,90,2,30,1,1,allow
55595,33677,1152,33677,210,140,70,4,14,3,1,allow
49341,53,41507,53,199,102,97,2,30,1,1,allow
53537,34901,47127,34901,672,426,246,11,21,7,4,allow
65115,53,52563,53,193,102,91,2,30,1,1,allow
62234,443,62234,443,187597,6822,180775,203,92,67,136,allow
64213,53,34758,53,342,105,237,4,53,2,2,allow
55286,53,38062,53,194,102,92,2,29,1,1,allow
63747,80,64940,80,314,192,122,6,15,4,2,allow
49384,53,28172,53,181,94,87,2,29,1,1,allow
64252,53,2109,53,199,102,97,2,29,1,1,allow
49699,53,7442,53,266,89,177,4,58,2,2,allow
64438,53,9645,53,184,94,90,2,29,1,1,allow
65185,53,26657,53,453,186,267,6,30,3,3,allow
49361,53,37385,53,184,94,90,2,29,1,1,allow
56402,53,29838,53,322,134,188,2,30,1,1,allow
57416,53,8404,53,193,102,91,2,29,1,1,allow
55955,53,39332,53,164,86,78,2,30,1,1,allow
64997,53,31899,53,166,86,80,2,30,1,1,allow
65179,53,63378,53,184,94,90,2,31,1,1,allow
50022,53,26770,53,179,94,85,2,31,1,1,allow
65179,53,56146,53,184,94,90,2,30,1,1,allow
58080,3389,58080,3389,3564,1850,1714,18,32,10,8,allow
55664,53,37409,53,195,102,93,2,30,1,1,allow
64546,53,39505,53,183,94,89,2,31,1,1,allow
49945,53,3434,53,281,97,184,4,57,2,2,allow
64124,80,34060,80,1517,481,1036,11,15,6,5,allow
60883,443,40215,443,11586,5435,6151,46,46,25,21,allow
42790,443,55460,443,13859,3232,10627,50,256,21,29,allow
54932,443,37338,443,84306,6712,77594,156,236,58,98,allow
59814,443,30492,443,1560,977,583,15,30,8,7,allow
36811,80,46728,80,1475,837,638,10,15,5,5,allow
50423,80,33009,80,23470,2457,21013,31,22,13,18,allow
49369,53,36980,53,183,94,89,2,30,1,1,allow
56641,53,52292,53,453,186,267,6,30,3,3,allow
40926,53,16373,53,168,78,90,2,30,1,1,allow
57127,53,41835,53,195,102,93,2,30,1,1,allow
59089,443,40663,443,77560,5020,72540,93,121,34,59,allow
52221,443,62267,443,4567,717,3850,17,148,7,10,allow
60885,443,21890,443,3855,2679,1176,28,45,15,13,allow
56784,23140,27615,23140,70,70,0,1,5,1,0,allow
64783,53,41526,53,561,99,462,4,38,2,2,allow
63227,443,37596,443,1373,734,639,17,125,10,7,allow
56759,53,42507,53,338,118,220,2,30,1,1,allow
55937,53,58356,53,179,94,85,2,30,1,1,allow
57268,53,42841,53,205,94,111,2,30,1,1,allow
56167,53,4828,53,178,94,84,2,30,1,1,allow
64850,53,49939,53,196,102,94,2,30,1,1,allow
55955,53,59392,53,164,86,78,2,30,1,1,allow
65522,53,17756,53,1281,94,1187,2,30,1,1,allow
57323,53,57323,53,216,98,118,2,30,1,1,allow
64859,53,0,0,220,81,139,2,30,1,1,allow
37168,443,5501,443,4871,923,3948,19,360,10,9,allow
56932,53,30512,53,172,94,78,2,30,1,1,allow
55975,53,39571,53,195,102,93,2,30,1,1,allow
31710,53,31710,53,233,90,143,2,32,1,1,allow
60195,80,59592,80,70,70,0,1,5,1,0,allow
56775,20617,21189,20617,70,70,0,1,5,1,0,allow
51752,31677,14033,31677,70,70,0,1,5,1,0,allow
52194,80,42397,80,1151,711,440,10,15,5,5,allow
57134,53,29907,53,178,94,84,2,30,1,1,allow
49229,53,43907,53,178,94,84,2,30,1,1,allow
56326,53,34552,53,177,94,83,2,30,1,1,allow
55634,53,10243,53,210,110,100,2,30,1,1,allow
64303,53,3497,53,212,102,110,2,30,1,1,allow
49478,53,25544,53,172,94,78,2,30,1,1,allow
51459,53,51459,53,256,114,142,2,30,1,1,allow
42758,123,49346,123,184,94,90,2,30,1,1,allow
64235,53,18011,53,197,102,95,2,30,1,1,allow
65231,53,2677,53,200,102,98,2,30,1,1,allow
52088,53,34492,53,168,78,90,2,30,1,1,allow
59475,53,33895,53,179,86,93,2,30,1,1,allow
65451,53,9414,53,178,94,84,2,30,1,1,allow
49635,53,59666,53,210,110,100,2,30,1,1,allow
50022,53,51786,53,179,94,85,2,30,1,1,allow
55664,53,32292,53,195,102,93,2,30,1,1,allow
65371,53,1608,53,199,102,97,2,30,1,1,allow
65424,53,5090,53,210,110,100,2,31,1,1,allow
65513,53,29862,53,195,102,93,2,31,1,1,allow
65048,53,7806,53,194,102,92,2,30,1,1,allow
56066,53,20182,53,212,110,102,2,30,1,1,allow
56418,53,19002,53,183,94,89,2,30,1,1,allow
49442,53,40025,53,198,94,104,2,31,1,1,allow
64850,53,36878,53,196,102,94,2,31,1,1,allow
64677,53,46523,53,195,102,93,2,31,1,1,allow
65451,53,7550,53,178,94,84,2,31,1,1,allow
35685,443,31847,443,2967,876,2091,11,120,5,6,allow
64011,443,26030,443,4196,1407,2789,19,135,9,10,allow
33814,443,5866,443,8601,2870,5731,40,225,22,18,allow
56288,53,49732,53,183,94,89,2,31,1,1,allow
49631,443,48718,443,8558,1006,7552,16,121,7,9,allow
38659,443,10582,443,11202,2200,9002,39,131,20,19,allow
6881,6881,52538,6881,118,118,0,1,1200,1,0,allow
37965,20926,65479,20926,481,150,331,2,1199,1,1,allow
48991,80,63971,80,121475,5644,115831,163,145,81,82,allow
56418,53,28996,53,183,94,89,2,31,1,1,allow
65115,53,25677,53,368,95,273,4,61,2,2,allow
57415,443,15579,443,28216,10325,17891,93,23,42,51,allow
44928,443,35200,443,9345,2224,7121,40,112,22,18,allow
43227,443,48195,443,460628,23936,436692,580,124,264,316,allow
58190,53,48181,53,648,86,562,4,51,2,2,allow
60538,80,60538,80,318,120,198,6,26,3,3,allow
53915,443,38797,443,7917,2410,5507,32,26,18,14,allow
54998,53,29340,53,438,89,349,4,60,2,2,allow
49424,53,11040,53,198,102,96,2,33,1,1,allow
60539,80,60539,80,318,120,198,6,26,3,3,allow
48892,443,58975,443,740,210,530,12,110,4,8,allow
64055,53,48031,53,501,94,407,4,52,2,2,allow
56656,53,3129,53,255,88,167,4,53,2,2,allow
57351,62413,0,0,62,62,0,1,0,1,0,deny
61616,23,0,0,60,60,0,1,0,1,0,deny
52552,445,0,0,66,66,0,1,0,1,0,drop
57140,445,0,0,70,70,0,1,0,1,0,drop
59585,36237,0,0,62,62,0,1,0,1,0,deny
52128,445,0,0,70,70,0,1,0,1,0,drop
57132,445,0,0,70,70,0,1,0,1,0,drop
57130,445,0,0,70,70,0,1,0,1,0,drop
57129,445,0,0,70,70,0,1,0,1,0,drop
52126,445,0,0,70,70,0,1,0,1,0,drop
52549,445,0,0,66,66,0,1,0,1,0,drop
80,37649,0,0,60,60,0,1,0,1,0,deny
20726,2767,0,0,66,66,0,1,0,1,0,deny
11816,50584,0,0,66,66,0,1,0,1,0,deny
80,53945,0,0,60,60,0,1,0,1,0,deny
52121,445,0,0,70,70,0,1,0,1,0,drop
7275,39827,0,0,74,74,0,1,0,1,0,deny
57123,445,0,0,70,70,0,1,0,1,0,drop
60292,7129,0,0,62,62,0,1,0,1,0,deny
52120,445,0,0,70,70,0,1,0,1,0,drop
57121,445,0,0,70,70,0,1,0,1,0,drop
57119,445,0,0,70,70,0,1,0,1,0,drop
57117,445,0,0,70,70,0,1,0,1,0,drop
52543,445,0,0,66,66,0,1,0,1,0,drop
25360,51505,0,0,66,66,0,1,0,1,0,deny
32215,22114,0,0,66,66,0,1,0,1,0,deny
54276,39004,0,0,66,66,0,1,0,1,0,deny
52537,445,0,0,66,66,0,1,0,1,0,drop
52536,445,0,0,66,66,0,1,0,1,0,drop
52534,445,0,0,66,66,0,1,0,1,0,drop
12283,25773,0,0,139,139,0,1,0,1,0,reset-both
1024,64147,0,0,62,62,0,1,0,1,0,deny
52116,445,0,0,70,70,0,1,0,1,0,drop
52531,445,0,0,66,66,0,1,0,1,0,drop
52533,445,0,0,66,66,0,1,0,1,0,drop
52532,445,0,0,66,66,0,1,0,1,0,drop
59023,64097,0,0,66,66,0,1,0,1,0,deny
43457,31573,0,0,146,146,0,1,0,1,0,deny
53355,23117,0,0,66,66,0,1,0,1,0,deny
52115,445,0,0,70,70,0,1,0,1,0,drop
53053,64147,0,0,66,66,0,1,0,1,0,deny
80,9918,0,0,60,60,0,1,0,1,0,deny
37577,443,55436,443,499,425,74,4,0,3,1,allow
37580,443,1520,443,499,425,74,4,0,3,1,allow
37578,443,38222,443,499,425,74,4,0,3,1,allow
37579,443,43995,443,499,425,74,4,0,3,1,allow
37576,443,42873,443,499,425,74,4,0,3,1,allow
37575,443,28180,443,499,425,74,4,0,3,1,allow
62780,35440,0,0,66,66,0,1,0,1,0,deny
57116,445,0,0,70,70,0,1,0,1,0,drop
57114,445,0,0,70,70,0,1,0,1,0,drop
57110,445,0,0,70,70,0,1,0,1,0,drop
52528,445,0,0,66,66,0,1,0,1,0,drop
22683,39210,0,0,60,60,0,1,0,1,0,deny
57108,445,0,0,70,70,0,1,0,1,0,drop
52524,445,0,0,66,66,0,1,0,1,0,drop
11458,2767,0,0,62,62,0,1,0,1,0,deny
26439,37965,0,0,66,66,0,1,0,1,0,deny
52521,445,0,0,66,66,0,1,0,1,0,drop
52522,445,0,0,66,66,0,1,0,1,0,drop
52110,445,0,0,70,70,0,1,0,1,0,drop
53475,3389,0,0,62,62,0,1,0,1,0,deny
61043,57470,0,0,78,78,0,1,0,1,0,deny
52519,445,0,0,66,66,0,1,0,1,0,drop
42951,44847,0,0,66,66,0,1,0,1,0,deny
12232,41864,0,0,139,139,0,1,0,1,0,deny
14615,57866,0,0,62,62,0,1,0,1,0,deny
53166,61600,0,0,66,66,0,1,0,1,0,deny
54773,50584,0,0,66,66,0,1,0,1,0,deny
53211,22114,0,0,62,62,0,1,0,1,0,deny
57101,445,0,0,70,70,0,1,0,1,0,drop
57097,445,0,0,70,70,0,1,0,1,0,drop
57094,445,0,0,70,70,0,1,0,1,0,drop
58977,37965,0,0,66,66,0,1,0,1,0,deny
45603,35894,0,0,145,145,0,1,0,1,0,deny
61804,51505,0,0,66,66,0,1,0,1,0,deny
52508,445,0,0,66,66,0,1,0,1,0,drop
52097,445,0,0,70,70,0,1,0,1,0,drop
51196,53,0,0,206,83,123,2,0,1,1,allow
49424,53,32316,53,100,100,0,1,0,1,0,allow
6057,51221,0,0,62,62,0,1,0,1,0,deny
59156,50584,0,0,62,62,0,1,0,1,0,deny
19858,64147,0,0,62,62,0,1,0,1,0,deny
55254,50584,0,0,66,66,0,1,0,1,0,deny
52094,445,0,0,70,70,0,1,0,1,0,drop
21777,50584,0,0,62,62,0,1,0,1,0,deny
60875,56205,0,0,66,66,0,1,0,1,0,deny
52501,445,0,0,66,66,0,1,0,1,0,drop
57080,445,0,0,70,70,0,1,0,1,0,drop
52498,445,0,0,66,66,0,1,0,1,0,drop
52089,445,0,0,70,70,0,1,0,1,0,drop
45964,3111,0,0,60,60,0,1,0,1,0,deny
52088,445,0,0,70,70,0,1,0,1,0,drop
42572,995,0,0,60,60,0,1,0,1,0,deny
39941,995,0,0,60,60,0,1,0,1,0,deny
52086,445,0,0,70,70,0,1,0,1,0,drop
58382,50584,0,0,62,62,0,1,0,1,0,deny
52492,445,0,0,66,66,0,1,0,1,0,drop
52486,445,0,0,66,66,0,1,0,1,0,drop
40547,24051,0,0,74,74,0,1,0,1,0,deny
443,23220,0,0,100,100,0,1,0,1,0,deny
3521,6881,0,0,66,66,0,1,0,1,0,deny
52079,445,0,0,70,70,0,1,0,1,0,drop
5575,8889,5575,8889,497,497,0,1,0,1,0,deny
3225,64147,0,0,62,62,0,1,0,1,0,deny
52077,445,0,0,70,70,0,1,0,1,0,drop
57071,445,0,0,70,70,0,1,0,1,0,drop
57070,445,0,0,70,70,0,1,0,1,0,drop
57068,445,0,0,70,70,0,1,0,1,0,drop
52475,445,0,0,66,66,0,1,0,1,0,drop
52476,445,0,0,66,66,0,1,0,1,0,drop
52474,445,0,0,66,66,0,1,0,1,0,drop
52469,445,0,0,66,66,0,1,0,1,0,drop
52470,445,0,0,66,66,0,1,0,1,0,drop
52473,445,0,0,66,66,0,1,0,1,0,drop
52472,445,0,0,66,66,0,1,0,1,0,drop
52471,445,0,0,66,66,0,1,0,1,0,drop
46093,32661,0,0,74,74,0,1,0,1,0,deny
52076,445,0,0,70,70,0,1,0,1,0,drop
63670,64097,0,0,66,66,0,1,0,1,0,deny
52075,445,0,0,70,70,0,1,0,1,0,drop
52074,445,0,0,70,70,0,1,0,1,0,drop
52068,445,0,0,70,70,0,1,0,1,0,drop
52067,445,0,0,70,70,0,1,0,1,0,drop
27368,22114,0,0,62,62,0,1,0,1,0,deny
49516,35894,0,0,62,62,0,1,0,1,0,deny
52055,445,0,0,70,70,0,1,0,1,0,drop
52054,445,0,0,70,70,0,1,0,1,0,drop
52049,445,0,0,70,70,0,1,0,1,0,drop
1284,50584,0,0,62,62,0,1,0,1,0,deny
57063,445,0,0,70,70,0,1,0,1,0,drop
57057,445,0,0,70,70,0,1,0,1,0,drop
57056,445,0,0,70,70,0,1,0,1,0,drop
20844,64147,0,0,66,66,0,1,0,1,0,deny
52045,445,0,0,70,70,0,1,0,1,0,drop
52044,445,0,0,70,70,0,1,0,1,0,drop
62678,57470,0,0,62,62,0,1,0,1,0,deny
64788,43890,0,0,62,62,0,1,0,1,0,deny
52456,445,0,0,66,66,0,1,0,1,0,drop
52455,445,0,0,66,66,0,1,0,1,0,drop
52453,445,0,0,66,66,0,1,0,1,0,drop
64406,50584,0,0,66,66,0,1,0,1,0,deny
57452,57470,0,0,62,62,0,1,0,1,0,deny
36881,56205,0,0,146,146,0,1,0,1,0,deny
57050,445,0,0,70,70,0,1,0,1,0,drop
49800,5900,0,0,60,60,0,1,0,1,0,deny
52749,64147,0,0,66,66,0,1,0,1,0,deny
30307,51505,0,0,62,62,0,1,0,1,0,deny
57048,445,0,0,70,70,0,1,0,1,0,drop
57043,445,0,0,70,70,0,1,0,1,0,drop
57038,445,0,0,70,70,0,1,0,1,0,drop
57039,445,0,0,70,70,0,1,0,1,0,drop
59523,37965,0,0,62,62,0,1,0,1,0,deny
52033,445,0,0,70,70,0,1,0,1,0,drop
46495,4607,0,0,60,60,0,1,0,1,0,deny
29623,37807,0,0,62,62,0,1,0,1,0,deny
8910,62413,0,0,146,146,0,1,0,1,0,deny
55045,53,38947,53,747,92,655,2,30,1,1,allow
54854,443,6189,443,32544,28348,4196,63,332,31,32,allow
5530,80,5530,80,514,246,268,9,91,5,4,allow
43107,443,43113,443,3051,1801,1250,18,16,8,10,allow
50497,443,10813,443,1642025,26957,1615068,1478,17,406,1072,allow
49897,80,15304,80,188,128,60,3,15,2,1,allow
137,137,20437,137,384,384,0,5,51,5,0,allow
56418,53,62864,53,182,93,89,2,30,1,1,allow
55337,53,11833,53,294,106,188,4,56,2,2,allow
58215,443,23391,443,7337,1630,5707,23,256,12,11,allow
51768,61765,18579,61765,70,70,0,2,8,2,0,allow
51751,55855,62891,55855,66,66,0,1,5,1,0,allow
51749,1408,5548,1408,66,66,0,1,5,1,0,allow
55540,53,5728,53,757,98,659,2,31,1,1,allow
50128,53,3916,53,757,98,659,2,30,1,1,allow
59850,443,34758,443,10260,1360,8900,22,18,7,15,allow
63745,39800,55951,39800,504,382,122,8,16,6,2,allow
56376,53,45759,53,196,100,96,2,30,1,1,allow
59800,443,57363,443,94202,5247,88955,115,37,41,74,allow
59846,443,17762,443,23856,3218,20638,40,18,16,24,allow
59849,443,38799,443,8368,1360,7008,19,18,7,12,allow
60962,443,57911,443,50093,8331,41762,75,48,36,39,allow
47822,80,47822,80,1435,1293,142,5,15,3,2,allow
63750,63343,14942,63343,66,66,0,1,5,1,0,allow
56656,53,54597,53,255,88,167,4,53,2,2,allow
59838,443,12869,443,5520,3416,2104,27,22,13,14,allow
45268,443,29338,443,7503,2345,5158,34,256,17,17,allow
60537,80,60537,80,318,120,198,6,25,3,3,allow
56288,53,56709,53,182,93,89,2,31,1,1,allow
59409,443,2486,443,7775,3174,4601,25,16,11,14,allow
59839,443,29303,443,93467,4007,89460,107,22,33,74,allow
56772,61424,62775,61424,66,66,0,1,5,1,0,allow
59725,443,1736,443,89790,6036,83754,112,55,41,71,allow
47150,9339,62687,9339,179194,19657,159537,415,149,202,213,allow
64327,53,64327,53,243,100,143,2,30,1,1,allow
59845,443,19704,443,14702,1976,12726,28,18,10,18,allow
57342,80,40590,80,1056,682,374,10,15,6,4,allow
49631,443,7469,443,11772,5416,6356,25,49,15,10,allow
48556,80,48556,80,19225,817,18408,29,15,13,16,allow
59835,443,54646,443,13306,9499,3807,32,23,17,15,allow
53112,29258,48583,29258,70,70,0,1,5,1,0,allow
4009,53,4009,53,231,88,143,2,33,1,1,allow
54204,443,50779,443,18159,12786,5373,34,270,19,15,allow
59905,443,62793,443,21212,14546,6666,43,362,24,19,allow
42881,443,61289,443,28707,2793,25914,58,115,29,29,allow
49625,443,57635,443,4252,726,3526,13,16,7,6,allow
60391,47212,11970,47212,164,70,94,2,5,1,1,allow
60392,1134,49045,1134,70,70,0,1,5,1,0,allow
61645,443,61645,443,4702,1795,2907,19,28,11,8,allow
39611,443,31755,443,234,234,0,4,12,4,0,allow
55394,53,55394,53,197,76,121,2,30,1,1,allow
65159,53,15273,53,286,103,183,4,52,2,2,allow
64811,53,2888,53,186,95,91,2,30,1,1,allow
64706,53,4952,53,174,89,85,2,30,1,1,allow
55664,53,44957,53,190,97,93,2,30,1,1,allow
49672,53,36267,53,761,100,661,2,30,1,1,allow
33845,53,0,0,82,82,0,1,30,1,0,allow
65372,53,1041,53,196,100,96,2,31,1,1,allow
58035,80,30742,80,100364,4917,95447,133,241,67,66,allow
5938,6987,0,0,60,60,0,1,90,1,0,allow
57614,443,56701,443,25824,14215,11609,65,757,32,33,allow
6882,6889,43478,6889,221,111,110,2,1200,1,1,allow
54677,5228,25400,5228,6679,2730,3949,43,4309,23,20,allow
46844,53,0,0,82,82,0,1,31,1,0,allow
56727,53,26195,53,762,101,661,2,31,1,1,allow
56458,53,36864,53,192,98,94,2,31,1,1,allow
60593,80,31498,80,123436,6053,117383,165,241,83,82,allow
64840,53,31006,53,186,95,91,2,31,1,1,allow
56924,53,30417,53,216,110,106,2,31,1,1,allow
54489,443,33538,443,4263,2019,2244,14,136,7,7,allow
50584,55727,63781,55727,2268,1050,1218,15,5442,8,7,allow
30960,45686,49488,45686,330,330,0,6,3609,6,0,allow
12605,57470,0,0,62,62,0,1,0,1,0,deny
12821,37965,0,0,66,66,0,1,0,1,0,deny
21274,30188,0,0,62,62,0,1,0,1,0,deny
52029,445,0,0,70,70,0,1,0,1,0,drop
51685,57470,0,0,66,66,0,1,0,1,0,deny
62859,35440,0,0,66,66,0,1,0,1,0,deny
56526,443,61934,443,7563,3697,3866,19,15,10,9,allow
29363,443,29363,443,29861,6027,23834,65,37,34,31,allow
57028,445,0,0,70,70,0,1,0,1,0,drop
57026,445,0,0,70,70,0,1,0,1,0,drop
57024,445,0,0,70,70,0,1,0,1,0,drop
64051,36829,0,0,66,66,0,1,0,1,0,deny
52019,445,0,0,70,70,0,1,0,1,0,drop
52020,445,0,0,70,70,0,1,0,1,0,drop
58468,37965,0,0,66,66,0,1,0,1,0,deny
5914,10214,0,0,100,100,0,1,0,1,0,deny
6889,41864,0,0,143,143,0,1,0,1,0,deny
52016,445,0,0,70,70,0,1,0,1,0,drop
52015,445,0,0,70,70,0,1,0,1,0,drop
57165,34101,0,0,62,62,0,1,0,1,0,deny
43671,37965,0,0,62,62,0,1,0,1,0,deny
52012,445,0,0,70,70,0,1,0,1,0,drop
30496,57470,0,0,62,62,0,1,0,1,0,deny
50143,35253,0,0,66,66,0,1,0,1,0,deny
52433,445,0,0,66,66,0,1,0,1,0,drop
1025,35447,0,0,62,62,0,1,0,1,0,deny
57022,445,0,0,70,70,0,1,0,1,0,drop
57021,445,0,0,70,70,0,1,0,1,0,drop
65209,57866,0,0,66,66,0,1,0,1,0,deny
55286,37965,0,0,66,66,0,1,0,1,0,deny
52007,445,0,0,70,70,0,1,0,1,0,drop
6666,6379,0,0,60,60,0,1,0,1,0,deny
26332,57470,0,0,62,62,0,1,0,1,0,deny
52427,445,0,0,66,66,0,1,0,1,0,drop
51999,445,0,0,70,70,0,1,0,1,0,drop
52424,445,0,0,66,66,0,1,0,1,0,drop
51998,445,0,0,70,70,0,1,0,1,0,drop
57010,445,0,0,70,70,0,1,0,1,0,drop
52676,53733,0,0,62,62,0,1,0,1,0,deny
57004,445,0,0,70,70,0,1,0,1,0,drop
57002,445,0,0,70,70,0,1,0,1,0,drop
57001,445,0,0,70,70,0,1,0,1,0,drop
4594,35993,0,0,62,62,0,1,0,1,0,deny
32892,23,0,0,60,60,0,1,0,1,0,deny
56380,80,20906,80,1466,729,737,12,16,7,5,allow
44410,443,17016,443,2359,1436,923,18,38,10,8,allow
64914,53,27750,53,168,86,82,2,30,1,1,allow
56320,53,53678,53,183,94,89,2,30,1,1,allow
51103,53,0,0,174,77,97,2,30,1,1,allow
35991,443,1116,443,10857,4247,6610,27,121,13,14,allow
49332,53,28193,53,281,98,183,4,56,2,2,allow
64235,53,30515,53,321,99,222,4,52,2,2,allow
5234,28162,61929,28162,449555,320,449235,719,50,6,713,allow
60536,80,60536,80,318,120,198,6,25,3,3,allow
51770,37237,29637,37237,316,136,180,6,6,3,3,allow
58682,80,4123,80,1345,726,619,16,362,8,8,allow
55337,53,8346,53,294,106,188,4,56,2,2,allow
48893,443,17087,443,16227,2037,14190,40,109,19,21,allow
56656,53,41327,53,255,88,167,4,52,2,2,allow
49888,443,12324,443,1072526,64733,1007793,1501,232,690,811,allow
57417,443,11340,443,43052,2466,40586,64,18,21,43,allow
55337,53,22307,53,294,106,188,4,55,2,2,allow
47264,443,35933,443,7201,3870,3331,33,315,17,16,allow
63943,53,24441,53,509,176,333,6,56,3,3,allow
58704,80,26628,80,4115,3452,663,13,15,7,6,allow
55719,8060,30409,8060,70,70,0,2,7,2,0,allow
56816,80,41001,80,420340,15216,405124,441,376,163,278,allow
60004,443,3185,443,134,60,74,3,4,2,1,allow
49699,53,17835,53,266,89,177,4,58,2,2,allow
65424,53,57166,53,210,110,100,2,29,1,1,allow
60535,80,60535,80,318,120,198,6,25,3,3,allow
64546,53,11850,53,183,94,89,2,29,1,1,allow
48012,443,51500,443,1429,1295,134,10,29,8,2,allow
51137,80,51137,80,66992,5462,61530,79,26,30,49,allow
56425,80,34044,80,17188,1559,15629,25,31,10,15,allow
64914,53,63909,53,86,86,0,1,29,1,0,allow
56656,53,40908,53,255,88,167,4,53,2,2,allow
64982,53,7068,53,321,97,224,4,57,2,2,allow
28122,443,63914,443,7808,2487,5321,34,446,16,18,allow
123,123,44322,123,184,94,90,2,29,1,1,allow
65159,53,20643,53,286,103,183,4,51,2,2,allow
64939,53,4454,53,199,94,105,2,29,1,1,allow
64531,53,56972,53,183,94,89,2,29,1,1,allow
55931,53,41701,53,294,118,176,2,29,1,1,allow
61041,53,61041,53,214,90,124,2,29,1,1,allow
65532,53,19828,53,819,102,717,2,30,1,1,allow
64689,53,34039,53,183,94,89,2,30,1,1,allow
55372,53,7739,53,448,184,264,6,30,3,3,allow
59811,443,39338,443,36149,11297,24852,56,29,25,31,allow
53209,443,56508,443,11086,2564,8522,42,186,21,21,allow
50945,80,50945,80,78911,2499,76412,88,26,32,56,allow
55013,53,33517,53,821,102,719,2,30,1,1,allow
65168,53,45025,53,749,94,655,2,30,1,1,allow
64982,53,35426,53,195,102,93,2,30,1,1,allow
50165,53,36668,53,211,78,133,2,30,1,1,allow
59416,443,53026,443,10642,3654,6988,26,125,14,12,allow
49830,443,7649,443,6131,1960,4171,18,15,10,8,allow
55013,53,27966,53,198,102,96,2,30,1,1,allow
64823,53,7121,53,199,102,97,2,31,1,1,allow
49418,27015,10254,27015,78,78,0,1,30,1,0,allow
64982,53,7315,53,195,102,93,2,30,1,1,allow
64689,53,48296,53,183,94,89,2,30,1,1,allow
49748,53,20050,53,763,102,661,2,30,1,1,allow
51767,59158,21535,59158,70,70,0,2,8,2,0,allow
12116,53,12116,53,214,82,132,2,33,1,1,allow
64608,53,12446,53,212,110,102,2,30,1,1,allow
50367,53,23115,53,198,102,96,2,30,1,1,allow
56403,443,35663,443,24745,1926,22819,39,170,18,21,allow
51008,80,51008,80,114613,6365,108248,134,26,51,83,allow
56339,53,35770,53,280,78,202,2,30,1,1,allow
56320,53,14969,53,183,94,89,2,30,1,1,allow
56288,53,30293,53,183,94,89,2,30,1,1,allow
64677,53,6467,53,195,102,93,2,30,1,1,allow
50291,53,32259,53,86,86,0,1,30,1,0,allow
49418,27017,44700,27017,78,78,0,1,30,1,0,allow
55038,443,25937,443,11429,4904,6525,33,156,18,15,allow
28064,53,28064,53,233,90,143,2,32,1,1,allow
56023,53,4937,53,338,106,232,4,37,2,2,allow
50880,80,50880,80,163985,6578,157407,188,26,72,116,allow
47400,80,1203,80,1052,612,440,10,15,5,5,allow
49297,53,48060,53,183,94,89,2,30,1,1,allow
5405,53,5405,53,645,90,555,2,30,1,1,allow
5284,53,5284,53,178,82,96,2,30,1,1,allow
64703,53,15968,53,314,92,222,4,31,2,2,allow
61938,443,14944,443,7118,2462,4656,18,75,10,8,allow
49346,53,23031,53,228,110,118,2,30,1,1,allow
64608,53,62804,53,212,110,102,2,30,1,1,allow
64726,53,39418,53,178,94,84,2,30,1,1,allow
56376,53,65133,53,198,102,96,2,30,1,1,allow
44929,443,17835,443,554,280,274,9,111,5,4,allow
50916,80,44611,80,11456216,116932,11339284,9298,139,1683,7615,allow
49267,443,42451,443,19851,15702,4149,63,109,34,29,allow
55337,53,17571,53,294,106,188,4,56,2,2,allow
59813,443,22135,443,23244,13793,9451,50,29,26,24,allow
59937,443,7727,443,8852,1428,7424,22,199,11,11,allow
51658,80,26955,80,39464,2150,37314,81,20,26,55,allow
10018,80,16761,80,1052,612,440,10,15,5,5,allow
52513,443,40002,443,5096,810,4286,15,15,8,7,allow
56767,34578,60694,34578,564,318,246,9,16,5,4,allow
51750,54567,46467,54567,70,70,0,1,5,1,0,allow
54410,443,16745,443,7256,1669,5587,27,318,15,12,allow
51266,16103,36869,16103,70,70,0,1,5,1,0,allow
52640,6881,33244,6881,719,413,306,10,14,5,5,allow
65067,53,43932,53,411,115,296,4,38,2,2,allow
52087,443,46518,443,5780,1646,4134,22,15,11,11,allow
37433,443,8364,443,8641,955,7686,19,259,8,11,allow
53521,443,50004,443,130,70,60,2,15,1,1,allow
57948,443,32601,443,5914,1514,4400,23,15,12,11,allow
56609,80,38761,80,234,234,0,4,12,4,0,allow
37385,443,16177,443,8824,2041,6783,34,255,17,17,allow
59936,443,17847,443,34167,3638,30529,50,200,23,27,allow
65048,53,15306,53,297,96,201,4,42,2,2,allow
64680,53,61021,53,808,272,536,8,78,4,4,allow
56932,53,43209,53,172,94,78,2,29,1,1,allow
64811,53,37013,53,193,102,91,2,29,1,1,allow
49635,53,38499,53,210,110,100,2,29,1,1,allow
50688,80,50688,80,167293,8028,159265,186,26,68,118,allow
46625,80,46625,80,51574,3466,48108,63,156,23,40,allow
46899,80,46899,80,82739,3221,79518,91,156,28,63,allow
49845,443,22803,443,10396,4585,5811,38,54,21,17,allow
55664,53,1350,53,195,102,93,2,30,1,1,allow
65159,53,25271,53,286,103,183,4,52,2,2,allow
56326,53,1837,53,177,94,83,2,29,1,1,allow
65115,53,24571,53,193,102,91,2,29,1,1,allow
49945,53,14331,53,281,97,184,4,56,2,2,allow
64706,53,11232,53,179,94,85,2,29,1,1,allow
49099,53,46349,53,238,94,144,2,30,1,1,allow
49297,53,44299,53,183,94,89,2,30,1,1,allow
1926,53,62848,53,210,78,132,2,30,1,1,allow
49589,53,21247,53,198,94,104,2,30,1,1,allow
64726,53,24139,53,178,94,84,2,30,1,1,allow
65186,27126,54671,27126,268,78,190,2,30,1,1,allow
65183,27126,22289,27126,268,78,190,2,30,1,1,allow
49378,53,33691,53,179,86,93,2,30,1,1,allow
50791,53,50791,53,231,90,141,2,30,1,1,allow
48817,64245,48817,64245,481,150,331,2,1200,1,1,allow
57338,80,37762,80,1420,715,705,12,16,7,5,allow
50367,53,53044,53,821,102,719,2,30,1,1,allow
64914,53,55728,53,168,86,82,2,30,1,1,allow
64546,53,29110,53,183,94,89,2,30,1,1,allow
64706,53,5159,53,179,94,85,2,30,1,1,allow
59848,53,28215,53,239,102,137,2,30,1,1,allow
56320,53,53146,53,183,94,89,2,30,1,1,allow
64689,53,60672,53,183,94,89,2,30,1,1,allow
64811,53,21833,53,193,102,91,2,30,1,1,allow
49418,27015,32814,27015,257,78,179,2,30,1,1,allow
59810,443,31870,443,27370,17071,10299,51,30,26,25,allow
53114,32975,31768,32975,70,70,0,2,8,2,0,allow
61716,80,3411,80,9323,5142,4181,23,20,12,11,allow
53108,7003,16327,7003,512,326,186,9,22,6,3,allow
65468,443,32669,443,421329,12430,408899,433,16,152,281,allow
65451,53,45725,53,178,94,84,2,30,1,1,allow
52483,443,4472,443,12863,8410,4453,22,31,13,9,allow
64726,53,25224,53,178,94,84,2,30,1,1,allow
50386,8080,50386,8080,5533,2632,2901,20,46,12,8,allow
64706,53,6789,53,179,94,85,2,30,1,1,allow
64850,53,16958,53,196,102,94,2,30,1,1,allow
64823,53,51719,53,199,102,97,2,30,1,1,allow
49418,27016,64137,27016,270,78,192,2,30,1,1,allow
56376,53,35947,53,198,102,96,2,30,1,1,allow
64608,53,18292,53,212,110,102,2,30,1,1,allow
42112,443,17056,443,11459,2165,9294,29,259,11,18,allow
56773,28093,43311,28093,70,70,0,1,5,1,0,allow
46624,80,46624,80,34504,2526,31978,45,156,16,29,allow
6712,80,6712,80,514,246,268,9,82,5,4,allow
1925,53,9734,53,210,78,132,2,30,1,1,allow
1923,53,53314,53,260,86,174,2,30,1,1,allow
49667,53,65184,53,448,184,264,6,30,3,3,allow
65185,27126,57830,27126,268,78,190,2,30,1,1,allow
65126,53,60546,53,718,94,624,2,30,1,1,allow
58873,53,50618,53,168,78,90,2,30,1,1,allow
65513,53,15039,53,195,102,93,2,31,1,1,allow
58499,123,31733,123,184,94,90,2,30,1,1,allow
48040,53,11212,53,168,78,90,2,30,1,1,allow
64322,53,52794,53,250,94,156,2,30,1,1,allow
49418,27015,15763,27015,248,78,170,2,30,1,1,allow
56376,53,49970,53,198,102,96,2,31,1,1,allow
56458,53,9119,53,196,102,94,2,31,1,1,allow
34726,53,62948,53,168,78,90,2,30,1,1,allow
56953,443,22328,443,7245,1282,5963,16,135,7,9,allow
64517,53,39078,53,194,102,92,2,31,1,1,allow
65167,443,56897,443,4925,2188,2737,36,360,16,20,allow
44847,6882,30467,6882,502,150,352,2,1200,1,1,allow
55877,39578,13811,39578,150,150,0,1,1200,1,0,allow
64997,53,57263,53,166,86,80,2,31,1,1,allow
65532,53,33764,53,196,102,94,2,30,1,1,allow
49566,53,59606,53,200,94,106,2,30,1,1,allow
39785,443,37102,443,7967,2261,5706,18,121,8,10,allow
46013,80,29418,80,134,60,74,3,6,2,1,allow
52034,80,13450,80,4185,3462,723,14,16,7,7,allow
49828,443,20161,443,5927,1644,4283,18,16,10,8,allow
64139,53,9779,53,498,93,405,4,47,2,2,allow
65011,53,37444,53,183,94,89,2,31,1,1,allow
53575,1025,56604,1025,70,70,0,2,8,2,0,allow
50334,53,13800,53,216,110,106,2,30,1,1,allow
65187,27126,30981,27126,268,78,190,2,30,1,1,allow
49893,443,25504,443,617481,41514,575967,856,221,381,475,allow
65371,53,53875,53,356,101,255,4,55,2,2,allow
57221,443,19947,443,7306,2784,4522,22,202,12,10,allow
43895,443,52101,443,1442,721,721,15,199,8,7,allow
55730,53,15730,53,196,102,94,2,30,1,1,allow
64619,53,62516,53,229,94,135,2,30,1,1,allow
65371,53,17018,53,199,102,97,2,30,1,1,allow
52420,445,0,0,66,66,0,1,0,1,0,drop
64776,50584,0,0,62,62,0,1,0,1,0,deny
51992,445,0,0,70,70,0,1,0,1,0,drop
51991,445,0,0,70,70,0,1,0,1,0,drop
19747,37965,0,0,62,62,0,1,0,1,0,deny
57441,57470,0,0,66,66,0,1,0,1,0,deny
56996,445,0,0,70,70,0,1,0,1,0,drop
56993,445,0,0,70,70,0,1,0,1,0,drop
56990,445,0,0,70,70,0,1,0,1,0,drop
56991,445,0,0,70,70,0,1,0,1,0,drop
52472,7302,0,0,66,66,0,1,0,1,0,deny
38848,11119,0,0,146,146,0,1,0,1,0,deny
52415,445,0,0,66,66,0,1,0,1,0,drop
51987,445,0,0,70,70,0,1,0,1,0,drop
53447,44847,0,0,66,66,0,1,0,1,0,deny
61983,50432,0,0,66,66,0,1,0,1,0,deny
52407,445,0,0,66,66,0,1,0,1,0,drop
52412,445,0,0,66,66,0,1,0,1,0,drop
52406,445,0,0,66,66,0,1,0,1,0,drop
59701,44847,0,0,66,66,0,1,0,1,0,deny
20650,26467,0,0,62,62,0,1,0,1,0,deny
52403,445,0,0,66,66,0,1,0,1,0,drop
52405,445,0,0,66,66,0,1,0,1,0,drop
52404,445,0,0,66,66,0,1,0,1,0,drop
51985,445,0,0,70,70,0,1,0,1,0,drop
1227,56205,0,0,66,66,0,1,0,1,0,deny
56987,445,0,0,70,70,0,1,0,1,0,drop
56986,445,0,0,70,70,0,1,0,1,0,drop
56984,445,0,0,70,70,0,1,0,1,0,drop
54140,43890,0,0,66,66,0,1,0,1,0,deny
52439,35894,0,0,70,70,0,1,0,1,0,deny
9092,26672,0,0,60,60,0,1,0,1,0,deny
52399,445,0,0,66,66,0,1,0,1,0,drop
56980,445,0,0,70,70,0,1,0,1,0,drop
51981,445,0,0,70,70,0,1,0,1,0,drop
58248,50584,0,0,62,62,0,1,0,1,0,deny
55074,53,55407,53,770,101,669,2,0,1,1,allow
52397,445,0,0,66,66,0,1,0,1,0,drop
4903,42873,0,0,70,70,0,1,0,1,0,deny
80,37649,0,0,60,60,0,1,0,1,0,deny
52395,445,0,0,66,66,0,1,0,1,0,drop
52393,445,0,0,66,66,0,1,0,1,0,drop
27010,64147,0,0,62,62,0,1,0,1,0,deny
46587,57470,0,0,66,66,0,1,0,1,0,deny
80,53945,0,0,60,60,0,1,0,1,0,deny
63305,62413,0,0,66,66,0,1,0,1,0,deny
52391,445,0,0,66,66,0,1,0,1,0,drop
28839,30188,0,0,62,62,0,1,0,1,0,deny
17315,11392,0,0,66,66,0,1,0,1,0,deny
59411,37965,0,0,62,62,0,1,0,1,0,deny
56973,445,0,0,70,70,0,1,0,1,0,drop
10248,21247,0,0,62,62,0,1,0,1,0,deny
80,9918,0,0,60,60,0,1,0,1,0,deny
14397,37965,0,0,62,62,0,1,0,1,0,deny
56968,445,0,0,70,70,0,1,0,1,0,drop
56965,445,0,0,70,70,0,1,0,1,0,drop
52208,43890,0,0,62,62,0,1,0,1,0,deny
38976,46824,0,0,62,62,0,1,0,1,0,deny
54305,35440,0,0,62,62,0,1,0,1,0,deny
26722,11446,0,0,66,66,0,1,0,1,0,deny
51968,445,0,0,70,70,0,1,0,1,0,drop
63314,57470,0,0,66,66,0,1,0,1,0,deny
52383,445,0,0,66,66,0,1,0,1,0,drop
16293,57470,0,0,62,62,0,1,0,1,0,deny
51965,445,0,0,70,70,0,1,0,1,0,drop
44538,50584,0,0,62,62,0,1,0,1,0,deny
40547,24051,0,0,74,74,0,1,0,1,0,deny
59940,50584,0,0,66,66,0,1,0,1,0,deny
52373,445,0,0,66,66,0,1,0,1,0,drop
33931,50584,0,0,62,62,0,1,0,1,0,deny
65060,35440,0,0,66,66,0,1,0,1,0,deny
56952,445,0,0,70,70,0,1,0,1,0,drop
9957,32480,0,0,66,66,0,1,0,1,0,deny
38645,51221,0,0,62,62,0,1,0,1,0,deny
53437,44847,0,0,66,66,0,1,0,1,0,deny
51961,445,0,0,70,70,0,1,0,1,0,drop
26365,22,0,0,60,60,0,1,0,1,0,deny
55749,37965,0,0,66,66,0,1,0,1,0,deny
33979,23,0,0,60,60,0,1,0,1,0,deny
18545,23,0,0,60,60,0,1,0,1,0,deny
51959,445,0,0,70,70,0,1,0,1,0,drop
46093,32661,0,0,74,74,0,1,0,1,0,deny
52370,445,0,0,66,66,0,1,0,1,0,drop
30129,37965,0,0,72,72,0,1,0,1,0,deny
62804,37965,0,0,66,66,0,1,0,1,0,deny
0,0,0,0,156,156,0,2,0,2,0,allow
0,0,0,0,244,244,0,2,0,2,0,allow
51957,445,0,0,70,70,0,1,0,1,0,drop
64948,25198,0,0,145,145,0,1,0,1,0,deny
8211,28793,0,0,66,66,0,1,0,1,0,deny
53300,37807,0,0,62,62,0,1,0,1,0,deny
60188,15503,0,0,66,66,0,1,0,1,0,deny
52364,445,0,0,66,66,0,1,0,1,0,drop
65512,44847,0,0,66,66,0,1,0,1,0,deny
52361,445,0,0,66,66,0,1,0,1,0,drop
55937,53,29379,53,174,89,85,2,0,1,1,allow
34531,23117,0,0,62,62,0,1,0,1,0,deny
25602,64147,0,0,62,62,0,1,0,1,0,deny
51760,50584,0,0,66,66,0,1,0,1,0,deny
51244,3855,0,0,100,100,0,1,0,1,0,deny
51815,51221,0,0,74,74,0,1,0,1,0,deny
59055,11392,0,0,66,66,0,1,0,1,0,deny
43129,20220,0,0,62,62,0,1,0,1,0,deny
51950,445,0,0,70,70,0,1,0,1,0,drop
6889,48817,0,0,143,143,0,1,0,1,0,deny
51948,445,0,0,70,70,0,1,0,1,0,drop
25091,64147,0,0,66,66,0,1,0,1,0,deny
49628,35440,0,0,66,66,0,1,0,1,0,deny
59128,44847,0,0,66,66,0,1,0,1,0,deny
56945,445,0,0,70,70,0,1,0,1,0,drop
63701,46824,0,0,66,66,0,1,0,1,0,deny
56941,445,0,0,70,70,0,1,0,1,0,drop
56940,445,0,0,70,70,0,1,0,1,0,drop
51947,445,0,0,70,70,0,1,0,1,0,drop
21733,56205,0,0,66,66,0,1,0,1,0,deny
52347,445,0,0,66,66,0,1,0,1,0,drop
52346,445,0,0,66,66,0,1,0,1,0,drop
52345,445,0,0,66,66,0,1,0,1,0,drop
52342,445,0,0,66,66,0,1,0,1,0,drop
52341,445,0,0,66,66,0,1,0,1,0,drop
52344,445,0,0,66,66,0,1,0,1,0,drop
52348,445,0,0,66,66,0,1,0,1,0,drop
52340,445,0,0,66,66,0,1,0,1,0,drop
51946,445,0,0,70,70,0,1,0,1,0,drop
51945,445,0,0,70,70,0,1,0,1,0,drop
50084,26672,0,0,62,62,0,1,0,1,0,deny
51941,445,0,0,70,70,0,1,0,1,0,drop
51939,445,0,0,70,70,0,1,0,1,0,drop
45079,31573,0,0,66,66,0,1,0,1,0,deny
42632,44847,0,0,62,62,0,1,0,1,0,deny
57654,35440,0,0,66,66,0,1,0,1,0,deny
49976,22114,0,0,66,66,0,1,0,1,0,deny
51927,445,0,0,70,70,0,1,0,1,0,drop
51926,445,0,0,70,70,0,1,0,1,0,drop
15131,50584,0,0,62,62,0,1,0,1,0,deny
51923,445,0,0,70,70,0,1,0,1,0,drop
51914,445,0,0,70,70,0,1,0,1,0,drop
51913,445,0,0,70,70,0,1,0,1,0,drop
59732,443,44274,443,34866,3347,31519,55,54,22,33,allow
53572,22754,38870,22754,70,70,0,2,8,2,0,allow
46714,80,46714,80,83777,2610,81167,90,155,27,63,allow
59407,443,31789,443,3298,2132,1166,16,15,8,8,allow
3697,80,55800,80,6688,1208,5480,20,104,12,8,allow
65011,53,38944,53,182,93,89,2,30,1,1,allow
56769,11155,5156,11155,66,66,0,1,5,1,0,allow
51746,17867,44740,17867,136,136,0,3,14,3,0,allow
49768,80,40790,80,254,128,126,5,15,3,2,allow
49825,443,10152,443,15401,3011,12390,37,65,21,16,allow
44796,443,34897,443,8158,2927,5231,25,85,15,10,allow
44776,443,54500,443,10087,4073,6014,33,88,18,15,allow
56628,53,54812,53,789,110,679,2,30,1,1,allow
49580,53,21716,53,192,98,94,2,30,1,1,allow
48790,443,60676,443,7298,2661,4637,21,19,11,10,allow
59405,443,60870,443,9052,2120,6932,28,23,14,14,allow
64613,53,26326,53,89,89,0,1,30,1,0,allow
58006,443,30394,443,9596,1688,7908,26,255,13,13,allow
56598,443,16755,443,8630,2126,6504,20,15,11,9,allow
40764,443,58656,443,3321,1297,2024,13,28,7,6,allow
57064,443,57064,443,4378,1471,2907,19,29,11,8,allow
33317,53,33317,53,231,88,143,2,32,1,1,allow
59795,443,6313,443,120014,7352,112662,155,37,64,91,allow
52458,53,52458,53,231,88,143,2,33,1,1,allow
51765,52862,26786,52862,70,70,0,2,7,2,0,allow
51747,54301,33615,54301,136,136,0,3,14,3,0,allow
53557,39731,45884,39731,70,70,0,1,5,1,0,allow
51145,80,27456,80,78198970,2041652,76157318,79332,368,28698,50634,allow
42105,53,20788,53,168,78,90,2,30,1,1,allow
56597,443,58985,443,8700,2196,6504,21,16,12,9,allow
50317,443,44223,443,13565,6019,7546,35,112,19,16,allow
54506,443,29033,443,89702,83941,5761,91,181,66,25,allow
56857,53,30246,53,711,87,624,2,30,1,1,allow
59340,53,59340,53,215,90,125,2,30,1,1,allow
49996,53,3392,53,182,93,89,2,31,1,1,allow
49418,27015,26473,27015,280,71,209,2,31,1,1,allow
55577,53,64711,53,198,101,97,2,31,1,1,allow
59408,443,57336,443,2914,1780,1134,16,15,8,8,allow
51649,80,42317,80,1965,1402,563,13,16,7,6,allow
50116,22,50116,22,60,60,0,1,5,1,0,allow
40408,1488,40408,1488,156,156,0,3,8,3,0,allow
59808,443,39380,443,23950,2135,21815,43,35,16,27,allow
52920,443,42636,443,6253,2132,4121,19,16,10,9,allow
59847,443,63269,443,21180,2662,18518,34,17,14,20,allow
59788,443,40327,443,134688,7027,127661,166,37,64,102,allow
65312,53,47796,53,180,92,88,2,30,1,1,allow
49418,27015,16562,27015,269,71,198,2,31,1,1,allow
49418,27018,39372,27018,259,71,188,2,31,1,1,allow
52060,443,18866,443,40726,3421,37305,52,121,20,32,allow
60730,443,28797,443,14776,5238,9538,41,175,21,20,allow
55088,53,2549,53,186,95,91,2,31,1,1,allow
51135,443,21022,443,640504,257235,383269,1476,797,643,833,allow
44219,443,26012,443,35920,26656,9264,60,128,30,30,allow
40893,123,36091,123,184,94,90,2,31,1,1,allow
49418,27018,26196,27018,71,71,0,1,31,1,0,allow
49418,27017,43664,27017,259,71,188,2,31,1,1,allow
49418,27018,46953,27018,249,71,178,2,31,1,1,allow
57949,5228,62651,5228,2655,1540,1115,19,3601,9,10,allow
54316,53,0,0,325,77,248,2,31,1,1,allow
49418,27020,19032,27020,246,71,175,2,31,1,1,allow
49418,27015,41865,27015,242,71,171,2,31,1,1,allow
49418,27014,49598,27014,235,71,164,2,31,1,1,allow
42071,443,52227,443,9366,5830,3536,23,121,12,11,allow
1987,26467,0,0,62,62,0,1,0,1,0,deny
56939,445,0,0,70,70,0,1,0,1,0,drop
56937,445,0,0,70,70,0,1,0,1,0,drop
56926,445,0,0,70,70,0,1,0,1,0,drop
38633,51221,0,0,66,66,0,1,0,1,0,deny
46849,36237,0,0,62,62,0,1,0,1,0,deny
61013,41705,0,0,66,66,0,1,0,1,0,deny
52326,445,0,0,66,66,0,1,0,1,0,drop
52328,445,0,0,66,66,0,1,0,1,0,drop
52327,445,0,0,66,66,0,1,0,1,0,drop
56922,445,0,0,70,70,0,1,0,1,0,drop
25536,50584,0,0,62,62,0,1,0,1,0,deny
49418,27015,24745,27015,270,78,192,2,30,1,1,allow
65463,53,50986,53,177,94,83,2,30,1,1,allow
46275,64147,0,0,62,62,0,1,0,1,0,deny
56920,445,0,0,70,70,0,1,0,1,0,drop
51902,445,0,0,70,70,0,1,0,1,0,drop
33292,50584,0,0,66,66,0,1,0,1,0,deny
39165,23,0,0,60,60,0,1,0,1,0,deny
56911,445,0,0,70,70,0,1,0,1,0,drop
56912,445,0,0,70,70,0,1,0,1,0,drop
56908,445,0,0,70,70,0,1,0,1,0,drop
58022,5555,0,0,60,60,0,1,0,1,0,deny
34489,35440,0,0,66,66,0,1,0,1,0,deny
51999,37965,0,0,62,62,0,1,0,1,0,deny
30084,21247,0,0,146,146,0,1,0,1,0,deny
19610,9571,0,0,62,62,0,1,0,1,0,deny
26324,30188,0,0,62,62,0,1,0,1,0,deny
51895,445,0,0,70,70,0,1,0,1,0,drop
38980,17,0,0,60,60,0,1,0,1,0,deny
80,37649,0,0,60,60,0,1,0,1,0,deny
52975,23718,0,0,62,62,0,1,0,1,0,deny
56458,53,38538,53,196,102,94,2,30,1,1,allow
64997,53,25843,53,166,86,80,2,30,1,1,allow
38604,53,38604,53,203,82,121,2,30,1,1,allow
50089,443,48630,443,12446,2347,10099,44,190,23,21,allow
60747,40010,30374,40010,316,136,180,6,6,3,3,allow
53571,19636,50196,19636,70,70,0,2,7,2,0,allow
49216,53,31679,53,789,110,679,2,29,1,1,allow
49418,27025,65106,27025,240,78,162,2,30,1,1,allow
57968,443,57498,443,6254,1581,4673,21,190,12,9,allow
51062,80,29351,80,36568,23029,13539,94,194,47,47,allow
55084,443,37269,443,5556,1438,4118,22,196,12,10,allow
38570,443,8181,443,6260,1587,4673,21,191,12,9,allow
44099,443,28525,443,6235,1562,4673,21,191,12,9,allow
65513,53,57723,53,195,102,93,2,29,1,1,allow
53559,58968,6999,58968,70,70,0,1,4,1,0,allow
63769,47661,30265,47661,66,66,0,2,7,2,0,allow
53895,53,0,0,86,86,0,1,29,1,0,allow
56215,53,45300,53,168,78,90,2,29,1,1,allow
63771,7426,29432,7426,66,66,0,2,7,2,0,allow
65188,27126,32293,27126,268,78,190,2,29,1,1,allow
14430,443,35759,443,2629,1470,1159,18,15,8,10,allow
64355,53,49915,53,402,118,284,2,29,1,1,allow
47739,53,26929,53,168,78,90,2,29,1,1,allow
56418,53,6346,53,183,94,89,2,29,1,1,allow
64645,53,50507,53,391,96,295,4,49,2,2,allow
56239,53,9531,53,179,86,93,2,29,1,1,allow
56288,53,34669,53,183,94,89,2,30,1,1,allow
65184,27126,4649,27126,268,78,190,2,29,1,1,allow
65463,53,23022,53,177,94,83,2,30,1,1,allow
49418,23010,54751,23010,288,78,210,2,30,1,1,allow
56845,53,40181,53,730,102,628,2,30,1,1,allow
49418,27400,52679,27400,78,78,0,1,30,1,0,allow
40215,443,8042,443,6423,1543,4880,21,191,12,9,allow
51766,48169,62941,48169,70,70,0,2,7,2,0,allow
56924,53,7241,53,216,110,106,2,30,1,1,allow
64527,53,58780,53,228,102,126,2,30,1,1,allow
64871,53,62774,53,263,94,169,2,31,1,1,allow
49418,27017,57316,27017,262,78,184,2,30,1,1,allow
49418,27118,47467,27118,78,78,0,1,30,1,0,allow
49918,443,49171,443,10385,3107,7278,28,16,16,12,allow
32160,53,32160,53,233,90,143,2,32,1,1,allow
51988,53,22023,53,78,78,0,1,30,1,0,allow
41907,53,41907,53,233,90,143,2,33,1,1,allow
49418,27015,40892,27015,250,78,172,2,30,1,1,allow
18837,53,18837,53,233,90,143,2,32,1,1,allow
53551,60444,1391,60444,492,306,186,8,15,5,3,allow
56509,80,38678,80,3697,832,2865,12,15,7,5,allow
35374,443,7317,443,1558,971,587,14,123,8,6,allow
36682,80,24588,80,130,70,60,2,15,1,1,allow
56114,53,2423,53,216,110,106,2,30,1,1,allow
63128,443,30036,443,4994,379,4615,9,15,4,5,allow
44211,53,44211,53,850,114,736,2,30,1,1,allow
65312,53,52827,53,182,94,88,2,30,1,1,allow
65312,53,55577,53,182,94,88,2,30,1,1,allow
57132,53,36267,53,177,94,83,2,30,1,1,allow
56458,53,47423,53,196,102,94,2,30,1,1,allow
57321,53,18718,53,199,102,97,2,30,1,1,allow
51550,53,60452,53,168,78,90,2,30,1,1,allow
37696,443,12389,443,32798,2912,29886,58,170,29,29,allow
56770,52920,10024,52920,70,70,0,1,5,1,0,allow
64145,53,5953,53,504,105,399,4,35,2,2,allow
49230,443,49230,443,123041,10988,112053,185,67,86,99,allow
65372,53,40284,53,198,102,96,2,30,1,1,allow
49301,53,20768,53,214,102,112,2,30,1,1,allow
44116,123,64380,123,184,94,90,2,30,1,1,allow
64840,53,3676,53,193,102,91,2,30,1,1,allow
56924,53,61139,53,216,110,106,2,30,1,1,allow
64281,53,41166,53,492,90,402,4,45,2,2,allow
39042,443,60755,443,3589,1251,2338,15,20,9,6,allow
57321,53,57606,53,199,102,97,2,30,1,1,allow
65312,53,9346,53,182,94,88,2,30,1,1,allow
57367,53,52070,53,177,94,83,2,30,1,1,allow
50550,443,42250,443,8123,1809,6314,22,71,12,10,allow
43893,443,47910,443,1440,719,721,15,198,8,7,allow
49774,443,43328,443,8130,2220,5910,23,16,13,10,allow
36258,443,41571,443,1128432,47396,1081036,1242,142,458,784,allow
3688,80,37150,80,7072,1145,5927,20,105,12,8,allow
53570,24874,32383,24874,70,70,0,2,7,2,0,allow
41210,443,11454,443,234,234,0,4,11,4,0,allow
49418,27015,12745,27015,227,78,149,2,30,1,1,allow
65467,443,32500,443,92244,4799,87445,107,15,43,64,allow
52795,443,15981,443,1444,723,721,15,198,8,7,allow
51105,80,8408,80,366,240,126,7,20,5,2,allow
46989,80,46989,80,82082,3212,78870,90,155,27,63,allow
53556,1024,47936,1024,70,70,0,1,4,1,0,allow
51764,33432,19826,33432,70,70,0,2,8,2,0,allow
46053,443,15914,443,6999,1563,5436,18,186,3,15,allow
53553,2297,50955,2297,70,70,0,1,4,1,0,allow
63768,55755,28718,55755,66,66,0,2,7,2,0,allow
53111,50809,43690,50809,70,70,0,1,4,1,0,allow
52459,33899,52459,33899,66,66,0,1,5,1,0,allow
49418,53,51153,53,379,93,286,4,37,2,2,allow
53576,23505,43782,23505,70,70,0,2,7,2,0,allow
55612,36239,64723,36239,320,140,180,6,5,3,3,allow
30296,53,30296,53,233,90,143,2,33,1,1,allow
35373,443,52870,443,255313,6947,248366,253,123,74,179,allow
46910,443,1706,443,5714,1536,4178,24,21,13,11,allow
51221,64509,12506,64509,3564,3564,0,55,4073,55,0,allow
55730,53,1752,53,819,102,717,2,29,1,1,allow
57731,443,57731,443,5508,2261,3247,22,38,13,9,allow
50334,53,27323,53,216,110,106,2,29,1,1,allow
64811,53,25235,53,193,102,91,2,29,1,1,allow
56114,53,59313,53,216,110,106,2,30,1,1,allow
64517,53,41974,53,194,102,92,2,29,1,1,allow
64877,53,24531,53,309,110,199,2,30,1,1,allow
50164,53,36057,53,260,86,174,2,29,1,1,allow
64580,53,58796,53,200,94,106,2,30,1,1,allow
52652,443,42861,443,283768,16167,267601,384,116,148,236,allow
56924,53,48740,53,216,110,106,2,30,1,1,allow
56431,53,52567,53,323,110,213,2,30,1,1,allow
51120,443,19662,443,2940,787,2153,11,119,5,6,allow
37472,443,30492,443,17764,5080,12684,46,121,22,24,allow
49418,27015,51226,27015,274,78,196,2,30,1,1,allow
49418,27018,13297,27018,259,78,181,2,30,1,1,allow
64320,53,48665,53,199,102,97,2,30,1,1,allow
49418,27018,36116,27018,256,78,178,2,30,1,1,allow
65011,53,28977,53,183,94,89,2,31,1,1,allow
49418,27015,50232,27015,286,78,208,2,31,1,1,allow
35005,53,35005,53,233,90,143,2,33,1,1,allow
24276,53,24276,53,233,90,143,2,33,1,1,allow
56771,43648,21453,43648,70,70,0,1,5,1,0,allow
58552,443,44204,443,28468,2316,26152,43,42,15,28,allow
58541,28678,6280,28678,1806,1806,0,22,224,22,0,allow
51747,7000,51747,7000,3132,815,2317,14,15,7,7,allow
55577,53,12118,53,199,102,97,2,30,1,1,allow
49827,443,50182,443,5863,1580,4283,17,15,9,8,allow
3694,80,3582,80,6919,1220,5699,20,104,12,8,allow
8168,80,8168,80,282487,10736,271751,315,52,124,191,allow
64275,53,2712,53,644,198,446,6,48,3,3,allow
57132,53,31918,53,177,94,83,2,30,1,1,allow
55577,53,47306,53,199,102,97,2,30,1,1,allow
65443,53,31902,53,730,102,628,2,30,1,1,allow
49418,27200,10128,27200,78,78,0,1,30,1,0,allow
55788,53,26476,53,231,110,121,2,30,1,1,allow
49418,27015,52335,27015,295,78,217,2,30,1,1,allow
51715,443,60037,443,4887,2346,2541,16,120,8,8,allow
53888,443,42576,443,8935,4627,4308,22,121,12,10,allow
49418,27015,20814,27015,249,78,171,2,30,1,1,allow
48233,443,29829,443,9759,3896,5863,28,230,15,13,allow
3691,80,6351,80,6826,1214,5612,20,105,12,8,allow
65372,53,29268,53,198,102,96,2,30,1,1,allow
49996,53,62453,53,183,94,89,2,30,1,1,allow
49580,53,4352,53,196,102,94,2,30,1,1,allow
49580,53,60391,53,196,102,94,2,30,1,1,allow
49418,27017,6721,27017,300,78,222,2,30,1,1,allow
49418,27015,7927,27015,295,78,217,2,31,1,1,allow
49418,27018,21489,27018,255,78,177,2,31,1,1,allow
15503,56331,21797,56331,481,150,331,2,1200,1,1,allow
57470,52339,38751,52339,594,594,0,10,1199,10,0,allow
49418,27017,9977,27017,260,78,182,2,31,1,1,allow
49418,52013,42400,52013,278,78,200,2,31,1,1,allow
49418,27016,31344,27016,250,78,172,2,31,1,1,allow
53541,443,39871,443,10583,1889,8694,28,251,10,18,allow
57470,53377,9260,53377,594,594,0,10,1199,10,0,allow
45294,443,12924,443,6290,4832,1458,18,120,11,7,allow
49759,53,30943,53,216,110,106,2,31,1,1,allow
49418,27017,45242,27017,259,78,181,2,31,1,1,allow
57268,443,29567,443,11546,3604,7942,38,120,20,18,allow
49418,27017,22257,27017,271,78,193,2,31,1,1,allow
49418,27018,42742,27018,274,78,196,2,31,1,1,allow
55461,443,1970,443,6314,4856,1458,18,120,11,7,allow
64336,443,26343,443,10099,4296,5803,30,124,13,17,allow
49418,27035,7817,27035,250,78,172,2,31,1,1,allow
64613,53,60043,53,179,94,85,2,30,1,1,allow
57661,53,46284,53,70,70,0,1,30,1,0,allow
49418,27015,20912,27015,302,78,224,2,30,1,1,allow
49418,27016,50703,27016,258,78,180,2,31,1,1,allow
55593,80,19208,80,3276,404,2872,11,15,5,6,allow
51104,80,56002,80,1524,1028,496,10,21,7,3,allow
34217,443,35043,443,6650,1556,5094,23,18,13,10,allow
65318,80,50736,80,2356,499,1857,10,134,6,4,allow
64613,53,44378,53,179,94,85,2,30,1,1,allow
49418,27016,1873,27016,281,78,203,2,31,1,1,allow
65449,53,65266,53,507,193,314,6,57,3,3,allow
55608,17425,43686,17425,320,140,180,6,7,3,3,allow
39799,443,18557,443,5597,3595,2002,42,68,23,19,allow
55577,53,3000,53,699,204,495,6,57,3,3,allow
5115,53,5115,53,216,90,126,2,30,1,1,allow
55519,53,47075,53,193,102,91,2,30,1,1,allow
57271,53,58158,53,288,94,194,2,30,1,1,allow
6666,8888,0,0,60,60,0,1,0,1,0,deny
80,53945,0,0,60,60,0,1,0,1,0,deny
50422,50584,0,0,62,62,0,1,0,1,0,deny
51887,445,0,0,70,70,0,1,0,1,0,drop
51886,445,0,0,70,70,0,1,0,1,0,drop
56901,445,0,0,70,70,0,1,0,1,0,drop
56900,445,0,0,70,70,0,1,0,1,0,drop
56896,445,0,0,70,70,0,1,0,1,0,drop
80,9918,0,0,60,60,0,1,0,1,0,deny
59943,37807,0,0,146,146,0,1,0,1,0,deny
51880,445,0,0,70,70,0,1,0,1,0,drop
51881,445,0,0,70,70,0,1,0,1,0,drop
51877,445,0,0,70,70,0,1,0,1,0,drop
16393,22114,0,0,66,66,0,1,0,1,0,deny
60960,49049,0,0,62,62,0,1,0,1,0,deny
62930,21247,0,0,66,66,0,1,0,1,0,deny
30920,64147,0,0,62,62,0,1,0,1,0,deny
64982,50584,0,0,146,146,0,1,0,1,0,deny
34228,45129,0,0,148,148,0,1,0,1,0,deny
6881,6881,0,0,62,62,0,1,0,1,0,deny
54062,31573,0,0,66,66,0,1,0,1,0,deny
50181,64147,0,0,66,66,0,1,0,1,0,deny
52303,445,0,0,66,66,0,1,0,1,0,drop
56895,445,0,0,70,70,0,1,0,1,0,drop
56894,445,0,0,70,70,0,1,0,1,0,drop
51872,445,0,0,70,70,0,1,0,1,0,drop
3270,35440,0,0,66,66,0,1,0,1,0,deny
48478,49903,0,0,62,62,0,1,0,1,0,deny
51864,445,0,0,70,70,0,1,0,1,0,drop
34916,51185,0,0,62,62,0,1,0,1,0,deny
51861,445,0,0,70,70,0,1,0,1,0,drop
52298,445,0,0,66,66,0,1,0,1,0,drop
38053,50584,0,0,146,146,0,1,0,1,0,deny
35657,48637,0,0,62,62,0,1,0,1,0,deny
25523,35974,0,0,62,62,0,1,0,1,0,deny
52296,445,0,0,66,66,0,1,0,1,0,drop
56881,445,0,0,70,70,0,1,0,1,0,drop
58598,50584,0,0,66,66,0,1,0,1,0,deny
56878,445,0,0,70,70,0,1,0,1,0,drop
56874,445,0,0,70,70,0,1,0,1,0,drop
56872,445,0,0,70,70,0,1,0,1,0,drop
443,43775,0,0,97,97,0,1,0,1,0,deny
49699,64147,0,0,66,66,0,1,0,1,0,deny
52294,445,0,0,66,66,0,1,0,1,0,drop
51858,445,0,0,70,70,0,1,0,1,0,drop
51856,445,0,0,70,70,0,1,0,1,0,drop
60923,49903,0,0,66,66,0,1,0,1,0,deny
62392,15503,0,0,62,62,0,1,0,1,0,deny
5575,8889,5575,8889,498,498,0,1,0,1,0,deny
9092,26672,0,0,60,60,0,1,0,1,0,deny
56869,445,0,0,70,70,0,1,0,1,0,drop
49664,37965,0,0,66,66,0,1,0,1,0,deny
24480,35440,0,0,66,66,0,1,0,1,0,deny
51852,445,0,0,70,70,0,1,0,1,0,drop
56865,445,0,0,70,70,0,1,0,1,0,drop
56864,445,0,0,70,70,0,1,0,1,0,drop
56861,445,0,0,70,70,0,1,0,1,0,drop
55296,23718,0,0,66,66,0,1,0,1,0,deny
52287,445,0,0,66,66,0,1,0,1,0,drop
47962,16069,0,0,62,62,0,1,0,1,0,deny
51851,445,0,0,70,70,0,1,0,1,0,drop
52282,445,0,0,66,66,0,1,0,1,0,drop
52283,445,0,0,66,66,0,1,0,1,0,drop
52280,445,0,0,66,66,0,1,0,1,0,drop
52276,445,0,0,66,66,0,1,0,1,0,drop
52277,445,0,0,66,66,0,1,0,1,0,drop
52275,445,0,0,66,66,0,1,0,1,0,drop
62452,21247,0,0,62,62,0,1,0,1,0,deny
64482,64147,0,0,66,66,0,1,0,1,0,deny
16387,26193,0,0,60,60,0,1,0,1,0,deny
16387,35308,0,0,60,60,0,1,0,1,0,deny
16387,56995,0,0,60,60,0,1,0,1,0,deny
23528,44847,0,0,146,146,0,1,0,1,0,deny
51846,445,0,0,70,70,0,1,0,1,0,drop
56860,445,0,0,70,70,0,1,0,1,0,drop
56858,445,0,0,70,70,0,1,0,1,0,drop
56854,445,0,0,70,70,0,1,0,1,0,drop
56967,35440,0,0,66,66,0,1,0,1,0,deny
61426,64910,0,0,66,66,0,1,0,1,0,deny
52273,445,0,0,66,66,0,1,0,1,0,drop
54339,23117,0,0,66,66,0,1,0,1,0,deny
56852,445,0,0,70,70,0,1,0,1,0,drop
52269,445,0,0,66,66,0,1,0,1,0,drop
52267,445,0,0,66,66,0,1,0,1,0,drop
52265,445,0,0,66,66,0,1,0,1,0,drop
37876,5900,0,0,60,60,0,1,0,1,0,deny
52263,445,0,0,66,66,0,1,0,1,0,drop
50668,58833,0,0,62,62,0,1,0,1,0,deny
30303,19391,0,0,181,181,0,1,0,1,0,deny
80,37649,0,0,60,60,0,1,0,1,0,deny
80,53945,0,0,60,60,0,1,0,1,0,deny
54471,36237,0,0,66,66,0,1,0,1,0,deny
56844,445,0,0,70,70,0,1,0,1,0,drop
33832,55108,0,0,148,148,0,1,0,1,0,deny
59918,44847,0,0,66,66,0,1,0,1,0,deny
51833,445,0,0,70,70,0,1,0,1,0,drop
43580,57470,0,0,145,145,0,1,0,1,0,deny
443,11135,0,0,66,66,0,1,0,1,0,deny
80,9918,0,0,60,60,0,1,0,1,0,deny
56836,445,0,0,70,70,0,1,0,1,0,drop
56837,445,0,0,70,70,0,1,0,1,0,drop
46557,57866,0,0,62,62,0,1,0,1,0,deny
63852,35440,0,0,66,66,0,1,0,1,0,deny
0,0,0,0,60,60,0,1,0,1,0,deny
48087,16069,0,0,66,66,0,1,0,1,0,deny
52255,445,0,0,66,66,0,1,0,1,0,drop
5223,44091,0,0,220,220,0,1,0,1,0,deny
34211,23,0,0,60,60,0,1,0,1,0,deny
52245,445,0,0,66,66,0,1,0,1,0,drop
50439,64147,0,0,66,66,0,1,0,1,0,deny
51826,445,0,0,70,70,0,1,0,1,0,drop
56825,445,0,0,70,70,0,1,0,1,0,drop
1024,64147,0,0,62,62,0,1,0,1,0,deny
51824,445,0,0,70,70,0,1,0,1,0,drop
42685,51180,0,0,62,62,0,1,0,1,0,deny
1431,30041,0,0,62,62,0,1,0,1,0,deny
51822,445,0,0,70,70,0,1,0,1,0,drop
39217,31573,0,0,146,146,0,1,0,1,0,deny
31748,56205,0,0,146,146,0,1,0,1,0,deny
13654,50584,0,0,62,62,0,1,0,1,0,deny
52243,445,0,0,66,66,0,1,0,1,0,drop
44491,50584,0,0,146,146,0,1,0,1,0,deny
40834,50584,0,0,62,62,0,1,0,1,0,deny
52236,445,0,0,66,66,0,1,0,1,0,drop
64890,51180,0,0,66,66,0,1,0,1,0,deny
52231,445,0,0,66,66,0,1,0,1,0,drop
24592,50584,0,0,62,62,0,1,0,1,0,deny
25880,44847,0,0,146,146,0,1,0,1,0,deny
51815,445,0,0,70,70,0,1,0,1,0,drop
60192,35440,0,0,62,62,0,1,0,1,0,deny
8976,44847,0,0,66,66,0,1,0,1,0,deny
51815,51221,0,0,74,74,0,1,0,1,0,deny
56327,44512,0,0,66,66,0,1,0,1,0,deny
51813,445,0,0,70,70,0,1,0,1,0,drop
49418,27016,14268,27016,236,71,165,2,30,1,1,allow
49418,27016,42028,27016,246,71,175,2,30,1,1,allow
49418,52013,5997,52013,257,71,186,2,30,1,1,allow
39396,443,4891,443,7531,2720,4811,24,331,13,11,allow
61459,80,3928,80,4671,2593,2078,15,85,9,6,allow
43106,443,35974,443,3259,1913,1346,18,16,8,10,allow
44740,443,62303,443,5954,1454,4500,22,142,13,9,allow
49418,27015,34023,27015,249,71,178,2,30,1,1,allow
49418,27015,33472,27015,71,71,0,1,30,1,0,allow
49418,27015,48509,27015,266,71,195,2,31,1,1,allow
49418,27013,52057,27013,230,71,159,2,31,1,1,allow
65339,53,50441,53,186,95,91,2,31,1,1,allow
49418,27019,50504,27019,71,71,0,1,30,1,0,allow
43105,443,31281,443,3115,1849,1266,18,16,8,10,allow
64992,53,63333,53,170,87,83,2,30,1,1,allow
49418,27016,27118,27016,231,71,160,2,30,1,1,allow
55231,443,25575,443,10684454,328574,10355880,11599,77,3693,7906,allow
65317,80,47905,80,1014,507,507,8,133,5,3,allow
55519,53,8879,53,186,95,91,2,30,1,1,allow
49418,27016,26293,27016,257,71,186,2,30,1,1,allow
51117,60038,0,0,66,66,0,1,90,1,0,allow
51101,80,9411,80,366,240,126,7,20,5,2,allow
53974,53,45539,53,578,286,292,9,15,5,4,allow
60022,443,60022,443,18674,1910,16764,32,18,17,15,allow
49759,53,28731,53,216,110,106,2,30,1,1,allow
50614,443,33140,443,3499,1732,1767,15,16,9,6,allow
50447,443,44649,443,12362,3372,8990,34,143,18,16,allow
49418,27017,46358,27017,252,71,181,2,30,1,1,allow
57367,53,62826,53,170,87,83,2,30,1,1,allow
45713,53,45713,53,217,87,130,2,30,1,1,allow
6354,53,6354,53,217,87,130,2,30,1,1,allow
49418,27019,38743,27019,251,71,180,2,30,1,1,allow
49418,27018,61835,27018,248,71,177,2,30,1,1,allow
51425,53,0,0,194,87,107,2,30,1,1,allow
49418,27016,46428,27016,249,71,178,2,30,1,1,allow
49418,27015,56301,27015,258,71,187,2,30,1,1,allow
49418,27017,12752,27017,283,71,212,2,31,1,1,allow
49418,27015,14381,27015,248,71,177,2,31,1,1,allow
51744,1678,56992,1678,66,66,0,1,5,1,0,allow
51341,7000,51341,7000,3132,815,2317,14,16,7,7,allow
51745,2572,3211,2572,66,66,0,1,5,1,0,allow
54631,443,58856,443,8367,3945,4422,81,616,42,39,allow
28470,80,28470,80,355544,12402,343142,378,26,134,244,allow
35647,3389,35647,3389,4575,2400,2175,20,18,11,9,allow
50496,443,2792,443,751676,8792,742884,617,16,123,494,allow
43230,80,43230,80,6776,692,6084,16,20,8,8,allow
64320,53,33961,53,198,101,97,2,30,1,1,allow
49418,27016,22907,27016,254,71,183,2,30,1,1,allow
10001,40041,23223,40041,151,89,62,2,30,1,1,allow
28858,80,28858,80,83253,4938,78315,99,26,39,60,allow
49418,27017,63792,27017,256,71,185,2,30,1,1,allow
53670,53,0,0,82,82,0,1,30,1,0,allow
29245,80,29245,80,27233,4047,23186,44,27,20,24,allow
49418,27017,33582,27017,71,71,0,1,30,1,0,allow
49418,27015,17910,27015,232,71,161,2,31,1,1,allow
63810,443,22948,443,8243,4867,3376,33,137,16,17,allow
62524,123,21935,123,184,94,90,2,31,1,1,allow
60354,443,37287,443,10223,3933,6290,49,115,22,27,allow
61143,443,58972,443,6391,3788,2603,14,121,7,7,allow
53442,443,36564,443,28728581,857403,27871178,29322,132,8944,20378,allow
61475,443,7125,443,198481,12339,186142,247,64,112,135,allow
23151,53,23151,53,194,87,107,2,31,1,1,allow
60962,53,0,0,180,80,100,2,31,1,1,allow
59455,53,0,0,221,81,140,2,31,1,1,allow
30960,45673,1133,45673,462,462,0,8,3633,8,0,allow
64025,24855,0,0,66,66,0,1,90,1,0,allow
51812,445,0,0,70,70,0,1,0,1,0,drop
61315,48817,0,0,62,62,0,1,0,1,0,deny
51811,445,0,0,70,70,0,1,0,1,0,drop
51810,445,0,0,70,70,0,1,0,1,0,drop
64897,2323,0,0,60,60,0,1,0,1,0,deny
51806,445,0,0,70,70,0,1,0,1,0,drop
51807,445,0,0,70,70,0,1,0,1,0,drop
56815,445,0,0,70,70,0,1,0,1,0,drop
56813,445,0,0,70,70,0,1,0,1,0,drop
56812,445,0,0,70,70,0,1,0,1,0,drop
18655,50584,0,0,62,62,0,1,0,1,0,deny
52214,445,0,0,66,66,0,1,0,1,0,drop
52220,445,0,0,66,66,0,1,0,1,0,drop
51837,37965,0,0,66,66,0,1,0,1,0,deny
52219,445,0,0,66,66,0,1,0,1,0,drop
52217,445,0,0,66,66,0,1,0,1,0,drop
52215,445,0,0,66,66,0,1,0,1,0,deny
52216,445,0,0,66,66,0,1,0,1,0,drop
52213,445,0,0,66,66,0,1,0,1,0,drop
52212,445,0,0,66,66,0,1,0,1,0,drop
36656,64147,0,0,62,62,0,1,0,1,0,deny
51792,445,0,0,70,70,0,1,0,1,0,drop
51791,445,0,0,70,70,0,1,0,1,0,drop
51788,445,0,0,70,70,0,1,0,1,0,drop
49418,27017,35147,27017,78,78,0,1,30,1,0,allow
40583,80,60376,80,898,543,355,10,255,6,4,allow
28275,80,28275,80,303421,10894,292527,324,26,116,208,allow
20898,53,20898,53,233,90,143,2,32,1,1,allow
51758,31009,36831,31009,70,70,0,2,8,2,0,allow
45057,443,53651,443,1394,733,661,14,80,8,6,allow
49418,27017,15205,27017,252,78,174,2,30,1,1,allow
49996,53,6579,53,183,94,89,2,30,1,1,allow
55899,443,47257,443,4819,2304,2515,16,135,8,8,allow
49418,27016,47902,27016,245,78,167,2,30,1,1,allow
65319,80,8384,80,2284,484,1800,10,133,6,4,allow
58052,25,34376,25,540,256,284,9,30,5,4,allow
63741,36776,9191,36776,70,70,0,1,4,1,0,allow
10002,40012,52638,40012,261,198,63,2,29,1,1,allow
49418,27015,8182,27015,252,78,174,2,29,1,1,allow
49418,27016,33402,27016,259,78,181,2,29,1,1,allow
49418,27015,20028,27015,264,78,186,2,29,1,1,allow
49418,27015,52265,27015,266,78,188,2,30,1,1,allow
49418,27015,32130,27015,260,78,182,2,30,1,1,allow
49418,49000,14471,49000,270,78,192,2,30,1,1,allow
51060,80,61015,80,4632,2660,1972,49,193,26,23,allow
51231,443,1331,443,1396,735,661,14,80,8,6,allow
41502,443,22197,443,1053,566,487,10,48,6,4,allow
50448,443,27905,443,10382,3262,7120,30,142,16,14,allow
50912,80,58684,80,9578491,119422,9459069,8079,137,1689,6390,allow
57886,80,60119,80,6526,1210,5316,15,17,8,7,allow
41999,80,10138,80,38137,1920,36217,51,81,24,27,allow
63742,26305,40966,26305,70,70,0,1,4,1,0,allow
50048,80,54605,80,2140,1030,1110,22,149,8,14,allow
38091,7275,44065,7275,350,210,140,6,15,4,2,allow
65011,53,20412,53,183,94,89,2,29,1,1,allow
56955,53,20294,53,184,86,98,2,29,1,1,allow
64520,53,44752,53,184,86,98,2,29,1,1,allow
38211,123,28193,123,184,94,90,2,29,1,1,allow
49418,27015,10652,27015,224,78,146,2,30,1,1,allow
57367,53,51549,53,177,94,83,2,29,1,1,allow
49815,53,18819,53,212,102,110,2,29,1,1,allow
49418,27015,65524,27015,287,78,209,2,30,1,1,allow
49527,53,19400,53,200,94,106,2,30,1,1,allow
55088,53,55518,53,193,102,91,2,30,1,1,allow
49418,27015,2773,27015,243,78,165,2,30,1,1,allow
64828,53,62244,53,260,102,158,2,30,1,1,allow
56018,443,53493,443,162,102,60,2,5,1,1,allow
58876,80,60067,80,32098,2435,29663,47,75,24,23,allow
47812,443,45871,443,25864,15150,10714,105,217,54,51,allow
44861,443,26247,443,1053,566,487,10,47,6,4,allow
34183,443,44472,443,10459,2529,7930,31,375,13,18,allow
60139,53,31222,53,218,78,140,2,30,1,1,allow
45601,443,27195,443,5378,984,4394,18,17,10,8,allow
63112,443,43251,443,3695,2713,982,21,82,12,9,allow
46342,53,46342,53,233,90,143,2,32,1,1,allow
56335,53,31703,53,260,102,158,2,30,1,1,allow
63770,24466,46194,24466,312,132,180,6,6,3,3,allow
51495,443,20935,443,55465,11462,44003,89,31,43,46,allow
55971,53,55971,53,233,90,143,2,33,1,1,allow
51760,36558,43821,36558,70,70,0,2,8,2,0,allow
10092,443,29539,443,130,70,60,3,5,2,1,allow
60329,7000,60329,7000,3959,1738,2221,15,15,8,7,allow
35735,80,48997,80,1155,781,374,10,15,6,4,allow
50597,443,31048,443,8031,1915,6116,24,17,12,12,allow
54889,53,54889,53,832,106,726,2,30,1,1,allow
50579,443,37078,443,2707,1383,1324,29,36,16,13,allow
28391,80,28391,80,12237,2818,9419,27,26,14,13,allow
57298,8765,45553,8765,2466,1350,1116,37,569,19,18,allow
60397,43129,12174,43129,70,70,0,2,8,2,0,allow
64320,53,61236,53,199,102,97,2,30,1,1,allow
55377,53,9978,53,228,110,118,2,30,1,1,allow
62877,53,36980,53,248,78,170,2,30,1,1,allow
64891,53,17816,53,211,102,109,2,30,1,1,allow
49418,27015,23061,27015,256,78,178,2,30,1,1,allow
49482,53,59102,53,196,94,102,2,30,1,1,allow
55088,53,58589,53,193,102,91,2,30,1,1,allow
65147,53,52735,53,323,102,221,2,30,1,1,allow
49418,27015,26438,27015,78,78,0,1,30,1,0,allow
64314,53,49422,53,319,126,193,2,30,1,1,allow
49418,27025,2656,27025,250,78,172,2,30,1,1,allow
49418,27015,42227,27015,251,78,173,2,30,1,1,allow
40500,53,40500,53,203,82,121,2,30,1,1,allow
49807,53,0,0,218,77,141,2,30,1,1,allow
56650,53,58049,53,253,102,151,2,30,1,1,allow
59112,53,0,0,296,76,220,2,30,1,1,allow
49418,27018,53537,27018,256,78,178,2,30,1,1,allow
49418,27016,30888,27016,255,78,177,2,30,1,1,allow
65381,53,45140,53,241,110,131,2,30,1,1,allow
49418,27015,37811,27015,236,78,158,2,30,1,1,allow
51761,19136,54705,19136,70,70,0,2,8,2,0,allow
50444,80,3294,80,378,192,186,7,19,4,3,allow
65399,53,0,0,191,75,116,2,30,1,1,allow
61320,53,0,0,194,80,114,2,30,1,1,allow
49418,27015,40733,27015,242,78,164,2,30,1,1,allow
65339,53,24574,53,193,102,91,2,30,1,1,allow
57040,53,51890,53,236,94,142,2,30,1,1,allow
50533,443,28213,443,3518,1654,1864,10,120,5,5,allow
51221,19072,17591,19072,330,330,0,6,1200,6,0,allow
44516,443,57254,443,4709,2451,2258,18,304,8,10,allow
49418,27111,53348,27111,258,78,180,2,30,1,1,allow
6881,8999,10252,8999,502,150,352,2,1199,1,1,allow
49418,27016,45260,27016,255,78,177,2,30,1,1,allow
49418,27015,38539,27015,249,78,171,2,30,1,1,allow
65256,53,29045,53,357,105,252,4,57,2,2,allow
64946,53,64946,53,233,90,143,2,33,1,1,allow
49418,27019,26998,27019,242,78,164,2,30,1,1,allow
63744,47106,28036,47106,70,70,0,1,4,1,0,allow
65316,80,11827,80,2430,531,1899,10,133,6,4,allow
53549,40826,14418,40826,492,306,186,8,14,5,3,allow
49418,27333,30238,27333,254,78,176,2,30,1,1,allow
61717,80,65373,80,6160,2912,3248,17,18,9,8,allow
63743,46081,6085,46081,70,70,0,1,4,1,0,allow
50443,80,16210,80,378,192,186,7,19,4,3,allow
47123,443,37885,443,1053,566,487,10,43,6,4,allow
49759,53,16085,53,216,110,106,2,29,1,1,allow
49903,53,18446,53,215,102,113,2,29,1,1,allow
50445,443,50834,443,14431,2090,12341,42,142,20,22,allow
48568,443,2828,443,56258,45661,10597,165,244,88,77,allow
53547,27759,47610,27759,684,432,252,10,16,6,4,allow
49575,53,59647,53,244,102,142,2,29,1,1,allow
49418,27016,34441,27016,263,78,185,2,29,1,1,allow
49418,27015,32548,27015,255,78,177,2,29,1,1,allow
56779,43137,58075,43137,70,70,0,2,8,2,0,allow
64654,53,63011,53,240,110,130,2,30,1,1,allow
55600,80,11201,80,70,70,0,2,8,2,0,allow
51763,34121,10888,34121,70,70,0,2,8,2,0,allow
59794,443,46382,443,408,78,330,6,25,1,5,allow
57367,53,32502,53,177,94,83,2,30,1,1,allow
49996,53,8571,53,183,94,89,2,30,1,1,allow
49418,27017,24547,27017,258,78,180,2,29,1,1,allow
49580,53,62367,53,196,102,94,2,30,1,1,allow
49418,27016,62306,27016,261,78,183,2,30,1,1,allow
49810,53,13654,53,244,94,150,2,30,1,1,allow
55088,53,3753,53,193,102,91,2,29,1,1,allow
49418,27016,5778,27016,263,78,185,2,29,1,1,allow
49418,31000,20791,31000,78,78,0,1,30,1,0,allow
49640,53,5967,53,402,118,284,2,30,1,1,allow
54987,53,61181,53,215,102,113,2,30,1,1,allow
49115,443,63602,443,361013,18864,342149,392,296,110,282,allow
60383,16881,9133,16881,564,318,246,9,18,5,4,allow
45055,443,37161,443,1392,731,661,14,80,8,6,allow
60390,56494,54167,56494,70,70,0,1,5,1,0,allow
52953,80,11532,80,3247,1730,1517,12,36,7,5,allow
40465,443,49132,443,1053,566,487,10,47,6,4,allow
51607,53,31669,53,284,86,198,2,30,1,1,allow
49418,27016,58886,27016,242,78,164,2,30,1,1,allow
49418,27020,23482,27020,248,78,170,2,30,1,1,allow
49418,31000,56556,31000,260,78,182,2,30,1,1,allow
52751,443,8615,443,5378,984,4394,18,17,10,8,allow
49174,443,55183,443,524887,14310,510577,546,18,201,345,allow
49759,53,4425,53,381,110,271,4,32,2,2,allow
51759,55308,58744,55308,70,70,0,2,8,2,0,allow
63563,24096,60999,24096,198,198,0,1,5,1,0,allow
47651,443,48756,443,1053,566,487,10,43,6,4,allow
50416,80,7917,80,11343,3864,7479,22,21,11,11,allow
50442,80,8641,80,378,192,186,7,19,4,3,allow
55627,53,18188,53,240,110,130,2,30,1,1,allow
50912,443,28892,443,8527,2387,6140,21,31,11,10,allow
49418,27015,19557,27015,255,78,177,2,30,1,1,allow
49418,27015,62235,27015,258,78,180,2,30,1,1,allow
64992,53,56297,53,177,94,83,2,30,1,1,allow
123,123,4741,123,184,94,90,2,30,1,1,allow
55167,443,39745,443,12946,5235,7711,38,185,21,17,allow
49545,443,58325,443,7189,1694,5495,31,131,14,17,allow
59836,443,35828,443,1394,733,661,14,80,8,6,allow
51762,12747,44025,12747,70,70,0,2,8,2,0,allow
47894,443,64449,443,70,70,0,2,5,2,0,allow
53225,443,23994,443,6659,1215,5444,17,15,9,8,allow
28608,80,28608,80,602483,18143,584340,627,27,219,408,allow
64320,53,46178,53,199,102,97,2,30,1,1,allow
49418,27016,26183,27016,262,78,184,2,30,1,1,allow
49418,27018,39364,27018,247,78,169,2,30,1,1,allow
49418,30000,55086,30000,280,78,202,2,30,1,1,allow
3027,53,3027,53,199,90,109,2,30,1,1,allow
49418,27222,49485,27222,245,78,167,2,30,1,1,allow
49418,27015,26832,27015,248,78,170,2,30,1,1,allow
45225,443,59513,443,11233,3101,8132,37,150,18,19,allow
49418,27017,11133,27017,247,78,169,2,30,1,1,allow
37525,443,14541,443,9082,3492,5590,26,61,15,11,allow
57333,53,41487,53,258,110,148,2,31,1,1,allow
49246,53,63715,53,286,102,184,2,31,1,1,allow
49561,53,53882,53,211,102,109,2,30,1,1,allow
49160,63307,39518,63307,854,150,704,4,1200,2,2,allow
10151,55149,20876,55149,481,150,331,2,1200,1,1,allow
51221,27417,45430,27417,481,150,331,2,1200,1,1,allow
65339,53,13346,53,949,285,664,8,39,4,4,allow
53110,8830,57205,8830,70,70,0,1,5,1,0,allow
53464,443,61601,443,6550,1555,4995,25,53,13,12,allow
57470,10748,14210,10748,594,594,0,10,1200,10,0,allow
53554,8999,45352,8999,130,70,60,2,5,1,1,allow
59635,7275,39827,7275,448,78,370,6,25,1,5,allow
64090,53,12119,53,227,102,125,2,30,1,1,allow
57470,6881,51127,6881,594,594,0,10,1200,10,0,allow
63762,41373,50271,41373,66,66,0,2,8,2,0,allow
50690,443,43818,443,354,294,60,2,5,1,1,allow
49418,27015,50177,27015,78,78,0,1,30,1,0,allow
7222,57470,0,0,62,62,0,1,0,1,0,deny
51782,445,0,0,70,70,0,1,0,1,0,drop
51781,445,0,0,70,70,0,1,0,1,0,deny
55056,56205,0,0,62,62,0,1,0,1,0,deny
53987,57470,0,0,66,66,0,1,0,1,0,deny
24144,57470,0,0,62,62,0,1,0,1,0,deny
16660,55783,0,0,62,62,0,1,0,1,0,deny
45908,3383,0,0,60,60,0,1,0,1,0,deny
50877,30041,0,0,62,62,0,1,0,1,0,deny
56805,445,0,0,70,70,0,1,0,1,0,drop
56804,445,0,0,70,70,0,1,0,1,0,drop
56797,445,0,0,70,70,0,1,0,1,0,drop
52913,2767,0,0,66,66,0,1,0,1,0,deny
50788,48817,0,0,66,66,0,1,0,1,0,deny
52200,445,0,0,66,66,0,1,0,1,0,drop
52199,445,0,0,66,66,0,1,0,1,0,drop
52197,445,0,0,66,66,0,1,0,1,0,drop
59879,55783,0,0,66,66,0,1,0,1,0,deny
56794,445,0,0,70,70,0,1,0,1,0,drop
51770,445,0,0,70,70,0,1,0,1,0,drop
20726,2767,0,0,66,66,0,1,0,1,0,deny
56792,445,0,0,70,70,0,1,0,1,0,drop
19570,50584,0,0,66,66,0,1,0,1,0,deny
56791,445,0,0,70,70,0,1,0,1,0,drop
56784,445,0,0,70,70,0,1,0,1,0,drop
56783,445,0,0,70,70,0,1,0,1,0,drop
51766,445,0,0,70,70,0,1,0,1,0,drop
61764,57470,0,0,146,146,0,1,0,1,0,deny
54276,39004,0,0,66,66,0,1,0,1,0,deny
59168,39004,0,0,62,62,0,1,0,1,0,deny
3783,40740,0,0,160,160,0,1,0,1,0,deny
32215,22114,0,0,66,66,0,1,0,1,0,deny
51755,445,0,0,70,70,0,1,0,1,0,drop
51756,445,0,0,70,70,0,1,0,1,0,drop
56778,35440,0,0,66,66,0,1,0,1,0,deny
1027,44847,0,0,62,62,0,1,0,1,0,deny
59023,64097,0,0,66,66,0,1,0,1,0,deny
51754,445,0,0,70,70,0,1,0,1,0,drop
51753,445,0,0,70,70,0,1,0,1,0,drop
49001,65473,0,0,174,174,0,1,0,1,0,deny
51749,445,0,0,70,70,0,1,0,1,0,drop
56773,445,0,0,70,70,0,1,0,1,0,drop
56771,445,0,0,70,70,0,1,0,1,0,drop
56768,445,0,0,70,70,0,1,0,1,0,drop
54631,44847,0,0,74,74,0,1,0,1,0,deny
53053,64147,0,0,66,66,0,1,0,1,0,deny
25360,51505,0,0,66,66,0,1,0,1,0,deny
1024,64147,0,0,62,62,0,1,0,1,0,deny
4366,51505,0,0,62,62,0,1,0,1,0,deny
61865,35440,0,0,66,66,0,1,0,1,0,deny
53406,44847,0,0,62,62,0,1,0,1,0,deny
27442,44847,0,0,62,62,0,1,0,1,0,deny
47173,35440,0,0,62,62,0,1,0,1,0,deny
51744,445,0,0,70,70,0,1,0,1,0,drop
16221,50584,0,0,62,62,0,1,0,1,0,deny
52174,445,0,0,66,66,0,1,0,1,0,drop
52802,56205,0,0,62,62,0,1,0,1,0,deny
56767,445,0,0,70,70,0,1,0,1,0,drop
56766,445,0,0,70,70,0,1,0,1,0,drop
51734,445,0,0,70,70,0,1,0,1,0,drop
9092,26672,0,0,60,60,0,1,0,1,0,deny
7444,57470,0,0,66,66,0,1,0,1,0,deny
51733,445,0,0,70,70,0,1,0,1,0,drop
19858,38211,0,0,145,145,0,1,0,1,0,deny
8023,64147,0,0,146,146,0,1,0,1,0,deny
2467,2767,0,0,62,62,0,1,0,1,0,deny
42345,443,8962,443,7593,2146,5447,21,10,12,9,allow
52172,445,0,0,66,66,0,1,0,1,0,drop
61804,51505,0,0,66,66,0,1,0,1,0,deny
14082,50584,0,0,66,66,0,1,0,1,0,deny
52168,445,0,0,66,66,0,1,0,1,0,drop
56754,445,0,0,70,70,0,1,0,1,0,drop
51723,445,0,0,70,70,0,1,0,1,0,drop
54684,37965,0,0,62,62,0,1,0,1,0,deny
51722,445,0,0,70,70,0,1,0,1,0,drop
56751,445,0,0,70,70,0,1,0,1,0,drop
56747,445,0,0,70,70,0,1,0,1,0,drop
56746,445,0,0,70,70,0,1,0,1,0,drop
52167,445,0,0,66,66,0,1,0,1,0,drop
61566,44847,0,0,62,62,0,1,0,1,0,deny
51718,445,0,0,70,70,0,1,0,1,0,drop
56739,445,0,0,70,70,0,1,0,1,0,drop
56247,23,0,0,60,60,0,1,0,1,0,deny
51717,445,0,0,70,70,0,1,0,1,0,drop
56737,445,0,0,70,70,0,1,0,1,0,drop
56735,445,0,0,70,70,0,1,0,1,0,drop
56733,445,0,0,70,70,0,1,0,1,0,drop
52159,445,0,0,66,66,0,1,0,1,0,drop
62696,50584,0,0,62,62,0,1,0,1,0,deny
63065,54369,0,0,66,66,0,1,0,1,0,deny
52156,445,0,0,66,66,0,1,0,1,0,drop
52150,445,0,0,66,66,0,1,0,1,0,drop
52154,445,0,0,66,66,0,1,0,1,0,drop
61241,22114,0,0,66,66,0,1,0,1,0,deny
52148,445,0,0,66,66,0,1,0,1,0,drop
52149,445,0,0,66,66,0,1,0,1,0,drop
52146,445,0,0,66,66,0,1,0,1,0,drop
1873,37965,0,0,62,62,0,1,0,1,0,deny
56453,37965,0,0,66,66,0,1,0,1,0,deny
1025,35447,0,0,62,62,0,1,0,1,0,deny
6881,26296,0,0,143,143,0,1,0,1,0,deny
8999,64910,0,0,146,146,0,1,0,1,0,deny
58382,50584,0,0,62,62,0,1,0,1,0,deny
45941,23388,0,0,60,60,0,1,0,1,0,deny
51712,445,0,0,70,70,0,1,0,1,0,drop
56732,445,0,0,70,70,0,1,0,1,0,drop
56728,445,0,0,70,70,0,1,0,1,0,drop
56727,445,0,0,70,70,0,1,0,1,0,drop
6904,30228,0,0,146,146,0,1,0,1,0,deny
46349,51505,0,0,74,74,0,1,0,1,0,deny
52143,445,0,0,66,66,0,1,0,1,0,drop
56724,445,0,0,70,70,0,1,0,1,0,drop
11951,45026,0,0,60,60,0,1,0,1,0,deny
19642,23,0,0,60,60,0,1,0,1,0,deny
52141,445,0,0,66,66,0,1,0,1,0,drop
52139,445,0,0,66,66,0,1,0,1,0,drop
52138,445,0,0,66,66,0,1,0,1,0,drop
52135,445,0,0,66,66,0,1,0,1,0,drop
16524,22114,0,0,62,62,0,1,0,1,0,deny
50355,43890,0,0,66,66,0,1,0,1,0,deny
51699,445,0,0,70,70,0,1,0,1,0,drop
12471,31573,0,0,62,62,0,1,0,1,0,deny
56716,445,0,0,70,70,0,1,0,1,0,drop
56715,445,0,0,70,70,0,1,0,1,0,drop
56707,445,0,0,70,70,0,1,0,1,0,drop
51696,445,0,0,70,70,0,1,0,1,0,drop
58338,3375,0,0,60,60,0,1,0,1,0,deny
38926,37965,0,0,62,62,0,1,0,1,0,deny
1811,35440,0,0,62,62,0,1,0,1,0,deny
5379,37965,0,0,66,66,0,1,0,1,0,deny
52127,445,0,0,66,66,0,1,0,1,0,drop
51691,445,0,0,70,70,0,1,0,1,0,drop
51690,445,0,0,70,70,0,1,0,1,0,drop
52117,445,0,0,66,66,0,1,0,1,0,drop
56696,445,0,0,70,70,0,1,0,1,0,drop
51688,445,0,0,70,70,0,1,0,1,0,drop
63925,37965,0,0,62,62,0,1,0,1,0,deny
52115,445,0,0,66,66,0,1,0,1,0,drop
52108,445,0,0,66,66,0,1,0,1,0,drop
50972,3544,39467,3544,258,107,151,2,30,1,1,allow
37616,443,9088,443,702409,17257,685152,698,32,233,465,allow
49418,27017,55350,27017,275,71,204,2,31,1,1,allow
49418,27015,13881,27015,237,71,166,2,31,1,1,allow
49418,27015,34985,27015,239,71,168,2,31,1,1,allow
57086,53,16252,53,711,87,624,2,30,1,1,allow
61476,443,42404,443,230640,12863,217777,253,62,98,155,allow
49418,27015,42209,27015,234,71,163,2,31,1,1,allow
37584,80,39013,80,3587,2484,1103,19,135,10,9,allow
51741,48440,47763,48440,136,136,0,3,14,3,0,allow
51740,35988,5363,35988,136,136,0,3,14,3,0,allow
38659,15000,47156,15000,138,78,60,2,5,1,1,allow
49418,27022,63608,27022,229,71,158,2,31,1,1,allow
49418,27015,37107,27015,223,71,152,2,31,1,1,allow
49418,27015,14560,27015,71,71,0,1,30,1,0,allow
45859,443,65407,443,5508,999,4509,20,255,11,9,allow
54144,443,45159,443,5736,1990,3746,25,16,14,11,allow
49418,27015,52121,27015,232,71,161,2,31,1,1,allow
58851,443,62485,443,15848,13507,2341,37,32,19,18,allow
49418,27015,37886,27015,219,71,148,2,31,1,1,allow
49418,27016,40313,27016,71,71,0,1,30,1,0,allow
56683,443,56683,443,4533,1626,2907,19,28,11,8,allow
52096,443,15286,443,283,163,120,4,15,2,2,allow
50458,80,53639,80,1426,865,561,9,15,5,4,allow
57385,80,37415,80,2546,1294,1252,17,138,9,8,allow
55363,443,55363,443,5458,2211,3247,22,39,13,9,allow
58506,53,0,0,192,86,106,2,30,1,1,allow
5588,5588,0,0,3354,1792,1562,46,193,23,23,allow
57477,53,0,0,186,83,103,2,30,1,1,allow
49418,27018,3626,27018,71,71,0,1,30,1,0,allow
65518,53,19504,53,701,88,613,2,30,1,1,allow
5938,20273,0,0,60,60,0,1,90,1,0,allow
44277,443,64665,443,36026,28458,7568,70,407,30,40,allow
49418,27015,36683,27015,251,71,180,2,31,1,1,allow
49418,27017,34824,27017,255,71,184,2,31,1,1,allow
43103,443,44934,443,3149,1899,1250,19,15,9,10,allow
43104,443,41004,443,3067,1817,1250,18,15,8,10,allow
51757,54657,4096,54657,70,70,0,2,8,2,0,allow
63763,17368,13988,17368,66,66,0,2,8,2,0,allow
50532,443,27098,443,7416,1777,5639,23,74,12,11,allow
53550,1,57289,1,70,70,0,1,5,1,0,allow
46339,443,43068,443,4392,1781,2611,21,20,12,9,allow
59793,443,27595,443,840,456,384,14,25,8,6,allow
7487,443,7487,443,4265,1184,3081,18,16,9,9,allow
8978,443,11135,443,49938,20855,29083,165,216,81,84,allow
41643,443,51338,443,16032,13508,2524,37,36,19,18,allow
62731,443,62731,443,9938,3644,6294,31,18,18,13,allow
48889,443,65230,443,87648,6895,80753,131,364,66,65,allow
62108,443,7391,443,9652,2914,6738,22,124,11,11,allow
19473,6889,63001,6889,480,149,331,2,1200,1,1,allow
65306,443,3584,443,5756,1781,3975,23,136,11,12,allow
51681,445,0,0,70,70,0,1,0,1,0,drop
6881,6881,0,0,62,62,0,1,0,1,0,deny
52099,445,0,0,66,66,0,1,0,1,0,drop
26211,1433,0,0,60,60,0,1,0,1,0,deny
51679,445,0,0,70,70,0,1,0,1,0,drop
62859,35440,0,0,66,66,0,1,0,1,0,deny
49418,27015,49804,27015,248,78,170,2,30,1,1,allow
49766,80,16081,80,254,128,126,5,15,3,2,allow
6712,123,0,0,90,90,0,1,0,1,0,deny
51678,445,0,0,70,70,0,1,0,1,0,drop
61000,15503,0,0,146,146,0,1,0,1,0,deny
51677,445,0,0,70,70,0,1,0,1,0,drop
51676,445,0,0,70,70,0,1,0,1,0,drop
51673,445,0,0,70,70,0,1,0,1,0,drop
51672,445,0,0,70,70,0,1,0,1,0,drop
39715,35440,0,0,146,146,0,1,0,1,0,deny
11404,64147,0,0,62,62,0,1,0,1,0,deny
53298,26467,0,0,66,66,0,1,0,1,0,deny
30111,2323,0,0,60,60,0,1,0,1,0,deny
56687,445,0,0,70,70,0,1,0,1,0,drop
56686,445,0,0,70,70,0,1,0,1,0,drop
56683,445,0,0,70,70,0,1,0,1,0,drop
29706,50584,0,0,62,62,0,1,0,1,0,deny
52088,445,0,0,66,66,0,1,0,1,0,drop
52090,445,0,0,66,66,0,1,0,1,0,drop
52084,445,0,0,66,66,0,1,0,1,0,drop
51650,80,36691,80,141348,4210,137138,161,17,58,103,allow
53300,443,53300,443,4406,1499,2907,19,30,11,8,allow
49256,53,47190,53,177,94,83,2,30,1,1,allow
63609,53,0,0,182,81,101,2,30,1,1,allow
55216,53,0,0,192,86,106,2,30,1,1,allow
46893,443,27910,443,622,70,552,10,180,2,8,allow
64112,443,40510,443,4116645,96572,4020073,4029,58,1356,2673,allow
55606,21802,21715,21802,320,140,180,6,5,3,3,allow
49767,80,10412,80,70,70,0,1,4,1,0,allow
50979,80,12190,80,576971,8128,568843,497,38,114,383,allow
37267,443,16640,443,3296,1636,1660,17,255,9,8,allow
49892,443,4679,443,6966,1436,5530,32,600,13,19,allow
49540,443,8159,443,7454,2377,5077,33,130,15,18,allow
36151,443,3051,443,22856,2980,19876,43,116,19,24,allow
56033,443,58131,443,8396,1919,6477,27,116,12,15,allow
10080,443,4270,443,130,70,60,3,5,2,1,allow
36209,443,44738,443,656609,25419,631190,752,62,322,430,allow
51738,47483,4479,47483,70,70,0,1,5,1,0,allow
40334,443,51232,443,8296,3123,5173,40,132,14,26,allow
51656,80,50242,80,152651,4700,147951,174,17,65,109,allow
32053,443,32053,443,28195,6044,22151,58,17,30,28,allow
58941,80,60543,80,1114,534,580,12,15,7,5,allow
53574,23650,56670,23650,320,140,180,6,5,3,3,allow
63759,64509,33605,64509,66,66,0,2,7,2,0,allow
51743,40358,22101,40358,136,136,0,3,14,3,0,allow
56602,80,9300,80,234,234,0,4,11,4,0,allow
49418,27015,54748,27015,78,78,0,1,29,1,0,allow
61723,443,17384,443,6962,979,5983,19,15,10,9,allow
63675,123,55630,123,184,94,90,2,29,1,1,allow
49418,27015,38933,27015,78,78,0,1,29,1,0,allow
64992,53,39214,53,177,94,83,2,29,1,1,allow
49418,27015,35776,27015,78,78,0,1,29,1,0,allow
64992,53,21333,53,177,94,83,2,29,1,1,allow
42307,443,58231,443,101673,5966,95707,121,178,47,74,allow
56928,80,39650,80,526,304,222,8,35,5,3,allow
49418,27015,60296,27015,253,78,175,2,31,1,1,allow
50520,443,34844,443,9942,1211,8731,26,77,14,12,allow
49418,27018,24351,27018,240,78,162,2,30,1,1,allow
53286,443,1896,443,123194,68738,54456,402,287,167,235,allow
49214,443,4327,443,17273,11238,6035,73,919,36,37,allow
56781,17548,14113,17548,70,70,0,1,5,1,0,allow
47705,443,21979,443,25643,2181,23462,44,363,18,26,allow
51756,41471,23556,41471,70,70,0,2,8,2,0,allow
47832,80,56253,80,1151,711,440,10,15,5,5,allow
51407,443,57078,443,202,70,132,3,11,1,2,allow
65178,53,0,0,190,85,105,2,30,1,1,allow
59573,443,39847,443,289380,13628,275752,335,70,142,193,allow
49418,27015,5163,27015,265,78,187,2,31,1,1,allow
64532,53,56480,53,258,110,148,2,30,1,1,allow
56927,80,6442,80,214,140,74,4,35,3,1,allow
49418,27015,55530,27015,244,78,166,2,30,1,1,allow
55146,53,47576,53,277,110,167,2,30,1,1,allow
56709,53,55050,53,211,102,109,2,30,1,1,allow
43032,443,31725,443,6792,3009,3783,20,46,12,8,allow
55312,443,20877,443,7952,3638,4314,36,149,17,19,allow
49418,27015,12957,27015,271,78,193,2,31,1,1,allow
49418,27015,22382,27015,243,78,165,2,31,1,1,allow
49418,27013,52000,27013,241,78,163,2,30,1,1,allow
49418,27444,10177,27444,258,78,180,2,30,1,1,allow
45292,443,27457,443,26444,2671,23773,52,363,25,27,allow
59937,443,12788,443,70,70,0,1,5,1,0,allow
54346,443,30268,443,12594,5098,7496,32,36,17,15,allow
58530,53,0,0,188,84,104,2,30,1,1,allow
49256,53,12893,53,177,94,83,2,30,1,1,allow
59431,443,29795,443,12756,3596,9160,31,299,16,15,allow
61721,443,43568,443,9676,2327,7349,25,16,15,10,allow
57357,53,10860,53,231,94,137,2,30,1,1,allow
58110,53,0,0,178,79,99,2,30,1,1,allow
50972,3544,44578,3544,409,107,302,4,30,2,2,allow
49418,27015,47175,27015,234,78,156,2,30,1,1,allow
49418,27016,3773,27016,242,78,164,2,30,1,1,allow
56744,31151,15345,31151,1703,524,1179,9,30,5,4,allow
49522,80,55749,80,6908,1652,5256,26,225,12,14,allow
59957,443,65089,443,8677,2714,5963,21,114,13,8,allow
55611,53,41439,53,768,200,568,6,53,3,3,allow
52496,443,9919,443,9500,4662,4838,20,16,11,9,allow
51652,80,57447,80,141220,4280,136940,159,17,59,100,allow
51499,443,1743,443,6848,769,6079,17,15,9,8,allow
54528,443,20055,443,6256,1871,4385,20,45,12,8,allow
53573,14856,10337,14856,320,140,180,6,5,3,3,allow
47893,443,63291,443,172,172,0,2,4,2,0,allow
49418,27014,18652,27014,249,78,171,2,31,1,1,allow
49418,27015,11506,27015,248,78,170,2,30,1,1,allow
50208,1688,43148,1688,70,70,0,1,5,1,0,allow
46822,443,53756,443,71073,4403,66670,99,116,41,58,allow
53548,23310,59949,23310,70,70,0,1,4,1,0,allow
53298,443,53298,443,4348,1441,2907,19,29,11,8,allow
33841,443,9860,443,12521,6232,6289,43,80,22,21,allow
53552,8999,43016,8999,70,70,0,1,4,1,0,allow
35428,443,14497,443,9592,2361,7231,25,15,14,11,allow
55605,27274,38364,27274,130,70,60,3,5,2,1,allow
56468,80,52689,80,214,140,74,4,26,3,1,allow
63757,51413,7176,51413,66,66,0,2,7,2,0,allow
59938,443,3054,443,70,70,0,1,5,1,0,allow
51742,20110,30208,20110,136,136,0,3,14,3,0,allow
47892,443,55293,443,172,172,0,2,5,2,0,allow
50521,443,9816,443,11880,1972,9908,29,78,15,14,allow
57287,53,47799,53,305,102,203,2,29,1,1,allow
55807,53,4924,53,257,102,155,2,29,1,1,allow
58331,443,26953,443,31515,26798,4717,91,82,49,42,allow
55851,53,42151,53,277,110,167,2,30,1,1,allow
65339,53,32222,53,193,102,91,2,29,1,1,allow
49418,27015,18735,27015,244,78,166,2,30,1,1,allow
40329,80,42227,80,2128,798,1330,14,46,7,7,allow
64843,443,36183,443,13583,4157,9426,26,120,11,15,allow
55267,53,26990,53,214,102,112,2,29,1,1,allow
64201,53,27931,53,200,94,106,2,29,1,1,allow
64785,53,44600,53,281,94,187,2,29,1,1,allow
65057,53,8165,53,211,94,117,2,30,1,1,allow
64236,53,6587,53,211,102,109,2,30,1,1,allow
53483,443,14059,443,8333,2292,6041,27,360,15,12,allow
49418,4444,6124,4444,238,78,160,2,31,1,1,allow
51498,443,60787,443,7211,823,6388,16,15,10,6,allow
56760,48386,9485,48386,268,70,198,4,19,1,3,allow
59308,443,6790,443,12169,4963,7206,60,262,31,29,allow
49211,443,58097,443,9739,3414,6325,59,928,30,29,allow
53821,53,5224,53,199,94,105,2,30,1,1,allow
46758,123,10814,123,184,94,90,2,30,1,1,allow
56374,53,9778,53,212,102,110,2,30,1,1,allow
57664,443,45877,443,5111,2193,2918,19,120,9,10,allow
33107,443,39338,443,35031,3490,31541,60,363,28,32,allow
44155,443,5461,443,5157,917,4240,20,360,10,10,allow
49418,27015,33694,27015,246,78,168,2,31,1,1,allow
50464,80,5838,80,26020,2247,23773,47,18,23,24,allow
40243,443,64916,443,284,164,120,4,15,2,2,allow
49418,27017,12250,27017,239,78,161,2,30,1,1,allow
58420,443,23233,443,17161,1619,15542,18,149,4,14,allow
26805,443,51742,443,21055,15996,5059,39,22,22,17,allow
64027,53,2870,53,360,97,263,4,38,2,2,allow
62757,123,11526,123,184,94,90,2,30,1,1,allow
50089,53,56216,53,718,94,624,2,30,1,1,allow
64194,53,10058,53,262,126,136,2,30,1,1,allow
64114,53,0,0,200,90,110,2,30,1,1,allow
56120,53,44279,53,177,94,83,2,30,1,1,allow
56120,53,38603,53,177,94,83,2,30,1,1,allow
41485,443,16482,443,29513,23962,5551,40,121,24,16,allow
49418,29999,25371,29999,244,78,166,2,31,1,1,allow
58721,443,55162,443,7973,4166,3807,28,141,14,14,allow
64494,443,46008,443,2872,717,2155,14,135,6,8,allow
60711,443,38043,443,12258,1451,10807,27,360,13,14,allow
6881,39927,58260,39927,228,118,110,2,1199,1,1,allow
56035,443,61035,443,10622,4094,6528,29,514,16,13,allow
52556,443,21958,443,5696,2392,3304,23,135,10,13,allow
43108,443,38121,443,7578,2358,5220,18,121,8,10,allow
36192,443,26140,443,4555,859,3696,17,360,9,8,allow
57470,14806,59723,14806,132,132,0,3,1199,3,0,allow
43345,443,34624,443,7767,1069,6698,23,3971,7,16,allow
57470,33159,38691,33159,594,594,0,10,1199,10,0,allow
6881,6881,22683,6881,502,150,352,2,1200,1,1,allow
46697,5228,40766,5228,9263,549,8714,17,3638,5,12,allow
14667,443,14667,443,20280,2078,18202,35,17,19,16,allow
61376,443,37067,443,31612,3374,28238,59,271,29,30,allow
51204,123,19622,123,184,94,90,2,30,1,1,allow
55326,53,27995,53,177,94,83,2,30,1,1,allow
56096,443,56096,443,5493,2246,3247,22,39,13,9,allow
50036,53,50623,53,353,118,235,2,31,1,1,allow
49418,27001,19678,27001,274,78,196,2,31,1,1,allow
59787,443,59787,443,5525,2278,3247,22,40,13,9,allow
55366,53,65278,53,79,79,0,2,35,2,0,allow
50907,80,50964,80,16037318,218904,15818414,13595,136,2976,10619,allow
65347,53,20093,53,352,94,258,2,30,1,1,allow
54576,443,43696,443,5670,3091,2579,16,121,8,8,allow
52092,445,0,0,66,66,0,1,0,1,0,drop
52087,445,0,0,66,66,0,1,0,1,0,drop
52091,445,0,0,66,66,0,1,0,1,0,drop
52085,445,0,0,66,66,0,1,0,1,0,drop
52086,445,0,0,66,66,0,1,0,1,0,drop
51658,445,0,0,70,70,0,1,0,1,0,drop
51657,445,0,0,70,70,0,1,0,1,0,drop
51655,445,0,0,70,70,0,1,0,1,0,drop
51648,445,0,0,70,70,0,1,0,1,0,drop
51647,445,0,0,70,70,0,1,0,1,0,drop
51829,36134,0,0,66,66,0,1,0,1,0,deny
59315,35440,0,0,66,66,0,1,0,1,0,deny
17177,64147,0,0,62,62,0,1,0,1,0,deny
20389,64147,0,0,62,62,0,1,0,1,0,deny
28124,37965,0,0,145,145,0,1,0,1,0,deny
12311,6881,0,0,62,62,0,1,0,1,0,deny
42946,31573,0,0,146,146,0,1,0,1,0,deny
1227,56205,0,0,66,66,0,1,0,1,0,deny
56678,445,0,0,70,70,0,1,0,1,0,drop
56675,445,0,0,70,70,0,1,0,1,0,drop
56669,445,0,0,70,70,0,1,0,1,0,drop
4910,2149,0,0,66,66,0,1,0,1,0,deny
57441,57470,0,0,66,66,0,1,0,1,0,deny
52072,445,0,0,66,66,0,1,0,1,0,drop
52071,445,0,0,66,66,0,1,0,1,0,drop
52070,445,0,0,66,66,0,1,0,1,0,drop
30496,57470,0,0,62,62,0,1,0,1,0,deny
51636,445,0,0,70,70,0,1,0,1,0,drop
42128,54532,0,0,60,60,0,1,0,1,0,deny
64000,44847,0,0,62,62,0,1,0,1,0,deny
56666,445,0,0,70,70,0,1,0,1,0,drop
60246,44612,0,0,62,62,0,1,0,1,0,deny
50052,65008,0,0,60,60,0,1,0,1,0,deny
27368,22114,0,0,62,62,0,1,0,1,0,deny
11136,15503,0,0,62,62,0,1,0,1,0,deny
56663,445,0,0,70,70,0,1,0,1,0,drop
58329,62413,0,0,62,62,0,1,0,1,0,deny
56654,445,0,0,70,70,0,1,0,1,0,drop
56655,445,0,0,70,70,0,1,0,1,0,drop
56652,445,0,0,70,70,0,1,0,1,0,drop
40082,22,0,0,60,60,0,1,0,1,0,deny
51632,445,0,0,70,70,0,1,0,1,0,drop
64341,57470,0,0,62,62,0,1,0,1,0,deny
31845,55777,0,0,62,62,0,1,0,1,0,deny
59597,37965,0,0,66,66,0,1,0,1,0,deny
38681,15503,0,0,74,74,0,1,0,1,0,deny
53447,44847,0,0,66,66,0,1,0,1,0,deny
51623,445,0,0,70,70,0,1,0,1,0,drop
51622,445,0,0,70,70,0,1,0,1,0,drop
63379,36237,0,0,66,66,0,1,0,1,0,deny
51617,445,0,0,70,70,0,1,0,1,0,drop
51620,445,0,0,70,70,0,1,0,1,0,drop
52472,7302,0,0,66,66,0,1,0,1,0,deny
51616,445,0,0,70,70,0,1,0,1,0,drop
10003,64147,0,0,62,62,0,1,0,1,0,deny
30307,51505,0,0,62,62,0,1,0,1,0,deny
56641,445,0,0,70,70,0,1,0,1,0,drop
56640,445,0,0,70,70,0,1,0,1,0,drop
56639,445,0,0,70,70,0,1,0,1,0,drop
9067,44847,0,0,62,62,0,1,0,1,0,deny
54140,43890,0,0,66,66,0,1,0,1,0,deny
9092,26672,0,0,60,60,0,1,0,1,0,deny
61983,50432,0,0,66,66,0,1,0,1,0,deny
51963,22114,0,0,62,62,0,1,0,1,0,deny
51609,445,0,0,70,70,0,1,0,1,0,drop
1024,22114,0,0,146,146,0,1,0,1,0,deny
12605,57470,0,0,62,62,0,1,0,1,0,deny
10586,37965,0,0,62,62,0,1,0,1,0,deny
46587,57470,0,0,66,66,0,1,0,1,0,deny
51732,50584,0,0,146,146,0,1,0,1,0,deny
28839,30188,0,0,62,62,0,1,0,1,0,deny
65016,37965,0,0,66,66,0,1,0,1,0,deny
17315,11392,0,0,66,66,0,1,0,1,0,deny
52050,445,0,0,66,66,0,1,0,1,0,drop
56638,445,0,0,70,70,0,1,0,1,0,drop
56637,445,0,0,70,70,0,1,0,1,0,drop
60617,64147,0,0,62,62,0,1,0,1,0,deny
27010,64147,0,0,62,62,0,1,0,1,0,deny
51602,445,0,0,70,70,0,1,0,1,0,drop
51599,445,0,0,70,70,0,1,0,1,0,drop
10248,21247,0,0,62,62,0,1,0,1,0,deny
59701,44847,0,0,66,66,0,1,0,1,0,deny
58458,17,0,0,60,60,0,1,0,1,0,deny
2522,64147,0,0,62,62,0,1,0,1,0,deny
64024,57470,0,0,66,66,0,1,0,1,0,deny
48386,9485,0,0,60,60,0,1,0,1,0,deny
61148,37965,0,0,66,66,0,1,0,1,0,deny
26332,57470,0,0,62,62,0,1,0,1,0,deny
63314,57470,0,0,66,66,0,1,0,1,0,deny
52041,445,0,0,66,66,0,1,0,1,0,drop
51596,445,0,0,70,70,0,1,0,1,0,drop
51594,445,0,0,70,70,0,1,0,1,0,drop
52040,445,0,0,66,66,0,1,0,1,0,drop
56628,445,0,0,70,70,0,1,0,1,0,drop
3802,55777,0,0,66,66,0,1,0,1,0,deny
52788,64147,0,0,62,62,0,1,0,1,0,deny
55966,57866,0,0,62,62,0,1,0,1,0,deny
29313,48817,0,0,145,145,0,1,0,1,0,deny
56620,445,0,0,70,70,0,1,0,1,0,drop
56618,445,0,0,70,70,0,1,0,1,0,drop
56616,445,0,0,70,70,0,1,0,1,0,drop
52037,445,0,0,66,66,0,1,0,1,0,drop
25595,2323,0,0,60,60,0,1,0,1,0,deny
50116,22,0,0,60,60,0,1,0,1,0,deny
51590,445,0,0,70,70,0,1,0,1,0,drop
59940,50584,0,0,66,66,0,1,0,1,0,deny
65060,35440,0,0,66,66,0,1,0,1,0,deny
33931,50584,0,0,62,62,0,1,0,1,0,deny
9957,32480,0,0,66,66,0,1,0,1,0,deny
51589,445,0,0,70,70,0,1,0,1,0,drop
53437,44847,0,0,66,66,0,1,0,1,0,deny
51339,50584,0,0,62,62,0,1,0,1,0,deny
56613,445,0,0,70,70,0,1,0,1,0,deny
44538,50584,0,0,62,62,0,1,0,1,0,deny
56608,445,0,0,70,70,0,1,0,1,0,drop
56606,445,0,0,70,70,0,1,0,1,0,drop
56604,445,0,0,70,70,0,1,0,1,0,drop
30129,37965,0,0,72,72,0,1,0,1,0,deny
52188,1433,0,0,60,60,0,1,0,1,0,deny
62804,37965,0,0,66,66,0,1,0,1,0,deny
0,0,0,0,60,60,0,1,0,1,0,deny
52029,445,0,0,66,66,0,1,0,1,0,drop
3001,28680,0,0,148,148,0,1,0,1,0,deny
8211,28793,0,0,66,66,0,1,0,1,0,deny
46389,27098,0,0,66,66,0,1,0,1,0,deny
52027,445,0,0,66,66,0,1,0,1,0,drop
52025,445,0,0,66,66,0,1,0,1,0,drop
52022,445,0,0,66,66,0,1,0,1,0,drop
60188,15503,0,0,66,66,0,1,0,1,0,deny
8889,19777,0,0,60,60,0,1,0,1,0,deny
22541,64147,0,0,66,66,0,1,0,1,0,deny
52020,445,0,0,66,66,0,1,0,1,0,drop
52021,445,0,0,66,66,0,1,0,1,0,drop
55468,23,0,0,60,60,0,1,0,1,0,deny
51584,445,0,0,70,70,0,1,0,1,0,drop
52690,7302,0,0,66,66,0,1,0,1,0,deny
56601,445,0,0,70,70,0,1,0,1,0,drop
56600,445,0,0,70,70,0,1,0,1,0,drop
56598,445,0,0,70,70,0,1,0,1,0,drop
52017,445,0,0,66,66,0,1,0,1,0,drop
32710,22114,0,0,62,62,0,1,0,1,0,deny
56595,445,0,0,70,70,0,1,0,1,0,drop
5223,34403,0,0,220,220,0,1,0,1,0,deny
21733,56205,0,0,66,66,0,1,0,1,0,deny
52012,445,0,0,66,66,0,1,0,1,0,drop
30598,46824,0,0,62,62,0,1,0,1,0,deny
52519,44847,0,0,66,66,0,1,0,1,0,deny
53408,50243,0,0,145,145,0,1,0,1,0,deny
1749,64147,0,0,66,66,0,1,0,1,0,deny
52010,445,0,0,66,66,0,1,0,1,0,drop
52009,445,0,0,66,66,0,1,0,1,0,drop
50734,37965,0,0,62,62,0,1,0,1,0,deny
59128,44847,0,0,66,66,0,1,0,1,0,deny
25772,7302,0,0,66,66,0,1,0,1,0,deny
52007,445,0,0,66,66,0,1,0,1,0,drop
50084,26672,0,0,62,62,0,1,0,1,0,deny
54894,9571,0,0,66,66,0,1,0,1,0,deny
51571,445,0,0,70,70,0,1,0,1,0,drop
55413,37965,0,0,66,66,0,1,0,1,0,deny
42632,44847,0,0,62,62,0,1,0,1,0,deny
61185,54532,0,0,62,62,0,1,0,1,0,deny
42745,50011,0,0,62,62,0,1,0,1,0,deny
50084,26672,0,0,145,145,0,1,0,1,0,deny
56587,445,0,0,70,70,0,1,0,1,0,drop
51568,445,0,0,70,70,0,1,0,1,0,drop
63701,46824,0,0,66,66,0,1,0,1,0,deny
38976,46824,0,0,62,62,0,1,0,1,0,deny
35347,20238,0,0,62,62,0,1,0,1,0,deny
56583,445,0,0,70,70,0,1,0,1,0,drop
56581,445,0,0,70,70,0,1,0,1,0,drop
15131,50584,0,0,62,62,0,1,0,1,0,deny
51151,64147,0,0,66,66,0,1,0,1,0,deny
38645,51221,0,0,62,62,0,1,0,1,0,deny
42209,36237,0,0,146,146,0,1,0,1,0,deny
51413,32480,0,0,72,72,0,1,0,1,0,deny
4515,37807,0,0,146,146,0,1,0,1,0,deny
49418,27025,19302,27025,71,71,0,1,30,1,0,allow
49418,27021,53913,27021,232,71,161,2,30,1,1,allow
49418,27015,47844,27015,214,71,143,2,30,1,1,allow
49418,23333,56641,23333,244,71,173,2,30,1,1,allow
50502,123,48233,123,184,94,90,2,30,1,1,allow
61699,443,44016,443,16358,3103,13255,39,19,19,20,allow
50605,443,19181,443,13409,3033,10376,29,124,15,14,allow
64567,443,24686,443,24984,2042,22942,41,32,19,22,allow
49418,37579,44074,37579,239,71,168,2,30,1,1,allow
60395,6890,41049,6890,70,70,0,2,8,2,0,allow
55326,53,8434,53,170,87,83,2,30,1,1,allow
51164,443,40341,443,7569,2113,5456,26,361,14,12,allow
49418,30007,64637,30007,242,71,171,2,30,1,1,allow
53538,33791,33383,33791,618,432,186,9,17,6,3,allow
49418,37569,43147,37569,237,71,166,2,30,1,1,allow
37174,443,43183,443,752907,69016,683891,1372,231,537,835,allow
49418,27026,25116,27026,71,71,0,1,30,1,0,allow
49418,27022,21779,27022,71,71,0,1,30,1,0,allow
49418,30006,39633,30006,244,71,173,2,30,1,1,allow
62995,3389,62995,3389,4213,2429,1784,18,32,9,9,allow
32971,443,32971,443,18895,2061,16834,34,17,18,16,allow
18796,443,17365,443,2227,1018,1209,17,15,8,9,allow
53574,443,38690,443,117116,5692,111424,153,18,56,97,allow
52625,53,52625,53,231,88,143,2,32,1,1,allow
53565,58695,57027,58695,70,70,0,2,8,2,0,allow
35065,443,35065,443,5537,2290,3247,22,39,13,9,allow
28539,53,28539,53,231,88,143,2,32,1,1,allow
50622,53,42098,53,202,83,119,2,30,1,1,allow
46327,25903,25335,25903,332,192,140,6,25,4,2,allow
39207,80,48256,80,234,234,0,4,12,4,0,allow
36712,53,0,0,138,69,69,2,30,1,1,allow
50437,3389,50437,3389,3444,1730,1714,16,31,8,8,allow
49418,27019,20347,27019,71,71,0,1,30,1,0,allow
49418,27015,42779,27015,227,71,156,2,30,1,1,allow
49418,27015,63577,27015,71,71,0,1,30,1,0,allow
49418,12345,11846,12345,249,71,178,2,30,1,1,allow
49418,30010,58880,30010,238,71,167,2,30,1,1,allow
14469,443,14469,443,274,132,142,5,15,3,2,allow
50501,443,19632,443,1499,930,569,16,78,9,7,allow
42040,5228,16525,5228,60,60,0,1,5,1,0,allow
47091,443,36299,443,6326,4367,1959,31,144,17,14,allow
51753,15038,3918,15038,70,70,0,2,7,2,0,allow
44206,53,19423,53,202,83,119,2,30,1,1,allow
50172,443,41441,443,161,101,60,2,5,1,1,allow
53760,80,45731,80,1667,619,1048,10,45,6,4,allow
49418,30003,43016,30003,71,71,0,1,30,1,0,allow
49418,27015,44388,27015,71,71,0,1,30,1,0,allow
49418,27016,19249,27016,240,71,169,2,30,1,1,allow
49418,16666,10447,16666,71,71,0,1,30,1,0,allow
65348,53,36995,53,170,87,83,2,30,1,1,allow
49418,30002,50815,30002,242,71,171,2,30,1,1,allow
5938,19141,0,0,60,60,0,1,91,1,0,allow
50895,443,43273,443,14584,6798,7786,37,181,18,19,allow
30960,45684,7454,45684,330,330,0,6,3609,6,0,allow
37965,22343,64266,22343,1307,594,713,17,1657,10,7,allow
51997,445,0,0,66,66,0,1,0,1,0,drop
21492,51505,0,0,62,62,0,1,0,1,0,deny
11716,37965,0,0,62,62,0,1,0,1,0,deny
51563,445,0,0,70,70,0,1,0,1,0,drop
38633,51221,0,0,66,66,0,1,0,1,0,deny
54424,50584,0,0,146,146,0,1,0,1,0,deny
25536,50584,0,0,62,62,0,1,0,1,0,deny
51562,445,0,0,70,70,0,1,0,1,0,drop
443,9986,0,0,352,352,0,1,0,1,0,deny
51105,50584,0,0,66,66,0,1,0,1,0,deny
35644,67,0,0,60,60,0,1,0,1,0,deny
51560,445,0,0,70,70,0,1,0,1,0,drop
49418,26259,63056,26259,254,78,176,2,30,1,1,allow
49418,27016,30078,27016,78,78,0,1,30,1,0,allow
49418,30008,26844,30008,236,78,158,2,30,1,1,allow
34464,443,64076,443,1402,910,492,11,360,6,5,allow
57370,443,5735,443,7211,823,6388,16,15,10,6,allow
48252,443,35978,443,283034,39462,243572,536,224,257,279,allow
49418,37569,8517,37569,246,78,168,2,30,1,1,allow
52555,443,31121,443,4362,1826,2536,18,134,8,10,allow
55015,443,30029,443,8133,2402,5731,35,255,17,18,allow
49400,80,14888,80,40119,2475,37644,49,84,16,33,allow
52122,443,45457,443,5841,1986,3855,19,15,11,8,allow
49224,443,16302,443,93540,22718,70822,155,918,65,90,allow
7686,80,7686,80,176670,11287,165383,216,46,96,120,allow
38136,443,41208,443,3919,1099,2820,35,627,9,26,allow
49233,443,34014,443,9622,3524,6098,59,916,29,30,allow
49201,443,23062,443,13738,6378,7360,70,981,33,37,allow
49189,443,36551,443,15611,1501,14110,32,361,14,18,allow
55326,53,39375,53,177,94,83,2,29,1,1,allow
49418,27015,35116,27015,78,78,0,1,30,1,0,allow
49418,27001,35049,27001,256,78,178,2,30,1,1,allow
40232,53,19769,53,205,86,119,2,29,1,1,allow
49418,27015,31380,27015,239,78,161,2,30,1,1,allow
49418,33086,18224,33086,237,78,159,2,30,1,1,allow
56739,42421,49450,42421,2810,1382,1428,12,31,6,6,allow
49418,27015,24624,27015,78,78,0,1,30,1,0,allow
55594,53,28823,53,168,78,90,2,30,1,1,allow
56845,443,17798,443,16207,6355,9852,84,195,43,41,allow
60386,9136,45378,9136,624,318,306,10,16,5,5,allow
57714,53,57714,53,233,90,143,2,32,1,1,allow
63758,57825,49491,57825,312,132,180,6,6,3,3,allow
51739,62163,32244,62163,70,70,0,1,5,1,0,allow
63737,80,37849,80,314,192,122,6,15,4,2,allow
37352,80,54268,80,1115,562,553,13,362,6,7,allow
49418,27015,22086,27015,78,78,0,1,30,1,0,allow
49418,28002,23648,28002,271,78,193,2,30,1,1,allow
42128,80,52556,80,1139,506,633,10,15,6,4,allow
49418,27053,45679,27053,78,78,0,1,30,1,0,allow
56843,443,16451,443,54661,36820,17841,266,201,128,138,allow
51399,443,28295,443,642,582,60,2,5,1,1,allow
65198,53,6063,53,448,94,354,4,49,2,2,allow
49418,33032,30338,33032,78,78,0,1,30,1,0,allow
49418,27015,38880,27015,78,78,0,1,30,1,0,allow
47808,53,24079,53,168,78,90,2,30,1,1,allow
34465,443,9083,443,1402,910,492,11,360,6,5,allow
34466,443,32529,443,1402,910,492,11,360,6,5,allow
49418,33098,30068,33098,78,78,0,1,30,1,0,allow
56844,443,48471,443,10878,4815,6063,60,196,31,29,allow
65426,53,23528,53,706,195,511,6,52,3,3,allow
39356,443,35388,443,7134,2290,4844,29,80,15,14,allow
56541,443,9751,443,130,70,60,2,15,1,1,allow
49418,27015,59160,27015,78,78,0,1,30,1,0,allow
49418,30050,47158,30050,78,78,0,1,30,1,0,allow
64805,53,57151,53,215,102,113,2,30,1,1,allow
49418,33058,55897,33058,244,78,166,2,30,1,1,allow
57144,8525,57144,8525,138,78,60,2,5,1,1,allow
50550,443,50550,443,5642,2395,3247,22,38,13,9,allow
42686,443,38351,443,190,70,120,4,15,2,2,allow
44320,443,12809,443,7244,1861,5383,26,330,14,12,allow
57598,443,10245,443,12463,6762,5701,28,31,14,14,allow
49418,27015,25961,27015,234,78,156,2,30,1,1,allow
49418,27015,26023,27015,78,78,0,1,30,1,0,allow
49418,32036,34122,32036,243,78,165,2,30,1,1,allow
49418,27056,31810,27056,269,78,191,2,30,1,1,allow
56846,443,26374,443,9370,3805,5565,43,181,21,22,allow
44512,443,54023,443,1101393,30310,1071083,1137,109,381,756,allow
50516,443,49495,443,12855,2077,10778,30,78,15,15,allow
38653,443,63492,443,6969,2162,4807,20,15,11,9,allow
49228,443,26216,443,13758,6577,7181,66,918,34,32,allow
55212,443,36417,443,10500,5056,5444,23,143,11,12,allow
60964,443,25466,443,2080,1376,704,17,30,9,8,allow
44516,443,18408,443,156324,6993,149331,192,108,81,111,allow
44514,443,59227,443,448741,15805,432936,491,109,181,310,allow
51774,80,22011,80,240,120,120,5,27,3,2,allow
45619,80,13038,80,1052,612,440,10,15,5,5,allow
50497,443,60901,443,1322,725,597,14,78,7,7,allow
46291,443,48252,443,70,70,0,1,5,1,0,allow
49418,27015,58093,27015,78,78,0,1,30,1,0,allow
50996,443,60752,443,12654,1719,10935,28,21,15,13,allow
59770,443,37125,443,7316,1933,5383,27,16,15,12,allow
49418,29999,18255,29999,239,78,161,2,30,1,1,allow
35164,443,44026,443,5505,995,4510,20,255,11,9,allow
53227,53,29917,53,205,86,119,2,29,1,1,allow
49260,53,27595,53,177,86,91,2,29,1,1,allow
60384,64170,40565,64170,504,318,186,8,16,5,3,allow
49619,53,1376,53,184,86,98,2,30,1,1,allow
49418,27015,11221,27015,240,78,162,2,30,1,1,allow
65348,53,2839,53,177,94,83,2,30,1,1,allow
49418,27015,25593,27015,258,78,180,2,30,1,1,allow
49418,27080,21881,27080,238,78,160,2,30,1,1,allow
49418,27054,42342,27054,272,78,194,2,30,1,1,allow
49418,26169,6616,26169,78,78,0,1,30,1,0,allow
49418,32038,58741,32038,235,78,157,2,30,1,1,allow
49418,32058,6170,32058,78,78,0,1,30,1,0,allow
58663,53,40233,53,167,78,89,2,30,1,1,allow
55454,443,35001,443,1784,247,1537,7,120,4,3,allow
55455,443,13171,443,1786,172,1614,7,120,3,4,allow
50540,443,25941,443,134507,6585,127922,148,121,51,97,allow
50265,13302,54682,13302,2118,858,1260,28,1267,14,14,allow
51754,1182,55646,1182,70,70,0,2,7,2,0,allow
54020,53,54020,53,233,90,143,2,32,1,1,allow
51398,443,32490,443,322,262,60,2,5,1,1,allow
51942,443,54861,443,2646,1322,1324,28,36,15,13,allow
51620,443,24957,443,3330,2281,1049,17,16,9,8,allow
49418,27017,19640,27017,78,78,0,1,30,1,0,allow
49418,33071,57943,33071,78,78,0,1,30,1,0,allow
64133,53,49082,53,225,110,115,2,30,1,1,allow
49418,50019,9812,50019,268,78,190,2,30,1,1,allow
53084,443,55326,443,490914,83866,407048,1048,332,526,522,allow
38993,443,34045,443,7089,1290,5799,24,16,12,12,allow
23589,53,23589,53,220,90,130,2,30,1,1,allow
34294,53,17102,53,168,78,90,2,30,1,1,allow
53860,53,53860,53,197,90,107,2,30,1,1,allow
57235,443,36461,443,8954,3404,5550,34,46,19,15,allow
55326,53,7571,53,177,94,83,2,30,1,1,allow
56841,443,47510,443,156805,44621,112184,289,215,137,152,allow
49418,27015,63355,27015,244,78,166,2,30,1,1,allow
49418,33056,16028,33056,237,78,159,2,30,1,1,allow
49418,27058,37318,27058,263,78,185,2,30,1,1,allow
49418,27055,11921,27055,269,78,191,2,30,1,1,allow
49418,32056,18212,32056,245,78,167,2,30,1,1,allow
51221,27048,22916,27048,132,132,0,3,1200,3,0,allow
54659,443,56106,443,1773,1038,735,17,278,9,8,allow
21133,6085,5257,6085,481,150,331,2,1199,1,1,allow
50096,53,50096,53,197,90,107,2,30,1,1,allow
55440,53,55440,53,220,90,130,2,30,1,1,allow
48755,53,17288,53,168,78,90,2,30,1,1,allow
58662,53,17171,53,167,78,89,2,31,1,1,allow
63926,53,50565,53,260,102,158,2,31,1,1,allow
65183,53,44616,53,718,94,624,2,31,1,1,allow
59124,443,60758,443,27431,19413,8018,71,175,36,35,allow
63627,443,58785,443,17242,3015,14227,19,143,5,14,allow
63584,443,24147,443,3182,1568,1614,8,120,4,4,allow
6881,51413,35496,51413,475,150,325,2,1200,1,1,allow
49664,443,7925,443,134,60,74,3,6,2,1,allow
52495,443,36037,443,32875,8836,24039,37,16,15,22,allow
63425,443,8137,443,22815,20019,2796,55,81,31,24,allow
50913,80,46319,80,12767608,157856,12609752,11936,135,2227,9709,allow
50906,80,26380,80,13949172,164502,13784670,11537,135,2287,9250,allow
58837,3389,58837,3389,4429,2581,1848,21,33,11,10,allow
56680,8100,35918,8100,78,78,0,1,5,1,0,allow
53544,22051,5386,22051,70,70,0,1,5,1,0,allow
50488,443,22994,443,9765,2106,7659,27,83,14,13,allow
49449,80,5830,80,1948,912,1036,13,56,7,6,allow
50382,443,9728,443,10423,2542,7881,48,20,24,24,allow
50897,80,4903,80,13981183,155668,13825515,11482,136,2194,9288,allow
44187,53,44187,53,233,90,143,2,32,1,1,allow
65367,443,29972,443,5666,4417,1249,23,86,12,11,allow
50910,80,20207,80,14877069,179445,14697624,12450,135,2531,9919,allow
50900,80,32944,80,14423569,189925,14233644,12194,135,2586,9608,allow
49624,53,37843,53,216,94,122,2,30,1,1,allow
57082,53,1107,53,211,102,109,2,30,1,1,allow
39054,53,31083,53,168,78,90,2,30,1,1,allow
65348,53,40565,53,177,94,83,2,30,1,1,allow
51989,445,0,0,66,66,0,1,0,1,0,drop
35516,22,0,0,60,60,0,1,0,1,0,deny
56564,9571,0,0,78,78,0,1,0,1,0,deny
56567,445,0,0,70,70,0,1,0,1,0,drop
33292,50584,0,0,66,66,0,1,0,1,0,deny
34489,35440,0,0,66,66,0,1,0,1,0,deny
51986,445,0,0,66,66,0,1,0,1,0,drop
62338,50011,0,0,66,66,0,1,0,1,0,deny
62532,57354,0,0,159,159,0,1,0,1,0,deny
47013,37965,0,0,62,62,0,1,0,1,0,deny
51553,445,0,0,70,70,0,1,0,1,0,drop
54976,2273,0,0,60,60,0,1,0,1,0,deny
51977,445,0,0,66,66,0,1,0,1,0,drop
51549,445,0,0,70,70,0,1,0,1,0,drop
51975,445,0,0,66,66,0,1,0,1,0,drop
51548,445,0,0,70,70,0,1,0,1,0,drop
51547,445,0,0,70,70,0,1,0,1,0,drop
12694,12446,0,0,62,62,0,1,0,1,0,deny
56703,50584,0,0,66,66,0,1,0,1,0,deny
51546,445,0,0,70,70,0,1,0,1,0,deny
51328,30228,0,0,109,109,0,1,0,1,0,deny
58003,1433,0,0,60,60,0,1,0,1,0,deny
51544,445,0,0,70,70,0,1,0,1,0,drop
51540,445,0,0,70,70,0,1,0,1,0,drop
51191,26467,0,0,66,66,0,1,0,1,0,deny
63583,37965,0,0,66,66,0,1,0,1,0,deny
30599,46824,0,0,66,66,0,1,0,1,0,deny
56556,445,0,0,70,70,0,1,0,1,0,drop
56555,445,0,0,70,70,0,1,0,1,0,drop
51528,445,0,0,70,70,0,1,0,1,0,drop
51527,445,0,0,70,70,0,1,0,1,0,drop
51961,445,0,0,66,66,0,1,0,1,0,drop
51962,445,0,0,66,66,0,1,0,1,0,drop
51963,445,0,0,66,66,0,1,0,1,0,deny
51960,445,0,0,66,66,0,1,0,1,0,drop
51959,445,0,0,66,66,0,1,0,1,0,drop
51957,445,0,0,66,66,0,1,0,1,0,drop
51956,445,0,0,66,66,0,1,0,1,0,drop
3964,51505,0,0,62,62,0,1,0,1,0,deny
51525,445,0,0,70,70,0,1,0,1,0,drop
64166,35440,0,0,62,62,0,1,0,1,0,deny
51517,445,0,0,70,70,0,1,0,1,0,drop
51518,445,0,0,70,70,0,1,0,1,0,drop
64219,51050,0,0,66,66,0,1,0,1,0,deny
51953,37965,0,0,66,66,0,1,0,1,0,deny
42128,54532,0,0,60,60,0,1,0,1,0,deny
39823,36237,0,0,66,66,0,1,0,1,0,deny
57098,1,0,0,78,78,0,1,0,1,0,deny
34531,23117,0,0,62,62,0,1,0,1,0,deny
61845,11392,0,0,62,62,0,1,0,1,0,deny
56553,445,0,0,70,70,0,1,0,1,0,drop
56547,445,0,0,70,70,0,1,0,1,0,drop
56539,445,0,0,70,70,0,1,0,1,0,drop
51506,445,0,0,70,70,0,1,0,1,0,drop
8622,64147,0,0,66,66,0,1,0,1,0,deny
51943,445,0,0,66,66,0,1,0,1,0,drop
51940,445,0,0,66,66,0,1,0,1,0,drop
51941,445,0,0,66,66,0,1,0,1,0,drop
56537,445,0,0,70,70,0,1,0,1,0,drop
58598,50584,0,0,66,66,0,1,0,1,0,deny
56535,445,0,0,70,70,0,1,0,1,0,drop
49699,64147,0,0,66,66,0,1,0,1,0,deny
51502,445,0,0,70,70,0,1,0,1,0,drop
56531,445,0,0,70,70,0,1,0,1,0,drop
56527,445,0,0,70,70,0,1,0,1,0,drop
56524,445,0,0,70,70,0,1,0,1,0,drop
14613,12446,0,0,66,66,0,1,0,1,0,deny
49664,37965,0,0,66,66,0,1,0,1,0,deny
51999,37965,0,0,62,62,0,1,0,1,0,deny
18085,26467,0,0,62,62,0,1,0,1,0,deny
55296,23718,0,0,66,66,0,1,0,1,0,deny
51491,445,0,0,70,70,0,1,0,1,0,drop
51493,445,0,0,70,70,0,1,0,1,0,drop
42463,56205,0,0,146,146,0,1,0,1,0,deny
51489,445,0,0,70,70,0,1,0,1,0,drop
51488,445,0,0,70,70,0,1,0,1,0,drop
51486,445,0,0,70,70,0,1,0,1,0,drop
8999,43109,0,0,146,146,0,1,0,1,0,deny
46275,64147,0,0,62,62,0,1,0,1,0,deny
64482,64147,0,0,66,66,0,1,0,1,0,deny
56516,445,0,0,70,70,0,1,0,1,0,drop
56514,445,0,0,70,70,0,1,0,1,0,drop
56511,445,0,0,70,70,0,1,0,1,0,drop
24351,57470,0,0,62,62,0,1,0,1,0,deny
51774,29434,0,0,146,146,0,1,0,1,0,deny
51480,445,0,0,70,70,0,1,0,1,0,drop
43129,20220,0,0,62,62,0,1,0,1,0,deny
8999,1,0,0,62,62,0,1,0,1,0,deny
54280,3359,0,0,60,60,0,1,0,1,0,deny
54826,56205,0,0,62,62,0,1,0,1,0,deny
51472,445,0,0,70,70,0,1,0,1,0,drop
51918,445,0,0,66,66,0,1,0,1,0,drop
56510,445,0,0,70,70,0,1,0,1,0,drop
56508,445,0,0,70,70,0,1,0,1,0,drop
51471,445,0,0,70,70,0,1,0,1,0,drop
59918,44847,0,0,66,66,0,1,0,1,0,deny
54471,36237,0,0,66,66,0,1,0,1,0,deny
8999,1,0,0,146,146,0,1,0,1,0,deny
5200,6643,0,0,145,145,0,1,0,1,0,deny
51463,445,0,0,70,70,0,1,0,1,0,drop
50853,50584,0,0,62,62,0,1,0,1,0,deny
51462,445,0,0,70,70,0,1,0,1,0,drop
37571,443,14290,443,499,425,74,4,0,3,1,allow
37574,443,27983,443,499,425,74,4,0,3,1,allow
37573,443,61773,443,499,425,74,4,0,3,1,allow
37572,443,25877,443,499,425,74,4,0,3,1,allow
37570,443,49846,443,499,425,74,4,0,3,1,allow
37569,443,25156,443,499,425,74,4,0,3,1,allow
0,0,0,0,320,320,0,5,0,5,0,allow
51914,445,0,0,66,66,0,1,0,1,0,drop
48087,16069,0,0,66,66,0,1,0,1,0,deny
47962,16069,0,0,62,62,0,1,0,1,0,deny
14309,56205,0,0,62,62,0,1,0,1,0,deny
51911,445,0,0,66,66,0,1,0,1,0,drop
56495,445,0,0,70,70,0,1,0,1,0,drop
58876,57470,0,0,66,66,0,1,0,1,0,deny
56490,445,0,0,70,70,0,1,0,1,0,drop
56489,445,0,0,70,70,0,1,0,1,0,drop
56488,445,0,0,70,70,0,1,0,1,0,drop
51458,445,0,0,70,70,0,1,0,1,0,drop
51908,445,0,0,66,66,0,1,0,1,0,drop
51457,445,0,0,70,70,0,1,0,1,0,drop
56482,445,0,0,70,70,0,1,0,1,0,drop
56480,445,0,0,70,70,0,1,0,1,0,drop
56477,445,0,0,70,70,0,1,0,1,0,drop
56478,445,0,0,70,70,0,1,0,1,0,drop
51534,26467,0,0,62,62,0,1,0,1,0,deny
51902,445,0,0,66,66,0,1,0,1,0,drop
51452,445,0,0,70,70,0,1,0,1,0,drop
51893,445,0,0,66,66,0,1,0,1,0,drop
51896,445,0,0,66,66,0,1,0,1,0,drop
51897,445,0,0,66,66,0,1,0,1,0,drop
51891,445,0,0,66,66,0,1,0,1,0,drop
51892,445,0,0,66,66,0,1,0,1,0,drop
51889,445,0,0,66,66,0,1,0,1,0,drop
42685,51180,0,0,62,62,0,1,0,1,0,deny
56753,44847,0,0,62,62,0,1,0,1,0,deny
49831,30188,0,0,66,66,0,1,0,1,0,deny
64890,51180,0,0,66,66,0,1,0,1,0,deny
50200,44847,0,0,70,70,0,1,0,1,0,deny
56474,445,0,0,70,70,0,1,0,1,0,drop
56471,445,0,0,70,70,0,1,0,1,0,drop
56469,445,0,0,70,70,0,1,0,1,0,drop
51887,445,0,0,66,66,0,1,0,1,0,drop
56467,445,0,0,70,70,0,1,0,1,0,drop
443,10010,0,0,60,60,0,1,0,1,0,deny
51884,445,0,0,66,66,0,1,0,1,0,drop
51882,445,0,0,66,66,0,1,0,1,0,drop
51881,445,0,0,66,66,0,1,0,1,0,drop
37616,443,4256,443,18611,3046,15565,41,362,20,21,allow
61385,80,34601,80,30257,2427,27830,45,255,22,23,allow
61390,80,4844,80,13706,1388,12318,26,255,14,12,allow
51318,443,40980,443,11191,4657,6534,32,129,14,18,allow
57512,80,20735,80,1377,881,496,12,48,7,5,allow
65381,80,14160,80,1630,982,648,13,78,7,6,allow
49736,443,37577,443,378,192,186,7,15,4,3,allow
54688,443,54688,443,149676,25300,124376,220,110,122,98,allow
51265,63960,62847,63960,70,70,0,1,5,1,0,allow
56778,35292,48198,35292,70,70,0,1,5,1,0,allow
65387,443,41173,443,2289,1583,706,14,18,8,6,allow
61389,80,44525,80,17407,1529,15878,30,255,16,14,allow
61388,80,19899,80,14158,1392,12766,26,255,14,12,allow
17750,6881,6103,6881,149,149,0,1,1200,1,0,allow
5938,26428,0,0,60,60,0,1,90,1,0,allow
61706,80,6564,80,1840,1242,598,11,16,6,5,allow
62462,53,62462,53,238,99,139,2,30,1,1,allow
51564,443,53413,443,2888,1566,1322,17,18,9,8,allow
61387,80,56509,80,28791,2297,26494,41,255,20,21,allow
17861,443,17861,443,1155,728,427,11,26,7,4,allow
65362,80,32536,80,1347,771,576,11,86,7,4,allow
58046,53,58046,53,231,88,143,2,32,1,1,allow
7665,80,7665,80,110567,7016,103551,135,46,60,75,allow
42213,443,21488,443,4622,926,3696,18,255,10,8,allow
52629,53,0,0,232,77,155,2,33,1,1,allow
41322,443,7553,443,153,93,60,2,5,1,1,allow
55598,41565,26251,41565,70,70,0,2,8,2,0,allow
52540,443,62112,443,153,93,60,2,5,1,1,allow
49175,2710,9134,2710,66,66,0,1,5,1,0,allow
54614,443,21022,443,36109,16793,19316,62,19,32,30,allow
50475,443,44824,443,3893,1910,1983,36,255,17,19,allow
43422,80,45475,80,3863,875,2988,12,16,8,4,allow
56981,443,53338,443,7238,2601,4637,20,22,10,10,allow
33911,53,0,0,82,82,0,1,30,1,0,allow
5588,5588,0,0,3498,1872,1626,48,205,24,24,allow
51953,443,6688,443,7571,3372,4199,33,88,17,16,allow
52000,80,35865,80,3495,1150,2345,17,18,8,9,allow
55744,80,6834,80,5146,3694,1452,20,249,10,10,allow
61386,80,24052,80,17583,1529,16054,30,255,16,14,allow
56774,39553,10646,39553,70,70,0,2,8,2,0,allow
54105,443,23340,443,2227,1018,1209,17,16,8,9,allow
49285,53,48057,53,168,78,90,2,30,1,1,allow
60419,53,60419,53,217,87,130,2,30,1,1,allow
55890,53,46214,53,711,87,624,2,30,1,1,allow
57568,53,57568,53,235,98,137,2,30,1,1,allow
57371,53,40591,53,728,96,632,2,30,1,1,allow
59204,443,10417,443,9335,3052,6283,25,125,11,14,allow
40631,53,40631,53,262,107,155,2,30,1,1,allow
41426,443,52242,443,3396,1964,1432,16,361,8,8,allow
54397,443,59448,443,1786,172,1614,7,120,3,4,allow
50265,27034,40304,27034,480,149,331,2,1200,1,1,allow
42119,36237,0,0,66,66,0,1,0,1,0,deny
51439,445,0,0,70,70,0,1,0,1,0,drop
51837,37965,0,0,66,66,0,1,0,1,0,deny
51878,445,0,0,66,66,0,1,0,1,0,drop
49386,64147,0,0,62,62,0,1,0,1,0,deny
10262,11392,0,0,62,62,0,1,0,1,0,deny
64767,51221,0,0,62,62,0,1,0,1,0,deny
51464,23,0,0,60,60,0,1,0,1,0,deny
51436,445,0,0,70,70,0,1,0,1,0,drop
8999,15503,0,0,146,146,0,1,0,1,0,deny
1128,44847,0,0,62,62,0,1,0,1,0,deny
50102,17546,0,0,66,66,0,1,0,1,0,deny
45394,443,62065,443,1314,653,661,13,185,7,6,allow
49772,80,25587,80,1155,781,374,10,15,6,4,allow
49526,53,60849,53,402,118,284,2,30,1,1,allow
64998,27037,61288,27037,3287,2072,1215,12,30,6,6,allow
57009,53,8536,53,177,94,83,2,30,1,1,allow
49988,443,49988,443,1466,696,770,20,120,10,10,allow
50896,80,56677,80,11459959,142694,11317265,9719,135,1994,7725,allow
50917,80,57551,80,11626518,135099,11491419,9627,134,1907,7720,allow
50509,443,29330,443,9535,1246,8289,29,77,15,14,allow
53561,35885,64999,35885,70,70,0,2,7,2,0,allow
45540,8100,64668,8100,78,78,0,1,4,1,0,allow
51736,34343,51970,34343,70,70,0,1,5,1,0,allow
65366,443,3510,443,4319,2473,1846,24,85,10,14,allow
53505,8102,48744,8102,1495,843,652,10,30,5,5,allow
21909,53,21909,53,197,90,107,2,30,1,1,allow
50941,443,22406,443,12831,2277,10554,37,145,17,20,allow
57224,53,20310,53,532,198,334,6,50,3,3,allow
55067,443,14245,443,1146,360,786,20,75,7,13,allow
50899,80,62536,80,13974043,173337,13800706,11715,134,2429,9286,allow
50508,443,43933,443,5938,1012,4926,20,77,11,9,allow
43837,443,27944,443,70,70,0,1,4,1,0,allow
50507,443,55208,443,7171,1729,5442,24,78,13,11,allow
60746,40010,7294,40010,316,136,180,6,6,3,3,allow
53543,51819,47777,51819,70,70,0,1,4,1,0,allow
33730,443,53132,443,5947,1579,4368,22,315,12,10,allow
35343,80,43757,80,953,538,415,11,318,6,5,allow
57223,443,27688,443,24283,14945,9338,46,318,26,20,allow
50679,443,24042,443,14172,2714,11458,32,637,13,19,allow
55946,443,34803,443,9274,5282,3992,42,186,22,20,allow
65273,53,14991,53,338,110,228,2,29,1,1,allow
64338,53,55215,53,292,102,190,2,29,1,1,allow
44883,53,44883,53,216,90,126,2,29,1,1,allow
65348,53,17423,53,177,94,83,2,29,1,1,allow
56776,18318,59158,18318,70,70,0,1,5,1,0,allow
43483,443,14734,443,144138,17538,126600,275,300,115,160,allow
58659,53,58909,53,167,78,89,2,30,1,1,allow
54322,27015,10656,27015,924,924,0,3,30,3,0,allow
55154,443,28417,443,1610,771,839,22,120,11,11,allow
56176,53,8371,53,194,102,92,2,30,1,1,allow
65263,80,27562,80,7440,4032,3408,48,629,25,23,allow
56775,20617,28248,20617,70,70,0,2,8,2,0,allow
51748,15177,40687,15177,70,70,0,2,9,2,0,allow
56601,80,22349,80,234,234,0,4,12,4,0,allow
43488,443,22133,443,6817,1221,5596,26,285,14,12,allow
44847,46972,13667,46972,150,150,0,1,1200,1,0,allow
36961,443,20198,443,7326,1399,5927,29,280,15,14,allow
57396,53,39255,53,358,102,256,2,30,1,1,allow
55114,53,53852,53,392,100,292,4,33,2,2,allow
51576,443,13071,443,9753,2821,6932,39,201,22,17,allow
8986,443,12105,443,8062,2804,5258,43,161,20,23,allow
46442,80,6730,80,1373,669,704,10,16,5,5,allow
49774,53,5014,53,236,94,142,2,30,1,1,allow
41418,443,15753,443,6670,1576,5094,23,200,13,10,allow
64706,27065,37449,27065,924,924,0,3,30,3,0,allow
55229,53,55587,53,199,94,105,2,30,1,1,allow
59175,53,63239,53,168,78,90,2,30,1,1,allow
57009,53,48433,53,177,94,83,2,30,1,1,allow
50714,443,52657,443,9477,1950,7527,31,181,14,17,allow
44252,443,6888,443,14455,6007,8448,45,120,26,19,allow
51735,50794,12843,50794,70,70,0,1,5,1,0,allow
56395,443,48597,443,77506,2940,74566,100,80,38,62,allow
39527,443,33957,443,8447,3506,4941,28,333,15,13,allow
54321,27015,6955,27015,924,924,0,3,30,3,0,allow
54320,27016,28839,27016,924,924,0,3,30,3,0,allow
35587,123,5043,123,184,94,90,2,30,1,1,allow
6882,8999,49067,8999,238,118,120,2,1200,1,1,allow
65262,80,27207,80,8814,4800,4014,52,629,27,25,allow
61384,80,43597,80,2526,843,1683,12,255,7,5,allow
63264,53,63264,53,197,90,107,2,30,1,1,allow
49796,53,34008,53,238,102,136,2,30,1,1,allow
61256,443,47931,443,2680,255,2425,9,120,4,5,allow
65427,443,32092,443,14205,1527,12678,13,147,2,11,allow
50901,80,6668,80,14661588,141996,14519592,11768,134,2012,9756,allow
55597,7485,9099,7485,70,70,0,2,8,2,0,allow
50903,80,42549,80,13644327,154437,13489890,11257,134,2201,9056,allow
51752,31677,2687,31677,70,70,0,2,8,2,0,allow
7595,80,7595,80,34707,1796,32911,45,45,20,25,allow
57353,443,32586,443,150,150,0,1,5,1,0,allow
56777,42486,21252,42486,70,70,0,1,5,1,0,allow
56964,53,13707,53,267,87,180,4,57,2,2,allow
28989,53,28989,53,197,90,107,2,29,1,1,allow
61492,80,29860,80,901,398,503,10,15,5,5,allow
62109,443,64847,443,21219,1329,19890,32,122,13,19,allow
65287,53,32403,53,222,86,136,2,30,1,1,allow
56126,53,59441,53,336,110,226,2,29,1,1,allow
55567,53,55567,53,216,90,126,2,30,1,1,allow
49553,53,5635,53,614,239,375,6,53,3,3,allow
58664,53,10827,53,167,78,89,2,29,1,1,allow
49419,53,3552,53,343,100,243,4,52,2,2,allow
43484,443,55073,443,130,70,60,2,15,1,1,allow
49610,53,9285,53,168,78,90,2,30,1,1,allow
57588,443,16925,443,9109,2044,7065,25,22,14,11,allow
50645,53,27805,53,177,94,83,2,30,1,1,allow
50500,443,60385,443,12556,1134,11422,28,78,13,15,allow
50502,443,59383,443,11323,3376,7947,29,77,16,13,allow
50504,443,47105,443,5476,1073,4403,22,78,12,10,allow
52629,53,0,0,418,154,264,4,33,2,2,allow
46641,8100,2386,8100,78,78,0,1,4,1,0,allow
64657,53,35491,53,370,96,274,4,39,2,2,allow
4184,53,4184,53,216,90,126,2,29,1,1,allow
59179,53,29104,53,260,86,174,2,30,1,1,allow
50209,53,40978,53,86,86,0,1,30,1,0,allow
56174,443,33268,443,1310,649,661,13,185,7,6,allow
45392,443,53669,443,1312,651,661,13,185,7,6,allow
65251,80,48445,80,6352,4052,2300,44,630,23,21,allow
65466,443,13984,443,478996,13760,465236,490,16,171,319,allow
61712,80,5502,80,1864,1024,840,10,16,6,4,allow
51667,25826,43364,25826,9372,9372,0,11,30,11,0,allow
56291,53,51569,53,260,102,158,2,30,1,1,allow
58658,53,27150,53,260,86,174,2,30,1,1,allow
46297,80,56497,80,1155,781,374,10,15,6,4,allow
43482,443,29764,443,2316,1280,1036,20,278,11,9,allow
35509,3389,35509,3389,4224,2055,2169,22,21,13,9,allow
50645,53,59508,53,177,94,83,2,30,1,1,allow
54807,53,14408,53,206,86,120,2,30,1,1,allow
50825,443,30672,443,252960,10277,242683,301,209,119,182,allow
52321,443,49472,443,10320,5152,5168,45,15,25,20,allow
43487,443,8725,443,6886,1291,5595,27,285,15,12,allow
41296,80,53379,80,1056,682,374,10,15,6,4,allow
65379,443,56474,443,4514,2844,1670,29,84,14,15,allow
65264,80,41866,80,7440,4032,3408,48,629,25,23,allow
17532,53,17532,53,233,90,143,2,31,1,1,allow
52322,53,58058,53,86,86,0,1,30,1,0,allow
60163,443,11476,443,3041,1745,1296,28,3600,15,13,allow
56176,443,9976,443,1312,651,661,13,185,7,6,allow
55928,443,33892,443,5433,3275,2158,16,135,8,8,allow
53541,59939,18832,59939,70,70,0,1,5,1,0,allow
65465,443,59471,443,92040,4799,87241,107,16,43,64,allow
61835,443,61835,443,21703,2433,19270,44,76,18,26,allow
51797,80,9284,80,1929,796,1133,21,135,11,10,allow
61834,443,61834,443,220115,6038,214077,231,76,78,153,allow
50229,443,13758,443,6846,2479,4367,41,256,19,22,allow
50915,80,27954,80,10548172,142265,10405907,9105,134,1982,7123,allow
63968,53,61368,53,310,142,168,2,30,1,1,allow
58562,3389,58562,3389,5387,1909,3478,22,21,10,12,allow
50911,80,6093,80,13780884,170419,13610465,11542,134,2387,9155,allow
44187,443,10571,443,12382,2688,9694,37,361,19,18,allow
56462,445,0,0,70,70,0,1,0,1,0,drop
56454,445,0,0,70,70,0,1,0,1,0,drop
56450,445,0,0,70,70,0,1,0,1,0,drop
26531,37965,0,0,62,62,0,1,0,1,0,deny
51431,445,0,0,70,70,0,1,0,1,0,drop
50784,52952,0,0,66,66,0,1,0,1,0,deny
37568,443,2020,443,499,425,74,4,0,3,1,allow
37564,443,36169,443,499,425,74,4,0,3,1,allow
37567,443,17651,443,499,425,74,4,0,3,1,allow
37566,443,23464,443,499,425,74,4,0,3,1,allow
37563,443,52126,443,499,425,74,4,0,3,1,allow
37565,443,6723,443,499,425,74,4,0,3,1,allow
55865,64147,0,0,66,66,0,1,0,1,0,deny
61315,48817,0,0,62,62,0,1,0,1,0,deny
51870,445,0,0,66,66,0,1,0,1,0,drop
51430,445,0,0,70,70,0,1,0,1,0,drop
50788,48817,0,0,66,66,0,1,0,1,0,deny
51428,445,0,0,70,70,0,1,0,1,0,drop
34382,26314,0,0,143,143,0,1,0,1,0,deny
51244,16474,0,0,100,100,0,1,0,1,0,deny
59584,36237,0,0,66,66,0,1,0,1,0,deny
51244,21162,0,0,100,100,0,1,0,1,0,deny
58597,35440,0,0,62,62,0,1,0,1,0,deny
51244,29517,0,0,100,100,0,1,0,1,0,deny
51244,52290,0,0,100,100,0,1,0,1,0,deny
36656,64147,0,0,62,62,0,1,0,1,0,deny
51244,14984,0,0,100,100,0,1,0,1,0,deny
30114,65151,0,0,60,60,0,1,0,1,0,deny
51859,445,0,0,66,66,0,1,0,1,0,drop
51244,59353,0,0,100,100,0,1,0,1,0,deny
51244,57099,0,0,100,100,0,1,0,1,0,deny
56439,445,0,0,70,70,0,1,0,1,0,drop
36339,50584,0,0,62,62,0,1,0,1,0,deny
19570,50584,0,0,66,66,0,1,0,1,0,deny
1025,40108,0,0,146,146,0,1,0,1,0,deny
52802,56205,0,0,66,66,0,1,0,1,0,deny
60292,7129,0,0,62,62,0,1,0,1,0,deny
9659,81,0,0,60,60,0,1,0,1,0,deny
51856,445,0,0,66,66,0,1,0,1,0,drop
51421,445,0,0,70,70,0,1,0,1,0,drop
27328,21247,0,0,62,62,0,1,0,1,0,deny
51419,445,0,0,70,70,0,1,0,1,0,drop
54071,50265,0,0,62,62,0,1,0,1,0,deny
51848,445,0,0,66,66,0,1,0,1,0,drop
42128,54532,0,0,60,60,0,1,0,1,0,deny
51418,445,0,0,70,70,0,1,0,1,0,drop
51840,445,0,0,66,66,0,1,0,1,0,drop
51417,445,0,0,70,70,0,1,0,1,0,drop
51416,445,0,0,70,70,0,1,0,1,0,drop
51411,445,0,0,70,70,0,1,0,1,0,drop
54631,44847,0,0,74,74,0,1,0,1,0,deny
62780,35440,0,0,66,66,0,1,0,1,0,deny
11458,2767,0,0,66,66,0,1,0,1,0,deny
51398,445,0,0,70,70,0,1,0,1,0,drop
51397,445,0,0,70,70,0,1,0,1,0,drop
51391,445,0,0,70,70,0,1,0,1,0,drop
27442,44847,0,0,62,62,0,1,0,1,0,deny
26802,50584,0,0,146,146,0,1,0,1,0,deny
47173,35440,0,0,62,62,0,1,0,1,0,deny
51388,445,0,0,70,70,0,1,0,1,0,drop
51387,445,0,0,70,70,0,1,0,1,0,drop
26406,37965,0,0,66,66,0,1,0,1,0,deny
56430,445,0,0,70,70,0,1,0,1,0,drop
56428,445,0,0,70,70,0,1,0,1,0,drop
56427,445,0,0,70,70,0,1,0,1,0,drop
51832,445,0,0,66,66,0,1,0,1,0,drop
51833,445,0,0,66,66,0,1,0,1,0,drop
51834,445,0,0,66,66,0,1,0,1,0,drop
51831,445,0,0,66,66,0,1,0,1,0,drop
51827,445,0,0,66,66,0,1,0,1,0,drop
51829,445,0,0,66,66,0,1,0,1,0,drop
51828,445,0,0,66,66,0,1,0,1,0,drop
51826,445,0,0,66,66,0,1,0,1,0,drop
53475,3389,0,0,66,66,0,1,0,1,0,deny
22683,39210,0,0,60,60,0,1,0,1,0,deny
30443,44847,0,0,62,62,0,1,0,1,0,deny
14615,57866,0,0,66,66,0,1,0,1,0,deny
443,12105,0,0,66,66,0,1,0,1,0,deny
65501,57470,0,0,72,72,0,1,0,1,0,deny
62787,51221,0,0,66,66,0,1,0,1,0,deny
53211,22114,0,0,66,66,0,1,0,1,0,deny
6676,63836,0,0,145,145,0,1,0,1,0,deny
58977,37965,0,0,66,66,0,1,0,1,0,deny
51376,445,0,0,70,70,0,1,0,1,0,drop
53745,443,56954,443,499,425,74,4,0,3,1,allow
53744,443,46972,443,499,425,74,4,0,3,1,allow
7444,57470,0,0,66,66,0,1,0,1,0,deny
7222,57470,0,0,62,62,0,1,0,1,0,deny
6895,57354,0,0,148,148,0,1,0,1,0,deny
56422,445,0,0,70,70,0,1,0,1,0,drop
56417,445,0,0,70,70,0,1,0,1,0,drop
56412,445,0,0,70,70,0,1,0,1,0,drop
58748,80,58748,80,6516,564,5952,16,25,7,9,allow
14082,50584,0,0,66,66,0,1,0,1,0,deny
44258,25,0,0,74,74,0,1,0,1,0,deny
51814,445,0,0,66,66,0,1,0,1,0,drop
51813,445,0,0,66,66,0,1,0,1,0,drop
51812,445,0,0,66,66,0,1,0,1,0,drop
19858,64147,0,0,62,62,0,1,0,1,0,deny
56410,445,0,0,70,70,0,1,0,1,0,drop
33822,57470,0,0,66,66,0,1,0,1,0,deny
7301,14914,0,0,157,157,0,1,0,1,0,deny
51372,445,0,0,70,70,0,1,0,1,0,drop
56407,445,0,0,70,70,0,1,0,1,0,drop
56406,445,0,0,70,70,0,1,0,1,0,drop
56403,445,0,0,70,70,0,1,0,1,0,drop
56395,445,0,0,70,70,0,1,0,1,0,drop
33289,50584,0,0,62,62,0,1,0,1,0,deny
48676,53395,0,0,60,60,0,1,0,1,0,deny
51361,445,0,0,70,70,0,1,0,1,0,drop
51363,445,0,0,70,70,0,1,0,1,0,drop
56778,35440,0,0,66,66,0,1,0,1,0,deny
51359,445,0,0,70,70,0,1,0,1,0,drop
51358,445,0,0,70,70,0,1,0,1,0,drop
8999,57470,0,0,146,146,0,1,0,1,0,deny
51355,445,0,0,70,70,0,1,0,1,0,drop
20961,35440,0,0,62,62,0,1,0,1,0,deny
51074,80,51074,80,168467,7348,161119,184,8,67,117,allow
61241,22114,0,0,66,66,0,1,0,1,0,deny
54684,37965,0,0,62,62,0,1,0,1,0,deny
56453,37965,0,0,66,66,0,1,0,1,0,deny
6889,24748,0,0,143,143,0,1,0,1,0,deny
59156,50584,0,0,66,66,0,1,0,1,0,deny
60894,50584,0,0,62,62,0,1,0,1,0,deny
56390,445,0,0,70,70,0,1,0,1,0,drop
56385,445,0,0,70,70,0,1,0,1,0,drop
56383,445,0,0,70,70,0,1,0,1,0,drop
51350,445,0,0,70,70,0,1,0,1,0,drop
18291,37807,0,0,146,146,0,1,0,1,0,deny
46349,51505,0,0,74,74,0,1,0,1,0,deny
0,0,0,0,480,244,236,4,0,2,2,allow
3225,64147,0,0,66,66,0,1,0,1,0,deny
16221,50584,0,0,62,62,0,1,0,1,0,deny
51342,445,0,0,70,70,0,1,0,1,0,drop
51340,445,0,0,70,70,0,1,0,1,0,drop
51788,445,0,0,66,66,0,1,0,1,0,drop
56380,445,0,0,70,70,0,1,0,1,0,drop
16387,26193,0,0,60,60,0,1,0,1,0,deny
1027,44847,0,0,62,62,0,1,0,1,0,deny
50355,43890,0,0,66,66,0,1,0,1,0,deny
16387,35308,0,0,60,60,0,1,0,1,0,deny
16387,56995,0,0,60,60,0,1,0,1,0,deny
6712,123,0,0,90,90,0,1,0,1,0,deny
16524,22114,0,0,62,62,0,1,0,1,0,deny
61524,23,0,0,60,60,0,1,0,1,0,deny
51335,445,0,0,70,70,0,1,0,1,0,drop
51334,445,0,0,70,70,0,1,0,1,0,drop
5379,37965,0,0,66,66,0,1,0,1,0,deny
38926,37965,0,0,62,62,0,1,0,1,0,deny
1811,35440,0,0,62,62,0,1,0,1,0,deny
1024,64147,0,0,109,109,0,1,0,1,0,deny
51783,445,0,0,66,66,0,1,0,1,0,drop
1284,50584,0,0,66,66,0,1,0,1,0,deny
35269,61903,0,0,145,145,0,1,0,1,0,deny
28584,37965,0,0,62,62,0,1,0,1,0,deny
20844,64147,0,0,66,66,0,1,0,1,0,deny
64788,43890,0,0,66,66,0,1,0,1,0,deny
51782,445,0,0,66,66,0,1,0,1,0,drop
51330,445,0,0,70,70,0,1,0,1,0,drop
56368,445,0,0,70,70,0,1,0,1,0,drop
13188,35440,0,0,62,62,0,1,0,1,0,deny
56364,445,0,0,70,70,0,1,0,1,0,drop
56361,445,0,0,70,70,0,1,0,1,0,drop
56360,445,0,0,70,70,0,1,0,1,0,drop
51329,445,0,0,70,70,0,1,0,1,0,drop
51781,445,0,0,66,66,0,1,0,1,0,drop
45941,23388,0,0,60,60,0,1,0,1,0,deny
45941,23388,0,0,60,60,0,1,0,1,0,deny
59523,37965,0,0,62,62,0,1,0,1,0,deny
49516,35894,0,0,62,62,0,1,0,1,0,deny
63433,57866,0,0,62,62,0,1,0,1,0,deny
55618,56205,0,0,62,62,0,1,0,1,0,deny
56354,445,0,0,70,70,0,1,0,1,0,drop
56352,445,0,0,70,70,0,1,0,1,0,drop
56351,445,0,0,70,70,0,1,0,1,0,drop
56348,445,0,0,70,70,0,1,0,1,0,drop
51324,445,0,0,70,70,0,1,0,1,0,drop
57750,37965,0,0,146,146,0,1,0,1,0,deny
39475,443,29487,443,3310,2291,1019,17,16,10,7,allow
33968,443,15691,443,10073,4379,5694,33,42,17,16,allow
50306,443,54494,443,9889,2800,7089,28,82,17,11,allow
63750,63343,38388,63343,66,66,0,2,8,2,0,allow
51731,39392,29228,39392,66,66,0,1,5,1,0,allow
59738,443,4655,443,510,164,346,2,31,1,1,allow
57849,443,35072,443,11893,6064,5829,29,92,15,14,allow
39473,443,25041,443,11226,3340,7886,28,16,16,12,allow
43071,80,63845,80,808,480,328,13,158,9,4,allow
50696,80,3909,80,55872,28838,27034,234,175,117,117,allow
47932,443,21603,443,9467,2741,6726,24,20,15,9,allow
61622,80,61622,80,48702,2799,45903,74,110,38,36,allow
38283,443,38283,443,6981,948,6033,17,54,10,7,allow
50574,80,53098,80,2734,1250,1484,16,15,10,6,allow
60391,47212,53433,47212,258,70,188,4,8,2,2,allow
38085,443,1147,443,78,78,0,1,5,1,0,allow
56964,53,45347,53,267,87,180,4,54,2,2,allow
49465,443,57765,443,11184,6821,4363,27,53,14,13,allow
123,123,62754,123,184,94,90,2,30,1,1,allow
50692,80,35406,80,57678,29714,27964,241,175,120,121,allow
52452,80,35444,80,5582,591,4991,14,75,7,7,allow
50693,80,37544,80,56849,29352,27497,239,175,120,119,allow
39477,443,24151,443,3655,2308,1347,18,15,10,8,allow
60392,1134,52281,1134,70,70,0,2,8,2,0,allow
61836,443,61836,443,132180,4407,127773,146,75,51,95,allow
64530,53,55254,53,261,87,174,4,45,2,2,allow
49523,53,10736,53,728,96,632,2,30,1,1,allow
50695,80,60576,80,58726,30286,28440,246,175,123,123,allow
56559,443,41687,443,2723,1564,1159,15,17,9,6,allow
23317,443,22656,443,2227,1018,1209,17,15,8,9,allow
57470,44224,31554,44224,480,149,331,2,1200,1,1,allow
52454,80,19961,80,2425,529,1896,11,75,6,5,allow
52065,80,16889,80,81670,2359,79311,89,621,30,59,allow
50685,80,30111,80,60374,30984,29390,250,175,123,127,allow
53112,29258,11040,29258,70,70,0,2,8,2,0,allow
49171,443,1136,443,15437,8368,7069,40,361,19,21,allow
51946,443,31314,443,2666,1542,1124,17,17,9,8,allow
62111,443,62044,443,3262,256,3006,9,121,4,5,allow
51749,1408,51950,1408,70,70,0,1,5,1,0,allow
59737,53,18837,53,382,164,218,2,31,1,1,allow
61340,443,7462,443,31549,6352,25197,64,206,26,38,allow
56923,53,49262,53,711,87,624,2,30,1,1,allow
56772,61424,18304,61424,70,70,0,2,8,2,0,allow
39871,53,52816,53,198,93,105,2,31,1,1,allow
30960,45683,56128,45683,330,330,0,6,3609,6,0,allow
30960,45670,41313,45670,462,462,0,8,3632,8,0,allow
61030,443,16792,443,109010,37307,71703,152,895,62,90,allow
21365,23718,0,0,62,62,0,1,0,1,0,deny
51773,445,0,0,66,66,0,1,0,1,0,drop
51769,445,0,0,66,66,0,1,0,1,0,drop
51768,445,0,0,66,66,0,1,0,1,0,drop
51764,445,0,0,66,66,0,1,0,1,0,drop
52514,23,0,0,60,60,0,1,0,1,0,deny
28914,26296,0,0,159,159,0,1,0,1,0,deny
51763,445,0,0,66,66,0,1,0,1,0,drop
51762,445,0,0,66,66,0,1,0,1,0,drop
51761,445,0,0,66,66,0,1,0,1,0,drop
46495,4607,0,0,60,60,0,1,0,1,0,deny
1182,23,0,0,60,60,0,1,0,1,0,deny
61693,443,50704,443,12203,3519,8684,65,18,35,30,allow
50689,80,10754,80,54757,28216,26541,229,175,114,115,allow
50697,80,44763,80,54775,28230,26545,230,175,115,115,allow
50582,80,62835,80,53959,2683,51276,69,16,30,39,allow
31871,53,40960,53,209,86,123,2,29,1,1,allow
64375,53,1918,53,228,110,118,2,29,1,1,allow
57305,53,63466,53,177,94,83,2,30,1,1,allow
55054,443,7526,443,6903,1481,5422,33,612,12,21,allow
43214,443,49896,443,1563663,41030,1522633,1538,40,479,1059,allow
56734,45086,42195,45086,1640,460,1180,8,30,4,4,allow
50909,80,20271,80,12826704,145724,12680980,10558,133,2024,8534,allow
50902,80,26223,80,12578792,132594,12446198,10198,133,1845,8353,allow
52453,443,8871,443,6650,950,5700,18,75,9,9,allow
51733,30688,11073,30688,70,70,0,1,4,1,0,allow
53539,6881,61115,6881,492,306,186,8,14,5,3,allow
42922,80,60551,80,78,78,0,1,4,1,0,allow
52210,443,33908,443,6294,1716,4578,27,23,16,11,allow
51604,443,37096,443,7086,2173,4913,20,16,10,10,allow
57747,80,27520,80,2754,1602,1152,17,22,9,8,allow
34760,443,55387,443,70,70,0,1,4,1,0,allow
39948,5223,55367,5223,5551,1338,4213,28,1323,11,17,allow
64882,53,49587,53,279,126,153,2,30,1,1,allow
57470,8100,10100,8100,3281,894,2387,14,1200,7,7,allow
49848,53,60109,53,260,102,158,2,30,1,1,allow
60380,55125,31447,55125,70,70,0,1,5,1,0,allow
60382,62582,16978,62582,70,70,0,1,5,1,0,allow
51266,16103,3760,16103,70,70,0,2,8,2,0,allow
60062,53,61702,53,168,78,90,2,30,1,1,allow
38321,80,40490,80,543,469,74,6,16,5,1,allow
64530,53,18888,53,261,87,174,4,45,2,2,allow
64573,53,58393,53,558,104,454,4,49,2,2,allow
60385,59696,6029,59696,70,70,0,1,5,1,0,allow
43215,443,55751,443,3245691,49693,3195998,2856,38,666,2190,allow
59016,443,23931,443,12676,4222,8454,36,87,20,16,allow
50501,123,36469,123,184,94,90,2,30,1,1,allow
49621,443,55607,443,46983,4167,42816,66,44,28,38,allow
57305,53,33562,53,177,94,83,2,30,1,1,allow
60895,443,6009,443,9387,2961,6426,38,18,23,15,allow
9129,53,56648,53,205,86,119,2,30,1,1,allow
59739,443,20531,443,304,86,218,2,30,1,1,allow
12433,53,7842,53,208,86,122,2,30,1,1,allow
55339,443,4853,443,2552065,30474,2521591,2074,129,236,1838,allow
23560,53,25867,53,219,86,133,2,30,1,1,allow
60381,26312,40513,26312,70,70,0,1,5,1,0,allow
51734,59825,48074,59825,70,70,0,1,5,1,0,allow
51582,443,29660,443,9080,2186,6894,27,108,14,13,allow
62947,53,18275,53,213,86,127,2,30,1,1,allow
55596,53,49236,53,177,94,83,2,30,1,1,allow
51233,443,5696,443,9925,2939,6986,30,46,17,13,allow
39640,53,64225,53,168,78,90,2,30,1,1,allow
15503,42638,40530,42638,1367,664,703,16,1200,9,7,allow
50908,80,37284,80,14077960,171956,13906004,11755,133,2437,9318,allow
50694,80,5032,80,54760,27837,26923,229,175,114,115,allow
52455,443,34682,443,7356,1014,6342,20,75,10,10,allow
59419,80,51819,80,3442,1672,1770,19,22,10,9,allow
36065,443,10379,443,3171,1490,1681,22,21,12,10,allow
34856,443,47870,443,7524,1903,5621,31,22,18,13,allow
51750,54567,18193,54567,70,70,0,2,7,2,0,allow
46167,80,23731,80,234,234,0,4,11,4,0,allow
57416,66,12942,66,70,70,0,1,4,1,0,allow
7322,80,9945,80,950,485,465,9,16,5,4,allow
50824,443,63186,443,337727,11283,326444,367,208,126,241,allow
56964,53,17076,53,267,87,180,4,53,2,2,allow
61837,443,61837,443,18398,2360,16038,39,75,17,22,allow
47110,80,30489,80,436,222,214,7,19,4,3,allow
50602,443,33341,443,572966,109738,463228,1277,624,639,638,allow
33649,123,62077,123,184,94,90,2,30,1,1,allow
65248,53,8659,53,197,94,103,2,30,1,1,allow
64218,53,41220,53,212,94,118,2,30,1,1,allow
49915,53,47403,53,225,102,123,2,30,1,1,allow
34285,53,45642,53,168,78,90,2,30,1,1,allow
51798,80,50477,80,1825,824,1001,21,134,11,10,allow
56661,53,1967,53,900,110,790,2,30,1,1,allow
48362,443,23544,443,8075,1766,6309,22,78,13,9,allow
57165,53,9169,53,216,102,114,2,30,1,1,allow
41882,53,0,0,86,86,0,1,29,1,0,allow
28481,53,51837,53,205,86,119,2,30,1,1,allow
59740,53,42403,53,304,86,218,2,30,1,1,allow
52495,443,27354,443,787462,10645,776817,653,131,87,566,allow
59727,443,28777,443,304,86,218,2,31,1,1,allow
59725,443,21996,443,304,86,218,2,31,1,1,allow
37965,40840,26004,40840,150,150,0,1,1199,1,0,allow
49501,443,35522,443,13077,4380,8697,34,1881,17,17,allow
59731,443,4869,443,384,166,218,2,31,1,1,allow
51732,54299,38142,54299,70,70,0,1,5,1,0,allow
52907,80,17763,80,1659,653,1006,10,16,6,4,allow
44929,443,44929,443,5469,2222,3247,22,38,13,9,allow
41811,443,11732,443,28899,3134,25765,66,271,32,34,allow
59742,53,55013,53,448,166,282,2,30,1,1,allow
56207,53,30514,53,260,102,158,2,30,1,1,allow
39039,443,46475,443,3159,1237,1922,14,19,8,6,allow
56773,28093,5962,28093,70,70,0,2,8,2,0,allow
53220,80,25607,80,17976,840,17136,21,16,6,15,allow
56964,53,61136,53,267,87,180,4,59,2,2,allow
59741,443,12538,443,384,166,218,2,30,1,1,allow
54743,443,47896,443,166136,7244,158892,202,149,76,126,allow
52784,443,47288,443,2802,1626,1176,18,72,9,9,allow
64720,53,3807,53,216,102,114,2,30,1,1,allow
60044,443,17036,443,15769,1619,14150,17,141,4,13,allow
53069,443,18651,443,13074,8472,4602,31,135,16,15,allow
36936,443,13188,443,490,210,280,8,131,4,4,allow
36934,443,62872,443,490,210,280,8,131,4,4,allow
63171,5228,60967,5228,3535,1973,1562,36,3961,18,18,allow
62110,443,43597,443,10390,3051,7339,16,121,6,10,allow
53562,8999,49942,8999,320,140,180,6,6,3,3,allow
53540,34134,25153,34134,70,70,0,1,5,1,0,allow
50609,80,26280,80,4163,2891,1272,17,17,9,8,allow
50691,80,17442,80,55050,28089,26961,228,175,112,116,allow
42451,443,55087,443,4886,895,3991,16,31,9,7,allow
57264,53,9791,53,214,102,112,2,30,1,1,allow
50112,123,33230,123,184,94,90,2,30,1,1,allow
52493,443,57807,443,32907,8900,24007,38,16,16,22,allow
64530,53,39688,53,261,87,174,4,46,2,2,allow
63733,47013,29294,47013,70,70,0,1,5,1,0,allow
39486,80,4046,80,1184,524,660,7,78,4,3,allow
63530,3389,63530,3389,3489,1534,1955,17,19,9,8,allow
50482,443,21793,443,2520,1267,1253,17,83,9,8,allow
50481,443,21430,443,1258,716,542,13,83,7,6,allow
50684,80,24128,80,57576,29602,27974,239,175,118,121,allow
53214,80,58168,80,19877,856,19021,22,16,6,16,allow
123,123,8140,123,184,94,90,2,30,1,1,allow
56378,53,11573,53,214,102,112,2,30,1,1,allow
123,123,42021,123,184,94,90,2,30,1,1,allow
55704,53,11582,53,260,102,158,2,30,1,1,allow
59733,53,57614,53,384,166,218,2,30,1,1,allow
49777,443,42531,443,35152,27056,8096,56,104,31,25,allow
53556,1024,53867,1024,70,70,0,2,8,2,0,allow
63732,40642,2876,40642,70,70,0,1,5,1,0,allow
50703,80,3596,80,54304,27807,26497,227,175,113,114,allow
50978,80,46474,80,1442,700,742,12,35,6,6,allow
2980,53,2980,53,216,90,126,2,30,1,1,allow
62113,443,7270,443,3262,256,3006,9,121,4,5,allow
33109,443,18483,443,6749,1593,5156,23,123,12,11,allow
62865,443,23097,443,21313,7245,14068,48,128,22,26,allow
56345,445,0,0,70,70,0,1,0,1,0,drop
56343,445,0,0,70,70,0,1,0,1,0,drop
56342,445,0,0,70,70,0,1,0,1,0,drop
51948,37965,0,0,62,62,0,1,0,1,0,deny
51759,445,0,0,66,66,0,1,0,1,0,drop
52401,623,0,0,60,60,0,1,0,1,0,deny
56339,445,0,0,70,70,0,1,0,1,0,drop
51755,445,0,0,66,66,0,1,0,1,0,drop
51311,445,0,0,70,70,0,1,0,1,0,drop
57165,34101,0,0,66,66,0,1,0,1,0,deny
51753,445,0,0,66,66,0,1,0,1,0,drop
51752,445,0,0,66,66,0,1,0,1,0,drop
5180,57866,0,0,62,62,0,1,0,1,0,deny
53298,26467,0,0,66,66,0,1,0,1,0,deny
49501,11392,0,0,62,62,0,1,0,1,0,deny
51749,445,0,0,66,66,0,1,0,1,0,drop
51308,445,0,0,70,70,0,1,0,1,0,drop
59315,35440,0,0,66,66,0,1,0,1,0,deny
5223,5025,0,0,220,220,0,1,0,1,0,deny
6916,9822,0,0,100,100,0,1,0,1,0,deny
56335,445,0,0,70,70,0,1,0,1,0,drop
52650,36237,0,0,62,62,0,1,0,1,0,deny
56330,445,0,0,70,70,0,1,0,1,0,drop
56324,445,0,0,70,70,0,1,0,1,0,drop
55286,37965,0,0,66,66,0,1,0,1,0,deny
17177,64147,0,0,62,62,0,1,0,1,0,deny
29682,44847,0,0,62,62,0,1,0,1,0,deny
62148,37965,0,0,62,62,0,1,0,1,0,deny
51304,445,0,0,70,70,0,1,0,1,0,drop
51829,36134,0,0,66,66,0,1,0,1,0,deny
51302,445,0,0,70,70,0,1,0,1,0,drop
21998,51221,0,0,62,62,0,1,0,1,0,deny
51737,445,0,0,66,66,0,1,0,1,0,drop
51300,445,0,0,70,70,0,1,0,1,0,drop
4910,2149,0,0,66,66,0,1,0,1,0,deny
8999,50432,0,0,62,62,0,1,0,1,0,deny
42128,54532,0,0,60,60,0,1,0,1,0,deny
36538,64147,0,0,62,62,0,1,0,1,0,deny
4594,35993,0,0,66,66,0,1,0,1,0,deny
45941,23386,0,0,60,60,0,1,0,1,0,deny
62392,15503,0,0,146,146,0,1,0,1,0,deny
12471,31573,0,0,62,62,0,1,0,1,0,deny
51730,445,0,0,66,66,0,1,0,1,0,drop
28832,36237,0,0,62,62,0,1,0,1,0,deny
56311,445,0,0,70,70,0,1,0,1,0,drop
64776,50584,0,0,66,66,0,1,0,1,0,deny
1025,64147,0,0,62,62,0,1,0,1,0,deny
51293,445,0,0,70,70,0,1,0,1,0,drop
51727,445,0,0,66,66,0,1,0,1,0,drop
51291,445,0,0,70,70,0,1,0,1,0,drop
25565,54864,0,0,60,60,0,1,0,1,0,deny
52676,53733,0,0,66,66,0,1,0,1,0,deny
57837,64147,0,0,62,62,0,1,0,1,0,deny
51290,445,0,0,70,70,0,1,0,1,0,drop
51289,445,0,0,70,70,0,1,0,1,0,drop
51720,445,0,0,66,66,0,1,0,1,0,drop
51288,445,0,0,70,70,0,1,0,1,0,drop
63379,36237,0,0,66,66,0,1,0,1,0,deny
20650,26467,0,0,66,66,0,1,0,1,0,deny
51286,445,0,0,70,70,0,1,0,1,0,drop
51283,445,0,0,70,70,0,1,0,1,0,drop
58849,64147,0,0,62,62,0,1,0,1,0,deny
51713,445,0,0,66,66,0,1,0,1,0,drop
58486,57470,0,0,66,66,0,1,0,1,0,deny
9067,44847,0,0,62,62,0,1,0,1,0,deny
41908,1433,0,0,60,60,0,1,0,1,0,deny
53743,443,64755,443,495,421,74,4,1,3,1,allow
51270,445,0,0,70,70,0,1,0,1,0,drop
51268,445,0,0,70,70,0,1,0,1,0,drop
52439,35894,0,0,74,74,0,1,0,1,0,deny
51264,445,0,0,70,70,0,1,0,1,0,drop
51260,445,0,0,70,70,0,1,0,1,0,drop
51259,445,0,0,70,70,0,1,0,1,0,drop
52135,2790,0,0,66,66,0,1,0,1,0,deny
56303,445,0,0,70,70,0,1,0,1,0,drop
56301,445,0,0,70,70,0,1,0,1,0,drop
56299,445,0,0,70,70,0,1,0,1,0,drop
4041,50584,0,0,62,62,0,1,0,1,0,deny
51702,445,0,0,66,66,0,1,0,1,0,drop
51704,445,0,0,66,66,0,1,0,1,0,drop
51701,445,0,0,66,66,0,1,0,1,0,drop
51699,445,0,0,66,66,0,1,0,1,0,drop
51697,445,0,0,66,66,0,1,0,1,0,drop
51705,445,0,0,66,66,0,1,0,1,0,drop
51700,445,0,0,66,66,0,1,0,1,0,drop
51698,445,0,0,66,66,0,1,0,1,0,drop
51085,56205,0,0,66,66,0,1,0,1,0,deny
27084,50584,0,0,66,66,0,1,0,1,0,deny
60184,37965,0,0,66,66,0,1,0,1,0,deny
3352,50584,0,0,62,62,0,1,0,1,0,deny
51248,445,0,0,70,70,0,1,0,1,0,drop
64024,57470,0,0,66,66,0,1,0,1,0,deny
64341,57470,0,0,62,62,0,1,0,1,0,deny
54305,35440,0,0,62,62,0,1,0,1,0,deny
7889,48817,0,0,146,146,0,1,0,1,0,deny
52208,43890,0,0,66,66,0,1,0,1,0,deny
56298,445,0,0,70,70,0,1,0,1,0,drop
56292,445,0,0,70,70,0,1,0,1,0,drop
56285,445,0,0,70,70,0,1,0,1,0,drop
14397,37965,0,0,62,62,0,1,0,1,0,deny
51685,445,0,0,66,66,0,1,0,1,0,drop
51684,445,0,0,66,66,0,1,0,1,0,drop
51682,445,0,0,66,66,0,1,0,1,0,drop
3802,55777,0,0,66,66,0,1,0,1,0,deny
31845,55777,0,0,62,62,0,1,0,1,0,deny
50292,62413,0,0,146,146,0,1,0,1,0,deny
51244,445,0,0,70,70,0,1,0,1,0,drop
56282,445,0,0,70,70,0,1,0,1,0,drop
45941,23388,0,0,60,60,0,1,0,1,0,deny
56279,445,0,0,70,70,0,1,0,1,0,drop
51235,445,0,0,70,70,0,1,0,1,0,drop
51233,445,0,0,70,70,0,1,0,1,0,drop
56278,445,0,0,70,70,0,1,0,1,0,drop
56269,445,0,0,70,70,0,1,0,1,0,drop
56267,445,0,0,70,70,0,1,0,1,0,drop
51229,445,0,0,70,70,0,1,0,1,0,drop
51231,445,0,0,70,70,0,1,0,1,0,drop
1114,37965,0,0,62,62,0,1,0,1,0,deny
51227,445,0,0,70,70,0,1,0,1,0,drop
1024,44847,0,0,146,146,0,1,0,1,0,deny
55749,37965,0,0,66,66,0,1,0,1,0,deny
59411,37965,0,0,66,66,0,1,0,1,0,deny
53300,37807,0,0,66,66,0,1,0,1,0,deny
51745,30188,0,0,66,66,0,1,0,1,0,deny
22541,64147,0,0,66,66,0,1,0,1,0,deny
10003,64147,0,0,62,62,0,1,0,1,0,deny
8999,49001,0,0,146,146,0,1,0,1,0,deny
57360,18375,0,0,66,66,0,1,0,1,0,deny
51222,445,0,0,70,70,0,1,0,1,0,drop
32710,22114,0,0,62,62,0,1,0,1,0,deny
56262,445,0,0,70,70,0,1,0,1,0,drop
56259,445,0,0,70,70,0,1,0,1,0,drop
56255,445,0,0,70,70,0,1,0,1,0,drop
62970,44847,0,0,62,62,0,1,0,1,0,deny
53542,9192,0,0,148,148,0,1,0,1,0,deny
25091,64147,0,0,66,66,0,1,0,1,0,deny
52519,44847,0,0,66,66,0,1,0,1,0,deny
25602,64147,0,0,62,62,0,1,0,1,0,deny
1749,64147,0,0,66,66,0,1,0,1,0,deny
51214,445,0,0,70,70,0,1,0,1,0,drop
51212,445,0,0,70,70,0,1,0,1,0,drop
53960,30041,0,0,62,62,0,1,0,1,0,deny
25772,7302,0,0,66,66,0,1,0,1,0,deny
54894,9571,0,0,66,66,0,1,0,1,0,deny
11967,57470,0,0,62,62,0,1,0,1,0,deny
55413,37965,0,0,66,66,0,1,0,1,0,deny
10586,37965,0,0,62,62,0,1,0,1,0,deny
51661,445,0,0,66,66,0,1,0,1,0,drop
56279,23,0,0,60,60,0,1,0,1,0,deny
56251,445,0,0,70,70,0,1,0,1,0,drop
56246,445,0,0,70,70,0,1,0,1,0,drop
51207,445,0,0,70,70,0,1,0,1,0,drop
61185,54532,0,0,62,62,0,1,0,1,0,deny
51206,445,0,0,70,70,0,1,0,1,0,drop
61185,54532,0,0,145,145,0,1,0,1,0,deny
2522,64147,0,0,62,62,0,1,0,1,0,deny
51151,64147,0,0,66,66,0,1,0,1,0,deny
51202,445,0,0,70,70,0,1,0,1,0,drop
49744,80,36258,80,2455,475,1980,9,81,5,4,allow
50478,443,64929,443,36345,2308,34037,52,83,23,29,allow
52494,443,23008,443,5782,1008,4774,17,15,8,9,allow
64663,53,18610,53,578,286,292,9,15,5,4,allow
51139,80,1947,80,124,64,60,2,15,1,1,allow
49841,80,51896,80,3126,469,2657,9,75,5,4,allow
39474,443,60202,443,9766,2050,7716,23,15,12,11,allow
30960,45679,3682,45679,396,396,0,7,3615,7,0,allow
48817,6881,48817,6881,490,149,341,2,1200,1,1,allow
61696,443,54803,443,9097,2123,6974,25,16,15,10,allow
44910,443,16825,443,2841,1916,925,18,26,10,8,allow
50700,80,20685,80,55825,28792,27033,234,174,117,117,allow
54033,443,51149,443,43491,8521,34970,69,50,34,35,allow
50698,80,42687,80,54871,28320,26551,231,174,116,115,allow
50690,80,44292,80,56951,28706,28245,236,174,116,120,allow
24208,53,24208,53,231,88,143,2,32,1,1,allow
56769,11155,9985,11155,70,70,0,2,8,2,0,allow
50702,80,54989,80,55224,28254,26970,230,174,114,116,allow
22680,443,22680,443,18490,7811,10679,47,81,27,20,allow
55596,53,61686,53,170,87,83,2,30,1,1,allow
53533,22642,24303,22642,612,306,306,10,16,5,5,allow
60521,443,45323,443,45001,3799,41202,74,331,35,39,allow
39472,443,61496,443,9767,2138,7629,22,16,12,10,allow
43014,53,60826,53,198,93,105,2,30,1,1,allow
59729,53,2967,53,303,85,218,2,30,1,1,allow
56321,443,18769,443,4704,2423,2281,16,135,8,8,allow
53557,39731,46000,39731,70,70,0,2,8,2,0,allow
51378,3027,51378,3027,156,156,0,3,8,3,0,allow
50477,443,35054,443,2604,1413,1191,15,83,9,6,allow
51357,80,45603,80,124,64,60,2,16,1,1,allow
59730,443,46246,443,303,85,218,2,30,1,1,allow
44654,80,35775,80,2121,1558,563,13,16,7,6,allow
56704,53,33003,53,711,87,624,2,30,1,1,allow
51655,445,0,0,66,66,0,1,0,1,0,drop
21492,51505,0,0,62,62,0,1,0,1,0,deny
51653,445,0,0,66,66,0,1,0,1,0,drop
993,4281,0,0,66,66,0,1,0,1,0,deny
56239,445,0,0,70,70,0,1,0,1,0,drop
51200,445,0,0,70,70,0,1,0,1,0,drop
61013,41705,0,0,66,66,0,1,0,1,0,deny
49711,14984,0,0,66,66,0,1,0,1,0,deny
56237,445,0,0,70,70,0,1,0,1,0,drop
56234,445,0,0,70,70,0,1,0,1,0,drop
56232,445,0,0,70,70,0,1,0,1,0,drop
7842,23,0,0,60,60,0,1,0,1,0,deny
51651,445,0,0,66,66,0,1,0,1,0,drop
6666,3389,0,0,60,60,0,1,0,1,0,deny
38484,48637,0,0,60,60,0,1,0,1,0,deny
51105,50584,0,0,66,66,0,1,0,1,0,deny
53233,51221,0,0,66,66,0,1,0,1,0,deny
62331,61689,0,0,62,62,0,1,0,1,0,deny
35957,51185,0,0,60,60,0,1,0,1,0,deny
50994,35974,0,0,60,60,0,1,0,1,0,deny
51196,445,0,0,70,70,0,1,0,1,0,drop
56225,445,0,0,70,70,0,1,0,1,0,drop
42745,50011,0,0,62,62,0,1,0,1,0,deny
56224,445,0,0,70,70,0,1,0,1,0,drop
56222,445,0,0,70,70,0,1,0,1,0,drop
56220,445,0,0,70,70,0,1,0,1,0,drop
62338,50011,0,0,66,66,0,1,0,1,0,deny
51643,445,0,0,66,66,0,1,0,1,0,drop
30598,46824,0,0,62,62,0,1,0,1,0,deny
51641,445,0,0,66,66,0,1,0,1,0,drop
51640,445,0,0,66,66,0,1,0,1,0,drop
51639,445,0,0,66,66,0,1,0,1,0,drop
20371,35440,0,0,62,62,0,1,0,1,0,deny
51634,445,0,0,66,66,0,1,0,1,0,drop
51632,445,0,0,66,66,0,1,0,1,0,drop
51633,445,0,0,66,66,0,1,0,1,0,drop
52910,51221,0,0,78,78,0,1,0,1,0,deny
52975,23718,0,0,66,66,0,1,0,1,0,deny
50422,50584,0,0,66,66,0,1,0,1,0,deny
50734,37965,0,0,62,62,0,1,0,1,0,deny
56703,50584,0,0,66,66,0,1,0,1,0,deny
56218,445,0,0,70,70,0,1,0,1,0,drop
11582,41599,40027,41599,70,70,0,1,5,1,0,allow
51643,80,38570,80,499,192,307,6,38,4,2,allow
49836,53,62893,53,168,78,90,2,30,1,1,allow
6881,19215,41309,19215,509,150,359,2,1199,1,1,allow
50699,80,28391,80,54318,27824,26494,227,174,113,114,allow
34692,443,49759,443,3386,1833,1553,17,255,9,8,allow
63734,28221,28610,28221,70,70,0,1,4,1,0,allow
53536,34200,55165,34200,70,70,0,1,4,1,0,allow
50662,443,7273,443,4606,3263,1343,19,304,10,9,allow
65426,443,27740,443,14205,1527,12678,13,145,2,11,allow
59379,443,58325,443,4518,1784,2734,30,23,15,15,allow
53213,80,60340,80,18040,904,17136,22,15,7,15,allow
51657,80,10496,80,318,192,126,6,37,4,2,allow
49565,443,37074,443,378,192,186,7,14,4,3,allow
53563,17355,37621,17355,320,140,180,6,5,3,3,allow
14422,443,38791,443,1857,1218,639,18,95,11,7,allow
51658,80,29469,80,318,192,126,6,37,4,2,allow
56770,52920,52041,52920,70,70,0,2,8,2,0,allow
53559,58968,7595,58968,70,70,0,2,7,2,0,allow
51645,80,57006,80,318,192,126,6,38,4,2,allow
51632,80,60453,80,502,256,246,9,39,5,4,allow
55878,53,24199,53,260,102,158,2,29,1,1,allow
59736,53,9602,53,571,166,405,2,29,1,1,allow
59735,443,11235,443,512,166,346,2,29,1,1,allow
55596,53,19558,53,177,94,83,2,30,1,1,allow
56046,53,22169,53,289,160,129,3,29,2,1,allow
62112,443,63604,443,4655,1649,3006,10,120,5,5,allow
56732,10271,46976,10271,3090,1706,1384,16,30,10,6,allow
51650,80,16811,80,312,192,120,6,37,4,2,allow
51635,80,49291,80,318,192,126,6,39,4,2,allow
56665,53,16180,53,216,102,114,2,30,1,1,allow
56546,53,5266,53,177,94,83,2,30,1,1,allow
56060,53,26992,53,224,102,122,2,30,1,1,allow
64945,53,32076,53,733,94,639,2,30,1,1,allow
51654,80,46130,80,318,192,126,6,37,4,2,allow
48297,443,9986,443,7320,1817,5503,41,106,16,25,allow
53715,443,59918,443,70,70,0,1,5,1,0,allow
53111,50809,36816,50809,70,70,0,2,8,2,0,allow
56600,80,32176,80,234,234,0,4,12,4,0,allow
46415,443,41654,443,9307,2265,7042,31,325,13,18,allow
36676,443,44727,443,7636,3367,4269,24,319,13,11,allow
51634,80,59507,80,378,192,186,7,39,4,3,allow
59166,123,2980,123,184,94,90,2,30,1,1,allow
56912,53,43272,53,216,94,122,2,30,1,1,allow
35688,53,49808,53,199,94,105,2,30,1,1,allow
47302,53,19968,53,168,78,90,2,30,1,1,allow
33196,53,25269,53,181,86,95,2,30,1,1,allow
53864,53,19118,53,168,78,90,2,30,1,1,allow
56546,53,1301,53,177,94,83,2,30,1,1,allow
36932,443,8229,443,280,140,140,5,130,3,2,allow
39458,443,56911,443,1053,566,487,10,31,6,4,allow
51647,80,60876,80,378,192,186,7,38,4,3,allow
51444,443,44166,443,7658,1309,6349,24,75,13,11,allow
49723,80,53474,80,2367,557,1810,10,82,6,4,allow
39310,53,33057,53,199,94,105,2,30,1,1,allow
63628,53,35423,53,289,86,203,2,30,1,1,allow
53772,53,7783,53,70,70,0,1,30,1,0,allow
56920,53,48525,53,184,78,106,2,30,1,1,allow
51646,80,56559,80,378,192,186,7,38,4,3,allow
50483,443,29109,443,10050,1192,8858,28,81,14,14,allow
65371,443,38245,443,34653,2523,32130,65,83,26,39,allow
51653,80,24193,80,454,262,192,8,37,5,3,allow
29176,7000,29176,7000,4731,2270,2461,18,15,10,8,allow
54418,443,37950,443,3350,1804,1546,19,255,10,9,allow
48000,443,53560,443,7193,1890,5303,22,37,15,7,allow
40360,443,31288,443,3146,766,2380,10,120,5,5,allow
52965,443,12004,443,8602,1050,7552,16,120,7,9,allow
10976,22,10976,22,9240,3413,5827,59,37,26,33,allow
51637,80,27014,80,378,192,186,7,39,4,3,allow
39532,443,10682,443,345779,9537,336242,359,26,123,236,allow
35710,443,47207,443,1053,566,487,10,31,6,4,allow
30188,59035,2297,59035,1794,750,1044,12,4220,6,6,allow
53462,443,47212,443,6384,1091,5293,18,30,10,8,allow
35897,443,1439,443,6692,1642,5050,24,275,11,13,allow
51659,80,25484,80,318,192,126,6,37,4,2,allow
51102,443,49198,443,3402,1258,2144,13,135,6,7,allow
50014,80,33183,80,810,670,140,6,34,4,2,allow
51652,80,59640,80,454,262,192,8,37,5,3,allow
51644,80,3834,80,499,192,307,6,38,4,2,allow
50064,443,33198,443,6376,2499,3877,20,16,10,10,allow
60195,80,26973,80,3059,1869,1190,17,105,13,4,allow
51655,80,54219,80,318,192,126,6,37,4,2,allow
64530,53,20478,53,261,87,174,4,44,2,2,allow
35422,443,35422,443,5172,1925,3247,22,39,13,9,allow
39983,80,39983,80,6416,997,5419,17,30,8,9,allow
51636,80,6805,80,318,192,126,6,39,4,2,allow
52735,443,43904,443,41870,3567,38303,68,15,34,34,allow
53553,2297,8843,2297,70,70,0,2,7,2,0,allow
53215,443,56280,443,6983,1629,5354,17,15,9,8,allow
52064,80,62647,80,65658,3155,62503,76,621,26,50,allow
60393,46347,14352,46347,320,140,180,6,7,3,3,allow
51638,80,60451,80,318,192,126,6,39,4,2,allow
55596,53,2008,53,177,94,83,2,29,1,1,allow
48006,443,61488,443,1429,1295,134,10,30,8,2,allow
51497,443,32306,443,4710,699,4011,12,15,8,4,allow
53566,80,56289,80,2270749,47314,2223435,2132,99,651,1481,allow
58711,53,20725,53,277,78,199,2,30,1,1,allow
65235,53,39902,53,216,94,122,2,30,1,1,allow
59734,443,60915,443,512,166,346,2,29,1,1,allow
59178,53,27947,53,260,86,174,2,30,1,1,allow
59732,53,64408,53,384,166,218,2,30,1,1,allow
57629,443,51109,443,14555,5048,9507,82,134,33,49,allow
55877,47528,12404,47528,491,150,341,2,1200,1,1,allow
59728,53,43809,53,304,86,218,2,30,1,1,allow
59726,53,53950,53,304,86,218,2,30,1,1,allow
44979,443,39259,443,10311,2186,8125,26,186,14,12,allow
41039,443,10141,443,1053,566,487,10,31,6,4,allow
58046,443,22923,443,1536,1089,447,11,56,7,4,allow
56421,53,8309,53,177,94,83,2,30,1,1,allow
49160,51413,10192,51413,800,150,650,4,1200,2,2,allow
44404,443,27524,443,9060,3523,5537,27,319,15,12,allow
51633,80,4651,80,502,256,246,9,39,5,4,allow
46236,53,38054,53,199,94,105,2,30,1,1,allow
56261,53,65402,53,199,94,105,2,30,1,1,allow
11295,40033,17184,40033,156,94,62,2,30,1,1,allow
49872,53,15358,53,216,94,122,2,30,1,1,allow
51640,80,25604,80,2895,1428,1467,12,38,7,5,allow
52657,80,31996,80,26073,2868,23205,41,110,17,24,allow
51656,80,3808,80,318,192,126,6,37,4,2,allow
56771,43648,30018,43648,70,70,0,2,8,2,0,allow
50479,443,28335,443,1654,1011,643,16,82,9,7,allow
59724,53,63001,53,304,86,218,2,30,1,1,allow
59723,443,40207,443,304,86,218,2,30,1,1,allow
57173,53,39121,53,168,78,90,2,30,1,1,allow
55008,53,19602,53,215,102,113,2,30,1,1,allow
46970,443,52704,443,8394,3155,5239,28,271,16,12,allow
51221,65264,24402,65264,870,330,540,12,1573,6,6,allow
63744,47106,38855,47106,66,66,0,2,8,2,0,allow
60740,80,7735,80,254,128,126,5,16,3,2,allow
65109,53,42813,53,229,102,127,2,30,1,1,allow
56759,53,36247,53,733,94,639,2,31,1,1,allow
50353,443,35772,443,7397,1784,5613,27,306,13,14,allow
63741,36776,34457,36776,66,66,0,2,8,2,0,allow
57076,5222,34364,5222,15600,7789,7811,155,169,82,73,allow
51198,443,22207,443,8075,2723,5352,42,117,24,18,allow
57880,80,31507,80,13028,3246,9782,29,30,16,13,allow
7068,53,7068,53,197,90,107,2,30,1,1,allow
35132,53,35132,53,469,165,304,4,31,2,2,allow
51514,443,43958,443,2188,1329,859,23,19,13,10,allow
58701,27030,9286,27030,70,70,0,1,5,1,0,allow
65388,80,37790,80,1498,392,1106,10,16,5,5,allow
51466,443,4846,443,1878,1050,828,9,16,5,4,allow
49923,53,8519,53,702,194,508,6,67,3,3,allow
53785,53,12230,53,167,78,89,2,31,1,1,allow
56215,445,0,0,70,70,0,1,0,1,0,drop
56212,445,0,0,70,70,0,1,0,1,0,drop
45964,7778,0,0,60,60,0,1,0,1,0,deny
51183,445,0,0,70,70,0,1,0,1,0,drop
63583,37965,0,0,66,66,0,1,0,1,0,deny
51191,26467,0,0,66,66,0,1,0,1,0,deny
51628,445,0,0,66,66,0,1,0,1,0,drop
30599,46824,0,0,66,66,0,1,0,1,0,deny
56211,445,0,0,70,70,0,1,0,1,0,drop
53030,56205,0,0,66,66,0,1,0,1,0,deny
51625,445,0,0,66,66,0,1,0,1,0,drop
60960,49049,0,0,66,66,0,1,0,1,0,deny
62930,21247,0,0,66,66,0,1,0,1,0,deny
51623,445,0,0,66,66,0,1,0,1,0,drop
51622,445,0,0,66,66,0,1,0,1,0,drop
51180,445,0,0,70,70,0,1,0,1,0,drop
2904,44847,0,0,78,78,0,1,0,1,0,deny
46116,51505,0,0,62,62,0,1,0,1,0,deny
51619,445,0,0,66,66,0,1,0,1,0,drop
21294,57470,0,0,62,62,0,1,0,1,0,deny
46849,36237,0,0,66,66,0,1,0,1,0,deny
64219,51050,0,0,66,66,0,1,0,1,0,deny
48815,22114,0,0,146,146,0,1,0,1,0,deny
14084,43890,0,0,62,62,0,1,0,1,0,deny
37234,44847,0,0,62,62,0,1,0,1,0,deny
56206,445,0,0,70,70,0,1,0,1,0,drop
51176,445,0,0,70,70,0,1,0,1,0,drop
39823,36237,0,0,66,66,0,1,0,1,0,deny
51174,445,0,0,70,70,0,1,0,1,0,drop
56200,445,0,0,70,70,0,1,0,1,0,drop
56192,445,0,0,70,70,0,1,0,1,0,drop
1987,26467,0,0,62,62,0,1,0,1,0,deny
11716,37965,0,0,62,62,0,1,0,1,0,deny
10736,6112,0,0,60,60,0,1,0,1,0,deny
51172,445,0,0,70,70,0,1,0,1,0,drop
6666,8530,0,0,60,60,0,1,0,1,0,deny
51608,445,0,0,66,66,0,1,0,1,0,drop
34916,51185,0,0,62,62,0,1,0,1,0,deny
51601,445,0,0,66,66,0,1,0,1,0,drop
60923,49903,0,0,66,66,0,1,0,1,0,deny
51165,445,0,0,70,70,0,1,0,1,0,drop
56183,445,0,0,70,70,0,1,0,1,0,drop
35657,48637,0,0,62,62,0,1,0,1,0,deny
25523,35974,0,0,62,62,0,1,0,1,0,deny
48478,49903,0,0,62,62,0,1,0,1,0,deny
51163,445,0,0,70,70,0,1,0,1,0,drop
33405,37965,0,0,62,62,0,1,0,1,0,deny
51599,445,0,0,66,66,0,1,0,1,0,drop
58715,57470,0,0,62,62,0,1,0,1,0,deny
51162,445,0,0,70,70,0,1,0,1,0,drop
51161,445,0,0,70,70,0,1,0,1,0,drop
51160,445,0,0,70,70,0,1,0,1,0,drop
51157,445,0,0,70,70,0,1,0,1,0,drop
51156,445,0,0,70,70,0,1,0,1,0,drop
1036,64147,0,0,62,62,0,1,0,1,0,deny
51590,445,0,0,66,66,0,1,0,1,0,drop
62452,21247,0,0,66,66,0,1,0,1,0,deny
51586,445,0,0,66,66,0,1,0,1,0,drop
13279,10387,0,0,159,159,0,1,0,1,0,deny
6057,51221,0,0,62,62,0,1,0,1,0,deny
53737,443,15661,443,499,425,74,4,0,3,1,allow
53738,443,58635,443,499,425,74,4,0,3,1,allow
53739,443,35645,443,499,425,74,4,0,3,1,allow
53735,443,34476,443,499,425,74,4,0,3,1,allow
53736,443,20137,443,499,425,74,4,0,3,1,allow
53733,443,35168,443,499,425,74,4,0,3,1,allow
53734,443,22403,443,499,425,74,4,0,3,1,allow
53732,443,58255,443,499,425,74,4,0,3,1,allow
53730,443,15340,443,499,425,74,4,0,3,1,allow
53729,443,15910,443,499,425,74,4,0,3,1,allow
53731,443,61889,443,499,425,74,4,0,3,1,allow
53727,443,53687,443,499,425,74,4,0,3,1,allow
35092,22,0,0,60,60,0,1,0,1,0,deny
51142,445,0,0,70,70,0,1,0,1,0,drop
51140,445,0,0,70,70,0,1,0,1,0,drop
51136,445,0,0,70,70,0,1,0,1,0,drop
51132,445,0,0,70,70,0,1,0,1,0,drop
51131,445,0,0,70,70,0,1,0,1,0,drop
53728,443,11260,443,499,425,74,4,0,3,1,allow
53725,443,12003,443,499,425,74,4,0,3,1,allow
53726,443,39961,443,499,425,74,4,0,3,1,allow
53721,443,9349,443,499,425,74,4,0,3,1,allow
53724,443,54768,443,499,425,74,4,0,3,1,allow
53723,443,16354,443,499,425,74,4,0,3,1,allow
53722,443,25032,443,499,425,74,4,0,3,1,allow
53720,443,24279,443,499,425,74,4,0,3,1,allow
53716,443,47571,443,499,425,74,4,0,3,1,allow
53717,443,51020,443,499,425,74,4,0,3,1,allow
53718,443,3459,443,499,425,74,4,0,3,1,allow
53719,443,17807,443,499,425,74,4,0,3,1,allow
56967,35440,0,0,66,66,0,1,0,1,0,deny
61600,56205,0,0,62,62,0,1,0,1,0,deny
56174,445,0,0,70,70,0,1,0,1,0,drop
56173,445,0,0,70,70,0,1,0,1,0,drop
56171,445,0,0,70,70,0,1,0,1,0,drop
51576,445,0,0,66,66,0,1,0,1,0,drop
51568,445,0,0,66,66,0,1,0,1,0,drop
51575,445,0,0,66,66,0,1,0,1,0,drop
51574,445,0,0,66,66,0,1,0,1,0,drop
51573,445,0,0,66,66,0,1,0,1,0,drop
51570,445,0,0,66,66,0,1,0,1,0,drop
51571,445,0,0,66,66,0,1,0,1,0,drop
51569,445,0,0,66,66,0,1,0,1,0,drop
50668,58833,0,0,66,66,0,1,0,1,0,deny
30920,64147,0,0,62,62,0,1,0,1,0,deny
51120,445,0,0,70,70,0,1,0,1,0,drop
6666,21,0,0,60,60,0,1,0,1,0,deny
2791,7302,0,0,62,62,0,1,0,1,0,deny
46557,57866,0,0,66,66,0,1,0,1,0,deny
56327,44512,0,0,66,66,0,1,0,1,0,deny
56168,445,0,0,70,70,0,1,0,1,0,drop
56165,445,0,0,70,70,0,1,0,1,0,drop
56156,445,0,0,70,70,0,1,0,1,0,drop
53771,37965,0,0,66,66,0,1,0,1,0,deny
56703,22,0,0,60,60,0,1,0,1,0,deny
51115,445,0,0,70,70,0,1,0,1,0,drop
25570,35440,0,0,62,62,0,1,0,1,0,deny
51553,445,0,0,66,66,0,1,0,1,0,drop
51555,445,0,0,66,66,0,1,0,1,0,drop
51554,445,0,0,66,66,0,1,0,1,0,drop
45941,23386,0,0,60,60,0,1,0,1,0,deny
54346,44847,0,0,62,62,0,1,0,1,0,deny
14309,56205,0,0,62,62,0,1,0,1,0,deny
56153,445,0,0,70,70,0,1,0,1,0,drop
51103,445,0,0,70,70,0,1,0,1,0,drop
51104,445,0,0,70,70,0,1,0,1,0,drop
51101,445,0,0,70,70,0,1,0,1,0,drop
51100,445,0,0,70,70,0,1,0,1,0,drop
43129,20220,0,0,62,62,0,1,0,1,0,deny
56151,445,0,0,70,70,0,1,0,1,0,drop
51097,445,0,0,70,70,0,1,0,1,0,drop
5637,23,0,0,60,60,0,1,0,1,0,deny
31061,23,0,0,60,60,0,1,0,1,0,deny
56148,445,0,0,70,70,0,1,0,1,0,drop
56145,445,0,0,70,70,0,1,0,1,0,drop
56144,445,0,0,70,70,0,1,0,1,0,drop
57226,51505,0,0,66,66,0,1,0,1,0,deny
57723,45129,0,0,148,148,0,1,0,1,0,deny
40480,30317,0,0,146,146,0,1,0,1,0,deny
63786,35440,0,0,62,62,0,1,0,1,0,deny
62569,44847,0,0,66,66,0,1,0,1,0,deny
51090,445,0,0,70,70,0,1,0,1,0,drop
56753,44847,0,0,62,62,0,1,0,1,0,deny
49831,30188,0,0,66,66,0,1,0,1,0,deny
15274,19473,0,0,62,62,0,1,0,1,0,deny
1114,37965,0,0,62,62,0,1,0,1,0,deny
56131,445,0,0,70,70,0,1,0,1,0,drop
56129,445,0,0,70,70,0,1,0,1,0,drop
56128,445,0,0,70,70,0,1,0,1,0,drop
60192,35440,0,0,66,66,0,1,0,1,0,deny
57729,19750,0,0,66,66,0,1,0,1,0,deny
51083,445,0,0,70,70,0,1,0,1,0,drop
51080,445,0,0,70,70,0,1,0,1,0,drop
59914,65473,0,0,145,145,0,1,0,1,0,deny
51076,445,0,0,70,70,0,1,0,1,0,drop
53395,50321,40284,50321,7546,4168,3378,37,53,24,13,allow
61460,80,11498,80,1507,1184,323,11,79,7,4,allow
58429,53,0,0,1254,160,1094,4,49,2,2,allow
57470,31381,16195,31381,792,792,0,13,1200,13,0,allow
57356,53,56372,53,815,95,720,2,30,1,1,allow
45434,443,37816,443,74123,16210,57913,106,57,52,54,allow
51730,33399,18349,33399,66,66,0,1,5,1,0,allow
61458,443,40730,443,3505,2042,1463,27,82,15,12,allow
42090,443,46273,443,5041,817,4224,20,373,8,12,allow
43098,443,63074,443,3133,1883,1250,19,16,9,10,allow
51745,2572,13644,2572,70,70,0,2,8,2,0,allow
49308,53,0,0,180,80,100,2,30,1,1,allow
51724,25807,42911,25807,66,66,0,1,5,1,0,allow
43735,53,43735,53,216,88,128,2,30,1,1,allow
49650,53,63255,53,322,110,212,4,30,2,2,allow
56421,53,23965,53,170,87,83,2,30,1,1,allow
51870,53,51870,53,825,99,726,2,30,1,1,allow
57061,53,26951,53,711,87,624,2,30,1,1,allow
53227,443,53227,443,4107,2486,1621,20,24,10,10,allow
53228,443,53228,443,4456,2436,2020,19,24,10,9,allow
38363,15000,1161,15000,130,70,60,2,6,1,1,allow
63751,17102,12860,17102,312,132,180,6,6,3,3,allow
49045,80,27391,80,1105,624,481,13,316,7,6,allow
54817,443,47884,443,12861,6761,6100,34,164,20,14,allow
54818,443,9214,443,13069,6969,6100,37,164,23,14,allow
51727,1024,54726,1024,66,66,0,1,5,1,0,allow
51744,1678,51884,1678,70,70,0,2,8,2,0,allow
50068,53,50068,53,240,96,144,2,30,1,1,allow
49650,53,21786,53,216,110,106,2,30,1,1,allow
56980,53,43925,53,701,88,613,2,30,1,1,allow
60913,443,14058,443,18805,1162,17643,28,135,11,17,allow
54032,53,0,0,195,79,116,2,31,1,1,allow
64933,53,1484,53,738,86,652,2,31,1,1,allow
19229,53,19229,53,213,87,126,2,31,1,1,allow
57281,53,58597,53,711,87,624,2,31,1,1,allow
56760,53,60380,53,760,96,664,2,31,1,1,allow
61716,443,60379,443,3168,1038,2130,16,136,8,8,allow
30960,45682,63379,45682,330,330,0,6,3609,6,0,allow
15503,27645,52952,27645,480,149,331,2,1200,1,1,allow
6881,6881,14545,6881,492,150,342,2,1200,1,1,allow
51075,445,0,0,70,70,0,1,0,1,0,drop
51530,445,0,0,66,66,0,1,0,1,0,drop
38484,48637,0,0,60,60,0,1,0,1,0,deny
56124,445,0,0,70,70,0,1,0,1,0,drop
56118,445,0,0,70,70,0,1,0,1,0,drop
42119,36237,0,0,66,66,0,1,0,1,0,deny
41156,53,41156,53,216,82,134,2,31,1,1,allow
49162,53,61794,53,371,94,277,2,29,1,1,allow
49650,53,24810,53,216,110,106,2,29,1,1,allow
123,123,13833,123,184,94,90,2,30,1,1,allow
57470,43155,32052,43155,594,594,0,10,1199,10,0,allow
58429,53,0,0,360,160,200,4,49,2,2,allow
64114,443,8780,443,1411,852,559,13,24,7,6,allow
51751,80,4770,80,1854,1360,494,12,15,7,5,allow
54350,443,6406,443,2402,1444,958,18,167,10,8,allow
60078,80,2527,80,1114,534,580,12,15,7,5,allow
54535,80,13360,80,4162,3455,707,14,15,8,6,allow
64574,53,64558,53,388,95,293,4,32,2,2,allow
60377,65054,58961,65054,624,318,306,10,15,5,5,allow
63743,46081,59158,46081,66,66,0,2,7,2,0,allow
55787,53,59622,53,229,102,127,2,29,1,1,allow
55488,53,31385,53,210,94,116,2,29,1,1,allow
49650,53,11402,53,216,110,106,2,30,1,1,allow
64742,53,25271,53,165,86,79,2,29,1,1,allow
52996,443,47538,443,22513,15188,7325,69,517,31,38,allow
61448,443,1765,443,6109,1902,4207,33,141,19,14,allow
34499,443,29656,443,19518,11774,7744,46,168,26,20,allow
50413,80,12074,80,8388,2010,6378,17,23,8,9,allow
50338,80,9655,80,2668,870,1798,13,47,7,6,allow
43206,443,34471,443,4550611,95139,4455472,4046,217,935,3111,allow
61953,443,64547,443,15246,5574,9672,60,391,27,33,allow
56143,53,42893,53,195,94,101,2,30,1,1,allow
52466,443,10561,443,5082,896,4186,16,70,8,8,allow
56356,2710,17176,2710,1222,747,475,10,23,5,5,allow
50409,443,27908,443,5386,4374,1012,18,34,11,7,allow
52944,53,19420,53,168,78,90,2,30,1,1,allow
53287,80,8055,80,2881,1001,1880,12,52,7,5,allow
56939,53,33751,53,351,94,257,2,30,1,1,allow
36390,443,36390,443,4563,1656,2907,19,28,11,8,allow
56998,53,2449,53,199,94,105,2,30,1,1,allow
64746,53,10441,53,260,86,174,2,30,1,1,allow
65313,53,33070,53,193,102,91,2,30,1,1,allow
59613,443,9064,443,10366,4530,5836,21,135,10,11,allow
53111,80,26592,80,45904,3904,42000,65,16,33,32,allow
49501,80,23659,80,183116,16652,166464,279,486,59,220,allow
8430,53,21349,53,80361,77433,2928,946,89,930,16,allow
64676,53,19072,53,276,94,182,2,30,1,1,allow
58853,443,38782,443,59754,9493,50261,131,367,68,63,allow
54954,443,24434,443,469752,21060,448692,589,64,265,324,allow
40890,53,0,0,86,86,0,1,30,1,0,allow
64123,53,16597,53,325,102,223,2,30,1,1,allow
60376,58302,44068,58302,624,318,306,10,15,5,5,allow
33588,443,49965,443,6382,2331,4051,24,109,13,11,allow
49268,443,60948,443,77368,9874,67494,139,100,65,74,allow
52711,443,64979,443,107997,3957,104040,135,80,51,84,allow
63742,26305,43986,26305,66,66,0,2,7,2,0,allow
49735,443,35310,443,6292,1682,4610,21,15,9,12,allow
51401,443,9077,443,130,70,60,2,4,1,1,allow
51729,63553,6792,63553,70,70,0,1,5,1,0,allow
52127,443,33029,443,18360,1198,17162,27,25,9,18,allow
56799,443,34365,443,5057,880,4177,16,70,8,8,allow
59636,80,29464,80,1352,848,504,13,169,8,5,allow
60807,443,39155,443,9127,2506,6621,38,146,20,18,allow
60874,443,2065,443,777438,37182,740256,940,64,407,533,allow
64742,53,28467,53,173,94,79,2,29,1,1,allow
60517,53,55123,53,215,94,121,2,29,1,1,allow
50408,443,29487,443,5638,4258,1380,19,34,11,8,allow
56421,53,33128,53,177,94,83,2,29,1,1,allow
64021,53,10744,53,339,118,221,2,29,1,1,allow
49308,53,0,0,627,80,547,2,29,1,1,allow
55367,443,46972,443,101466,17775,83691,225,74,112,113,allow
65313,53,6135,53,193,102,91,2,30,1,1,allow
64747,53,25665,53,167,78,89,2,30,1,1,allow
49397,53,28669,53,365,94,271,2,30,1,1,allow
1100,27540,17868,27540,132,70,62,2,30,1,1,allow
39312,443,51370,443,10148,2203,7945,37,120,19,18,allow
57238,53,58179,53,165,86,79,2,30,1,1,allow
49603,53,2204,53,238,110,128,2,30,1,1,allow
49965,53,21038,53,285,110,175,2,30,1,1,allow
50415,443,63011,443,2542,1504,1038,16,20,9,7,allow
51465,80,10875,80,913,410,503,10,15,5,5,allow
46799,443,46799,443,22215,2460,19755,39,198,15,24,allow
60390,56494,64175,56494,70,70,0,2,8,2,0,allow
51725,32787,46505,32787,70,70,0,1,5,1,0,allow
40648,443,10699,443,130,70,60,3,5,2,1,allow
55588,49737,20798,49737,504,318,186,8,15,5,3,allow
49503,80,52162,80,121857,7431,114426,166,486,38,128,allow
49500,80,17093,80,309313,41646,267667,433,486,113,320,allow
65527,53,57886,53,194,94,100,2,30,1,1,allow
41858,53,0,0,86,86,0,1,30,1,0,allow
35132,53,35132,53,86,86,0,1,30,1,0,allow
50265,55637,31401,55637,528,528,0,9,1200,9,0,allow
50417,80,26233,80,1658,1247,411,8,15,5,3,allow
60742,20010,30698,20010,70,70,0,1,5,1,0,allow
49493,80,3964,80,143422,12598,130824,226,487,52,174,allow
35287,443,46797,443,47587,20536,27051,345,581,173,172,allow
33444,53,33346,53,168,78,90,2,30,1,1,allow
55800,53,32257,53,177,94,83,2,30,1,1,allow
55800,53,5218,53,177,94,83,2,30,1,1,allow
6881,6881,60771,6881,150,150,0,1,1200,1,0,allow
51689,80,35961,80,16205,2525,13680,31,139,15,16,allow
55450,53,40253,53,213,102,111,2,30,1,1,allow
57238,53,29243,53,165,86,79,2,30,1,1,allow
56421,53,57015,53,177,94,83,2,30,1,1,allow
57240,53,54621,53,180,94,86,2,30,1,1,allow
33823,443,20715,443,8237,1724,6513,31,270,16,15,allow
39545,443,12909,443,5596,3797,1799,27,96,14,13,allow
65382,53,20411,53,274,94,180,2,30,1,1,allow
63847,443,57992,443,8012,4410,3602,20,135,10,10,allow
64655,53,25772,53,225,102,123,2,30,1,1,allow
55545,53,22001,53,177,94,83,2,30,1,1,allow
58932,53,21682,53,168,78,90,2,31,1,1,allow
44725,443,58969,443,7998,1347,6651,49,1647,10,39,allow
6881,6881,40959,6881,238,118,120,2,1200,1,1,allow
57470,64919,63117,64919,594,594,0,10,1199,10,0,allow
57470,56432,6012,56432,132,132,0,3,1199,3,0,allow
64966,53,51667,53,458,188,270,6,31,3,3,allow
53554,8999,6458,8999,130,70,60,3,6,2,1,allow
60745,40010,27877,40010,316,136,180,6,6,3,3,allow
48975,443,52782,443,130,70,60,3,5,2,1,allow
49767,80,33888,80,70,70,0,2,8,2,0,allow
63422,443,21466,443,10617247,317598,10299649,11317,243,4141,7176,allow
49435,443,3627,443,10377,3140,7237,23,52,11,12,allow
64631,53,54731,53,351,93,258,4,50,2,2,allow
64399,53,19303,53,373,90,283,4,53,2,2,allow
52731,443,19807,443,10819,5326,5493,45,16,27,18,allow
52277,80,52277,80,259496,6676,252820,249,28,74,175,allow
53548,23310,1766,23310,70,70,0,2,8,2,0,allow
55545,53,60601,53,177,94,83,2,30,1,1,allow
65276,53,46929,53,212,102,110,2,30,1,1,allow
49853,53,48467,53,811,94,717,2,30,1,1,allow
35957,51185,0,0,60,60,0,1,0,1,0,deny
1431,30041,0,0,62,62,0,1,0,1,0,deny
50994,35974,0,0,60,60,0,1,0,1,0,deny
6881,55108,0,0,148,148,0,1,0,1,0,deny
59584,36237,0,0,66,66,0,1,0,1,0,deny
55056,56205,0,0,66,66,0,1,0,1,0,deny
51071,445,0,0,70,70,0,1,0,1,0,drop
13567,23684,0,0,168,168,0,1,0,1,0,deny
40500,48817,0,0,143,143,0,1,0,1,0,deny
51070,445,0,0,70,70,0,1,0,1,0,drop
51528,445,0,0,66,66,0,1,0,1,0,drop
50877,30041,0,0,66,66,0,1,0,1,0,deny
50784,52952,0,0,66,66,0,1,0,1,0,deny
1128,44847,0,0,62,62,0,1,0,1,0,deny
1128,44847,0,0,146,146,0,1,0,1,0,deny
51524,445,0,0,66,66,0,1,0,1,0,drop
56115,445,0,0,70,70,0,1,0,1,0,drop
56109,445,0,0,70,70,0,1,0,1,0,drop
56105,445,0,0,70,70,0,1,0,1,0,drop
56104,445,0,0,70,70,0,1,0,1,0,drop
11842,35440,0,0,62,62,0,1,0,1,0,deny
51522,445,0,0,66,66,0,1,0,1,0,drop
58912,11392,0,0,62,62,0,1,0,1,0,deny
51065,445,0,0,70,70,0,1,0,1,0,drop
36339,50584,0,0,62,62,0,1,0,1,0,deny
17702,6881,0,0,62,62,0,1,0,1,0,deny
56098,445,0,0,70,70,0,1,0,1,0,drop
56096,445,0,0,70,70,0,1,0,1,0,drop
56095,445,0,0,70,70,0,1,0,1,0,drop
56092,445,0,0,70,70,0,1,0,1,0,drop
51514,445,0,0,66,66,0,1,0,1,0,drop
57351,62413,0,0,66,66,0,1,0,1,0,deny
51511,445,0,0,66,66,0,1,0,1,0,drop
51510,445,0,0,66,66,0,1,0,1,0,drop
51505,445,0,0,66,66,0,1,0,1,0,drop
18461,19473,0,0,66,66,0,1,0,1,0,deny
51503,445,0,0,66,66,0,1,0,1,0,drop
51504,445,0,0,66,66,0,1,0,1,0,drop
51502,445,0,0,66,66,0,1,0,1,0,drop
64106,64147,0,0,62,62,0,1,0,1,0,deny
45964,7776,0,0,60,60,0,1,0,1,0,deny
17916,48817,0,0,148,148,0,1,0,1,0,deny
51052,445,0,0,70,70,0,1,0,1,0,drop
56090,445,0,0,70,70,0,1,0,1,0,drop
56089,445,0,0,70,70,0,1,0,1,0,drop
56086,445,0,0,70,70,0,1,0,1,0,drop
51499,445,0,0,66,66,0,1,0,1,0,drop
56083,445,0,0,70,70,0,1,0,1,0,drop
51049,445,0,0,70,70,0,1,0,1,0,drop
62780,35440,0,0,66,66,0,1,0,1,0,deny
51495,445,0,0,66,66,0,1,0,1,0,drop
53406,44847,0,0,66,66,0,1,0,1,0,deny
26531,37965,0,0,62,62,0,1,0,1,0,deny
11458,2767,0,0,66,66,0,1,0,1,0,deny
61865,35440,0,0,66,66,0,1,0,1,0,deny
51494,445,0,0,66,66,0,1,0,1,0,drop
51491,445,0,0,66,66,0,1,0,1,0,drop
26406,37965,0,0,66,66,0,1,0,1,0,deny
59477,36829,0,0,62,62,0,1,0,1,0,deny
51490,445,0,0,66,66,0,1,0,1,0,drop
14615,57866,0,0,66,66,0,1,0,1,0,deny
30443,44847,0,0,62,62,0,1,0,1,0,deny
55196,10387,0,0,159,159,0,1,0,1,0,deny
53475,3389,0,0,66,66,0,1,0,1,0,deny
51535,64147,0,0,62,62,0,1,0,1,0,deny
4366,51505,0,0,62,62,0,1,0,1,0,deny
51043,445,0,0,70,70,0,1,0,1,0,drop
51041,445,0,0,70,70,0,1,0,1,0,drop
50113,51505,0,0,62,62,0,1,0,1,0,deny
56077,445,0,0,70,70,0,1,0,1,0,drop
60292,7129,0,0,62,62,0,1,0,1,0,deny
51038,445,0,0,70,70,0,1,0,1,0,drop
53211,22114,0,0,66,66,0,1,0,1,0,deny
56074,445,0,0,70,70,0,1,0,1,0,drop
56069,445,0,0,70,70,0,1,0,1,0,drop
19394,44847,0,0,62,62,0,1,0,1,0,deny
20706,37965,0,0,62,62,0,1,0,1,0,deny
65501,57470,0,0,72,72,0,1,0,1,0,deny
50972,443,8971,443,469,403,66,4,0,3,1,allow
37906,37965,0,0,62,62,0,1,0,1,0,deny
50081,57470,0,0,66,66,0,1,0,1,0,deny
6890,34729,0,0,146,146,0,1,0,1,0,deny
51480,445,0,0,66,66,0,1,0,1,0,drop
2467,2767,0,0,66,66,0,1,0,1,0,deny
45941,23386,0,0,60,60,0,1,0,1,0,deny
20133,2767,0,0,62,62,0,1,0,1,0,deny
58977,37965,0,0,66,66,0,1,0,1,0,deny
12668,42707,0,0,62,62,0,1,0,1,0,deny
51973,44847,0,0,62,62,0,1,0,1,0,deny
10262,11392,0,0,62,62,0,1,0,1,0,deny
1114,37965,0,0,62,62,0,1,0,1,0,deny
51031,445,0,0,70,70,0,1,0,1,0,drop
31136,50584,0,0,62,62,0,1,0,1,0,deny
51471,445,0,0,66,66,0,1,0,1,0,drop
51029,445,0,0,70,70,0,1,0,1,0,drop
56056,445,0,0,70,70,0,1,0,1,0,drop
61566,44847,0,0,66,66,0,1,0,1,0,deny
51028,445,0,0,70,70,0,1,0,1,0,drop
51027,445,0,0,70,70,0,1,0,1,0,drop
51468,445,0,0,66,66,0,1,0,1,0,drop
51026,445,0,0,70,70,0,1,0,1,0,drop
51023,445,0,0,70,70,0,1,0,1,0,drop
51020,445,0,0,70,70,0,1,0,1,0,drop
62696,50584,0,0,66,66,0,1,0,1,0,deny
51461,445,0,0,66,66,0,1,0,1,0,drop
13164,39033,0,0,145,145,0,1,0,1,0,deny
51008,445,0,0,70,70,0,1,0,1,0,drop
51007,445,0,0,70,70,0,1,0,1,0,drop
51453,445,0,0,66,66,0,1,0,1,0,drop
51001,445,0,0,70,70,0,1,0,1,0,drop
20961,35440,0,0,62,62,0,1,0,1,0,deny
50997,445,0,0,70,70,0,1,0,1,0,drop
50998,445,0,0,70,70,0,1,0,1,0,drop
59156,50584,0,0,66,66,0,1,0,1,0,deny
5200,6643,0,0,145,145,0,1,0,1,0,deny
56047,445,0,0,70,70,0,1,0,1,0,drop
56045,445,0,0,70,70,0,1,0,1,0,drop
56043,445,0,0,70,70,0,1,0,1,0,drop
3225,64147,0,0,66,66,0,1,0,1,0,deny
51443,445,0,0,66,66,0,1,0,1,0,drop
51446,445,0,0,66,66,0,1,0,1,0,drop
51444,445,0,0,66,66,0,1,0,1,0,drop
51438,445,0,0,66,66,0,1,0,1,0,drop
51445,445,0,0,66,66,0,1,0,1,0,drop
51439,445,0,0,66,66,0,1,0,1,0,drop
51441,445,0,0,66,66,0,1,0,1,0,drop
51440,445,0,0,66,66,0,1,0,1,0,drop
1873,37965,0,0,62,62,0,1,0,1,0,deny
50986,445,0,0,70,70,0,1,0,1,0,drop
3407,57866,0,0,66,66,0,1,0,1,0,deny
63503,42707,0,0,66,66,0,1,0,1,0,deny
64191,44847,0,0,62,62,0,1,0,1,0,deny
45964,2666,0,0,60,60,0,1,0,1,0,deny
47910,7454,0,0,60,60,0,1,0,1,0,deny
1025,35447,0,0,62,62,0,1,0,1,0,deny
5223,44091,0,0,220,220,0,1,0,1,0,deny
56041,445,0,0,70,70,0,1,0,1,0,drop
56040,445,0,0,70,70,0,1,0,1,0,drop
56028,445,0,0,70,70,0,1,0,1,0,drop
50982,445,0,0,70,70,0,1,0,1,0,drop
1284,50584,0,0,66,66,0,1,0,1,0,deny
51426,445,0,0,66,66,0,1,0,1,0,drop
51425,445,0,0,66,66,0,1,0,1,0,drop
51423,445,0,0,66,66,0,1,0,1,0,drop
45941,23388,0,0,60,60,0,1,0,1,0,deny
64788,43890,0,0,66,66,0,1,0,1,0,deny
50973,445,0,0,70,70,0,1,0,1,0,drop
50971,445,0,0,70,70,0,1,0,1,0,drop
56025,445,0,0,70,70,0,1,0,1,0,drop
50969,445,0,0,70,70,0,1,0,1,0,drop
50970,445,0,0,70,70,0,1,0,1,0,drop
50964,445,0,0,70,70,0,1,0,1,0,drop
56023,445,0,0,70,70,0,1,0,1,0,drop
20844,64147,0,0,66,66,0,1,0,1,0,deny
19858,64147,0,0,62,62,0,1,0,1,0,deny
56013,445,0,0,70,70,0,1,0,1,0,drop
56012,445,0,0,70,70,0,1,0,1,0,drop
56014,445,0,0,70,70,0,1,0,1,0,drop
30654,51221,0,0,72,72,0,1,0,1,0,deny
63925,37965,0,0,66,66,0,1,0,1,0,deny
33215,37965,0,0,62,62,0,1,0,1,0,deny
40885,23,0,0,60,60,0,1,0,1,0,deny
32974,37965,0,0,66,66,0,1,0,1,0,deny
21365,23718,0,0,62,62,0,1,0,1,0,deny
52802,56205,0,0,66,66,0,1,0,1,0,deny
53535,1393,14227,1393,70,70,0,1,5,1,0,allow
50285,80,56429,80,4064,607,3457,12,45,6,6,allow
57240,53,16899,53,176,90,86,2,30,1,1,allow
49708,443,54037,443,456387,11878,444509,427,81,121,306,allow
56759,55201,40009,55201,66,66,0,1,5,1,0,allow
53799,80,41607,80,1056,682,374,10,15,6,4,allow
50283,80,41911,80,5689,1015,4674,16,45,8,8,allow
59401,443,58968,443,3010,1892,1118,16,15,8,8,allow
51689,443,47234,443,8488,2174,6314,23,255,12,11,allow
51946,443,39002,443,8670,1805,6865,28,26,15,13,allow
40662,443,40662,443,4624,1717,2907,19,28,11,8,allow
59404,443,10904,443,2962,1844,1118,16,15,8,8,allow
63846,443,9201,443,3811,1538,2273,20,135,10,10,allow
34885,443,20315,443,80828,20592,60236,124,180,54,70,allow
51464,443,29786,443,575,326,249,10,15,6,4,allow
39338,443,49574,443,7624,1384,6240,23,17,12,11,allow
25150,53,25150,53,217,87,130,2,30,1,1,allow
52273,80,52273,80,156876,7015,149861,158,28,49,109,allow
60534,80,60534,80,84558,3469,81089,94,16,34,60,allow
52275,80,52275,80,210890,8286,202604,208,28,64,144,allow
52276,80,52276,80,222010,7236,214774,216,28,66,150,allow
60531,80,48244,80,2122,1559,563,13,16,7,6,allow
59402,443,55166,443,4821,1882,2939,19,15,9,10,allow
53892,443,40316,443,9312,4088,5224,23,76,13,10,allow
52274,80,52274,80,852970,14195,838775,769,28,207,562,allow
46858,15000,17792,15000,130,70,60,2,5,1,1,allow
2487,53,2487,53,235,90,145,2,33,1,1,allow
44956,443,44956,443,5220,1973,3247,22,38,13,9,allow
47388,443,27845,443,350,210,140,6,15,4,2,allow
41793,53,3227,53,168,78,90,2,30,1,1,allow
55545,53,10302,53,170,87,83,2,30,1,1,allow
55450,443,1835,443,4275,2479,1796,22,316,11,11,allow
60855,443,10736,443,598135,40549,557586,873,251,326,547,allow
15792,3478,30536,3478,428935914,213443641,215492273,635946,2242,308738,327208,allow
59403,443,13461,443,2866,1684,1182,16,15,8,8,allow
53550,1,56985,1,70,70,0,2,8,2,0,allow
59399,443,48462,443,66108,6145,59963,93,16,41,52,allow
49705,443,51038,443,156357,6403,149954,155,81,44,111,allow
50116,22,50116,22,184,120,64,4,11,3,1,allow
37460,443,55415,443,2885,1732,1153,16,256,9,7,allow
43681,443,58156,443,7235,1097,6138,21,27,10,11,allow
59400,443,43611,443,6489,2731,3758,19,16,10,9,allow
65261,53,13380,53,168,86,82,2,30,1,1,allow
55926,53,35022,53,184,94,90,2,30,1,1,allow
55401,53,40210,53,168,86,82,2,31,1,1,allow
60320,443,1355,443,4679,2232,2447,15,136,7,8,allow
63626,443,34704,443,15769,1619,14150,17,138,4,13,allow
53983,443,37079,443,2571,330,2241,12,135,5,7,allow
46663,53,46663,53,209,83,126,2,30,1,1,allow
40603,53,40603,53,240,96,144,2,31,1,1,allow
39166,53,0,0,82,82,0,1,31,1,0,allow
64180,53,16774,53,176,90,86,2,31,1,1,allow
51584,443,13301,443,12641,5741,6900,26,362,12,14,allow
65428,443,7165,443,14203,1525,12678,13,143,2,11,allow
39414,443,32057,443,4179,1480,2699,18,124,9,9,allow
51160,8090,0,0,60,60,0,1,0,1,0,deny
50958,445,0,0,70,70,0,1,0,1,0,drop
51159,8090,0,0,60,60,0,1,0,1,0,deny
21332,23,0,0,60,60,0,1,0,1,0,deny
46090,50584,0,0,62,62,0,1,0,1,0,deny
64382,44847,0,0,62,62,0,1,0,1,0,deny
50486,443,8859,443,5791,3692,2099,21,78,13,8,allow
61681,443,6029,443,5922,1917,4005,24,18,14,10,allow
38484,48637,0,0,60,60,0,1,0,1,0,deny
35957,51185,0,0,60,60,0,1,0,1,0,deny
50994,35974,0,0,60,60,0,1,0,1,0,deny
56006,445,0,0,70,70,0,1,0,1,0,drop
56005,445,0,0,70,70,0,1,0,1,0,drop
56001,445,0,0,70,70,0,1,0,1,0,drop
50951,445,0,0,70,70,0,1,0,1,0,drop
61216,12250,0,0,148,148,0,1,0,1,0,deny
50949,445,0,0,70,70,0,1,0,1,0,drop
33289,50584,0,0,62,62,0,1,0,1,0,deny
59037,51505,0,0,62,62,0,1,0,1,0,deny
57165,34101,0,0,66,66,0,1,0,1,0,deny
29706,50584,0,0,66,66,0,1,0,1,0,deny
50944,445,0,0,70,70,0,1,0,1,0,drop
50943,445,0,0,70,70,0,1,0,1,0,drop
39161,17,0,0,60,60,0,1,0,1,0,deny
46640,3780,0,0,60,60,0,1,0,1,0,deny
7744,32480,0,0,62,62,0,1,0,1,0,deny
51403,445,0,0,66,66,0,1,0,1,0,drop
45908,3383,0,0,60,60,0,1,0,1,0,deny
55997,445,0,0,70,70,0,1,0,1,0,drop
55990,445,0,0,70,70,0,1,0,1,0,drop
44147,64147,0,0,62,62,0,1,0,1,0,deny
29682,44847,0,0,62,62,0,1,0,1,0,deny
50937,445,0,0,70,70,0,1,0,1,0,drop
48600,23718,0,0,66,66,0,1,0,1,0,deny
23807,44847,0,0,62,62,0,1,0,1,0,deny
6881,10104,0,0,107,107,0,1,0,1,0,deny
52650,36237,0,0,62,62,0,1,0,1,0,deny
59523,37965,0,0,62,62,0,1,0,1,0,deny
50902,80,25107,80,5166,1278,3888,14,144,8,6,allow
57936,443,57936,443,18738,1904,16834,33,17,17,16,allow
45987,123,19536,123,184,94,90,2,30,1,1,allow
64169,53,57112,53,212,102,110,2,30,1,1,allow
57344,53,65328,53,177,94,83,2,30,1,1,allow
8430,53,61822,53,239209,233954,5255,2850,88,2822,28,allow
52272,80,52272,80,237488,7574,229914,231,27,71,160,allow
57240,53,32655,53,180,94,86,2,29,1,1,allow
51880,8001,48278,8001,86,86,0,1,29,1,0,allow
50238,53,16273,53,164,78,86,2,29,1,1,allow
49563,53,57038,53,199,94,105,2,29,1,1,allow
56236,443,26673,443,9597,2488,7109,32,287,16,16,allow
42385,443,55838,443,321621,14025,307596,408,41,185,223,allow
56326,80,40390,80,2541,689,1852,13,60,8,5,allow
49513,80,22592,80,476333,9582,466751,453,225,135,318,allow
49567,443,12074,443,6260,3089,3171,27,142,13,14,allow
52128,443,43146,443,16113,2152,13961,35,20,18,17,allow
54971,443,20430,443,13124,8442,4682,40,43,24,16,allow
55926,53,47769,53,184,94,90,2,29,1,1,allow
65074,53,7213,53,227,94,133,2,29,1,1,allow
57046,53,24095,53,234,94,140,2,29,1,1,allow
65330,53,59699,53,766,102,664,2,29,1,1,allow
53110,8830,31632,8830,70,70,0,2,8,2,0,allow
58478,53,13215,53,332,102,230,2,29,1,1,allow
53552,8999,58202,8999,70,70,0,2,7,2,0,allow
51880,8000,41455,8000,172,94,78,2,29,1,1,allow
49722,53,29083,53,215,94,121,2,30,1,1,allow
49477,53,25866,53,183,86,97,2,30,1,1,allow
61680,443,50542,443,12015,3771,8244,41,18,23,18,allow
56950,53,15623,53,363,109,254,4,46,2,2,allow
53529,17130,52813,17130,492,306,186,8,15,5,3,allow
37202,53,37202,53,216,90,126,2,30,1,1,allow
26900,443,4352,443,24703,16382,8321,49,21,28,21,allow
57902,443,28629,443,20509,7660,12849,54,131,28,26,allow
49930,53,51940,53,258,110,148,2,30,1,1,allow
38009,443,41561,443,130,70,60,3,5,2,1,allow
56424,80,11869,80,17135,1507,15628,24,22,9,15,allow
57344,53,21861,53,177,94,83,2,30,1,1,allow
54761,443,53919,443,103367,3730,99637,117,170,42,75,allow
65405,53,15243,53,210,102,108,2,30,1,1,allow
53108,80,57072,80,1797,1070,727,10,15,5,5,allow
52492,443,60482,443,33131,9092,24039,41,15,19,22,allow
46342,53,46342,53,220,90,130,2,30,1,1,allow
50903,80,4352,80,8600,1437,7163,18,144,10,8,allow
50575,443,24477,443,5197,3181,2016,50,261,26,24,allow
45396,53,7036,53,168,78,90,2,30,1,1,allow
49496,53,24067,53,194,102,92,2,30,1,1,allow
64806,53,2007,53,273,94,179,2,30,1,1,allow
57339,53,58719,53,248,94,154,2,30,1,1,allow
10151,6881,61137,6881,469,150,319,2,1200,1,1,allow
55314,53,61384,53,279,110,169,2,30,1,1,allow
57584,443,53316,443,915797,52405,863392,1231,269,604,627,allow
50934,443,50934,443,5661,2414,3247,22,37,13,9,allow
56755,53,8890,53,663,212,451,6,63,3,3,allow
64137,53,55466,53,228,94,134,2,30,1,1,allow
49787,53,45265,53,196,94,102,2,30,1,1,allow
60097,53,60097,53,193,90,103,2,30,1,1,allow
64874,53,41940,53,324,94,230,2,30,1,1,allow
62119,53,18352,53,239,102,137,2,30,1,1,allow
52706,53,0,0,82,82,0,2,40,2,0,allow
46056,80,34041,80,5066,4404,662,11,30,6,5,allow
61417,80,18297,80,214,140,74,4,55,3,1,allow
50320,53,20919,53,168,78,90,2,30,1,1,allow
56785,53,13080,53,213,102,111,2,30,1,1,allow
65466,53,26406,53,248,94,154,2,30,1,1,allow
63016,53,49407,53,243,94,149,2,30,1,1,allow
15503,11731,3627,11731,1188,1188,0,19,2298,19,0,allow
64566,443,6952,443,8573,2039,6534,25,31,14,11,allow
42440,443,11681,443,9412,2994,6418,27,48,16,11,allow
58753,443,28125,443,70,70,0,1,5,1,0,allow
51405,80,23596,80,1510,481,1029,11,20,6,5,allow
50208,1688,32119,1688,70,70,0,2,8,2,0,allow
55586,17332,8583,17332,70,70,0,1,5,1,0,allow
56464,443,4268,443,5058,913,4145,17,25,10,7,allow
53448,5223,10796,5223,134,60,74,3,4,2,1,allow
57183,53,5484,53,199,94,105,2,29,1,1,allow
49496,53,27238,53,194,102,92,2,30,1,1,allow
65016,53,63384,53,215,94,121,2,29,1,1,allow
57340,53,50973,53,258,110,148,2,30,1,1,allow
56782,53,60829,53,227,94,133,2,29,1,1,allow
64277,53,1694,53,337,110,227,2,30,1,1,allow
50000,53,40875,53,263,110,153,2,30,1,1,allow
49602,53,44779,53,247,102,145,2,30,1,1,allow
55926,53,60455,53,184,94,90,2,30,1,1,allow
55545,53,31002,53,177,94,83,2,30,1,1,allow
49430,53,18362,53,279,94,185,2,30,1,1,allow
55401,53,24581,53,168,86,82,2,30,1,1,allow
49973,53,45350,53,309,110,199,2,30,1,1,allow
36061,4500,28501,4500,12526,5944,6582,24,3599,11,13,allow
55635,53,55876,53,177,94,83,2,30,1,1,allow
64180,53,29611,53,180,94,86,2,31,1,1,allow
53109,80,20052,80,8176,1443,6733,20,15,10,10,allow
56599,80,32983,80,234,234,0,4,12,4,0,allow
59669,80,64457,80,2026957,42480,1984477,1975,80,655,1320,allow
50491,443,45806,443,1304,878,426,12,78,7,5,allow
55665,53,45679,53,229,94,135,2,30,1,1,allow
50433,53,61618,53,770,102,668,2,30,1,1,allow
65261,53,34538,53,168,86,82,2,30,1,1,allow
50870,80,58385,80,7313,1684,5629,15,148,8,7,allow
53526,45046,24762,45046,552,306,246,9,15,5,4,allow
63729,6969,28915,6969,70,70,0,1,5,1,0,allow
63725,80,55530,80,374,192,182,7,15,4,3,allow
52488,443,19422,443,7165,1099,6066,16,18,9,7,allow
58392,3389,58392,3389,4624,1524,3100,17,17,9,8,allow
50490,443,43169,443,1353,903,450,12,78,7,5,allow
55585,48063,18600,48063,70,70,0,1,5,1,0,allow
50542,443,10876,443,86426,3497,82929,102,170,38,64,allow
53521,8999,10502,8999,312,186,126,5,15,3,2,allow
40252,443,46211,443,543828,50144,493684,682,172,254,428,allow
44414,123,11306,123,184,94,90,2,30,1,1,allow
56103,53,56052,53,279,94,185,2,30,1,1,allow
57240,53,1415,53,180,94,86,2,30,1,1,allow
57123,53,38680,53,811,94,717,2,30,1,1,allow
55447,53,41152,53,194,102,92,2,30,1,1,allow
51221,57254,65381,57254,491,150,341,2,1200,1,1,allow
57347,443,57555,443,1081375,19607,1061768,921,122,142,779,allow
49722,53,50235,53,168,78,90,2,30,1,1,allow
49444,53,27495,53,199,94,105,2,30,1,1,allow
55317,53,59583,53,244,94,150,2,31,1,1,allow
57071,53,47529,53,274,110,164,2,31,1,1,allow
57366,53,60542,53,458,188,270,6,31,3,3,allow
55184,53,55740,53,443,92,351,4,31,2,2,allow
45726,443,49906,443,3068,1678,1390,17,242,9,8,allow
52292,443,35142,443,21680,2897,18783,35,120,15,20,allow
58143,443,15049,443,17812,8128,9684,55,343,27,28,allow
64611,53,46299,53,189,102,87,2,30,1,1,allow
43542,53,13639,53,168,78,90,2,30,1,1,allow
56631,53,31631,53,199,94,105,2,30,1,1,allow
50691,443,45100,443,152,86,66,2,6,1,1,allow
52491,443,12140,443,22753,7559,15194,31,16,16,15,allow
56970,53,18773,53,230,110,120,2,30,1,1,allow
55151,53,16947,53,285,102,183,2,30,1,1,allow
55956,53,7528,53,200,94,106,2,30,1,1,allow
51408,443,60315,443,8774,3355,5419,19,36,11,8,allow
38495,443,26566,443,7778,1724,6054,29,17,16,13,allow
65170,53,60576,53,771,102,669,2,30,1,1,allow
65414,53,10727,53,197,102,95,2,31,1,1,allow
64825,53,28794,53,184,94,90,2,31,1,1,allow
20389,64147,0,0,66,66,0,1,0,1,0,deny
11404,64147,0,0,62,62,0,1,0,1,0,deny
55286,37965,0,0,66,66,0,1,0,1,0,deny
41271,50584,0,0,146,146,0,1,0,1,0,deny
51130,61689,0,0,62,62,0,1,0,1,0,deny
50936,445,0,0,70,70,0,1,0,1,0,drop
44411,37965,0,0,62,62,0,1,0,1,0,deny
51397,445,0,0,66,66,0,1,0,1,0,drop
4594,35993,0,0,66,66,0,1,0,1,0,deny
51393,445,0,0,66,66,0,1,0,1,0,drop
55984,445,0,0,70,70,0,1,0,1,0,drop
43815,50584,0,0,146,146,0,1,0,1,0,deny
55979,445,0,0,70,70,0,1,0,1,0,drop
55978,445,0,0,70,70,0,1,0,1,0,drop
55976,445,0,0,70,70,0,1,0,1,0,drop
64000,44847,0,0,66,66,0,1,0,1,0,deny
50931,445,0,0,70,70,0,1,0,1,0,drop
51389,445,0,0,66,66,0,1,0,1,0,drop
60246,44612,0,0,66,66,0,1,0,1,0,deny
11136,15503,0,0,62,62,0,1,0,1,0,deny
52676,53733,0,0,66,66,0,1,0,1,0,deny
61495,37965,0,0,66,66,0,1,0,1,0,deny
55972,445,0,0,70,70,0,1,0,1,0,drop
64776,50584,0,0,66,66,0,1,0,1,0,deny
14360,64147,0,0,145,145,0,1,0,1,0,deny
55968,445,0,0,70,70,0,1,0,1,0,drop
55967,445,0,0,70,70,0,1,0,1,0,drop
55964,445,0,0,70,70,0,1,0,1,0,drop
51383,445,0,0,66,66,0,1,0,1,0,drop
59597,37965,0,0,66,66,0,1,0,1,0,deny
4431,32480,0,0,66,66,0,1,0,1,0,deny
51380,445,0,0,66,66,0,1,0,1,0,drop
51378,445,0,0,66,66,0,1,0,1,0,drop
51375,445,0,0,66,66,0,1,0,1,0,drop
47132,1433,0,0,60,60,0,1,0,1,0,deny
59241,62413,0,0,62,62,0,1,0,1,0,deny
53051,44847,0,0,62,62,0,1,0,1,0,deny
51372,445,0,0,66,66,0,1,0,1,0,drop
51373,445,0,0,66,66,0,1,0,1,0,drop
51371,445,0,0,66,66,0,1,0,1,0,drop
50917,445,0,0,70,70,0,1,0,1,0,drop
20650,26467,0,0,66,66,0,1,0,1,0,deny
42995,26467,0,0,62,62,0,1,0,1,0,deny
50914,445,0,0,70,70,0,1,0,1,0,drop
55962,445,0,0,70,70,0,1,0,1,0,drop
55960,445,0,0,70,70,0,1,0,1,0,drop
55956,445,0,0,70,70,0,1,0,1,0,drop
51369,445,0,0,66,66,0,1,0,1,0,drop
54204,443,58891,443,499,425,74,4,0,3,1,allow
54196,443,33780,443,499,425,74,4,0,3,1,allow
54195,443,37622,443,499,425,74,4,0,3,1,allow
54199,443,31908,443,499,425,74,4,0,3,1,allow
54198,443,37713,443,499,425,74,4,0,3,1,allow
52439,35894,0,0,74,74,0,1,0,1,0,deny
36906,50584,0,0,146,146,0,1,0,1,0,deny
55955,445,0,0,70,70,0,1,0,1,0,drop
42252,33303,0,0,60,60,0,1,0,1,0,deny
49516,35894,0,0,62,62,0,1,0,1,0,deny
443,48120,0,0,97,97,0,1,0,1,0,deny
51365,445,0,0,66,66,0,1,0,1,0,drop
49516,35894,0,0,145,145,0,1,0,1,0,deny
38681,15503,0,0,74,74,0,1,0,1,0,deny
51963,22114,0,0,66,66,0,1,0,1,0,deny
51363,445,0,0,66,66,0,1,0,1,0,drop
51362,445,0,0,66,66,0,1,0,1,0,drop
37998,26467,0,0,66,66,0,1,0,1,0,deny
47132,1433,0,0,60,60,0,1,0,1,0,deny
50910,445,0,0,70,70,0,1,0,1,0,drop
50908,445,0,0,70,70,0,1,0,1,0,drop
65016,37965,0,0,66,66,0,1,0,1,0,deny
42075,36237,0,0,62,62,0,1,0,1,0,deny
43099,5900,0,0,60,60,0,1,0,1,0,deny
50906,445,0,0,70,70,0,1,0,1,0,drop
17777,30188,0,0,62,62,0,1,0,1,0,deny
55953,445,0,0,70,70,0,1,0,1,0,drop
55940,445,0,0,70,70,0,1,0,1,0,drop
55938,445,0,0,70,70,0,1,0,1,0,drop
54202,443,43752,443,499,425,74,4,0,3,1,allow
54203,443,21798,443,499,425,74,4,0,3,1,allow
54201,443,55731,443,499,425,74,4,0,3,1,allow
54200,443,47040,443,499,425,74,4,0,3,1,allow
54197,443,1352,443,499,425,74,4,0,3,1,allow
54194,443,16208,443,499,425,74,4,0,3,1,allow
54305,35440,0,0,62,62,0,1,0,1,0,deny
58248,50584,0,0,66,66,0,1,0,1,0,deny
52208,43890,0,0,66,66,0,1,0,1,0,deny
61148,37965,0,0,66,66,0,1,0,1,0,deny
51351,445,0,0,66,66,0,1,0,1,0,drop
42917,52952,0,0,62,62,0,1,0,1,0,deny
33822,57470,0,0,66,66,0,1,0,1,0,deny
54094,5900,0,0,60,60,0,1,0,1,0,deny
50899,445,0,0,70,70,0,1,0,1,0,drop
52788,64147,0,0,66,66,0,1,0,1,0,deny
50897,445,0,0,70,70,0,1,0,1,0,drop
55966,57866,0,0,66,66,0,1,0,1,0,deny
51341,445,0,0,66,66,0,1,0,1,0,drop
55929,445,0,0,70,70,0,1,0,1,0,drop
57107,64147,0,0,62,62,0,1,0,1,0,deny
50896,445,0,0,70,70,0,1,0,1,0,drop
50895,445,0,0,70,70,0,1,0,1,0,drop
50894,445,0,0,70,70,0,1,0,1,0,drop
43398,25604,0,0,146,146,0,1,0,1,0,deny
50888,445,0,0,70,70,0,1,0,1,0,drop
50889,445,0,0,70,70,0,1,0,1,0,drop
51339,50584,0,0,66,66,0,1,0,1,0,deny
51338,445,0,0,66,66,0,1,0,1,0,drop
59411,37965,0,0,66,66,0,1,0,1,0,deny
0,0,0,0,156,156,0,2,0,2,0,deny
0,0,0,0,156,156,0,2,0,2,0,deny
0,0,0,0,156,156,0,2,0,2,0,deny
0,0,0,0,156,156,0,2,0,2,0,deny
53300,37807,0,0,66,66,0,1,0,1,0,deny
55749,37965,0,0,66,66,0,1,0,1,0,deny
14397,37965,0,0,62,62,0,1,0,1,0,deny
50876,445,0,0,70,70,0,1,0,1,0,drop
50875,445,0,0,70,70,0,1,0,1,0,drop
50872,445,0,0,70,70,0,1,0,1,0,drop
51330,445,0,0,66,66,0,1,0,1,0,drop
50866,445,0,0,70,70,0,1,0,1,0,drop
50865,445,0,0,70,70,0,1,0,1,0,drop
52690,7302,0,0,66,66,0,1,0,1,0,deny
51325,445,0,0,66,66,0,1,0,1,0,drop
62970,44847,0,0,62,62,0,1,0,1,0,deny
52451,56205,0,0,66,66,0,1,0,1,0,deny
56006,23,0,0,60,60,0,1,0,1,0,deny
46389,27098,0,0,66,66,0,1,0,1,0,deny
41852,35440,0,0,62,62,0,1,0,1,0,deny
25091,64147,0,0,66,66,0,1,0,1,0,deny
25602,64147,0,0,62,62,0,1,0,1,0,deny
16387,56995,0,0,60,60,0,1,0,1,0,deny
55918,445,0,0,70,70,0,1,0,1,0,drop
55915,445,0,0,70,70,0,1,0,1,0,drop
55916,445,0,0,70,70,0,1,0,1,0,drop
14484,39004,0,0,145,145,0,1,0,1,0,deny
50854,445,0,0,70,70,0,1,0,1,0,drop
14255,2767,0,0,62,62,0,1,0,1,0,deny
51310,445,0,0,66,66,0,1,0,1,0,drop
51311,445,0,0,66,66,0,1,0,1,0,drop
51313,445,0,0,66,66,0,1,0,1,0,drop
51312,445,0,0,66,66,0,1,0,1,0,drop
51315,445,0,0,66,66,0,1,0,1,0,drop
51314,445,0,0,66,66,0,1,0,1,0,drop
51308,445,0,0,66,66,0,1,0,1,0,drop
51309,445,0,0,66,66,0,1,0,1,0,drop
45964,14444,0,0,60,60,0,1,0,1,0,deny
35347,20238,0,0,66,66,0,1,0,1,0,deny
50849,445,0,0,70,70,0,1,0,1,0,drop
49555,443,34197,443,740109,22948,717161,800,54,311,489,allow
49963,53,30474,53,279,96,183,4,58,2,2,allow
59774,443,17301,443,846,420,426,15,29,8,7,allow
59791,443,43640,443,6603,1085,5518,23,28,11,12,allow
59398,443,65413,443,3730,1956,1774,16,15,8,8,allow
42821,53,25927,53,168,78,90,2,30,1,1,allow
59759,443,40820,443,13342,1221,12121,33,41,15,18,allow
59747,443,56102,443,1991,1190,801,21,32,11,10,allow
49475,80,53528,80,1548,847,701,10,16,5,5,allow
52791,80,25328,80,82430,3774,78656,108,67,49,59,allow
53831,80,61237,80,5774,1483,4291,14,162,8,6,allow
51945,443,60723,443,8830,1950,6880,27,25,14,13,allow
46654,80,33249,80,1518,954,564,14,320,8,6,allow
59798,443,49371,443,1887,1152,735,18,28,9,9,allow
55920,53,58162,53,770,102,668,2,30,1,1,allow
59397,443,43163,443,3218,1700,1518,16,15,8,8,allow
35112,8635,35112,8635,138,78,60,2,5,1,1,allow
63728,11785,51708,11785,66,66,0,1,5,1,0,allow
51667,80,5248,80,20457,4742,15715,37,139,20,17,allow
54649,443,1081,443,355822,186974,168848,1039,1626,433,606,allow
59757,443,13672,443,11663,1141,10522,30,41,14,16,allow
52309,80,52309,80,450,246,204,8,29,5,3,allow
59775,443,41953,443,4951,711,4240,15,29,8,7,allow
52308,80,52308,80,14704,1558,13146,25,29,11,14,allow
49476,80,51976,80,5000,4058,942,15,15,8,7,allow
59770,443,53384,443,9630,1304,8326,28,30,14,14,allow
59646,5223,55530,5223,70,70,0,1,5,1,0,allow
56689,53,22159,53,738,86,652,2,30,1,1,allow
59624,443,22456,443,18261,2059,16202,40,31,20,20,allow
42566,53,42566,53,216,98,118,2,30,1,1,allow
52311,80,52311,80,450,246,204,8,29,5,3,allow
49498,443,36900,443,267319,11446,255873,336,192,117,219,allow
56520,53,14015,53,757,98,659,2,30,1,1,allow
56223,53,26065,53,768,99,669,2,30,1,1,allow
52175,443,52175,443,506908,20303,486605,548,25,204,344,allow
64825,53,38972,53,184,94,90,2,30,1,1,allow
41974,443,41974,443,214163,29159,185004,242,20,108,134,allow
53208,443,19606,443,11664,7921,3743,23,16,14,9,allow
58077,36653,2343,36653,204,64,140,4,10,2,2,allow
59787,443,40007,443,1457,816,641,15,28,7,8,allow
9278,23,9278,23,146,60,86,2,10,1,1,allow
59805,443,46522,443,2334,1113,1221,19,27,9,10,allow
59777,443,29457,443,966,480,486,17,29,9,8,allow
59771,443,63690,443,7672,1164,6508,24,30,12,12,allow
59799,443,7688,443,10642,1102,9540,25,27,11,14,allow
55635,53,27124,53,170,87,83,2,30,1,1,allow
55048,53,59185,53,780,104,676,2,30,1,1,allow
56176,53,4646,53,188,96,92,2,30,1,1,allow
6882,59689,61028,59689,221,111,110,2,1200,1,1,allow
43096,443,6075,443,3063,1813,1250,18,16,8,10,allow
50851,80,30396,80,1123758,19319,1104439,1037,133,278,759,allow
64706,443,64706,443,274,132,142,5,76,3,2,allow
56727,53,56099,53,168,86,82,3,50,2,1,allow
52095,443,20736,443,325846,10609,315237,326,38,106,220,allow
53398,443,48527,443,5196,2308,2888,34,137,16,18,allow
50802,80,54812,80,3874,684,3190,11,141,6,5,allow
52100,443,47301,443,298527,11814,286713,310,37,107,203,allow
60745,123,31928,123,184,94,90,2,30,1,1,allow
49846,443,59260,443,278883,9002,269881,313,72,115,198,allow
55732,53,62249,53,188,96,92,2,31,1,1,allow
63965,53,30693,53,192,90,102,2,31,1,1,allow
58770,53,51678,53,168,78,90,2,31,1,1,allow
57334,53,29836,53,204,104,100,2,31,1,1,allow
64989,53,14791,53,756,95,661,2,31,1,1,allow
49892,443,11967,443,5930,910,5020,18,36,9,9,allow
49848,443,21903,443,5997,976,5021,19,72,10,9,allow
49850,443,7446,443,147320,5771,141549,184,72,73,111,allow
57372,53,34702,53,756,95,661,2,31,1,1,allow
50265,61668,33376,61668,132,132,0,3,1201,3,0,allow
54753,443,7702,443,84945,5052,79893,120,360,61,59,allow
65349,53,30593,53,772,103,669,2,31,1,1,allow
56050,53,45848,53,172,88,84,2,30,1,1,allow
64359,53,39260,53,192,98,94,2,31,1,1,allow
49847,443,53706,443,6117,976,5141,21,72,10,11,allow
49849,443,49569,443,6117,976,5141,21,72,10,11,allow
49866,443,16607,443,6058,1038,5020,20,56,11,9,allow
49865,443,25068,443,6177,1038,5139,22,56,11,11,allow
57173,53,42104,53,216,110,106,2,31,1,1,allow
55896,53,50702,53,184,94,90,2,31,1,1,allow
53006,443,46019,443,17711,5894,11817,47,96,24,23,allow
52968,80,9235,80,4004,1347,2657,29,114,15,14,allow
52868,80,24153,80,54968,1915,53053,71,125,24,47,allow
52902,443,33545,443,13263,7381,5882,51,118,26,25,allow
49824,53,9699,53,172,88,84,2,31,1,1,allow
65049,53,32515,53,204,104,100,2,31,1,1,allow
57173,53,12903,53,216,110,106,2,31,1,1,allow
49864,443,13446,443,5930,910,5020,18,56,9,9,allow
49859,443,23944,443,6065,1045,5020,20,60,11,9,allow
55605,53,47383,53,772,103,669,2,31,1,1,allow
49862,443,63314,443,819841,23462,796379,897,56,298,599,allow
49863,443,31339,443,6057,1038,5019,20,56,11,9,allow
49861,443,11860,443,5995,974,5021,19,56,10,9,allow
49844,443,42026,443,6117,976,5141,21,72,10,11,allow
49845,443,44493,443,5996,976,5020,19,72,10,9,allow
56478,53,58747,53,200,102,98,2,31,1,1,allow
55921,53,12219,53,747,92,655,2,31,1,1,allow
50111,443,14390,443,60978,3794,57184,73,137,26,47,allow
55907,445,0,0,70,70,0,1,0,1,0,drop
55906,445,0,0,70,70,0,1,0,1,0,drop
55900,445,0,0,70,70,0,1,0,1,0,drop
50839,445,0,0,70,70,0,1,0,1,0,drop
50840,445,0,0,70,70,0,1,0,1,0,drop
56103,21247,0,0,66,66,0,1,0,1,0,deny
51296,445,0,0,66,66,0,1,0,1,0,drop
51295,445,0,0,66,66,0,1,0,1,0,drop
51293,445,0,0,66,66,0,1,0,1,0,drop
50838,445,0,0,70,70,0,1,0,1,0,drop
50837,445,0,0,70,70,0,1,0,1,0,drop
10965,22114,0,0,62,62,0,1,0,1,0,deny
58012,5555,0,0,60,60,0,1,0,1,0,deny
29623,37807,0,0,146,146,0,1,0,1,0,deny
50833,445,0,0,70,70,0,1,0,1,0,drop
5222,21212,0,0,66,66,0,1,0,1,0,deny
61013,41705,0,0,66,66,0,1,0,1,0,deny
55897,445,0,0,70,70,0,1,0,1,0,drop
32520,50265,0,0,145,145,0,1,0,1,0,deny
6889,41615,0,0,143,143,0,1,0,1,0,deny
38484,48637,0,0,60,60,0,1,0,1,0,deny
53314,64097,0,0,62,62,0,1,0,1,0,deny
35957,51185,0,0,60,60,0,1,0,1,0,deny
55895,445,0,0,70,70,0,1,0,1,0,drop
53330,443,1024,443,5454,1157,4297,15,22,9,6,allow
56176,53,62297,53,102,102,0,1,30,1,0,allow
55926,53,56818,53,184,94,90,2,29,1,1,allow
49567,53,58916,53,244,94,150,2,29,1,1,allow
64858,53,57701,53,196,102,94,2,30,1,1,allow
50994,35974,0,0,60,60,0,1,0,1,0,deny
29145,8168,0,0,62,62,0,1,0,1,0,deny
60617,64147,0,0,62,62,0,1,0,1,0,deny
45908,3383,0,0,60,60,0,1,0,1,0,deny
57959,21247,0,0,66,66,0,1,0,1,0,deny
55892,445,0,0,70,70,0,1,0,1,0,drop
55888,445,0,0,70,70,0,1,0,1,0,drop
55883,445,0,0,70,70,0,1,0,1,0,drop
52611,9571,0,0,62,62,0,1,0,1,0,deny
50827,445,0,0,70,70,0,1,0,1,0,drop
20371,35440,0,0,62,62,0,1,0,1,0,deny
8889,60297,0,0,60,60,0,1,0,1,0,deny
47013,37965,0,0,62,62,0,1,0,1,0,deny
39244,36829,0,0,146,146,0,1,0,1,0,deny
52975,23718,0,0,66,66,0,1,0,1,0,deny
50820,445,0,0,70,70,0,1,0,1,0,drop
50818,445,0,0,70,70,0,1,0,1,0,drop
50422,50584,0,0,66,66,0,1,0,1,0,deny
55875,445,0,0,70,70,0,1,0,1,0,drop
55874,445,0,0,70,70,0,1,0,1,0,drop
55873,445,0,0,70,70,0,1,0,1,0,drop
64177,44847,0,0,62,62,0,1,0,1,0,deny
56798,9571,0,0,62,62,0,1,0,1,0,deny
33469,61903,0,0,145,145,0,1,0,1,0,deny
443,10010,0,0,60,60,0,1,0,1,0,deny
43271,50584,0,0,146,146,0,1,0,1,0,deny
3964,51505,0,0,62,62,0,1,0,1,0,deny
61357,64147,0,0,62,62,0,1,0,1,0,deny
50813,445,0,0,70,70,0,1,0,1,0,drop
2404,35440,0,0,146,146,0,1,0,1,0,deny
46849,36237,0,0,66,66,0,1,0,1,0,deny
50812,445,0,0,70,70,0,1,0,1,0,drop
60960,49049,0,0,66,66,0,1,0,1,0,deny
62930,21247,0,0,66,66,0,1,0,1,0,deny
53353,26467,0,0,62,62,0,1,0,1,0,deny
64166,35440,0,0,66,66,0,1,0,1,0,deny
46116,51505,0,0,62,62,0,1,0,1,0,deny
51953,37965,0,0,66,66,0,1,0,1,0,deny
51273,445,0,0,66,66,0,1,0,1,0,drop
50808,445,0,0,70,70,0,1,0,1,0,drop
55868,445,0,0,70,70,0,1,0,1,0,drop
55862,445,0,0,70,70,0,1,0,1,0,drop
51570,443,51570,443,11204,3773,7431,29,132,12,17,allow
49275,53,23304,53,212,102,110,2,30,1,1,allow
52490,443,51639,443,23518,8884,14634,32,15,15,17,allow
57863,443,52780,443,1981,1155,826,19,86,10,9,allow
53209,80,42720,80,1452,484,968,8,15,5,3,allow
57413,443,19121,443,16749,7614,9135,74,17,34,40,allow
55635,53,55478,53,177,94,83,2,29,1,1,allow
55776,53,11095,53,272,110,162,2,29,1,1,allow
64611,53,9832,53,181,94,87,2,29,1,1,allow
58771,80,64938,80,2062,904,1158,10,258,6,4,allow
64762,53,23924,53,200,94,106,2,30,1,1,allow
57486,80,57486,80,1248,535,713,10,20,5,5,allow
55732,53,1656,53,194,102,92,2,30,1,1,allow
33057,80,61093,80,1151,711,440,10,15,5,5,allow
56481,443,31113,443,1853,1214,639,18,134,11,7,allow
51715,29358,11619,29358,414,136,278,6,16,3,3,allow
52313,80,52313,80,450,246,204,8,29,5,3,allow
51771,80,34714,80,76066,3663,72403,92,24,40,52,allow
56624,53,50985,53,196,102,94,2,30,1,1,allow
56730,53,45534,53,210,110,100,2,30,1,1,allow
65464,443,36070,443,395647,11870,383777,409,16,144,265,allow
59781,443,23445,443,546,180,366,10,28,4,6,allow
43055,80,43055,80,1246,533,713,10,20,5,5,allow
59752,443,31611,443,12150,1262,10888,29,41,13,16,allow
53196,443,1285,443,4371,1115,3256,19,19,9,10,allow
49939,53,36312,53,384,103,281,4,50,2,2,allow
51739,62163,31026,62163,70,70,0,2,8,2,0,allow
51118,80,26346,80,1952,1118,834,21,365,11,10,allow
55635,53,13643,53,177,94,83,2,30,1,1,allow
49963,53,54838,53,279,96,183,4,59,2,2,allow
64946,53,45329,53,210,102,108,2,30,1,1,allow
49614,53,48437,53,258,110,148,2,30,1,1,allow
55217,53,21902,53,189,102,87,2,30,1,1,allow
37984,443,32167,443,3149,1829,1320,22,315,12,10,allow
52730,443,26039,443,8040,2587,5453,39,16,23,16,allow
60368,443,14990,443,10483,4072,6411,20,26,9,11,allow
39036,443,62520,443,1768,541,1227,11,20,7,4,allow
64858,53,5118,53,819,102,717,2,30,1,1,allow
65298,53,31126,53,277,110,167,2,30,1,1,allow
56602,53,21237,53,197,102,95,2,30,1,1,allow
35338,443,9775,443,7504,2762,4742,35,61,17,18,allow
51773,80,63744,80,40993,2984,38009,57,24,28,29,allow
56768,10880,3397,10880,70,70,0,1,5,1,0,allow
55879,53,32478,53,200,94,106,2,30,1,1,allow
53049,443,20030,443,7393,2050,5343,34,92,16,18,allow
52997,443,41046,443,10754,4129,6625,42,112,20,22,allow
51768,80,6690,80,211684,9903,201781,247,27,109,138,allow
38891,80,9037,80,5491,2690,2801,13,15,7,6,allow
51770,80,6696,80,135293,6214,129079,161,24,71,90,allow
50970,80,27517,80,1123476,15099,1108377,963,39,223,740,allow
56482,443,53337,443,10788,6521,4267,61,134,31,30,allow
57414,443,40284,443,103144,2997,100147,114,16,36,78,allow
38305,443,38305,443,5510,2263,3247,22,40,13,9,allow
51738,47483,28405,47483,70,70,0,2,8,2,0,allow
51723,10622,28735,10622,70,70,0,1,5,1,0,allow
34157,443,57470,443,154,94,60,2,5,1,1,allow
59789,443,31655,443,5520,1212,4308,18,28,9,9,allow
46734,53,46734,53,314,98,216,2,29,1,1,allow
33022,443,32074,443,162,102,60,2,5,1,1,allow
55447,53,22356,53,194,102,92,2,29,1,1,allow
55769,53,28226,53,373,103,270,4,43,2,2,allow
56925,53,26704,53,275,110,165,2,29,1,1,allow
52310,80,52310,80,450,246,204,8,29,5,3,allow
59779,443,65358,443,18360,1734,16626,32,28,13,19,allow
64489,53,3033,53,320,97,223,4,50,2,2,allow
36452,53,36452,53,226,106,120,2,29,1,1,allow
51675,53,24941,53,168,78,90,2,29,1,1,allow
64742,53,25545,53,761,102,659,2,29,1,1,allow
49446,80,49446,80,5724,3966,1758,25,38,14,11,allow
60306,53,57588,53,168,78,90,2,29,1,1,allow
64890,53,55634,53,210,110,100,2,29,1,1,allow
52312,80,52312,80,450,246,204,8,29,5,3,allow
49557,53,50413,53,272,110,162,2,29,1,1,allow
59780,443,27949,443,19224,2358,16866,38,28,15,23,allow
65025,53,29192,53,786,110,676,2,29,1,1,allow
64890,53,13860,53,210,110,100,2,30,1,1,allow
55896,53,65305,53,184,94,90,2,30,1,1,allow
56154,53,34116,53,291,94,197,2,29,1,1,allow
56730,53,53565,53,210,110,100,2,30,1,1,allow
55217,53,28752,53,189,102,87,2,30,1,1,allow
41923,53,17859,53,168,78,90,2,30,1,1,allow
55498,53,3379,53,340,134,206,2,30,1,1,allow
56793,53,24911,53,196,102,94,2,30,1,1,allow
49864,53,65077,53,212,102,110,2,30,1,1,allow
64359,53,44275,53,196,102,94,2,30,1,1,allow
50921,443,40184,443,9516,1896,7620,21,127,11,10,allow
49959,443,21643,443,102240,4349,97891,128,136,46,82,allow
56050,53,45376,53,178,94,84,2,30,1,1,allow
49896,443,43604,443,5996,976,5020,19,35,10,9,allow
19473,44929,9531,44929,481,150,331,2,1200,1,1,allow
50683,443,25335,443,6414,1372,5042,19,171,9,10,allow
50893,443,25118,443,9452,1832,7620,20,130,10,10,allow
59494,443,29596,443,338,278,60,2,5,1,1,allow
53107,44060,27368,44060,70,70,0,1,5,1,0,allow
40375,443,13030,443,130,70,60,3,5,2,1,allow
37450,443,11367,443,617919,23432,594487,706,39,297,409,allow
64188,53,11006,53,299,98,201,4,57,2,2,allow
56624,53,20436,53,819,102,717,2,30,1,1,allow
64487,53,6176,53,225,110,115,2,30,1,1,allow
49213,53,21489,53,272,94,178,2,30,1,1,allow
57235,53,3428,53,212,102,110,2,30,1,1,allow
33806,443,17179,443,37541,4945,32596,69,127,31,38,allow
52993,443,38783,443,10754,4129,6625,42,112,20,22,allow
57879,80,31290,80,318,192,126,6,27,4,2,allow
51772,80,5918,80,93693,4469,89224,115,24,53,62,allow
51294,443,42258,443,162,102,60,2,5,1,1,allow
49612,80,42484,80,1388,562,826,11,315,6,5,allow
59776,443,24367,443,966,480,486,17,29,9,8,allow
57334,53,43556,53,210,110,100,2,30,1,1,allow
55403,53,28747,53,211,102,109,2,30,1,1,allow
56176,53,42328,53,194,102,92,2,30,1,1,allow
46865,80,11797,80,662,600,62,12,495,11,1,allow
50841,443,31504,443,10475,1518,8957,24,139,11,13,allow
59778,443,33771,443,6723,1014,5709,19,29,10,9,allow
46186,443,59452,443,10103,3482,6621,59,16,29,30,allow
40576,443,40576,443,4433,1526,2907,19,27,11,8,allow
49522,53,16817,53,688,185,503,6,45,3,3,allow
49128,443,6577,443,3062,1747,1315,17,16,9,8,allow
52797,443,22094,443,8355,1923,6432,32,16,18,14,allow
43634,80,30485,80,1151,711,440,10,15,5,5,allow
65414,53,34166,53,197,102,95,2,30,1,1,allow
56268,53,23212,53,210,102,108,2,30,1,1,allow
57334,53,14690,53,210,110,100,2,30,1,1,allow
56793,53,12485,53,196,102,94,2,30,1,1,allow
64153,53,64829,53,340,134,206,2,30,1,1,allow
56478,53,62940,53,200,102,98,2,30,1,1,allow
44847,6881,59803,6881,484,150,334,2,1200,1,1,allow
55649,443,18027,443,7045,2145,4900,18,136,8,10,allow
50939,443,38504,443,8058,1136,6922,19,126,9,10,allow
50680,443,16561,443,7066,1129,5937,19,172,9,10,allow
60880,443,53335,443,12278,1931,10347,32,56,18,14,allow
60873,443,47153,443,60954,33730,27224,101,63,50,51,allow
50894,80,58930,80,5900,751,5149,15,130,7,8,allow
56050,53,26569,53,178,94,84,2,30,1,1,allow
56522,53,58867,53,322,134,188,2,30,1,1,allow
55384,53,33566,53,212,102,110,2,30,1,1,allow
65246,53,1802,53,209,102,107,2,30,1,1,allow
49854,443,54861,443,5089,1037,4052,20,61,11,9,allow
65049,53,22516,53,210,110,100,2,30,1,1,allow
64513,53,7726,53,396,102,294,2,31,1,1,allow
57173,53,30572,53,322,110,212,4,31,2,2,allow
57294,443,32624,443,122959,4611,118348,142,150,51,91,allow
49473,53,57880,53,290,118,172,2,30,1,1,allow
64865,53,41424,53,423,102,321,2,30,1,1,allow
39569,443,64666,443,125906,21096,104810,172,130,68,104,allow
55313,443,62411,443,4005,1162,2843,17,142,8,9,allow
60849,443,12589,443,3364,1737,1627,15,360,8,7,allow
65496,123,10878,123,184,94,90,2,30,1,1,allow
55896,53,44537,53,184,94,90,2,30,1,1,allow
56997,123,16433,123,184,94,90,2,30,1,1,allow
49679,53,54923,53,166,86,80,2,30,1,1,allow
65418,53,64332,53,211,102,109,2,30,1,1,allow
56050,53,44342,53,178,94,84,2,30,1,1,allow
59278,53,0,0,86,86,0,1,30,1,0,allow
54369,53,50744,53,168,78,90,2,31,1,1,allow
55732,53,61011,53,194,102,92,2,30,1,1,allow
56602,53,29182,53,197,102,95,2,30,1,1,allow
57334,53,19722,53,210,110,100,2,30,1,1,allow
64825,53,52627,53,184,94,90,2,30,1,1,allow
64056,53,57608,53,383,94,289,2,30,1,1,allow
45614,123,42191,123,184,94,90,2,30,1,1,allow
49540,53,39432,53,198,110,88,2,31,1,1,allow
63965,53,54423,53,180,94,86,2,31,1,1,allow
57470,20014,49843,20014,528,528,0,9,1200,9,0,allow
65423,443,16318,443,5854,1796,4058,21,142,10,11,allow
48344,443,10226,443,68467,4750,63717,100,276,48,52,allow
42934,443,36835,443,4514,1928,2586,17,241,8,9,allow
49540,53,53210,53,198,110,88,2,30,1,1,allow
49890,443,45754,443,6068,1047,5021,20,50,11,9,allow
49885,443,59973,443,37539,4310,33229,63,51,27,36,allow
49858,443,16431,443,2027955,75406,1952549,2104,60,564,1540,allow
55951,53,13243,53,197,102,95,2,31,1,1,allow
57173,53,19613,53,216,110,106,2,31,1,1,allow
49889,443,5001,443,214782,13389,201393,277,50,98,179,allow
49177,53,40047,53,184,94,90,2,31,1,1,allow
64643,443,21220,443,3433,1192,2241,13,136,6,7,allow
49873,443,58284,443,14476,2843,11633,45,55,22,23,allow
49876,443,4745,443,5993,974,5019,19,54,10,9,allow
47534,443,60052,443,291717,11752,279965,319,137,123,196,allow
51221,53239,19108,53239,1487,594,893,19,1571,10,9,allow
55292,53,33154,53,211,102,109,2,31,1,1,allow
46866,80,59082,80,662,600,62,12,495,11,1,allow
53330,443,46161,443,3701,1232,2469,13,136,6,7,allow
56727,53,55377,53,250,86,164,4,52,2,2,allow
49963,53,15871,53,279,96,183,4,58,2,2,allow
49963,53,58470,53,564,191,373,6,62,3,3,allow
55922,53,46699,53,423,102,321,2,30,1,1,allow
56983,53,28765,53,424,108,316,4,55,2,2,allow
64180,53,4267,53,180,94,86,2,30,1,1,allow
64825,53,49543,53,184,94,90,2,31,1,1,allow
50031,53,36003,53,386,134,252,2,30,1,1,allow
49679,53,7089,53,166,86,80,2,31,1,1,allow
64297,53,33648,53,199,94,105,2,30,1,1,allow
56478,53,14582,53,200,102,98,2,30,1,1,allow
49839,443,14297,443,5026,973,4053,19,72,10,9,allow
56341,443,32673,443,49417,5511,43906,108,439,54,54,allow
55732,53,40584,53,194,102,92,2,31,1,1,allow
56366,443,56718,443,7234,4345,2889,27,235,15,12,allow
65049,53,4020,53,210,110,100,2,31,1,1,allow
49842,443,41562,443,5309,1043,4266,22,72,11,11,allow
55033,53,37383,53,182,94,88,2,31,1,1,allow
36902,443,18209,443,10252,2152,8100,38,126,18,20,allow
37264,443,36936,443,3068,1678,1390,17,241,9,8,allow
50692,443,11802,443,152,86,66,2,5,1,1,allow
53527,45626,13998,45626,70,70,0,1,5,1,0,allow
61705,80,47319,80,134,60,74,3,11,2,1,allow
50865,443,45042,443,6883,1378,5505,19,131,9,10,allow
49511,80,32515,80,1693924,34466,1659458,1627,230,522,1105,allow
50804,443,11310,443,6337,1378,4959,19,140,9,10,allow
50840,443,34565,443,8057,1135,6922,19,139,9,10,allow
53530,8999,1234,8999,70,70,0,1,5,1,0,allow
56736,53,58809,53,283,94,189,4,41,2,2,allow
56793,53,43867,53,196,102,94,2,30,1,1,allow
49824,53,46232,53,178,94,84,2,30,1,1,allow
64256,53,5483,53,334,94,240,2,31,1,1,allow
55896,53,45886,53,184,94,90,2,31,1,1,allow
49824,53,29358,53,178,94,84,2,31,1,1,allow
49883,443,3067,443,4960,1114,3846,21,51,12,9,allow
49894,443,1865,443,8633,2099,6534,29,35,15,14,allow
49875,443,6451,443,31715,20427,11288,103,54,54,49,allow
49827,443,61208,443,5523,3016,2507,36,75,20,16,allow
56524,53,60434,53,182,102,80,2,31,1,1,allow
13826,53,57057,53,200,94,106,2,31,1,1,allow
50265,64304,32485,64304,970,598,372,14,1201,8,6,allow
56430,443,5643,443,2274816,85295,2189521,2305,127,825,1480,allow
55049,5228,10544,5228,9193,2770,6423,51,5193,28,23,allow
55548,443,42567,443,12205,2036,10169,33,138,18,15,allow
53528,20485,28809,20485,70,70,0,1,5,1,0,allow
50864,443,18823,443,6663,1556,5107,21,132,10,11,allow
50919,443,47767,443,6412,1370,5042,19,129,9,10,allow
50828,443,49506,443,6337,1378,4959,19,140,9,10,allow
50867,443,26907,443,6351,1370,4981,18,131,9,9,allow
50914,443,19872,443,8058,1136,6922,19,129,9,10,allow
50800,443,31236,443,7067,1129,5938,19,141,9,10,allow
14084,43890,0,0,62,62,0,1,0,1,0,deny
56100,57470,0,0,62,62,0,1,0,1,0,deny
61845,11392,0,0,66,66,0,1,0,1,0,deny
50806,445,0,0,70,70,0,1,0,1,0,drop
12694,12446,0,0,62,62,0,1,0,1,0,deny
26573,44847,0,0,62,62,0,1,0,1,0,deny
6889,55108,0,0,143,143,0,1,0,1,0,deny
51413,54351,0,0,136,136,0,1,0,1,0,deny
49298,18593,0,0,145,145,0,1,0,1,0,deny
1987,26467,0,0,62,62,0,1,0,1,0,deny
51413,1,0,0,72,72,0,1,0,1,0,deny
49386,64147,0,0,62,62,0,1,0,1,0,deny
30951,50584,0,0,62,62,0,1,0,1,0,deny
51266,445,0,0,66,66,0,1,0,1,0,drop
14993,50584,0,0,62,62,0,1,0,1,0,deny
51263,445,0,0,66,66,0,1,0,1,0,drop
55855,445,0,0,70,70,0,1,0,1,0,drop
9775,30188,0,0,62,62,0,1,0,1,0,deny
50802,445,0,0,70,70,0,1,0,1,0,drop
8999,42873,0,0,146,146,0,1,0,1,0,deny
55851,445,0,0,70,70,0,1,0,1,0,drop
55850,445,0,0,70,70,0,1,0,1,0,drop
55847,445,0,0,70,70,0,1,0,1,0,drop
51262,445,0,0,66,66,0,1,0,1,0,drop
6069,45680,0,0,159,159,0,1,0,1,0,deny
48478,49903,0,0,62,62,0,1,0,1,0,deny
60923,49903,0,0,66,66,0,1,0,1,0,deny
58486,57470,0,0,66,66,0,1,0,1,0,deny
16275,23117,0,0,146,146,0,1,0,1,0,deny
55842,445,0,0,70,70,0,1,0,1,0,drop
14613,12446,0,0,66,66,0,1,0,1,0,deny
55840,445,0,0,70,70,0,1,0,1,0,drop
55838,445,0,0,70,70,0,1,0,1,0,drop
55836,445,0,0,70,70,0,1,0,1,0,drop
52666,40108,0,0,148,148,0,1,0,1,0,deny
51254,445,0,0,66,66,0,1,0,1,0,drop
18085,26467,0,0,66,66,0,1,0,1,0,deny
51247,445,0,0,66,66,0,1,0,1,0,drop
51248,445,0,0,66,66,0,1,0,1,0,drop
51245,445,0,0,66,66,0,1,0,1,0,drop
50789,445,0,0,70,70,0,1,0,1,0,drop
51233,43890,0,0,66,66,0,1,0,1,0,deny
23379,57866,0,0,146,146,0,1,0,1,0,deny
51243,445,0,0,66,66,0,1,0,1,0,drop
51244,445,0,0,66,66,0,1,0,1,0,drop
51241,445,0,0,66,66,0,1,0,1,0,drop
59586,57470,0,0,66,66,0,1,0,1,0,deny
62452,21247,0,0,66,66,0,1,0,1,0,deny
50786,445,0,0,70,70,0,1,0,1,0,drop
19838,23,0,0,60,60,0,1,0,1,0,deny
55835,445,0,0,70,70,0,1,0,1,0,drop
55833,445,0,0,70,70,0,1,0,1,0,drop
55828,445,0,0,70,70,0,1,0,1,0,drop
51240,445,0,0,66,66,0,1,0,1,0,drop
55827,445,0,0,70,70,0,1,0,1,0,drop
56967,35440,0,0,66,66,0,1,0,1,0,deny
51236,445,0,0,66,66,0,1,0,1,0,drop
51234,445,0,0,66,66,0,1,0,1,0,drop
51233,445,0,0,66,66,0,1,0,1,0,drop
55262,44847,0,0,62,62,0,1,0,1,0,deny
50781,445,0,0,70,70,0,1,0,1,0,drop
26888,23,0,0,60,60,0,1,0,1,0,deny
50780,445,0,0,70,70,0,1,0,1,0,drop
51230,445,0,0,66,66,0,1,0,1,0,drop
50668,58833,0,0,66,66,0,1,0,1,0,deny
50778,445,0,0,70,70,0,1,0,1,0,drop
25151,58833,0,0,146,146,0,1,0,1,0,deny
25342,8168,0,0,62,62,0,1,0,1,0,deny
54826,56205,0,0,66,66,0,1,0,1,0,deny
55821,445,0,0,70,70,0,1,0,1,0,drop
24351,57470,0,0,62,62,0,1,0,1,0,deny
55818,445,0,0,70,70,0,1,0,1,0,drop
55815,445,0,0,70,70,0,1,0,1,0,drop
46557,57866,0,0,66,66,0,1,0,1,0,deny
50853,50584,0,0,66,66,0,1,0,1,0,deny
50771,445,0,0,70,70,0,1,0,1,0,drop
51221,445,0,0,66,66,0,1,0,1,0,drop
25570,35440,0,0,62,62,0,1,0,1,0,deny
0,0,0,0,156,156,0,2,0,2,0,allow
0,0,0,0,244,244,0,2,0,2,0,allow
50769,445,0,0,70,70,0,1,0,1,0,drop
49359,64147,0,0,66,66,0,1,0,1,0,deny
6889,30170,0,0,143,143,0,1,0,1,0,deny
40990,10387,0,0,148,148,0,1,0,1,0,deny
50768,445,0,0,70,70,0,1,0,1,0,drop
50767,445,0,0,70,70,0,1,0,1,0,drop
50,64147,0,0,62,62,0,1,0,1,0,deny
51212,445,0,0,66,66,0,1,0,1,0,drop
50766,445,0,0,70,70,0,1,0,1,0,drop
58876,57470,0,0,66,66,0,1,0,1,0,deny
55800,445,0,0,70,70,0,1,0,1,0,drop
50761,445,0,0,70,70,0,1,0,1,0,drop
50760,445,0,0,70,70,0,1,0,1,0,drop
37213,36237,0,0,66,66,0,1,0,1,0,deny
6890,11204,0,0,146,146,0,1,0,1,0,deny
56411,50584,0,0,62,62,0,1,0,1,0,deny
51209,445,0,0,66,66,0,1,0,1,0,drop
50748,445,0,0,70,70,0,1,0,1,0,drop
50747,445,0,0,70,70,0,1,0,1,0,drop
53957,35440,0,0,146,146,0,1,0,1,0,deny
50745,445,0,0,70,70,0,1,0,1,0,drop
60132,50584,0,0,62,62,0,1,0,1,0,deny
25973,26467,0,0,66,66,0,1,0,1,0,deny
50738,445,0,0,70,70,0,1,0,1,0,drop
50737,445,0,0,70,70,0,1,0,1,0,drop
56327,44512,0,0,66,66,0,1,0,1,0,deny
23650,37807,0,0,62,62,0,1,0,1,0,deny
51201,445,0,0,66,66,0,1,0,1,0,drop
35657,48637,0,0,62,62,0,1,0,1,0,deny
34916,51185,0,0,62,62,0,1,0,1,0,deny
25523,35974,0,0,62,62,0,1,0,1,0,deny
51194,445,0,0,66,66,0,1,0,1,0,drop
25523,35974,0,0,145,145,0,1,0,1,0,deny
50200,44847,0,0,74,74,0,1,0,1,0,deny
60192,35440,0,0,66,66,0,1,0,1,0,deny
10753,22114,0,0,146,146,0,1,0,1,0,deny
50726,445,0,0,70,70,0,1,0,1,0,drop
25470,24748,0,0,143,143,0,1,0,1,0,deny
6890,27520,0,0,146,146,0,1,0,1,0,deny
52941,443,58388,443,14630,5941,8689,52,115,26,26,allow
60189,443,11334,443,10816,1112,9704,22,125,10,12,allow
50332,80,19945,80,2862,1465,1397,11,47,6,5,allow
60309,443,17740,443,130,70,60,3,5,2,1,allow
49860,443,20445,443,10754,2778,7976,38,59,19,19,allow
49893,443,34865,443,7115,1670,5445,24,35,13,11,allow
53138,443,56360,443,7141,2507,4634,28,42,13,15,allow
52912,443,9289,443,41094,14929,26165,126,116,69,57,allow
52942,443,55996,443,14696,5947,8749,53,115,26,27,allow
52921,443,44773,443,36892,20283,16609,191,116,77,114,allow
52879,443,43280,443,286404,12478,273926,379,118,130,249,allow
52887,80,9477,80,5694,2514,3180,36,118,19,17,allow
52918,443,11338,443,326078,45627,280451,737,116,252,485,allow
47744,443,50454,443,7761,2376,5385,24,256,12,12,allow
52928,443,12845,443,56910,3384,53526,85,115,33,52,allow
52940,443,39271,443,14640,5951,8689,52,115,26,26,allow
52938,443,4484,443,14896,6021,8875,56,115,27,29,allow
60187,443,13141,443,9875,1112,8763,21,125,10,11,allow
37066,443,58040,443,9705,4332,5373,32,321,17,15,allow
61714,443,30943,443,134,60,74,3,10,2,1,allow
53194,443,63620,443,1462,965,497,13,18,7,6,allow
53127,443,49935,443,68982,15774,53208,113,45,42,71,allow
53128,443,36411,443,72734,14614,58120,112,44,39,73,allow
52880,443,45002,443,1695880,25777,1670103,1423,118,264,1159,allow
53018,443,30354,443,48877,5205,43672,95,93,32,63,allow
52931,443,32527,443,23112,6278,16834,140,115,55,85,allow
60190,443,8550,443,10178,1101,9077,22,125,10,12,allow
53525,34759,11727,34759,70,70,0,1,5,1,0,allow
53195,443,48069,443,1462,965,497,13,18,7,6,allow
53179,80,43162,80,1628,828,800,10,25,6,4,allow
52943,443,54392,443,14640,5951,8689,52,115,26,26,allow
52930,443,54761,443,21194,5779,15415,118,115,47,71,allow
53115,443,63976,443,9616,6956,2660,39,47,21,18,allow
52898,80,57619,80,3020,1414,1606,30,118,16,14,allow
51411,443,64614,443,7842,1155,6687,19,105,10,9,allow
51265,63960,52529,63960,70,70,0,2,8,2,0,allow
45426,80,3986,80,416,210,206,7,28,4,3,allow
49175,2710,30746,2710,70,70,0,2,8,2,0,allow
44481,443,29524,443,6336,1633,4703,22,256,12,10,allow
49662,443,55920,443,9534,4029,5505,22,59,12,10,allow
48360,3389,48360,3389,4085,1916,2169,21,19,12,9,allow
45428,80,14591,80,350,210,140,6,28,4,2,allow
49649,443,64805,443,5964,674,5290,16,60,7,9,allow
55951,53,16889,53,194,99,95,2,31,1,1,allow
46980,443,8668,443,7633,5620,2013,31,60,19,12,allow
45427,80,37690,80,350,210,140,6,28,4,2,allow
50571,80,64124,80,300,174,126,5,15,3,2,allow
38306,443,65032,443,4580,1210,3370,17,28,10,7,allow
50848,80,48215,80,1213557,27203,1186354,1120,133,327,793,allow
50863,80,47507,80,5874,744,5130,14,131,7,7,allow
53524,45395,27489,45395,70,70,0,1,5,1,0,allow
49674,443,62205,443,8656,2060,6596,20,57,10,10,allow
56420,443,51933,443,5220,922,4298,17,135,10,7,allow
49722,443,17749,443,5943,850,5093,16,50,7,9,allow
60188,443,15594,443,9811,1112,8699,21,125,10,11,allow
52896,80,13613,80,3020,1414,1606,30,118,16,14,allow
45119,443,36541,443,5082,969,4113,18,30,10,8,allow
52904,443,65264,443,17521,6560,10961,55,117,28,27,allow
52903,443,57569,443,253281,6271,247010,276,117,66,210,allow
52939,443,34090,443,16053,6801,9252,51,115,26,25,allow
52876,443,35265,443,501046,7967,493079,419,118,69,350,allow
49894,443,19598,443,7418,2721,4697,23,20,12,11,allow
38808,443,46954,443,25120,1874,23246,39,171,17,22,allow
57595,443,62180,443,291,171,120,4,16,2,2,allow
50795,443,7705,443,18444,12288,6156,36,149,20,16,allow
64915,443,15491,443,4659604,120303,4539301,4651,74,1586,3065,allow
49177,53,33754,53,184,94,90,2,31,1,1,allow
49851,443,11118,443,6058,1038,5020,20,71,11,9,allow
59950,53,51206,53,395,115,280,2,30,1,1,allow
5938,47968,0,0,60,60,0,1,91,1,0,allow
57737,443,13855,443,15625,4662,10963,25,123,11,14,allow
52865,443,62658,443,120290,2988,117302,123,132,32,91,allow
52901,443,37617,443,87558,4155,83403,115,117,41,74,allow
52895,443,23981,443,18795,10297,8498,56,118,29,27,allow
53137,443,3588,443,7648,3641,4007,29,42,13,16,allow
53131,443,52675,443,33229,7810,25419,63,44,24,39,allow
50214,53,34671,53,789,110,679,2,31,1,1,allow
49364,53,62830,53,180,92,88,2,31,1,1,allow
54952,5228,14099,5228,12140,3028,9112,54,4653,28,26,allow
53005,443,10690,443,13028,4115,8913,45,95,23,22,allow
52897,80,31689,80,4292,1932,2360,32,118,17,15,allow
53002,443,30088,443,16537,4585,11952,46,96,24,22,allow
53129,443,62080,443,51742,10734,41008,85,44,33,52,allow
43568,80,8531,80,2277,1521,756,16,16,10,6,allow
56215,53,26623,53,216,110,106,2,31,1,1,allow
64914,443,15488,443,6120028,157580,5962448,6108,75,2083,4025,allow
39381,53,0,0,82,82,0,1,31,1,0,allow
47504,53,47504,53,174,77,97,2,30,1,1,allow
63945,53,52680,53,216,110,106,2,31,1,1,allow
65127,53,26912,53,188,96,92,2,31,1,1,allow
56322,53,7412,53,202,103,99,2,31,1,1,allow
57470,46772,63151,46772,528,528,0,9,1201,9,0,allow
57356,443,4225,443,7802,4189,3613,22,136,11,11,allow
55478,443,16411,443,23029908,732047,22297861,24550,183,8143,16407,allow
52925,5555,0,0,60,60,0,1,0,1,0,deny
55791,445,0,0,70,70,0,1,0,1,0,drop
30920,64147,0,0,62,62,0,1,0,1,0,deny
55788,445,0,0,70,70,0,1,0,1,0,drop
55787,445,0,0,70,70,0,1,0,1,0,drop
51187,445,0,0,66,66,0,1,0,1,0,drop
51185,445,0,0,66,66,0,1,0,1,0,drop
51186,445,0,0,66,66,0,1,0,1,0,drop
51184,445,0,0,66,66,0,1,0,1,0,drop
51182,445,0,0,66,66,0,1,0,1,0,drop
51183,445,0,0,66,66,0,1,0,1,0,drop
51181,445,0,0,66,66,0,1,0,1,0,drop
51179,445,0,0,66,66,0,1,0,1,0,drop
18655,50584,0,0,146,146,0,1,0,1,0,deny
64767,51221,0,0,62,62,0,1,0,1,0,deny
50722,445,0,0,70,70,0,1,0,1,0,drop
50102,17546,0,0,66,66,0,1,0,1,0,deny
13743,33720,0,0,159,159,0,1,0,1,0,deny
52917,443,43916,443,7148,2358,4790,40,116,18,22,allow
52952,443,15638,443,9381,3074,6307,47,114,24,23,allow
52924,443,50522,443,21789,7672,14117,78,115,39,39,allow
50404,80,8357,80,4242,3615,627,15,32,8,7,allow
50403,80,8423,80,4332,3596,736,14,32,8,6,allow
46346,35440,0,0,66,66,0,1,0,1,0,deny
56405,62413,0,0,66,66,0,1,0,1,0,deny
27517,23,0,0,60,60,0,1,0,1,0,deny
50712,445,0,0,70,70,0,1,0,1,0,drop
50711,445,0,0,70,70,0,1,0,1,0,drop
60192,35440,0,0,62,62,0,1,0,1,0,deny
55056,56205,0,0,66,66,0,1,0,1,0,deny
55779,445,0,0,70,70,0,1,0,1,0,drop
55776,445,0,0,70,70,0,1,0,1,0,drop
55772,445,0,0,70,70,0,1,0,1,0,drop
50707,445,0,0,70,70,0,1,0,1,0,drop
50708,445,0,0,70,70,0,1,0,1,0,drop
1431,30041,0,0,62,62,0,1,0,1,0,deny
50877,30041,0,0,66,66,0,1,0,1,0,deny
61329,51505,0,0,62,62,0,1,0,1,0,deny
50705,445,0,0,70,70,0,1,0,1,0,drop
51167,445,0,0,66,66,0,1,0,1,0,drop
51164,445,0,0,66,66,0,1,0,1,0,drop
51166,445,0,0,66,66,0,1,0,1,0,drop
55770,445,0,0,70,70,0,1,0,1,0,drop
58597,35440,0,0,66,66,0,1,0,1,0,deny
55767,445,0,0,70,70,0,1,0,1,0,drop
55762,445,0,0,70,70,0,1,0,1,0,drop
55761,445,0,0,70,70,0,1,0,1,0,drop
50875,53,15135,53,234,234,0,4,47,4,0,allow
49870,443,21099,443,6062,1042,5020,20,55,11,9,allow
49882,443,51154,443,79524,18512,61012,205,50,101,104,allow
56847,53,25632,53,225,86,139,2,30,1,1,allow
55190,53,57289,53,311,94,217,2,30,1,1,allow
55951,53,4112,53,197,102,95,2,30,1,1,allow
42853,443,43627,443,3508,2120,1388,20,241,10,10,allow
50265,33734,14802,33734,132,132,0,3,1200,3,0,allow
52975,443,20822,443,291803,6522,285281,284,113,58,226,allow
50771,80,8237,80,6420,677,5743,13,151,6,7,allow
50852,80,1179,80,1118864,18787,1100077,1036,132,280,756,allow
50859,443,27316,443,6886,1380,5506,19,132,9,10,allow
50895,443,56217,443,6354,1373,4981,18,129,9,9,allow
50866,443,31244,443,9517,1897,7620,21,130,11,10,allow
55947,53,33524,53,311,108,203,4,42,2,2,allow
48017,443,12876,443,198,78,120,4,6,2,2,allow
53543,51819,43192,51819,70,70,0,2,7,2,0,allow
50689,443,50217,443,152,86,66,2,4,1,1,allow
64991,443,64991,443,9107,1499,7608,20,75,11,9,allow
52965,443,44159,443,86041,4656,81385,102,113,34,68,allow
50849,80,37869,80,1218354,26709,1191645,1128,133,332,796,allow
50739,443,62875,443,6335,1376,4959,19,165,9,10,allow
56727,53,4531,53,250,86,164,4,46,2,2,allow
50770,443,41782,443,6350,1369,4981,18,151,9,9,allow
50682,80,52857,80,5237,680,4557,12,170,6,6,allow
49897,443,23230,443,33013,21249,11764,151,492,79,72,allow
50972,80,5146,80,1095399,7129,1088270,832,37,106,726,allow
50686,443,29049,443,6340,1381,4959,19,170,9,10,allow
50746,443,7838,443,6354,1372,4982,18,161,9,9,allow
60871,443,15673,443,95311,21869,73442,140,62,61,79,allow
50720,443,25123,443,6336,1377,4959,19,169,9,10,allow
50064,443,49945,443,4118,2209,1909,36,239,21,15,allow
50744,443,22315,443,6854,1380,5474,18,161,9,9,allow
50769,443,26960,443,6882,1377,5505,19,151,9,10,allow
50965,443,11513,443,8949,1200,7749,21,85,10,11,allow
50843,443,54645,443,6337,1378,4959,19,135,9,10,allow
57348,443,22476,443,6250,1312,4938,23,315,12,11,allow
61828,443,31671,443,7490,2688,4802,23,383,10,13,allow
50920,443,55566,443,6273,1375,4898,18,127,9,9,allow
56135,53,22804,53,542,112,430,4,34,2,2,allow
53544,22051,5953,22051,70,70,0,2,7,2,0,allow
49727,443,58320,443,4116,972,3144,15,50,8,7,allow
53522,24116,50290,24116,70,70,0,1,4,1,0,allow
49673,443,32250,443,6404,829,5575,18,57,9,9,allow
53203,443,27595,443,3656,2345,1311,18,17,9,9,allow
52846,80,43511,80,3626,1778,1848,36,143,19,17,allow
52990,443,9852,443,7093,2235,4858,39,111,20,19,allow
53081,443,13924,443,16157,6478,9679,46,83,23,23,allow
52951,443,13326,443,628801,19603,609198,708,114,227,481,allow
53163,443,16194,443,7432,1694,5738,23,27,12,11,allow
53027,443,45299,443,26309,3035,23274,69,92,27,42,allow
49499,443,13640,443,87970,5355,82615,141,483,55,86,allow
49775,53,55039,53,399,93,306,4,41,2,2,allow
49689,443,55526,443,1179,655,524,13,56,7,6,allow
49881,443,45580,443,5997,978,5019,19,53,10,9,allow
49900,443,21992,443,6896,2139,4757,31,33,15,16,allow
63927,53,30501,53,196,94,102,2,30,1,1,allow
65412,53,14297,53,305,118,187,2,30,1,1,allow
55281,53,43570,53,210,102,108,2,30,1,1,allow
43444,53,43444,53,314,98,216,2,30,1,1,allow
64694,53,57973,53,209,102,107,2,30,1,1,allow
64018,53,10598,53,229,94,135,2,30,1,1,allow
61060,53,61060,53,257,106,151,2,30,1,1,allow
53052,443,60187,443,8476,2030,6446,38,91,19,19,allow
56363,443,4827,443,4864,3011,1853,20,234,12,8,allow
53063,80,2438,80,2725,1228,1497,24,90,13,11,allow
53023,443,2353,443,9625,3512,6113,41,92,21,20,allow
53022,443,29069,443,15099,7828,7271,45,92,24,21,allow
53204,443,30061,443,3655,2344,1311,18,17,9,9,allow
53093,443,27460,443,6774,3651,3123,35,80,18,17,allow
53004,443,34423,443,18064,5135,12929,108,95,44,64,allow
52949,443,60761,443,9564,2054,7510,42,114,20,22,allow
53010,443,23300,443,31660,3248,28412,58,93,23,35,allow
53037,80,8932,80,2906,1233,1673,24,92,13,11,allow
52948,443,49245,443,9629,2119,7510,42,114,20,22,allow
51736,34343,5872,34343,70,70,0,2,8,2,0,allow
52955,443,58633,443,23572,2063,21509,46,114,20,26,allow
53201,443,51458,443,3655,2344,1311,18,17,9,9,allow
41059,443,46382,443,1248874,30382,1218492,1261,111,425,836,allow
53165,443,14639,443,7434,1695,5739,23,27,12,11,allow
49901,443,3004,443,4949,1047,3902,22,33,11,11,allow
53207,443,15704,443,3655,2344,1311,18,17,9,9,allow
49884,443,63837,443,5998,978,5020,19,50,10,9,allow
53156,443,62340,443,3814,2664,1150,22,28,12,10,allow
53199,443,19271,443,1582,965,617,15,18,7,8,allow
49869,443,47117,443,7910,1967,5943,30,55,15,15,allow
53187,443,36781,443,5244,1925,3319,33,21,17,16,allow
49857,443,36785,443,4221,1038,3183,19,59,11,8,allow
19236,53,19236,53,235,90,145,2,33,1,1,allow
53193,443,17954,443,1462,965,497,13,18,7,6,allow
49895,443,39538,443,6060,1040,5020,20,34,11,9,allow
58677,28678,3047,28678,1806,1806,0,22,225,22,0,allow
49826,443,4711,443,1738,1159,579,16,74,10,6,allow
53055,443,19489,443,17225,7769,9456,71,91,34,37,allow
35900,443,35900,443,5661,2414,3247,22,39,13,9,allow
49650,53,42506,53,248,110,138,2,30,1,1,allow
52944,443,11890,443,58499,47163,11336,106,115,59,47,allow
34989,80,37174,80,350,210,140,6,28,4,2,allow
54309,80,4585,80,552,280,272,9,30,5,4,allow
52886,80,7195,80,5688,2508,3180,36,118,19,17,allow
64371,53,21841,53,181,86,95,2,30,1,1,allow
49721,443,52287,443,4588,843,3745,14,52,7,7,allow
64701,53,54317,53,195,94,101,2,30,1,1,allow
50244,80,52530,80,136475,59298,77177,166,53,78,88,allow
55033,53,44325,53,182,94,88,2,30,1,1,allow
49724,443,6596,443,7226,844,6382,19,50,9,10,allow
51667,21391,14607,21391,1345,679,666,9,30,5,4,allow
51666,45702,58433,45702,1201,577,624,8,30,4,4,allow
52985,80,52009,80,3111,1364,1747,28,112,15,13,allow
53206,443,65067,443,3656,2345,1311,18,17,9,9,allow
52957,443,8095,443,38149,4388,33761,68,113,26,42,allow
53064,443,10926,443,8095,2586,5509,38,90,19,19,allow
53154,443,28335,443,3947,2796,1151,22,28,12,10,allow
53160,443,52369,443,2738,1904,834,18,28,10,8,allow
60881,443,31300,443,31109,2922,28187,54,52,26,28,allow
41657,443,13161,443,122547,6414,116133,160,81,61,99,allow
36262,443,11222,443,678861,22499,656362,749,19,290,459,allow
53241,443,45177,443,1950,1176,774,18,103,11,7,allow
50405,80,63982,80,4530,3395,1135,15,32,8,7,allow
49872,443,32419,443,4595,1038,3557,19,54,11,8,allow
49877,443,32997,443,37364,16799,20565,189,53,87,102,allow
49828,443,7626,443,1737,1158,579,16,74,10,6,allow
56362,443,29740,443,12746,7725,5021,39,234,24,15,allow
57424,53,8409,53,210,102,108,2,30,1,1,allow
56215,53,24448,53,216,110,106,2,30,1,1,allow
64749,53,21766,53,227,110,117,2,30,1,1,allow
63965,53,11899,53,180,94,86,2,30,1,1,allow
64029,443,14573,443,252,70,182,3,120,1,2,allow
35459,443,42175,443,2350,1392,958,17,275,9,8,allow
63127,55860,37307,55860,316,190,126,5,15,3,2,allow
49718,443,25229,443,4524,779,3745,13,52,6,7,allow
49723,443,63349,443,6780,710,6070,16,50,7,9,allow
49668,443,23437,443,7978,2204,5774,20,58,10,10,allow
49715,443,43667,443,4418,789,3629,13,54,6,7,allow
53035,443,38723,443,20048,9134,10914,96,92,39,57,allow
53161,443,30923,443,2731,1895,836,18,28,10,8,allow
52973,443,33521,443,9294,2728,6566,43,113,22,21,allow
52852,80,35656,80,7572,3232,4340,42,140,23,19,allow
53197,443,58160,443,1462,965,497,13,18,7,6,allow
53012,443,44779,443,13938,3220,10718,44,93,21,23,allow
49824,53,4911,53,392,88,304,4,53,2,2,allow
34988,80,55946,80,416,210,206,7,28,4,3,allow
35106,443,63708,443,309321,13076,296245,368,189,150,218,allow
49853,443,20017,443,11534,2076,9458,43,60,21,22,allow
54310,80,7871,80,552,280,272,9,30,5,4,allow
9707,3389,9707,3389,3441,1552,1889,17,21,10,7,allow
57917,443,1119,443,6520,1550,4970,19,54,11,8,allow
60878,443,38028,443,764899,31427,733472,883,60,368,515,allow
50868,80,40174,80,12388,742,11646,18,130,7,11,allow
50803,443,31091,443,6417,1376,5041,19,140,9,10,allow
50918,80,48461,80,9643,812,8831,18,128,8,10,allow
50681,443,36673,443,6888,1380,5508,19,171,9,10,allow
50801,443,41271,443,6893,1384,5509,19,140,9,10,allow
60840,443,45920,443,54975,32043,22932,71,319,40,31,allow
50745,80,27446,80,2977,680,2297,11,161,6,5,allow
60872,443,25312,443,27204,15677,11527,59,62,30,29,allow
50873,443,21465,443,6889,1381,5508,19,129,9,10,allow
50892,443,40533,443,8057,1135,6922,19,129,9,10,allow
50878,80,60118,80,325925,18062,307863,377,146,161,216,allow
50898,443,1887,443,6883,1378,5505,19,128,9,10,allow
51721,35426,54780,35426,70,70,0,1,5,1,0,allow
50944,443,36385,443,9517,1898,7619,21,85,11,10,allow
50850,443,34368,443,6341,1382,4959,19,132,9,10,allow
62705,443,21442,443,357841,77119,280722,646,142,316,330,allow
51735,50794,43847,50794,70,70,0,2,8,2,0,allow
36261,443,56856,443,1269784,41489,1228295,1339,37,478,861,allow
65463,443,25060,443,92752,4519,88233,105,15,39,66,allow
50690,443,9122,443,152,86,66,2,4,1,1,allow
53520,37553,29607,37553,70,70,0,1,4,1,0,allow
53531,48908,42269,48908,70,70,0,1,4,1,0,allow
40521,28678,47764,28678,1806,1806,0,22,225,22,0,allow
52640,443,13563,443,70,70,0,1,5,1,0,allow
49720,443,54089,443,4936,855,4081,17,52,7,10,allow
42925,443,37247,443,5617,1559,4058,22,138,13,9,allow
60191,443,1843,443,7292,950,6342,19,125,9,10,allow
49726,443,2292,443,3941,902,3039,13,50,7,6,allow
53155,443,52565,443,3866,2774,1092,21,28,12,9,allow
36256,443,38729,443,3936219,107920,3828299,3880,132,1208,2672,allow
53152,443,44569,443,16706,6162,10544,39,29,19,20,allow
52913,443,33752,443,50739,5508,45231,100,116,36,64,allow
49719,443,28042,443,4717,849,3868,15,52,7,8,allow
53079,443,11081,443,8233,5537,2696,40,84,21,19,allow
53192,443,46060,443,35788,2073,33715,54,21,20,34,allow
52857,443,23236,443,10234,2550,7684,47,139,23,24,allow
53164,443,1379,443,7434,1695,5739,23,27,12,11,allow
53140,443,40797,443,8349,1987,6362,23,30,12,11,allow
52853,80,51325,80,7502,3168,4334,41,140,22,19,allow
52959,443,64973,443,9257,2079,7178,39,113,19,20,allow
52891,443,27899,443,320255,9207,311048,343,117,107,236,allow
52866,80,44619,80,6022,2590,3432,37,131,20,17,allow
53198,443,2334,443,1462,965,497,13,18,7,6,allow
53186,443,23298,443,10332,2735,7597,36,21,17,19,allow
52961,443,6824,443,925322,25097,900225,971,113,287,684,allow
52956,443,14626,443,15659,3294,12365,60,114,25,35,allow
52970,443,47039,443,19221,5366,13855,88,113,36,52,allow
53159,443,33030,443,9711,3950,5761,38,28,22,16,allow
53094,443,6776,443,6726,3603,3123,34,80,17,17,allow
50968,443,54503,443,13683,6075,7608,58,5113,23,35,allow
50974,80,21113,80,1095989,7833,1088156,841,37,117,724,allow
49880,443,51797,443,1087632,32231,1055401,1112,53,334,778,allow
49868,443,19461,443,11578,2375,9203,47,55,22,25,allow
49856,443,10855,443,5512,978,4534,20,60,10,10,allow
49879,443,31980,443,6121,1042,5079,21,53,11,10,allow
64359,53,14911,53,196,102,94,2,30,1,1,allow
56524,53,26224,53,182,102,80,2,30,1,1,allow
55853,53,62979,53,228,110,118,2,30,1,1,allow
65361,53,62352,53,211,102,109,2,30,1,1,allow
64614,53,60972,53,168,86,82,2,31,1,1,allow
49855,443,64909,443,28887,9850,19037,96,60,41,55,allow
49871,443,47130,443,615040,25597,589443,704,54,245,459,allow
49829,443,43793,443,3026,1775,1251,23,74,14,9,allow
56364,443,28728,443,10427,6311,4116,33,234,20,13,allow
65432,53,33110,53,448,184,264,6,30,3,3,allow
56215,53,5017,53,216,110,106,2,30,1,1,allow
37297,443,18068,443,4514,1928,2586,17,240,8,9,allow
21133,59392,22505,59392,481,150,331,2,1199,1,1,allow
49961,53,9720,53,327,126,201,2,30,1,1,allow
50977,80,25806,80,1111949,11633,1100316,906,37,173,733,allow
52473,443,5513,443,1625,1038,587,14,28,8,6,allow
48252,443,55839,443,60300,47341,12959,192,39,108,84,allow
49671,443,7194,443,1485,940,545,13,57,7,6,allow
51685,80,11134,80,1516,481,1035,11,15,6,5,allow
54307,443,65534,443,5661,1444,4217,19,135,11,8,allow
56598,80,2431,80,234,234,0,4,12,4,0,allow
38171,443,40043,443,1649,980,669,14,28,7,7,allow
49725,443,45081,443,7162,780,6382,18,50,8,10,allow
53043,443,3283,443,11020,3760,7260,56,92,25,31,allow
52397,443,10007,443,9680,2399,7281,47,136,27,20,allow
52919,443,28761,443,7573,1986,5587,40,115,19,21,allow
53080,443,53725,443,108155,4527,103628,115,83,30,85,allow
52888,443,11223,443,12876,2739,10137,44,118,21,23,allow
52932,443,63575,443,13165,3626,9539,56,115,30,26,allow
52967,443,11017,443,9893,2231,7662,42,113,21,21,allow
53200,443,25558,443,1462,965,497,13,18,7,6,allow
52875,443,25381,443,89335,4699,84636,107,118,32,75,allow
52894,443,46843,443,5424,1445,3979,29,117,14,15,allow
52937,443,42865,443,22218,12408,9810,66,115,33,33,allow
53202,443,64942,443,3655,2344,1311,18,17,9,9,allow
29029,53,43871,53,323,77,246,4,30,2,2,allow
55081,53,46160,53,209,102,107,2,30,1,1,allow
57341,3389,57341,3389,3428,1714,1714,16,33,8,8,allow
49691,443,33512,443,1183,659,524,13,56,7,6,allow
49684,443,64157,443,9083,2300,6783,19,56,10,9,allow
50402,80,18324,80,5981,3589,2392,15,32,8,7,allow
53114,443,33125,443,15277,10027,5250,36,46,21,15,allow
52861,443,16498,443,3633587,34615,3598972,2964,137,514,2450,allow
52874,443,59388,443,392514,41757,350757,626,118,209,417,allow
52966,80,53251,80,2974,1352,1622,28,113,15,13,allow
53184,443,16399,443,13515,3057,10458,40,21,20,20,allow
52872,443,5601,443,110507,3940,106567,129,118,37,92,allow
53205,443,46818,443,3658,2347,1311,18,17,9,9,allow
53026,443,50319,443,14051,6332,7719,43,92,21,22,allow
65079,53,34794,53,272,94,178,2,30,1,1,allow
65049,53,16377,53,210,110,100,2,30,1,1,allow
49878,443,52783,443,5997,978,5019,19,53,10,9,allow
49841,443,32376,443,7084,1611,5473,29,71,15,14,allow
49840,443,9507,443,58656,12994,45662,148,71,64,84,allow
50403,53,9932,53,749,94,655,2,30,1,1,allow
56478,53,64286,53,200,102,98,2,30,1,1,allow
65218,53,47163,53,276,126,150,2,30,1,1,allow
49874,443,3516,443,6058,1037,5021,20,54,11,9,allow
49886,443,23328,443,7488,1598,5890,25,50,13,12,allow
45402,443,57057,443,7710,3375,4335,32,131,18,14,allow
56758,40000,5881,40000,70,70,0,1,5,1,0,allow
34990,80,31222,80,350,210,140,6,28,4,2,allow
49716,443,56032,443,4653,785,3868,14,52,6,8,allow
49717,443,52321,443,4876,855,4021,16,52,7,9,allow
53019,443,6559,443,30012,3461,26551,72,93,28,44,allow
53121,443,1605,443,10893,7149,3744,31,45,18,13,allow
53031,443,7092,443,16055,5856,10199,97,92,42,55,allow
52885,80,48034,80,5688,2508,3180,36,118,19,17,allow
53047,443,44730,443,13229,3527,9702,56,91,28,28,allow
53077,443,28917,443,6715,1415,5300,27,84,14,13,allow
36563,6851,45259,6851,7584,4075,3509,51,169,27,24,allow
52870,443,27625,443,113894,15573,98321,182,119,67,115,allow
52920,443,54361,443,31161,4934,26227,73,115,32,41,allow
49756,53,22675,53,243,118,125,2,30,1,1,allow
56881,53,21712,53,181,86,95,2,30,1,1,allow
49413,53,52444,53,231,110,121,2,30,1,1,allow
52989,443,57788,443,182945,23135,159810,191,111,63,128,allow
59988,443,59988,443,8589,2809,5780,30,16,15,15,allow
52428,80,60172,80,2516,1929,587,15,16,9,6,allow
56365,443,42336,443,4850,2997,1853,20,234,12,8,allow
56215,53,1097,53,216,110,106,2,30,1,1,allow
65127,53,45861,53,194,102,92,2,30,1,1,allow
56322,53,2088,53,209,110,99,2,30,1,1,allow
57074,53,27906,53,259,78,181,2,30,1,1,allow
49177,53,24852,53,184,94,90,2,30,1,1,allow
49627,53,57352,53,288,110,178,2,31,1,1,allow
64835,53,56147,53,200,102,98,2,31,1,1,allow
32299,40015,23096,40015,188,70,118,2,31,1,1,allow
5588,5588,0,0,3562,1936,1626,48,196,24,24,allow
64077,53,54964,53,199,94,105,2,30,1,1,allow
58981,443,5501,443,3155,836,2319,13,135,6,7,allow
57470,6881,59936,6881,132,132,0,3,1199,3,0,allow
6881,1564,62594,1564,324,150,174,2,1200,1,1,allow
57470,25089,59334,25089,132,132,0,3,1199,3,0,allow
52994,443,57845,443,10694,4129,6565,41,111,20,21,allow
52910,443,4102,443,179433,12614,166819,217,116,78,139,allow
52998,443,44367,443,22480,2705,19775,49,109,22,27,allow
56727,53,51350,53,250,86,164,4,54,2,2,allow
53029,443,57596,443,9246,1808,7438,35,92,17,18,allow
65056,53,43061,53,211,102,109,2,30,1,1,allow
41095,443,28178,443,108842,88940,19902,313,255,159,154,allow
52329,53,12571,53,294,86,208,2,30,1,1,allow
40682,443,13381,443,10010,4051,5959,32,346,17,15,allow
49897,443,33898,443,8586,1352,7234,27,34,13,14,allow
64814,53,5615,53,243,94,149,2,30,1,1,allow
56367,443,5869,443,4863,3011,1852,20,234,12,8,allow
64359,53,62943,53,196,102,94,2,30,1,1,allow
56617,53,16257,53,286,94,192,2,30,1,1,allow
55972,53,36064,53,193,102,91,2,30,1,1,allow
55559,53,59475,53,182,94,88,2,30,1,1,allow
65020,53,52884,53,289,102,187,2,30,1,1,allow
55951,53,63735,53,197,102,95,2,31,1,1,allow
59946,443,42319,443,11836,3531,8305,37,121,19,18,allow
60046,443,51072,443,8241,2346,5895,18,136,8,10,allow
47274,5223,2647,5223,4269,1451,2818,22,3002,13,9,allow
65277,53,17756,53,819,102,717,2,31,1,1,allow
55972,53,18787,53,193,102,91,2,31,1,1,allow
63945,53,11861,53,216,110,106,2,31,1,1,allow
60303,443,45517,443,7914400,166459,7747941,6839,775,1138,5701,allow
39615,443,10074,443,6133,1343,4790,22,275,12,10,allow
64742,53,40488,53,194,94,100,2,31,1,1,allow
57470,1,27948,1,132,132,0,3,1199,3,0,allow
57470,51413,17602,51413,330,330,0,6,1199,6,0,allow
57470,46501,13184,46501,132,132,0,3,1199,3,0,allow
50265,24387,12796,24387,132,132,0,3,1200,3,0,allow
50265,42698,16471,42698,726,726,0,12,1200,12,0,allow
58612,443,21355,443,154,94,60,2,5,1,1,allow
55759,445,0,0,70,70,0,1,0,1,0,drop
50699,445,0,0,70,70,0,1,0,1,0,drop
30114,65151,0,0,60,60,0,1,0,1,0,deny
43840,50265,0,0,72,72,0,1,0,1,0,deny
27328,21247,0,0,66,66,0,1,0,1,0,deny
44258,25,0,0,74,74,0,1,0,1,0,deny
54071,50265,0,0,66,66,0,1,0,1,0,deny
50692,445,0,0,70,70,0,1,0,1,0,drop
26792,37965,0,0,62,62,0,1,0,1,0,deny
42285,57470,0,0,62,62,0,1,0,1,0,deny
50689,445,0,0,70,70,0,1,0,1,0,drop
55746,445,0,0,70,70,0,1,0,1,0,drop
55745,445,0,0,70,70,0,1,0,1,0,drop
55743,445,0,0,70,70,0,1,0,1,0,drop
11136,15503,0,0,62,62,0,1,0,1,0,deny
50685,445,0,0,70,70,0,1,0,1,0,drop
50684,445,0,0,70,70,0,1,0,1,0,drop
4366,51505,0,0,62,62,0,1,0,1,0,deny
61865,35440,0,0,66,66,0,1,0,1,0,deny
53406,44847,0,0,66,66,0,1,0,1,0,deny
50680,445,0,0,70,70,0,1,0,1,0,drop
1042,64147,0,0,145,145,0,1,0,1,0,deny
51144,445,0,0,66,66,0,1,0,1,0,drop
55741,445,0,0,70,70,0,1,0,1,0,drop
55734,445,0,0,70,70,0,1,0,1,0,drop
50678,445,0,0,70,70,0,1,0,1,0,drop
50386,22114,0,0,62,62,0,1,0,1,0,deny
1027,65473,0,0,159,159,0,1,0,1,0,deny
36945,23,0,0,60,60,0,1,0,1,0,deny
22683,39210,0,0,60,60,0,1,0,1,0,deny
50081,57470,0,0,66,66,0,1,0,1,0,deny
2467,2767,0,0,66,66,0,1,0,1,0,deny
25412,23,0,0,60,60,0,1,0,1,0,deny
51137,445,0,0,66,66,0,1,0,1,0,drop
50674,445,0,0,70,70,0,1,0,1,0,drop
37042,48983,0,0,159,159,0,1,0,1,0,deny
2919,57866,0,0,62,62,0,1,0,1,0,deny
51134,445,0,0,66,66,0,1,0,1,0,drop
25739,64147,0,0,62,62,0,1,0,1,0,deny
55731,445,0,0,70,70,0,1,0,1,0,drop
62787,51221,0,0,66,66,0,1,0,1,0,deny
62632,35440,0,0,66,66,0,1,0,1,0,deny
55726,445,0,0,70,70,0,1,0,1,0,drop
55724,445,0,0,70,70,0,1,0,1,0,drop
55721,445,0,0,70,70,0,1,0,1,0,drop
51132,445,0,0,66,66,0,1,0,1,0,drop
17070,48817,0,0,140,140,0,1,0,1,0,deny
31136,50584,0,0,62,62,0,1,0,1,0,deny
39480,8055,0,0,148,148,0,1,0,1,0,deny
6057,51221,0,0,78,78,0,1,0,1,0,deny
61566,44847,0,0,66,66,0,1,0,1,0,deny
55714,445,0,0,70,70,0,1,0,1,0,drop
15793,64147,0,0,66,66,0,1,0,1,0,deny
55712,445,0,0,70,70,0,1,0,1,0,drop
55710,445,0,0,70,70,0,1,0,1,0,drop
55708,445,0,0,70,70,0,1,0,1,0,drop
50661,445,0,0,70,70,0,1,0,1,0,drop
51125,445,0,0,66,66,0,1,0,1,0,drop
60894,50584,0,0,66,66,0,1,0,1,0,deny
63331,51221,0,0,62,62,0,1,0,1,0,deny
2182,57354,0,0,145,145,0,1,0,1,0,deny
51121,445,0,0,66,66,0,1,0,1,0,drop
51117,445,0,0,66,66,0,1,0,1,0,drop
51120,445,0,0,66,66,0,1,0,1,0,drop
51114,445,0,0,66,66,0,1,0,1,0,drop
51113,445,0,0,66,66,0,1,0,1,0,drop
51112,445,0,0,66,66,0,1,0,1,0,drop
50658,445,0,0,70,70,0,1,0,1,0,drop
62696,50584,0,0,66,66,0,1,0,1,0,deny
58318,15503,0,0,66,66,0,1,0,1,0,deny
17760,50584,0,0,62,62,0,1,0,1,0,deny
33822,57470,0,0,66,66,0,1,0,1,0,deny
55707,445,0,0,70,70,0,1,0,1,0,drop
55705,445,0,0,70,70,0,1,0,1,0,drop
55703,445,0,0,70,70,0,1,0,1,0,drop
58326,50584,0,0,146,146,0,1,0,1,0,deny
51110,445,0,0,66,66,0,1,0,1,0,drop
55699,445,0,0,70,70,0,1,0,1,0,drop
50653,445,0,0,70,70,0,1,0,1,0,drop
51106,445,0,0,66,66,0,1,0,1,0,drop
50652,445,0,0,70,70,0,1,0,1,0,drop
51105,445,0,0,66,66,0,1,0,1,0,drop
51104,445,0,0,66,66,0,1,0,1,0,drop
50650,445,0,0,70,70,0,1,0,1,0,drop
0,0,0,0,320,320,0,5,0,5,0,allow
51101,445,0,0,66,66,0,1,0,1,0,drop
50116,22,0,0,60,60,0,1,0,1,0,deny
43129,20220,0,0,62,62,0,1,0,1,0,deny
55694,445,0,0,70,70,0,1,0,1,0,drop
45908,3383,0,0,60,60,0,1,0,1,0,deny
52459,33890,0,0,60,60,0,1,0,1,0,deny
6881,9074,0,0,143,143,0,1,0,1,0,deny
55685,445,0,0,70,70,0,1,0,1,0,drop
55684,445,0,0,70,70,0,1,0,1,0,drop
50643,445,0,0,70,70,0,1,0,1,0,drop
45941,23386,0,0,60,60,0,1,0,1,0,deny
50641,445,0,0,70,70,0,1,0,1,0,drop
51092,445,0,0,66,66,0,1,0,1,0,drop
49818,37965,0,0,62,62,0,1,0,1,0,deny
26198,64147,0,0,62,62,0,1,0,1,0,deny
13188,35440,0,0,66,66,0,1,0,1,0,deny
50640,445,0,0,70,70,0,1,0,1,0,drop
50639,445,0,0,70,70,0,1,0,1,0,drop
50638,445,0,0,70,70,0,1,0,1,0,drop
50635,445,0,0,70,70,0,1,0,1,0,drop
50632,445,0,0,70,70,0,1,0,1,0,drop
51083,445,0,0,66,66,0,1,0,1,0,drop
16948,990,0,0,60,60,0,1,0,1,0,deny
55672,445,0,0,70,70,0,1,0,1,0,drop
33457,27015,0,0,67,67,0,1,0,1,0,deny
55878,7302,0,0,62,62,0,1,0,1,0,deny
1446,35440,0,0,62,62,0,1,0,1,0,deny
50620,445,0,0,70,70,0,1,0,1,0,drop
50619,445,0,0,70,70,0,1,0,1,0,drop
50613,445,0,0,70,70,0,1,0,1,0,drop
63864,23,0,0,60,60,0,1,0,1,0,deny
63925,37965,0,0,66,66,0,1,0,1,0,deny
1873,37965,0,0,62,62,0,1,0,1,0,deny
63433,57866,0,0,66,66,0,1,0,1,0,deny
51080,445,0,0,66,66,0,1,0,1,0,drop
50610,445,0,0,70,70,0,1,0,1,0,drop
50609,445,0,0,70,70,0,1,0,1,0,drop
51073,445,0,0,66,66,0,1,0,1,0,drop
2995,26467,0,0,62,62,0,1,0,1,0,deny
123,123,15561,123,184,94,90,2,30,1,1,allow
64614,53,55255,53,168,86,82,2,30,1,1,allow
56117,53,10364,53,757,98,659,2,30,1,1,allow
55479,53,3977,53,789,110,679,2,30,1,1,allow
43095,443,16830,443,3067,1817,1250,18,16,8,10,allow
52089,443,15915,443,6032,3616,2416,39,187,20,19,allow
61399,80,3299,80,5518,527,4991,13,75,6,7,allow
56755,31774,8678,31774,378,192,186,7,15,4,3,allow
45377,443,49244,443,5291,3987,1304,19,255,11,8,allow
51719,13715,9141,13715,66,66,0,1,5,1,0,allow
64756,53,24462,53,757,98,659,2,30,1,1,allow
52933,80,52933,80,98765,5293,93472,131,199,48,83,allow
63720,55027,38364,55027,1233,902,331,12,17,8,4,allow
54853,443,64447,443,7689,3574,4115,65,308,32,33,allow
61397,80,22347,80,2500,531,1969,11,75,6,5,allow
38807,443,45968,443,99092,3694,95398,115,170,43,72,allow
50537,5223,31982,5223,12710,4688,8022,44,2961,19,25,allow
57108,53,22880,53,186,95,91,2,30,1,1,allow
55972,53,10428,53,186,95,91,2,30,1,1,allow
45937,443,35765,443,4592,697,3895,14,25,8,6,allow
53546,17203,56777,17203,320,140,180,6,7,3,3,allow
51717,63436,58721,63436,66,66,0,1,5,1,0,allow
50807,443,17833,443,9328,1709,7619,18,139,8,10,allow
57594,443,61887,443,291,171,120,4,15,2,2,allow
44036,443,28418,443,6599,3950,2649,36,186,20,16,allow
56617,3389,56617,3389,3425,1470,1955,16,17,8,8,allow
51718,55003,59957,55003,66,66,0,1,5,1,0,allow
61398,80,45091,80,2425,529,1896,11,75,6,5,allow
23228,443,23228,443,20540,5514,15026,52,76,29,23,allow
5588,5588,0,0,3498,1872,1626,48,200,24,24,allow
50061,443,9312,443,7199,2528,4671,18,76,10,8,allow
48965,443,50088,443,9519,4377,5142,33,354,17,16,allow
22452,443,22452,443,5785,2575,3210,24,76,14,10,allow
53545,27700,24861,27700,320,140,180,6,7,3,3,allow
63808,53,2452,53,578,286,292,9,15,5,4,allow
38809,443,49064,443,79659,3269,76390,96,170,37,59,allow
37570,443,53443,443,986,499,487,9,17,5,4,allow
64835,53,1399,53,200,102,98,2,30,1,1,allow
56243,53,64458,53,762,101,661,2,30,1,1,allow
55559,53,26431,53,180,92,88,2,30,1,1,allow
50870,5228,4125,5228,7069,1804,5265,20,3602,11,9,allow
16387,29288,0,0,60,60,0,1,61,1,0,allow
16387,64374,0,0,60,60,0,1,61,1,0,allow
16387,25523,0,0,60,60,0,1,61,1,0,allow
65460,53,42143,53,194,99,95,2,31,1,1,allow
51066,445,0,0,66,66,0,1,0,1,0,drop
1025,64147,0,0,62,62,0,1,0,1,0,deny
443,43775,0,0,97,97,0,1,0,1,0,deny
49418,57470,0,0,62,62,0,1,0,1,0,deny
62673,34159,0,0,66,66,0,1,0,1,0,deny
46495,4607,0,0,60,60,0,1,0,1,0,deny
56296,53,43298,53,216,110,106,2,30,1,1,allow
50582,53,45109,53,216,110,106,2,30,1,1,allow
65277,53,20067,53,196,102,94,2,30,1,1,allow
65127,53,38412,53,194,102,92,2,30,1,1,allow
50119,443,16718,443,15168,5689,9479,51,34,27,24,allow
49160,28890,3522,28890,830,150,680,4,1200,2,2,allow
57122,53,32018,53,216,110,106,2,30,1,1,allow
50120,443,54666,443,29503,9695,19808,55,34,30,25,allow
49364,53,61563,53,182,94,88,2,30,1,1,allow
49769,443,1740,443,13455,1982,11473,29,31,16,13,allow
56897,7003,14885,7003,1098,672,426,14,734,8,6,allow
64950,53,11191,53,326,88,238,4,52,2,2,allow
65460,53,26483,53,197,102,95,2,30,1,1,allow
51716,57137,20087,57137,70,70,0,1,5,1,0,allow
51720,51388,35731,51388,70,70,0,1,5,1,0,allow
49364,53,40148,53,182,94,88,2,30,1,1,allow
57108,53,35898,53,193,102,91,2,30,1,1,allow
55824,53,60939,53,819,102,717,2,30,1,1,allow
64614,53,52648,53,168,86,82,2,31,1,1,allow
36448,80,28179,80,1325,336,989,10,15,5,5,allow
51734,59825,40402,59825,70,70,0,2,8,2,0,allow
60385,59696,28455,59696,70,70,0,2,8,2,0,allow
34155,443,36605,443,154,94,60,2,5,1,1,allow
23270,443,23270,443,5802,2592,3210,24,76,14,10,allow
60382,62582,18649,62582,70,70,0,2,8,2,0,allow
56435,53,21877,53,193,102,91,2,30,1,1,allow
40804,8434,40804,8434,156,156,0,3,8,3,0,allow
64580,53,23762,53,199,102,97,2,30,1,1,allow
35666,443,50206,443,3389452,85022,3304430,3290,159,997,2293,allow
55824,53,12441,53,196,102,94,2,30,1,1,allow
57108,53,37838,53,193,102,91,2,30,1,1,allow
19840,7000,19840,7000,3610,2043,1567,16,17,9,7,allow
56234,443,33837,443,8971,2446,6525,50,347,23,27,allow
65134,53,31124,53,229,110,119,2,30,1,1,allow
36924,53,36924,53,257,106,151,2,30,1,1,allow
57122,53,3566,53,216,110,106,2,30,1,1,allow
65403,53,24512,53,249,102,147,2,30,1,1,allow
50561,53,34475,53,763,102,661,2,30,1,1,allow
63582,443,11318,443,6178,1669,4509,19,15,11,8,allow
50969,80,54293,80,921711,12229,909482,780,37,172,608,allow
52489,443,60427,443,32975,9028,23947,39,15,18,21,allow
60744,40010,53059,40010,316,136,180,6,5,3,3,allow
60381,26312,6064,26312,70,70,0,2,8,2,0,allow
48016,443,47269,443,138,78,60,2,5,1,1,allow
60306,443,28741,443,9188,3421,5767,43,83,19,24,allow
50973,80,49428,80,1095221,7065,1088156,829,36,105,724,allow
60380,55125,53805,55125,70,70,0,2,8,2,0,allow
53156,51689,64576,51689,546,306,240,9,142,5,4,allow
53541,59939,24806,59939,70,70,0,2,7,2,0,allow
37523,443,28556,443,154,94,60,2,4,1,1,allow
22352,443,22352,443,6899,3403,3496,27,76,16,11,allow
51733,30688,48958,30688,70,70,0,2,8,2,0,allow
57416,66,17429,66,70,70,0,2,7,2,0,allow
56712,53,4721,53,448,184,264,6,29,3,3,allow
50572,80,46272,80,62,62,0,1,5,1,0,allow
64968,53,11604,53,448,98,350,4,41,2,2,allow
52849,443,32844,443,7735,1260,6475,16,133,7,9,allow
65123,53,24943,53,307,110,197,2,29,1,1,allow
23276,443,23276,443,4668,1745,2923,21,76,12,9,allow
55559,53,16251,53,182,94,88,2,30,1,1,allow
49177,53,27104,53,184,94,90,2,30,1,1,allow
55559,53,6941,53,182,94,88,2,29,1,1,allow
55017,53,20456,53,288,110,178,2,29,1,1,allow
64580,53,13673,53,199,102,97,2,30,1,1,allow
57108,53,1595,53,193,102,91,2,30,1,1,allow
56322,53,24189,53,209,110,99,2,30,1,1,allow
64835,53,60535,53,200,102,98,2,31,1,1,allow
60047,443,20320,443,229060,38515,190545,283,135,113,170,allow
52155,80,42520,80,1056,682,374,10,15,6,4,allow
56862,53,7245,53,198,94,104,2,30,1,1,allow
49364,53,15202,53,182,94,88,2,30,1,1,allow
56829,53,48980,53,199,102,97,2,30,1,1,allow
33048,443,57285,443,90054,6681,83373,104,133,33,71,allow
49168,443,13690,443,519325,13798,505527,535,18,193,342,allow
55342,443,55342,443,5593,2346,3247,22,39,13,9,allow
49648,7275,24792,7275,8962,1625,7337,28,16,15,13,allow
48632,443,58774,443,12433,4515,7918,32,136,17,15,allow
48631,443,20403,443,42910,5005,37905,72,136,36,36,allow
50582,53,14787,53,216,110,106,2,30,1,1,allow
57330,53,31519,53,228,94,134,2,30,1,1,allow
65049,443,55584,443,12674,1396,11278,12,139,2,10,allow
17750,30022,45838,30022,481,150,331,2,1200,1,1,allow
51732,54299,27558,54299,70,70,0,2,8,2,0,allow
64586,80,64586,80,123115,6863,116252,160,29,76,84,allow
56435,53,33982,53,193,102,91,2,30,1,1,allow
64615,53,40640,53,198,94,104,2,30,1,1,allow
56829,53,59229,53,199,102,97,2,30,1,1,allow
55535,53,57254,53,199,102,97,2,30,1,1,allow
58082,443,14473,443,45314943,1391230,43923713,47149,303,15196,31953,allow
49249,443,43033,443,35406,17785,17621,79,141,40,39,allow
55535,53,2360,53,199,102,97,2,31,1,1,allow
50265,6881,13047,6881,491,150,341,2,1200,1,1,allow
50008,53,47667,53,193,102,91,2,31,1,1,allow
63733,47013,45780,47013,66,66,0,2,8,2,0,allow
48408,443,3268,443,115036,11567,103469,189,103,92,97,allow
64357,53,38839,53,469,103,366,4,43,2,2,allow
43078,80,13694,80,1052,612,440,10,15,5,5,allow
50971,80,41640,80,1094437,6233,1088204,817,36,92,725,allow
63945,53,38413,53,216,110,106,2,30,1,1,allow
27999,443,45047,443,5577,1390,4187,19,15,9,10,allow
61676,443,64478,443,6353,1520,4833,20,17,12,8,allow
60900,443,23820,443,134,60,74,3,6,2,1,allow
45540,8100,25472,8100,234,234,0,4,12,4,0,allow
64659,53,14647,53,464,99,365,4,39,2,2,allow
45227,80,43141,80,1114,534,580,12,16,7,5,allow
43175,53,11498,53,194,86,108,2,30,1,1,allow
50598,445,0,0,70,70,0,1,0,1,0,drop
25565,55690,0,0,60,60,0,1,0,1,0,deny
52668,51221,0,0,66,66,0,1,0,1,0,deny
55664,445,0,0,70,70,0,1,0,1,0,drop
55660,445,0,0,70,70,0,1,0,1,0,drop
55659,445,0,0,70,70,0,1,0,1,0,drop
51948,37965,0,0,62,62,0,1,0,1,0,deny
51052,445,0,0,66,66,0,1,0,1,0,drop
51054,445,0,0,66,66,0,1,0,1,0,drop
51057,445,0,0,66,66,0,1,0,1,0,drop
51051,445,0,0,66,66,0,1,0,1,0,drop
51058,445,0,0,66,66,0,1,0,1,0,drop
51055,445,0,0,66,66,0,1,0,1,0,drop
51056,445,0,0,66,66,0,1,0,1,0,drop
51050,445,0,0,66,66,0,1,0,1,0,drop
5180,57866,0,0,66,66,0,1,0,1,0,deny
48544,44847,0,0,146,146,0,1,0,1,0,deny
49501,11392,0,0,66,66,0,1,0,1,0,deny
57896,1,0,0,100,100,0,1,0,1,0,deny
55618,56205,0,0,66,66,0,1,0,1,0,deny
29706,50584,0,0,66,66,0,1,0,1,0,deny
5121,35440,0,0,62,62,0,1,0,1,0,deny
25151,58833,0,0,62,62,0,1,0,1,0,deny
50594,445,0,0,70,70,0,1,0,1,0,drop
56564,9571,0,0,78,78,0,1,0,1,0,deny
44933,26467,0,0,62,62,0,1,0,1,0,deny
28584,37965,0,0,62,62,0,1,0,1,0,deny
41836,23,0,0,60,60,0,1,0,1,0,deny
47910,7454,0,0,60,60,0,1,0,1,0,deny
9471,23,0,0,60,60,0,1,0,1,0,deny
50583,445,0,0,70,70,0,1,0,1,0,drop
50585,445,0,0,70,70,0,1,0,1,0,drop
6889,47807,0,0,143,143,0,1,0,1,0,deny
50581,445,0,0,70,70,0,1,0,1,0,drop
50579,445,0,0,70,70,0,1,0,1,0,drop
62148,37965,0,0,62,62,0,1,0,1,0,deny
50578,445,0,0,70,70,0,1,0,1,0,drop
1025,35447,0,0,62,62,0,1,0,1,0,deny
55654,445,0,0,70,70,0,1,0,1,0,drop
55649,445,0,0,70,70,0,1,0,1,0,drop
55644,445,0,0,70,70,0,1,0,1,0,drop
44318,51180,0,0,74,74,0,1,0,1,0,deny
51038,445,0,0,66,66,0,1,0,1,0,drop
51037,445,0,0,66,66,0,1,0,1,0,drop
51035,445,0,0,66,66,0,1,0,1,0,drop
26379,23,0,0,60,60,0,1,0,1,0,deny
6980,48543,0,0,139,139,0,1,0,1,0,deny
20389,64147,0,0,66,66,0,1,0,1,0,deny
55641,445,0,0,70,70,0,1,0,1,0,drop
11404,64147,0,0,62,62,0,1,0,1,0,deny
64000,44847,0,0,66,66,0,1,0,1,0,deny
60246,44612,0,0,66,66,0,1,0,1,0,deny
11136,15503,0,0,145,145,0,1,0,1,0,deny
11136,17500,0,0,62,62,0,1,0,1,0,deny
11136,57587,0,0,62,62,0,1,0,1,0,deny
55639,445,0,0,70,70,0,1,0,1,0,drop
50572,445,0,0,70,70,0,1,0,1,0,drop
28832,36237,0,0,66,66,0,1,0,1,0,deny
55635,445,0,0,70,70,0,1,0,1,0,drop
55634,445,0,0,70,70,0,1,0,1,0,drop
55632,445,0,0,70,70,0,1,0,1,0,drop
30923,12883,0,0,157,157,0,1,0,1,0,deny
57837,64147,0,0,66,66,0,1,0,1,0,deny
50564,445,0,0,70,70,0,1,0,1,0,drop
50563,445,0,0,70,70,0,1,0,1,0,drop
59597,37965,0,0,66,66,0,1,0,1,0,deny
5223,44091,0,0,220,220,0,1,0,1,0,deny
50558,445,0,0,70,70,0,1,0,1,0,drop
6975,29028,0,0,139,139,0,1,0,1,0,deny
55621,445,0,0,70,70,0,1,0,1,0,drop
55619,445,0,0,70,70,0,1,0,1,0,drop
55615,445,0,0,70,70,0,1,0,1,0,deny
6975,26543,0,0,139,139,0,1,0,1,0,deny
50556,445,0,0,70,70,0,1,0,1,0,drop
5637,37965,0,0,62,62,0,1,0,1,0,deny
58486,57470,0,0,66,66,0,1,0,1,0,deny
38681,15503,0,0,74,74,0,1,0,1,0,deny
9756,26467,0,0,62,62,0,1,0,1,0,deny
50052,65008,0,0,60,60,0,1,0,1,0,deny
50552,445,0,0,70,70,0,1,0,1,0,drop
51963,22114,0,0,66,66,0,1,0,1,0,deny
4041,50584,0,0,62,62,0,1,0,1,0,deny
58849,64147,0,0,66,66,0,1,0,1,0,deny
51085,56205,0,0,66,66,0,1,0,1,0,deny
42075,36237,0,0,62,62,0,1,0,1,0,deny
50551,445,0,0,70,70,0,1,0,1,0,drop
65016,37965,0,0,66,66,0,1,0,1,0,deny
51014,445,0,0,66,66,0,1,0,1,0,drop
42252,33303,0,0,60,60,0,1,0,1,0,deny
24504,37965,0,0,62,62,0,1,0,1,0,deny
55613,445,0,0,70,70,0,1,0,1,0,drop
55606,445,0,0,70,70,0,1,0,1,0,drop
60184,37965,0,0,66,66,0,1,0,1,0,deny
3352,50584,0,0,66,66,0,1,0,1,0,deny
50546,445,0,0,70,70,0,1,0,1,0,drop
3052,20421,0,0,104,104,0,1,0,1,0,deny
21998,51221,0,0,62,62,0,1,0,1,0,deny
51009,445,0,0,66,66,0,1,0,1,0,drop
61148,37965,0,0,66,66,0,1,0,1,0,deny
42917,52952,0,0,62,62,0,1,0,1,0,deny
51006,445,0,0,66,66,0,1,0,1,0,drop
55601,445,0,0,70,70,0,1,0,1,0,drop
55595,445,0,0,70,70,0,1,0,1,0,drop
55591,445,0,0,70,70,0,1,0,1,0,drop
55592,445,0,0,70,70,0,1,0,1,0,drop
52788,64147,0,0,66,66,0,1,0,1,0,deny
51004,445,0,0,66,66,0,1,0,1,0,drop
55966,57866,0,0,66,66,0,1,0,1,0,deny
36538,64147,0,0,62,62,0,1,0,1,0,deny
53927,64147,0,0,66,66,0,1,0,1,0,deny
11136,15503,0,0,62,62,0,1,0,1,0,deny
5661,37965,0,0,62,62,0,1,0,1,0,deny
52934,26467,0,0,66,66,0,1,0,1,0,deny
9532,56205,0,0,146,146,0,1,0,1,0,deny
56793,53,56695,53,192,98,94,2,0,1,1,allow
50533,445,0,0,70,70,0,1,0,1,0,drop
55586,445,0,0,70,70,0,1,0,1,0,drop
49711,14984,0,0,66,66,0,1,0,1,0,deny
5200,6643,0,0,145,145,0,1,0,1,0,deny
52328,44847,0,0,62,62,0,1,0,1,0,deny
51339,50584,0,0,66,66,0,1,0,1,0,deny
55584,445,0,0,70,70,0,1,0,1,0,drop
55582,445,0,0,70,70,0,1,0,1,0,drop
55580,445,0,0,70,70,0,1,0,1,0,drop
50995,445,0,0,66,66,0,1,0,1,0,deny
9265,37965,0,0,62,62,0,1,0,1,0,deny
50530,445,0,0,70,70,0,1,0,1,0,drop
50994,445,0,0,66,66,0,1,0,1,0,drop
50993,445,0,0,66,66,0,1,0,1,0,drop
50989,445,0,0,66,66,0,1,0,1,0,drop
33822,57470,0,0,66,66,0,1,0,1,0,deny
50987,445,0,0,66,66,0,1,0,1,0,drop
50985,445,0,0,66,66,0,1,0,1,0,drop
50984,445,0,0,66,66,0,1,0,1,0,drop
52690,7302,0,0,66,66,0,1,0,1,0,deny
57954,48817,0,0,78,78,0,1,0,1,0,deny
51353,46314,0,0,145,145,0,1,0,1,0,deny
15056,2222,0,0,60,60,0,1,0,1,0,deny
57360,18375,0,0,66,66,0,1,0,1,0,deny
443,10010,0,0,60,60,0,1,0,1,0,deny
50525,445,0,0,70,70,0,1,0,1,0,drop
19367,35440,0,0,146,146,0,1,0,1,0,deny
55578,445,0,0,70,70,0,1,0,1,0,drop
55572,445,0,0,70,70,0,1,0,1,0,drop
55573,445,0,0,70,70,0,1,0,1,0,drop
50524,445,0,0,70,70,0,1,0,1,0,drop
50982,445,0,0,66,66,0,1,0,1,0,drop
55571,445,0,0,70,70,0,1,0,1,0,drop
40898,5555,0,0,60,60,0,1,0,1,0,deny
50979,445,0,0,66,66,0,1,0,1,0,drop
1028,64147,0,0,62,62,0,1,0,1,0,deny
50522,445,0,0,70,70,0,1,0,1,0,drop
11552,44847,0,0,62,62,0,1,0,1,0,deny
50977,445,0,0,66,66,0,1,0,1,0,drop
50975,445,0,0,66,66,0,1,0,1,0,drop
53957,35440,0,0,62,62,0,1,0,1,0,deny
14255,2767,0,0,62,62,0,1,0,1,0,deny
50973,445,0,0,66,66,0,1,0,1,0,drop
53960,30041,0,0,66,66,0,1,0,1,0,deny
49502,44847,0,0,66,66,0,1,0,1,0,deny
7307,23,0,0,60,60,0,1,0,1,0,deny
55566,445,0,0,70,70,0,1,0,1,0,drop
32051,37965,0,0,62,62,0,1,0,1,0,deny
50515,445,0,0,70,70,0,1,0,1,0,drop
46389,27098,0,0,66,66,0,1,0,1,0,deny
45964,55559,0,0,60,60,0,1,0,1,0,deny
55559,445,0,0,70,70,0,1,0,1,0,drop
55554,445,0,0,70,70,0,1,0,1,0,drop
35347,20238,0,0,66,66,0,1,0,1,0,deny
50513,445,0,0,70,70,0,1,0,1,0,drop
7377,57470,0,0,62,62,0,1,0,1,0,deny
54165,443,54165,443,147750,13521,134229,182,92,84,98,allow
23406,443,23406,443,5368,1609,3759,21,75,12,9,allow
58520,443,24680,443,9429,3621,5808,60,80,26,34,allow
53912,3478,60537,3478,3532,1792,1740,58,88,29,29,allow
65114,53,35237,53,192,98,94,2,30,1,1,allow
60272,443,24375,443,1853,1214,639,18,87,11,7,allow
54887,443,54887,443,5573,2326,3247,22,40,13,9,allow
65154,443,37170,443,5753,3034,2719,52,281,25,27,allow
50967,443,62336,443,5841,1986,3855,19,17,11,8,allow
62306,443,62306,443,5442,2195,3247,22,39,13,9,allow
60387,32087,24462,32087,320,140,180,6,7,3,3,allow
63166,443,63166,443,5407,2160,3247,22,38,13,9,allow
53436,443,59367,443,7941,2678,5263,25,122,12,13,allow
64289,53,24247,53,198,101,97,2,30,1,1,allow
50387,443,41513,443,8507,1945,6562,21,33,10,11,allow
58884,15000,25949,15000,138,78,60,2,5,1,1,allow
59395,443,39581,443,5817,1995,3822,19,16,10,9,allow
53109,41661,38343,41661,320,140,180,6,8,3,3,allow
37965,24475,30249,24475,480,149,331,2,1200,1,1,allow
52173,443,52173,443,201007,10015,190992,239,22,100,139,allow
64600,80,64600,80,98859,6426,92433,136,27,68,68,allow
49430,443,47050,443,18859,5795,13064,62,3666,28,34,allow
49660,53,64845,53,186,95,91,2,30,1,1,allow
50172,443,51694,443,3756,1914,1842,19,361,9,10,allow
57547,80,39933,80,32368,2187,30181,45,337,23,22,allow
46477,443,29699,443,4900,904,3996,16,97,9,7,allow
46478,443,23649,443,493,280,213,8,97,5,3,allow
65176,53,13076,53,299,103,196,4,51,2,2,allow
41624,15000,41127,15000,130,70,60,2,5,1,1,allow
50008,53,29808,53,186,95,91,2,30,1,1,allow
49154,80,61897,80,2438,565,1873,10,75,6,4,allow
63403,443,54530,443,4470,1597,2873,16,138,8,8,allow
49866,443,40314,443,2937,717,2220,14,136,6,8,allow
30960,45676,24387,45676,396,396,0,7,3616,7,0,allow
53151,29500,62396,29500,514,274,240,8,143,4,4,allow
64926,53,43197,53,192,98,94,2,40,1,1,allow
50012,7000,50012,7000,3132,815,2317,14,16,7,7,allow
51731,39392,6820,39392,70,70,0,2,8,2,0,allow
51709,40705,29645,40705,66,66,0,1,5,1,0,allow
59396,443,16679,443,5801,1995,3806,19,16,10,9,allow
55535,53,31917,53,198,101,97,2,30,1,1,allow
52174,443,52174,443,55503,7279,48224,79,22,32,47,allow
60271,443,5474,443,10324,8406,1918,44,87,26,18,allow
65201,53,7188,53,216,110,106,2,30,1,1,allow
55090,53,47013,53,192,98,94,2,30,1,1,allow
54387,5228,7370,5228,7019,1592,5427,25,3600,14,11,allow
56296,53,27962,53,216,110,106,2,30,1,1,allow
59649,443,47146,443,11784,7785,3999,55,120,28,27,allow
38603,5228,52662,5228,3534,1679,1855,30,3640,11,19,allow
50965,445,0,0,66,66,0,1,0,1,0,drop
50512,445,0,0,70,70,0,1,0,1,0,drop
39100,2767,0,0,62,62,0,1,0,1,0,deny
50511,445,0,0,70,70,0,1,0,1,0,drop
50510,445,0,0,70,70,0,1,0,1,0,drop
50507,445,0,0,70,70,0,1,0,1,0,drop
50506,445,0,0,70,70,0,1,0,1,0,drop
55142,26467,0,0,62,62,0,1,0,1,0,deny
17777,30188,0,0,62,62,0,1,0,1,0,deny
10965,22114,0,0,62,62,0,1,0,1,0,deny
10965,22114,0,0,146,146,0,1,0,1,0,deny
50955,445,0,0,66,66,0,1,0,1,0,drop
65201,53,5294,53,216,110,106,2,30,1,1,allow
62331,61689,0,0,66,66,0,1,0,1,0,deny
55543,445,0,0,70,70,0,1,0,1,0,drop
53233,51221,0,0,66,66,0,1,0,1,0,deny
50492,445,0,0,70,70,0,1,0,1,0,drop
50490,445,0,0,70,70,0,1,0,1,0,drop
50485,445,0,0,70,70,0,1,0,1,0,drop
50482,445,0,0,70,70,0,1,0,1,0,drop
50481,445,0,0,70,70,0,1,0,1,0,drop
38363,5900,0,0,60,60,0,1,0,1,0,deny
50953,445,0,0,66,66,0,1,0,1,0,drop
45912,44847,0,0,62,62,0,1,0,1,0,deny
50945,445,0,0,66,66,0,1,0,1,0,drop
56973,443,44291,443,7481,2264,5217,22,135,10,12,allow
64869,443,59977,443,6454,1227,5227,18,122,9,9,allow
52916,443,43880,443,5455,1388,4067,17,15,9,8,allow
44633,443,21223,443,5715,1536,4179,24,16,13,11,allow
50869,80,23647,80,28291,3346,24945,46,144,25,21,allow
53540,34134,43313,34134,70,70,0,2,7,2,0,allow
37987,49152,22842,49152,156,156,0,3,7,3,0,allow
41995,80,63213,80,1105,634,471,11,15,6,5,allow
52171,443,52171,443,154883,8710,146173,182,23,69,113,allow
55535,53,24278,53,199,102,97,2,29,1,1,allow
56322,53,19228,53,209,110,99,2,29,1,1,allow
50008,53,33522,53,193,102,91,2,29,1,1,allow
56615,443,6112,443,22938,14436,8502,43,41,23,20,allow
47856,443,54908,443,7816,2371,5445,34,255,18,16,allow
63734,28221,59198,28221,66,66,0,2,7,2,0,allow
63732,40642,31051,40642,66,66,0,2,7,2,0,allow
53536,34200,55904,34200,70,70,0,2,7,2,0,allow
46641,8100,62793,8100,234,234,0,4,11,4,0,allow
39953,80,18059,80,1035,564,471,10,15,5,5,allow
48015,443,20608,443,138,78,60,2,4,1,1,allow
55972,53,35969,53,193,102,91,2,29,1,1,allow
55090,53,34414,53,196,102,94,2,29,1,1,allow
55090,53,59676,53,196,102,94,2,29,1,1,allow
56296,53,37666,53,216,110,106,2,30,1,1,allow
53041,443,62358,443,2881,346,2535,12,120,5,7,allow
17735,53,27345,53,223,86,137,2,29,1,1,allow
64835,53,33008,53,200,102,98,2,29,1,1,allow
56296,53,12716,53,216,110,106,2,29,1,1,allow
57455,123,24910,123,184,94,90,2,29,1,1,allow
55090,53,17815,53,196,102,94,2,30,1,1,allow
56597,80,61984,80,234,234,0,4,12,4,0,allow
51712,53203,62336,53203,70,70,0,1,5,1,0,allow
51710,43069,28929,43069,70,70,0,1,5,1,0,allow
53106,59478,22060,59478,70,70,0,1,5,1,0,allow
49413,443,7382,443,44505,6962,37543,64,48,21,43,allow
65114,53,28927,53,196,102,94,2,30,1,1,allow
49173,27402,64212,27402,70,70,0,1,5,1,0,allow
56764,45797,41990,45797,164,70,94,2,5,1,1,allow
47975,443,46443,443,8301,2172,6129,25,255,12,13,allow
60942,443,40230,443,5081,896,4185,16,70,8,8,allow
65208,53,46888,53,637,178,459,6,70,3,3,allow
56847,443,59529,443,35160,6404,28756,82,196,31,51,allow
46550,443,33261,443,7330,4420,2910,31,316,16,15,allow
34994,443,34994,443,5046,2069,2977,20,15,11,9,allow
37234,53,61804,53,168,78,90,2,30,1,1,allow
52176,443,52176,443,126525,6370,120155,147,22,56,91,allow
50008,53,59037,53,359,95,264,4,46,2,2,allow
63964,53,52901,53,196,94,102,2,30,1,1,allow
57780,53,53500,53,70,70,0,1,30,1,0,allow
6881,6881,26370,6881,502,150,352,2,1200,1,1,allow
49542,443,62121,443,40423,35897,4526,52,16,33,19,allow
65460,53,30831,53,197,102,95,2,30,1,1,allow
53542,50321,25266,50321,320,140,180,6,6,3,3,allow
56765,1841,2876,1841,70,70,0,1,5,1,0,allow
45214,443,34615,443,6641,4617,2024,34,80,18,16,allow
57470,34617,39417,34617,481,150,331,2,1199,1,1,allow
39348,443,17067,443,28301,21778,6523,88,125,49,39,allow
59683,443,22150,443,13310,4422,8888,47,136,27,20,allow
57582,80,30299,80,370,222,148,6,48,4,2,allow
60156,443,49389,443,178,118,60,2,15,1,1,allow
50900,80,42676,80,26867,2743,24124,45,140,23,22,allow
52088,443,13388,443,16165,3877,12288,53,186,25,28,allow
50975,80,56708,80,1095845,7641,1088204,839,35,114,725,allow
50976,80,46012,80,1094127,5977,1088150,812,35,88,724,allow
37988,49152,27635,49152,156,156,0,3,7,3,0,allow
27998,443,50249,443,5515,1388,4127,18,15,9,9,allow
52917,443,10403,443,5583,1390,4193,19,14,9,10,allow
56925,80,48459,80,214,140,74,4,25,3,1,allow
50385,443,20761,443,11098,2853,8245,25,33,12,13,allow
53715,443,45128,443,70,70,0,2,8,2,0,allow
56680,8100,25887,8100,234,234,0,4,11,4,0,allow
62729,51558,61898,51558,70,70,0,1,4,1,0,allow
53517,48019,30847,48019,70,70,0,1,4,1,0,allow
54964,443,18537,443,24232,10141,14091,74,76,39,35,allow
50378,443,15906,443,8663,1983,6680,21,33,10,11,allow
65176,53,64803,53,299,103,196,4,51,2,2,allow
49660,53,23772,53,193,102,91,2,30,1,1,allow
63945,53,51432,53,216,110,106,2,29,1,1,allow
49450,53,27588,53,227,94,133,2,29,1,1,allow
65127,53,53558,53,194,102,92,2,29,1,1,allow
64416,53,53808,53,211,94,117,2,30,1,1,allow
64414,53,58315,53,406,142,264,2,30,1,1,allow
11582,41599,27860,41599,70,70,0,2,8,2,0,allow
60715,80,28604,80,198,78,120,4,11,2,2,allow
52485,443,22795,443,22817,7615,15202,30,16,16,14,allow
56315,123,48493,123,184,94,90,2,30,1,1,allow
43374,443,52439,443,10176,2162,8014,25,186,14,11,allow
51713,33724,27696,33724,70,70,0,1,5,1,0,allow
56756,13973,64423,13973,70,70,0,1,5,1,0,allow
64614,53,61495,53,538,179,359,6,63,3,3,allow
64289,53,50043,53,199,102,97,2,30,1,1,allow
58984,443,13660,443,4874459,114404,4760055,4469,188,1112,3357,allow
64289,53,28932,53,199,102,97,2,30,1,1,allow
65201,53,42204,53,216,110,106,2,30,1,1,allow
64289,53,64357,53,199,102,97,2,30,1,1,allow
56536,443,9088,443,8866,2743,6123,23,139,11,12,allow
51711,1027,5156,1027,70,70,0,1,5,1,0,allow
52848,443,15385,443,6218,1239,4979,14,133,7,7,allow
56926,80,46037,80,214,140,74,4,25,3,1,allow
49820,123,49820,123,184,94,90,2,30,1,1,allow
65460,53,40464,53,197,102,95,2,30,1,1,allow
65201,53,38349,53,216,110,106,2,30,1,1,allow
61178,53,58018,53,290,86,204,2,30,1,1,allow
49222,53,61468,53,418,150,268,2,30,1,1,allow
48555,53,5829,53,215,86,129,2,30,1,1,allow
65114,53,27541,53,196,102,94,2,31,1,1,allow
57947,443,51760,443,3282,781,2501,17,136,8,9,allow
54631,443,52521,443,2352,1394,958,17,275,9,8,allow
51077,80,9544,80,9133,1055,8078,17,151,8,9,allow
6881,7560,34838,7560,509,150,359,2,1199,1,1,allow
51610,443,19441,443,6952,3608,3344,27,21,14,13,allow
60379,34301,5453,34301,320,140,180,6,7,3,3,allow
58701,27030,51697,27030,70,70,0,2,9,2,0,allow
42157,443,25655,443,4819,2903,1916,29,81,15,14,allow
49660,53,56463,53,193,102,91,2,31,1,1,allow
65515,53,22832,53,338,107,231,4,39,2,2,allow
60318,80,34962,80,2714,2154,560,12,26,7,5,allow
61382,443,28176,443,32082,12801,19281,62,150,25,37,allow
42922,80,41285,80,234,234,0,4,12,4,0,allow
49701,443,31912,443,13022,1500,11522,30,23,15,15,allow
3964,51505,0,0,62,62,0,1,0,1,0,deny
50939,445,0,0,66,66,0,1,0,1,0,drop
50470,445,0,0,70,70,0,1,0,1,0,drop
59196,34962,0,0,148,148,0,1,0,1,0,deny
443,39878,0,0,74,74,0,1,0,1,0,deny
49680,26467,0,0,146,146,0,1,0,1,0,deny
443,32698,0,0,89,89,0,1,0,1,0,deny
11020,62413,0,0,62,62,0,1,0,1,0,deny
11967,57470,0,0,62,62,0,1,0,1,0,deny
53030,56205,0,0,66,66,0,1,0,1,0,deny
13947,37965,0,0,145,145,0,1,0,1,0,deny
55536,445,0,0,70,70,0,1,0,1,0,drop
55532,445,0,0,70,70,0,1,0,1,0,drop
55531,445,0,0,70,70,0,1,0,1,0,drop
50926,445,0,0,66,66,0,1,0,1,0,drop
50928,445,0,0,66,66,0,1,0,1,0,drop
50929,445,0,0,66,66,0,1,0,1,0,drop
50925,445,0,0,66,66,0,1,0,1,0,drop
4607,6004,0,0,70,70,0,1,0,1,0,deny
50927,445,0,0,66,66,0,1,0,1,0,drop
50930,445,0,0,66,66,0,1,0,1,0,drop
50924,445,0,0,66,66,0,1,0,1,0,drop
50923,445,0,0,66,66,0,1,0,1,0,drop
50466,445,0,0,70,70,0,1,0,1,0,drop
64166,35440,0,0,66,66,0,1,0,1,0,deny
47013,37965,0,0,62,62,0,1,0,1,0,deny
51953,37965,0,0,66,66,0,1,0,1,0,deny
50457,445,0,0,70,70,0,1,0,1,0,drop
50455,445,0,0,70,70,0,1,0,1,0,drop
50453,445,0,0,70,70,0,1,0,1,0,drop
50454,445,0,0,70,70,0,1,0,1,0,drop
61845,11392,0,0,66,66,0,1,0,1,0,deny
50449,445,0,0,70,70,0,1,0,1,0,drop
37234,44847,0,0,66,66,0,1,0,1,0,deny
38041,10104,0,0,146,146,0,1,0,1,0,deny
21294,57470,0,0,62,62,0,1,0,1,0,deny
38664,37965,0,0,145,145,0,1,0,1,0,deny
55523,445,0,0,70,70,0,1,0,1,0,drop
55520,445,0,0,70,70,0,1,0,1,0,drop
55516,445,0,0,70,70,0,1,0,1,0,drop
41852,35440,0,0,62,62,0,1,0,1,0,deny
49717,666,0,0,60,60,0,1,0,1,0,deny
51413,1,0,0,72,72,0,1,0,1,0,deny
30303,30303,0,0,171,171,0,1,0,1,0,deny
14993,50584,0,0,62,62,0,1,0,1,0,deny
50910,445,0,0,66,66,0,1,0,1,0,drop
50908,445,0,0,66,66,0,1,0,1,0,drop
50907,445,0,0,66,66,0,1,0,1,0,drop
2904,44847,0,0,78,78,0,1,0,1,0,deny
53869,56205,0,0,62,62,0,1,0,1,0,deny
55514,445,0,0,70,70,0,1,0,1,0,drop
30399,44847,0,0,146,146,0,1,0,1,0,deny
50444,445,0,0,70,70,0,1,0,1,0,drop
58715,57470,0,0,66,66,0,1,0,1,0,deny
55511,445,0,0,70,70,0,1,0,1,0,drop
55504,445,0,0,70,70,0,1,0,1,0,drop
55502,445,0,0,70,70,0,1,0,1,0,drop
55500,445,0,0,70,70,0,1,0,1,0,drop
58486,57470,0,0,66,66,0,1,0,1,0,deny
50436,445,0,0,70,70,0,1,0,1,0,drop
50971,443,37029,443,469,403,66,4,0,3,1,allow
50970,443,47824,443,469,403,66,4,0,3,1,allow
14613,12446,0,0,66,66,0,1,0,1,0,deny
12694,12446,0,0,62,62,0,1,0,1,0,deny
50433,445,0,0,70,70,0,1,0,1,0,drop
6881,6881,0,0,146,146,0,1,0,1,0,deny
6057,51221,0,0,78,78,0,1,0,1,0,deny
18085,26467,0,0,66,66,0,1,0,1,0,deny
8239,37965,0,0,146,146,0,1,0,1,0,deny
33405,37965,0,0,62,62,0,1,0,1,0,deny
50140,44847,0,0,62,62,0,1,0,1,0,deny
53796,17546,0,0,62,62,0,1,0,1,0,deny
50429,445,0,0,70,70,0,1,0,1,0,drop
37316,22114,0,0,62,62,0,1,0,1,0,deny
50428,445,0,0,70,70,0,1,0,1,0,drop
55491,445,0,0,70,70,0,1,0,1,0,drop
55489,445,0,0,70,70,0,1,0,1,0,drop
55487,445,0,0,70,70,0,1,0,1,0,drop
45908,3383,0,0,60,60,0,1,0,1,0,deny
60617,64147,0,0,62,62,0,1,0,1,0,deny
50424,445,0,0,70,70,0,1,0,1,0,drop
61600,56205,0,0,66,66,0,1,0,1,0,deny
50052,65008,0,0,60,60,0,1,0,1,0,deny
50423,445,0,0,70,70,0,1,0,1,0,drop
50886,445,0,0,66,66,0,1,0,1,0,drop
56103,21247,0,0,66,66,0,1,0,1,0,deny
57434,50584,0,0,62,62,0,1,0,1,0,deny
55485,445,0,0,70,70,0,1,0,1,0,drop
55483,445,0,0,70,70,0,1,0,1,0,drop
54826,56205,0,0,66,66,0,1,0,1,0,deny
40611,9571,0,0,72,72,0,1,0,1,0,deny
51514,50584,0,0,62,62,0,1,0,1,0,deny
50418,445,0,0,70,70,0,1,0,1,0,drop
32124,30188,0,0,62,62,0,1,0,1,0,deny
50853,50584,0,0,66,66,0,1,0,1,0,deny
2791,7302,0,0,62,62,0,1,0,1,0,deny
50881,445,0,0,66,66,0,1,0,1,0,drop
1027,9822,0,0,146,146,0,1,0,1,0,deny
50878,445,0,0,66,66,0,1,0,1,0,drop
53771,37965,0,0,66,66,0,1,0,1,0,deny
55471,445,0,0,70,70,0,1,0,1,0,drop
55466,445,0,0,70,70,0,1,0,1,0,drop
55467,445,0,0,70,70,0,1,0,1,0,drop
55463,445,0,0,70,70,0,1,0,1,0,drop
54346,44847,0,0,66,66,0,1,0,1,0,deny
50875,445,0,0,66,66,0,1,0,1,0,drop
45766,2323,0,0,60,60,0,1,0,1,0,deny
58876,57470,0,0,66,66,0,1,0,1,0,deny
24351,57470,0,0,62,62,0,1,0,1,0,deny
18592,44612,0,0,62,62,0,1,0,1,0,deny
6909,57470,0,0,62,62,0,1,0,1,0,deny
50405,445,0,0,70,70,0,1,0,1,0,drop
55458,445,0,0,70,70,0,1,0,1,0,drop
2704,37,0,0,60,60,0,1,0,1,0,deny
57226,51505,0,0,66,66,0,1,0,1,0,deny
63287,44847,0,0,62,62,0,1,0,1,0,deny
50402,445,0,0,70,70,0,1,0,1,0,drop
56411,50584,0,0,62,62,0,1,0,1,0,deny
55456,445,0,0,70,70,0,1,0,1,0,drop
55454,445,0,0,70,70,0,1,0,1,0,drop
55453,445,0,0,70,70,0,1,0,1,0,drop
1036,64147,0,0,62,62,0,1,0,1,0,deny
50868,445,0,0,66,66,0,1,0,1,0,drop
25973,26467,0,0,66,66,0,1,0,1,0,deny
50865,445,0,0,66,66,0,1,0,1,0,drop
50863,445,0,0,66,66,0,1,0,1,0,drop
50861,445,0,0,66,66,0,1,0,1,0,drop
50856,445,0,0,66,66,0,1,0,1,0,drop
50859,445,0,0,66,66,0,1,0,1,0,drop
50858,445,0,0,66,66,0,1,0,1,0,drop
63786,35440,0,0,66,66,0,1,0,1,0,deny
62569,44847,0,0,66,66,0,1,0,1,0,deny
58238,23,0,0,60,60,0,1,0,1,0,deny
50397,445,0,0,70,70,0,1,0,1,0,drop
35657,48637,0,0,145,145,0,1,0,1,0,deny
50396,445,0,0,70,70,0,1,0,1,0,drop
50200,44847,0,0,74,74,0,1,0,1,0,deny
55450,445,0,0,70,70,0,1,0,1,0,drop
55448,445,0,0,70,70,0,1,0,1,0,drop
55446,445,0,0,70,70,0,1,0,1,0,drop
50394,445,0,0,70,70,0,1,0,1,0,drop
50854,445,0,0,66,66,0,1,0,1,0,drop
52034,26467,0,0,62,62,0,1,0,1,0,deny
55443,445,0,0,70,70,0,1,0,1,0,drop
56783,43890,0,0,66,66,0,1,0,1,0,deny
15274,19473,0,0,62,62,0,1,0,1,0,deny
54540,22,0,0,60,60,0,1,0,1,0,deny
50850,445,0,0,66,66,0,1,0,1,0,drop
50971,44847,0,0,62,62,0,1,0,1,0,deny
58916,21247,0,0,146,146,0,1,0,1,0,deny
50849,445,0,0,66,66,0,1,0,1,0,drop
50848,445,0,0,66,66,0,1,0,1,0,drop
50584,51748,57588,51748,1356,300,1056,6,1200,3,3,allow
56526,80,57143,80,1056,682,374,10,15,6,4,allow
57149,443,55393,443,1647,1375,272,9,37,5,4,allow
60069,443,60069,443,5610,2363,3247,22,40,13,9,allow
60323,443,19514,443,1743,1164,579,16,25,10,6,allow
60324,443,7520,443,1743,1164,579,16,25,10,6,allow
62238,443,62238,443,58141,3051,55090,78,78,29,49,allow
51648,80,61615,80,3227,2425,802,9,31,5,4,allow
63383,53,63383,53,235,90,145,2,33,1,1,allow
2267,53,19148,53,826,826,0,8,44,8,0,allow
38085,443,21750,443,234,234,0,4,12,4,0,allow
49573,80,24541,80,180917,5183,175734,175,65,49,126,allow
51730,33399,62466,33399,70,70,0,2,8,2,0,allow
64565,443,57848,443,24984,2042,22942,41,33,19,22,allow
49579,80,10648,80,277736,7810,269926,277,65,91,186,allow
49577,80,46203,80,147113,4021,143092,144,65,41,103,allow
60321,443,49674,443,1743,1164,579,16,25,10,6,allow
50047,443,50047,443,4534,1627,2907,19,27,11,8,allow
56014,443,56014,443,4334,1427,2907,19,30,11,8,allow
60320,443,16711,443,1743,1164,579,16,25,10,6,allow
51704,9266,12391,9266,66,66,0,1,5,1,0,allow
61692,443,18049,443,126,60,66,3,10,2,1,allow
51727,1024,33037,1024,70,70,0,2,8,2,0,allow
51705,59244,12307,59244,66,66,0,1,5,1,0,allow
62235,443,62235,443,16675,2296,14379,37,78,17,20,allow
63102,443,30669,443,8848,3081,5767,56,335,26,30,allow
60832,5222,60932,5222,3848,1039,2809,37,662,11,26,allow
56465,443,52483,443,6081,844,5237,17,15,9,8,allow
63976,53,34685,53,200,102,98,2,30,1,1,allow
5588,5588,0,0,3562,1936,1626,48,194,24,24,allow
57256,443,52300,443,47762,39522,8240,77,332,43,34,allow
50121,443,24047,443,307104860,2750998,304353862,234597,6122,15017,219580,allow
56177,443,61837,443,6826,5299,1527,22,330,12,10,allow
50060,80,8335,80,2425,529,1896,11,75,6,5,allow
60322,443,12700,443,1743,1164,579,16,25,10,6,allow
22419,1433,22419,1433,146,60,86,2,9,1,1,allow
49576,80,6202,80,174140,4942,169198,166,65,47,119,allow
30960,45656,54549,45656,66,66,0,1,3600,1,0,allow
48817,6889,48817,6889,480,149,331,2,1200,1,1,allow
50584,6881,63450,6881,1320,300,1020,6,1200,3,3,allow
50584,62833,22282,62833,1275,300,975,6,1200,3,3,allow
56597,53,9477,53,197,197,0,3,60,3,0,allow
62102,443,60782,443,3182,1568,1614,8,121,4,4,allow
50584,54321,2526,54321,1275,300,975,6,1200,3,3,allow
50584,30773,22058,30773,1356,300,1056,6,1200,3,3,allow
50584,45270,4666,45270,1377,300,1077,6,1200,3,3,allow
30960,45665,23931,45665,462,462,0,8,3632,8,0,allow
50845,445,0,0,66,66,0,1,0,1,0,drop
51062,1433,0,0,60,60,0,1,0,1,0,deny
57750,37965,0,0,62,62,0,1,0,1,0,deny
50387,445,0,0,70,70,0,1,0,1,0,drop
55440,445,0,0,70,70,0,1,0,1,0,drop
50385,445,0,0,70,70,0,1,0,1,0,drop
50102,17546,0,0,66,66,0,1,0,1,0,deny
55432,445,0,0,70,70,0,1,0,1,0,drop
55428,445,0,0,70,70,0,1,0,1,0,drop
50384,445,0,0,70,70,0,1,0,1,0,drop
443,25740,0,0,131,131,0,1,0,1,0,deny
50383,445,0,0,70,70,0,1,0,1,0,drop
27889,32480,0,0,100,100,0,1,0,1,0,deny
50382,445,0,0,70,70,0,1,0,1,0,drop
60192,35440,0,0,62,62,0,1,0,1,0,deny
50378,445,0,0,70,70,0,1,0,1,0,drop
50377,445,0,0,70,70,0,1,0,1,0,drop
50837,445,0,0,66,66,0,1,0,1,0,drop
443,10010,0,0,60,60,0,1,0,1,0,deny
44258,25,0,0,74,74,0,1,0,1,0,deny
45941,23386,0,0,60,60,0,1,0,1,0,deny
6881,26296,0,0,157,157,0,1,0,1,0,deny
59371,22114,0,0,62,62,0,1,0,1,0,deny
11842,35440,0,0,66,66,0,1,0,1,0,deny
50362,445,0,0,70,70,0,1,0,1,0,drop
50361,445,0,0,70,70,0,1,0,1,0,drop
50359,445,0,0,70,70,0,1,0,1,0,drop
50827,445,0,0,66,66,0,1,0,1,0,drop
58912,11392,0,0,66,66,0,1,0,1,0,deny
55415,445,0,0,70,70,0,1,0,1,0,drop
50351,445,0,0,70,70,0,1,0,1,0,drop
50210,26467,0,0,62,62,0,1,0,1,0,deny
5223,44091,0,0,66,66,0,1,0,1,0,deny
58597,35440,0,0,66,66,0,1,0,1,0,deny
61173,2323,0,0,60,60,0,1,0,1,0,deny
50824,445,0,0,66,66,0,1,0,1,0,drop
47398,7302,0,0,62,62,0,1,0,1,0,deny
39839,67,0,0,60,60,0,1,0,1,0,deny
43271,50584,0,0,62,62,0,1,0,1,0,deny
17702,6881,0,0,66,66,0,1,0,1,0,deny
27328,21247,0,0,66,66,0,1,0,1,0,deny
60292,7129,0,0,62,62,0,1,0,1,0,deny
43840,50265,0,0,72,72,0,1,0,1,0,deny
62092,35440,0,0,66,66,0,1,0,1,0,deny
54071,50265,0,0,66,66,0,1,0,1,0,deny
64106,64147,0,0,66,66,0,1,0,1,0,deny
50818,445,0,0,66,66,0,1,0,1,0,drop
50340,445,0,0,70,70,0,1,0,1,0,drop
50807,445,0,0,66,66,0,1,0,1,0,drop
50336,445,0,0,70,70,0,1,0,1,0,drop
55407,445,0,0,70,70,0,1,0,1,0,drop
55403,445,0,0,70,70,0,1,0,1,0,drop
55404,445,0,0,70,70,0,1,0,1,0,drop
53472,17,0,0,60,60,0,1,0,1,0,deny
59969,443,49407,443,6655,1166,5489,21,360,11,10,allow
45001,443,55898,443,570,318,252,10,20,6,4,allow
50584,6889,64241,6889,1326,300,1026,6,1200,3,3,allow
50584,28020,62483,28020,1302,300,1002,6,1200,3,3,allow
50584,54993,58004,54993,652,300,352,4,1200,3,1,allow
58248,53,0,0,633,83,550,2,30,1,1,allow
50880,80,36202,80,395978,13168,382810,411,143,151,260,allow
59779,443,2318,443,5834,1810,4024,24,17,13,11,allow
50535,22,50535,22,6292,2375,3917,35,20,19,16,allow
57594,443,55656,443,614577,24675,589902,673,149,228,445,allow
51737,54691,48488,54691,316,136,180,6,5,3,3,allow
65476,53,44080,53,226,110,116,2,29,1,1,allow
65304,53,52702,53,194,86,108,2,29,1,1,allow
50056,27018,43222,27018,468,390,78,5,29,4,1,allow
62678,53,62678,53,216,90,126,2,30,1,1,allow
50584,51413,45972,51413,1275,300,975,6,1200,3,3,allow
59162,80,16258,80,1031,314,717,13,175,3,10,allow
65176,53,35354,53,511,195,316,6,56,3,3,allow
42500,443,20918,443,8932,2039,6893,23,24,12,11,allow
49885,443,30250,443,4626083,113708,4512375,4382,213,1198,3184,allow
43210,443,51289,443,5960402,99613,5860789,5017,133,952,4065,allow
52314,443,46456,443,3448,1612,1836,31,36,17,14,allow
35498,80,39354,80,1270,387,883,16,392,4,12,allow
49608,80,59432,80,145752,3240,142512,128,61,23,105,allow
62237,443,62237,443,169315,5255,164060,190,77,66,124,allow
60742,20010,63644,20010,70,70,0,2,8,2,0,allow
51729,63553,13105,63553,70,70,0,2,8,2,0,allow
63106,443,7897,443,8712,3748,4964,51,255,23,28,allow
49577,53,54563,53,384,94,290,2,30,1,1,allow
49703,80,27292,80,71256,962,70294,63,52,11,52,allow
49700,80,44971,80,71320,1026,70294,64,52,12,52,allow
49702,80,5138,80,71256,962,70294,63,52,11,52,allow
60961,443,5669,443,75122,4244,70878,101,45,48,53,allow
60239,53,53135,53,219,102,117,2,30,1,1,allow
55610,53,9648,53,265,91,174,4,36,2,2,allow
57170,53,13134,53,298,102,196,4,36,2,2,allow
60777,443,22998,443,10417,2617,7800,32,15,17,15,allow
50618,443,50618,443,4351,1444,2907,19,28,11,8,allow
54810,80,61461,80,6098,1916,4182,31,357,16,15,allow
60959,443,46440,443,17149,2543,14606,40,46,22,18,allow
49634,443,7107,443,1575,988,587,13,35,7,6,allow
50318,80,21534,80,3855,828,3027,11,15,5,6,allow
60960,443,48167,443,7488,1552,5936,23,46,13,10,allow
49359,53,57768,53,102,102,0,1,60,1,0,allow
58248,53,0,0,186,83,103,2,30,1,1,allow
60989,443,62484,443,3182,1568,1614,8,120,4,4,allow
57798,443,21508,443,12877,5188,7689,27,130,12,15,allow
65005,53,2818,53,239,94,145,2,30,1,1,allow
50584,54741,14563,54741,868,150,718,4,1200,2,2,allow
50584,15926,55734,15926,1377,300,1077,6,1200,3,3,allow
49711,80,42345,80,2269,821,1448,15,51,8,7,allow
49701,80,63516,80,70321,956,69365,62,52,11,51,allow
62236,443,62236,443,28126,3114,25012,50,77,22,28,allow
51708,21278,38128,21278,70,70,0,1,5,1,0,allow
55581,64301,29198,64301,316,190,126,5,15,3,2,allow
65008,53,8162,53,312,94,218,2,30,1,1,allow
57266,53,22077,53,209,102,107,2,30,1,1,allow
2267,53,3037,53,826,826,0,8,44,8,0,allow
49891,443,20308,443,1820,1101,719,18,73,10,8,allow
51571,443,51571,443,1724,916,808,17,128,7,10,allow
52315,443,14653,443,24304,2974,21330,57,34,31,26,allow
49609,80,24955,80,11534,719,10815,18,61,7,11,allow
51572,443,51572,443,1724,916,808,17,128,7,10,allow
53188,443,8819,443,7878,3197,4681,22,18,11,11,allow
56009,53,4440,53,232,94,138,2,30,1,1,allow
50584,25935,2865,25935,1377,300,1077,6,1200,3,3,allow
50584,55624,58737,55624,1326,300,1026,6,1200,3,3,allow
44847,6881,3655,6881,324,150,174,2,1201,1,1,allow
50584,51413,47261,51413,1275,300,975,6,1200,3,3,allow
55104,443,37071,443,10470,3626,6844,20,131,9,11,allow
55385,443,7012,443,11771,2624,9147,50,20,25,25,allow
44586,443,61467,443,122708,5797,116911,169,132,75,94,allow
55036,443,41925,443,10001,2547,7454,27,35,14,13,allow
50929,80,17624,80,9630744,98097,9532647,7804,123,1387,6417,allow
60319,80,61391,80,194,128,66,4,25,3,1,allow
52177,443,52177,443,38013,6855,31158,58,21,25,33,allow
62233,443,62233,443,41941,3388,38553,67,77,26,41,allow
63976,53,54161,53,200,102,98,2,33,1,1,allow
51703,3010,58034,3010,70,70,0,1,5,1,0,allow
56463,443,48725,443,6364,1147,5217,19,24,11,8,allow
49892,443,65121,443,1820,1101,719,18,73,10,8,allow
64584,80,64584,80,142674,8057,134617,192,27,94,98,allow
65176,53,60246,53,299,103,196,4,53,2,2,allow
49698,80,3522,80,140258,1720,138538,117,52,18,99,allow
24009,53,46041,53,223,86,137,2,29,1,1,allow
61669,443,27122,443,12453,3460,8993,43,18,24,19,allow
49660,53,59057,53,193,102,91,2,29,1,1,allow
53392,53,53392,53,832,106,726,2,30,1,1,allow
65073,53,55415,53,325,102,223,2,29,1,1,allow
65114,53,15041,53,196,102,94,2,29,1,1,allow
7060,53,45870,53,197,94,103,2,30,1,1,allow
58409,53,57147,53,307,86,221,2,30,1,1,allow
56459,53,55165,53,392,86,306,2,30,1,1,allow
49412,443,56019,443,46271,6834,39437,63,47,19,44,allow
27393,53,7301,53,168,78,90,2,30,1,1,allow
55330,53,4334,53,216,102,114,2,30,1,1,allow
50584,56112,8598,56112,1377,300,1077,6,1200,3,3,allow
50584,61467,32483,61467,1377,300,1077,6,1200,3,3,allow
50584,11888,51615,11888,1356,300,1056,6,1200,3,3,allow
59970,443,18481,443,6720,1166,5554,22,360,11,11,allow
50584,40420,46560,40420,868,150,718,4,1200,2,2,allow
50584,8999,18180,8999,1356,300,1056,6,1200,3,3,allow
50584,49376,27285,49376,1320,300,1020,6,1200,3,3,allow
50584,54157,4800,54157,1377,300,1077,6,1200,3,3,allow
50584,6889,7914,6889,1326,300,1026,6,1200,3,3,allow
13971,53,13971,53,220,90,130,2,30,1,1,allow
63976,53,50670,53,200,102,98,2,30,1,1,allow
49538,53,56684,53,258,102,156,2,30,1,1,allow
50584,21094,39450,21094,1356,300,1056,6,1200,3,3,allow
63542,3389,63542,3389,3504,1790,1714,17,32,9,8,allow
54525,80,24122,80,50436663,1205750,49230913,49415,198,16827,32588,allow
51725,32787,39792,32787,70,70,0,2,8,2,0,allow
51706,30673,17118,30673,70,70,0,1,5,1,0,allow
49630,443,54596,443,7776,2266,5510,17,35,9,8,allow
65278,53,45335,53,264,110,154,2,30,1,1,allow
58828,53,32002,53,215,102,113,2,30,1,1,allow
50584,38578,41911,38578,1377,300,1077,6,1200,3,3,allow
50584,16455,26852,16455,1356,300,1056,6,1200,3,3,allow
55584,34914,32488,34914,504,318,186,8,15,5,3,allow
43817,53,0,0,82,82,0,2,40,2,0,allow
49688,443,44354,443,318,192,126,6,53,4,2,allow
63718,80,18056,80,314,192,122,6,15,4,2,allow
64038,53,4227,53,321,102,219,2,30,1,1,allow
58562,53,31864,53,215,102,113,2,30,1,1,allow
41267,443,45130,443,8248,876,7372,25,186,9,16,allow
50584,51413,31560,51413,800,150,650,4,1200,2,2,allow
50584,49001,36650,49001,1290,300,990,6,1200,3,3,allow
50584,47174,17468,47174,300,300,0,3,1200,3,0,allow
55877,62071,53667,62071,481,150,331,2,1200,1,1,allow
53936,443,5510,443,886,70,816,14,166,2,12,allow
49782,80,13908,80,1661,1147,514,9,210,5,4,allow
50584,8569,42866,8569,1356,300,1056,6,1200,3,3,allow
50584,6889,50435,6889,1326,300,1026,6,1200,3,3,allow
6881,666,16595,666,268,150,118,2,1199,1,1,allow
19987,53,54747,53,208,86,122,2,30,1,1,allow
64745,53,11106,53,196,94,102,2,31,1,1,allow
38770,5228,21583,5228,6033,1874,4159,33,4073,11,22,allow
46999,993,56009,993,45153,20621,24532,323,43,165,158,allow
50939,80,16478,80,1375,1038,337,7,137,4,3,allow
54366,443,39148,443,17629,5828,11801,39,41,20,19,allow
50933,80,44380,80,9932735,85391,9847344,7875,123,1237,6638,allow
64602,80,64602,80,18594,5204,13390,42,26,25,17,allow
52482,443,8869,443,26154,6874,19280,35,17,16,19,allow
36716,53,54815,53,224,78,146,2,31,1,1,allow
50796,445,0,0,66,66,0,1,0,1,0,drop
50802,445,0,0,66,66,0,1,0,1,0,drop
50800,445,0,0,66,66,0,1,0,1,0,drop
50795,445,0,0,66,66,0,1,0,1,0,drop
50798,445,0,0,66,66,0,1,0,1,0,drop
50799,445,0,0,66,66,0,1,0,1,0,drop
50797,445,0,0,66,66,0,1,0,1,0,drop
50794,445,0,0,66,66,0,1,0,1,0,drop
27125,51221,0,0,62,62,0,1,0,1,0,deny
51535,64147,0,0,66,66,0,1,0,1,0,deny
59477,36829,0,0,66,66,0,1,0,1,0,deny
50327,445,0,0,70,70,0,1,0,1,0,drop
50325,445,0,0,70,70,0,1,0,1,0,drop
50322,445,0,0,70,70,0,1,0,1,0,drop
50321,445,0,0,70,70,0,1,0,1,0,drop
55704,64097,0,0,66,66,0,1,0,1,0,deny
58338,3369,0,0,60,60,0,1,0,1,0,deny
50319,445,0,0,70,70,0,1,0,1,0,drop
50113,51505,0,0,66,66,0,1,0,1,0,deny
19394,44847,0,0,66,66,0,1,0,1,0,deny
35718,20238,0,0,62,62,0,1,0,1,0,deny
55397,445,0,0,70,70,0,1,0,1,0,drop
55394,445,0,0,70,70,0,1,0,1,0,drop
55387,445,0,0,70,70,0,1,0,1,0,drop
64767,51221,0,0,62,62,0,1,0,1,0,deny
62787,51221,0,0,66,66,0,1,0,1,0,deny
37538,37965,0,0,66,66,0,1,0,1,0,deny
35377,43890,0,0,62,62,0,1,0,1,0,deny
50780,445,0,0,66,66,0,1,0,1,0,drop
50782,445,0,0,66,66,0,1,0,1,0,drop
50779,445,0,0,66,66,0,1,0,1,0,drop
55663,44847,0,0,62,62,0,1,0,1,0,deny
50313,445,0,0,70,70,0,1,0,1,0,drop
20706,37965,0,0,62,62,0,1,0,1,0,deny
50626,43890,0,0,62,62,0,1,0,1,0,deny
42969,8146,0,0,62,62,0,1,0,1,0,deny
19963,2767,0,0,66,66,0,1,0,1,0,deny
55386,445,0,0,70,70,0,1,0,1,0,drop
51973,44847,0,0,66,66,0,1,0,1,0,deny
62663,35253,0,0,66,66,0,1,0,1,0,deny
55383,445,0,0,70,70,0,1,0,1,0,drop
55377,445,0,0,70,70,0,1,0,1,0,drop
55375,445,0,0,70,70,0,1,0,1,0,drop
55373,445,0,0,70,70,0,1,0,1,0,drop
50306,445,0,0,70,70,0,1,0,1,0,drop
50304,445,0,0,70,70,0,1,0,1,0,drop
6057,51221,0,0,78,78,0,1,0,1,0,deny
64059,30188,0,0,62,62,0,1,0,1,0,deny
58014,39004,0,0,62,62,0,1,0,1,0,deny
12668,42707,0,0,62,62,0,1,0,1,0,deny
9520,32480,0,0,62,62,0,1,0,1,0,deny
50299,445,0,0,70,70,0,1,0,1,0,drop
50298,445,0,0,70,70,0,1,0,1,0,drop
59374,51505,0,0,62,62,0,1,0,1,0,deny
55364,445,0,0,70,70,0,1,0,1,0,drop
55360,445,0,0,70,70,0,1,0,1,0,drop
55359,445,0,0,70,70,0,1,0,1,0,drop
50294,445,0,0,70,70,0,1,0,1,0,drop
60894,50584,0,0,66,66,0,1,0,1,0,deny
11136,57587,0,0,145,145,0,1,0,1,0,deny
17760,50584,0,0,62,62,0,1,0,1,0,deny
60092,51505,0,0,62,62,0,1,0,1,0,deny
50293,445,0,0,70,70,0,1,0,1,0,drop
50840,57470,0,0,66,66,0,1,0,1,0,deny
11825,38338,0,0,86,86,0,1,0,1,0,deny
58036,443,0,0,1097,1097,0,1,0,1,0,deny
0,0,0,0,134,64,70,2,0,1,1,allow
64191,44847,0,0,66,66,0,1,0,1,0,deny
443,50755,0,0,102,102,0,1,0,1,0,deny
1256,50584,0,0,146,146,0,1,0,1,0,deny
443,10010,0,0,60,60,0,1,0,1,0,deny
3407,57866,0,0,66,66,0,1,0,1,0,deny
50759,445,0,0,66,66,0,1,0,1,0,drop
5195,64147,0,0,66,66,0,1,0,1,0,deny
63503,42707,0,0,66,66,0,1,0,1,0,deny
55358,445,0,0,70,70,0,1,0,1,0,drop
55357,445,0,0,70,70,0,1,0,1,0,drop
50288,445,0,0,70,70,0,1,0,1,0,drop
56216,50584,0,0,62,62,0,1,0,1,0,deny
50753,445,0,0,66,66,0,1,0,1,0,drop
26795,6881,0,0,146,146,0,1,0,1,0,deny
50750,445,0,0,66,66,0,1,0,1,0,drop
55344,445,0,0,70,70,0,1,0,1,0,drop
13188,35440,0,0,66,66,0,1,0,1,0,deny
11777,37965,0,0,62,62,0,1,0,1,0,deny
55341,445,0,0,70,70,0,1,0,1,0,drop
55339,445,0,0,70,70,0,1,0,1,0,drop
55335,445,0,0,70,70,0,1,0,1,0,drop
50748,445,0,0,66,66,0,1,0,1,0,drop
50274,445,0,0,70,70,0,1,0,1,0,drop
45941,23386,0,0,60,60,0,1,0,1,0,deny
63888,57470,0,0,62,62,0,1,0,1,0,deny
50271,445,0,0,70,70,0,1,0,1,0,drop
60524,64147,0,0,66,66,0,1,0,1,0,deny
11651,64147,0,0,145,145,0,1,0,1,0,deny
55330,445,0,0,70,70,0,1,0,1,0,drop
5223,61002,0,0,161,161,0,1,0,1,0,deny
63433,57866,0,0,66,66,0,1,0,1,0,deny
64616,53,29802,53,184,80,104,2,30,1,1,allow
61046,443,61046,443,5830,2583,3247,22,40,13,9,allow
40710,5228,9746,5228,4065,2585,1480,28,40,14,14,allow
40709,53,32661,53,221,75,146,2,30,1,1,allow
50968,80,19228,80,109660,1992,107668,99,35,20,79,allow
5588,5588,0,0,3498,1872,1626,48,195,24,24,allow
993,54634,0,0,66,66,0,1,90,1,0,allow
52765,443,14674,443,283,163,120,4,16,2,2,allow
47740,443,62722,443,6234,4369,1865,25,316,12,13,allow
50967,80,65454,80,1439,697,742,12,35,6,6,allow
56149,80,45182,80,1286,403,883,16,400,4,12,allow
50312,80,15679,80,17102,1099,16003,19,16,5,14,allow
54368,443,18976,443,10707,2548,8159,27,39,15,12,allow
34338,443,23040,443,8152,3395,4757,27,18,15,12,allow
56896,80,32594,80,2684,2550,134,7,16,5,2,allow
46488,443,7780,443,87129,6924,80205,126,258,49,77,allow
54360,443,12392,443,7723,2282,5441,22,255,11,11,allow
23293,443,23293,443,50236,37417,12819,67,19,41,26,allow
56759,55201,4487,55201,70,70,0,2,8,2,0,allow
24037,443,24037,443,3611,2177,1434,24,17,13,11,allow
53535,1393,2385,1393,70,70,0,2,8,2,0,allow
57595,80,57595,80,254,120,134,5,26,3,2,allow
51724,25807,54569,25807,70,70,0,2,8,2,0,allow
48381,53,16694,53,221,75,146,2,30,1,1,allow
59808,443,49702,443,147637,6160,141477,164,121,56,108,allow
65404,443,46166,443,63040,3063,59977,78,129,30,48,allow
42298,40030,5035,40030,146,84,62,2,31,1,1,allow
50073,443,21032,443,9873,2384,7489,25,242,14,11,allow
55328,445,0,0,70,70,0,1,0,1,0,drop
55326,445,0,0,70,70,0,1,0,1,0,drop
55324,445,0,0,70,70,0,1,0,1,0,drop
50282,37965,0,0,66,66,0,1,0,1,0,deny
50739,445,0,0,66,66,0,1,0,1,0,drop
33215,37965,0,0,62,62,0,1,0,1,0,deny
32974,37965,0,0,66,66,0,1,0,1,0,deny
50962,5900,0,0,60,60,0,1,0,1,0,deny
50736,445,0,0,66,66,0,1,0,1,0,drop
50733,445,0,0,66,66,0,1,0,1,0,drop
50732,445,0,0,66,66,0,1,0,1,0,drop
50731,445,0,0,66,66,0,1,0,1,0,drop
50730,445,0,0,66,66,0,1,0,1,0,drop
50728,445,0,0,66,66,0,1,0,1,0,drop
50266,445,0,0,70,70,0,1,0,1,0,drop
46090,50584,0,0,66,66,0,1,0,1,0,deny
50265,445,0,0,70,70,0,1,0,1,0,drop
443,29326,0,0,82,82,0,1,0,1,0,deny
63729,6969,55353,6969,66,66,0,2,8,2,0,allow
48203,80,21963,80,946,531,415,11,315,6,5,allow
1924,80,29370,80,214,140,74,4,15,3,1,allow
50263,445,0,0,70,70,0,1,0,1,0,drop
57493,443,0,0,60,60,0,1,0,1,0,deny
55323,445,0,0,70,70,0,1,0,1,0,drop
55318,445,0,0,70,70,0,1,0,1,0,drop
55320,445,0,0,70,70,0,1,0,1,0,drop
50725,445,0,0,66,66,0,1,0,1,0,drop
40703,5900,0,0,60,60,0,1,0,1,0,deny
24311,22617,0,0,60,60,0,1,0,1,0,deny
55315,445,0,0,70,70,0,1,0,1,0,drop
34716,23,0,0,60,60,0,1,0,1,0,deny
58338,3362,0,0,60,60,0,1,0,1,0,deny
58338,3362,0,0,60,60,0,1,0,1,0,deny
50723,445,0,0,66,66,0,1,0,1,0,drop
49057,5900,0,0,60,60,0,1,0,1,0,deny
50721,445,0,0,66,66,0,1,0,1,0,drop
50720,445,0,0,66,66,0,1,0,1,0,drop
23061,23,0,0,60,60,0,1,0,1,0,deny
59037,51505,0,0,66,66,0,1,0,1,0,deny
60435,35440,0,0,62,62,0,1,0,1,0,deny
50717,445,0,0,66,66,0,1,0,1,0,drop
5180,57866,0,0,66,66,0,1,0,1,0,deny
49501,11392,0,0,66,66,0,1,0,1,0,deny
50256,445,0,0,70,70,0,1,0,1,0,drop
5223,1210,0,0,103,103,0,1,0,1,0,deny
55618,56205,0,0,66,66,0,1,0,1,0,deny
50254,445,0,0,70,70,0,1,0,1,0,drop
52431,64147,0,0,62,62,0,1,0,1,0,deny
58849,64147,0,0,66,66,0,1,0,1,0,deny
55310,445,0,0,70,70,0,1,0,1,0,drop
51426,52700,0,0,100,100,0,1,0,1,0,deny
50253,445,0,0,70,70,0,1,0,1,0,drop
23807,44847,0,0,66,66,0,1,0,1,0,deny
52910,51221,0,0,78,78,0,1,0,1,0,deny
55302,445,0,0,70,70,0,1,0,1,0,drop
55300,445,0,0,70,70,0,1,0,1,0,drop
50252,445,0,0,70,70,0,1,0,1,0,drop
50251,445,0,0,70,70,0,1,0,1,0,drop
54095,26467,0,0,62,62,0,1,0,1,0,deny
50249,445,0,0,70,70,0,1,0,1,0,drop
50246,445,0,0,70,70,0,1,0,1,0,drop
50438,19426,0,0,62,62,0,1,0,1,0,deny
51130,61689,0,0,66,66,0,1,0,1,0,deny
515,10214,0,0,62,62,0,1,0,1,0,deny
50708,445,0,0,66,66,0,1,0,1,0,drop
7744,32480,0,0,62,62,0,1,0,1,0,deny
443,29326,0,0,82,82,0,1,0,1,0,deny
12232,18593,0,0,139,139,0,1,0,1,0,deny
64277,30188,0,0,62,62,0,1,0,1,0,deny
50233,445,0,0,70,70,0,1,0,1,0,drop
50231,445,0,0,70,70,0,1,0,1,0,drop
50230,445,0,0,70,70,0,1,0,1,0,drop
50222,445,0,0,70,70,0,1,0,1,0,drop
50223,445,0,0,70,70,0,1,0,1,0,drop
65024,51505,0,0,62,62,0,1,0,1,0,deny
5223,44091,0,0,66,66,0,1,0,1,0,deny
5223,44091,0,0,119,119,0,1,0,1,0,deny
5223,44091,0,0,167,167,0,1,0,1,0,deny
6712,161,0,0,82,82,0,1,0,1,0,deny
443,10010,0,0,60,60,0,1,0,1,0,deny
52218,31573,0,0,62,62,0,1,0,1,0,deny
50699,445,0,0,66,66,0,1,0,1,0,drop
443,22238,0,0,112,112,0,1,0,1,0,deny
44147,64147,0,0,62,62,0,1,0,1,0,deny
28832,36237,0,0,66,66,0,1,0,1,0,deny
55288,445,0,0,70,70,0,1,0,1,0,drop
44411,37965,0,0,62,62,0,1,0,1,0,deny
64601,80,64601,80,56887,6820,50067,90,25,49,41,allow
58081,3389,58081,3389,3549,1594,1955,18,16,10,8,allow
60743,40010,9730,40010,316,136,180,6,6,3,3,allow
58438,53,46803,53,246,102,144,2,29,1,1,allow
54373,443,3920,443,16029,6377,9652,46,37,24,22,allow
54363,443,18639,443,23766,10707,13059,80,42,41,39,allow
50316,80,27928,80,1677,862,815,10,15,5,5,allow
54348,443,31489,443,27760,9709,18051,56,45,27,29,allow
53817,443,11999,443,7443,2043,5400,34,255,17,17,allow
53515,39608,40902,39608,70,70,0,1,4,1,0,allow
33637,443,44559,443,24214,18131,6083,81,118,44,37,allow
26758,443,6342,443,20851,15854,4997,36,20,20,16,allow
46985,993,3733,993,9725,3931,5794,46,48,25,21,allow
50028,53,56615,53,323,110,213,2,29,1,1,allow
50013,53,8122,53,662,195,467,6,39,3,3,allow
61670,443,47830,443,5943,1991,3952,23,17,14,9,allow
38413,53,37201,53,199,94,105,2,29,1,1,allow
37752,53,54109,53,220,78,142,2,30,1,1,allow
59437,53,35841,53,215,86,129,2,29,1,1,allow
58602,53,5583,53,197,86,111,2,29,1,1,allow
56763,27734,6083,27734,70,70,0,1,5,1,0,allow
34413,443,27966,443,8107,2200,5907,34,255,16,18,allow
42805,443,52110,443,130,70,60,2,15,1,1,allow
49445,80,19716,80,1586,808,778,13,45,7,6,allow
54374,443,44819,443,9131,3499,5632,39,24,21,18,allow
43221,443,25236,443,72183,3193,68990,89,20,34,55,allow
49166,53,8191,53,468,93,375,4,34,2,2,allow
55580,45817,63033,45817,70,70,0,1,5,1,0,allow
51702,33451,34580,33451,70,70,0,1,5,1,0,allow
55585,48063,46430,48063,70,70,0,2,8,2,0,allow
64593,53,5715,53,602,93,509,4,42,2,2,allow
43532,80,43879,80,1449,364,1085,13,15,6,7,allow
65318,53,16200,53,395,102,293,2,30,1,1,allow
43782,7275,17092,7275,4955,1749,3206,24,16,15,9,allow
57768,7635,57768,7635,138,78,60,2,6,1,1,allow
35105,443,59131,443,639937,14873,625064,627,230,188,439,allow
43402,53,65461,53,241,78,163,2,30,1,1,allow
56762,25080,40998,25080,70,70,0,1,5,1,0,allow
49812,53,37839,53,195,86,109,2,30,1,1,allow
39417,53,53271,53,224,78,146,2,30,1,1,allow
52785,443,33714,443,5806,1059,4747,16,63,8,8,allow
4683,53,49166,53,207,86,121,2,30,1,1,allow
40885,443,32340,443,4014,1592,2422,17,147,9,8,allow
49980,443,59748,443,7227,4437,2790,29,271,16,13,allow
59420,53,63231,53,224,78,146,2,30,1,1,allow
62103,443,43175,443,6345,3495,2850,18,120,9,9,allow
57470,1136,15403,1136,402,132,270,6,1209,3,3,allow
49505,53,46670,53,232,110,122,2,30,1,1,allow
52203,80,56885,80,432,246,186,7,40,4,3,allow
49154,53,7041,53,763,204,559,6,40,3,3,allow
49792,53,58447,53,339,110,229,2,30,1,1,allow
59801,443,35070,443,5678,2820,2858,25,141,11,14,allow
61675,80,46507,80,5108,676,4432,14,15,7,7,allow
60308,443,13749,443,5445,1072,4373,24,80,11,13,allow
55583,14822,28217,14822,70,70,0,1,5,1,0,allow
52402,53,52402,53,212,98,114,2,30,1,1,allow
49230,53,32099,53,195,94,101,2,30,1,1,allow
59943,443,41706,443,2979,914,2065,10,120,5,5,allow
64585,80,64585,80,405673,21057,384616,519,26,252,267,allow
49416,443,60307,443,27484,4857,22627,42,46,15,27,allow
49646,443,41538,443,5647,1832,3815,16,36,9,7,allow
60307,443,42783,443,5574,1200,4374,26,80,13,13,allow
51140,443,48264,443,5759,1904,3855,19,15,11,8,allow
53374,443,16272,443,4317,1134,3183,16,26,9,7,allow
55579,58420,44629,58420,70,70,0,1,5,1,0,allow
53375,443,59892,443,4317,1134,3183,16,26,9,7,allow
65461,443,11386,443,396698,11870,384828,409,16,144,265,allow
33099,443,5841,443,11110,1700,9410,33,750,11,22,allow
56595,80,43530,80,234,234,0,4,12,4,0,allow
39135,443,24335,443,8286,2195,6091,24,256,12,12,allow
44363,443,4525,443,10667,2992,7675,32,560,17,15,allow
33327,53,12719,53,199,94,105,2,29,1,1,allow
51069,80,24367,80,254,128,126,5,15,3,2,allow
47993,443,45711,443,5272,1535,3737,17,35,12,5,allow
53868,53,29458,53,86,86,0,1,30,1,0,allow
53663,80,16666,80,149148,7515,141633,197,20,95,102,allow
55582,26957,64555,26957,70,70,0,1,5,1,0,allow
50377,80,8000,80,1451,796,655,11,31,6,5,allow
63709,21989,3950,21989,696,508,188,10,16,7,3,allow
58866,53,56575,53,355,118,237,2,29,1,1,allow
60425,443,26007,443,1541,1004,537,14,26,8,6,allow
64947,53,12228,53,402,118,284,2,29,1,1,allow
61412,53,24202,53,225,78,147,2,30,1,1,allow
50355,443,60927,443,4137,2232,1905,13,132,8,5,allow
41677,443,61867,443,7292,1489,5803,21,187,11,10,allow
37965,51719,40903,51719,481,150,331,2,1199,1,1,allow
35101,443,31000,443,4988930,161289,4827641,5384,290,1964,3420,allow
51701,24343,49961,24343,70,70,0,1,5,1,0,allow
55578,45682,64868,45682,70,70,0,1,5,1,0,allow
50313,80,63654,80,736,670,66,6,15,5,1,allow
46619,123,26763,123,184,94,90,2,30,1,1,allow
36928,53,43446,53,241,78,163,2,30,1,1,allow
37383,443,62473,443,11389,4837,6552,27,120,13,14,allow
56761,34725,47498,34725,70,70,0,1,5,1,0,allow
53180,443,55711,443,7876,3195,4681,22,20,11,11,allow
5588,5588,0,0,3562,1936,1626,48,192,24,24,allow
60302,443,30801,443,39850,4375,35475,73,80,31,42,allow
57318,53,50520,53,418,88,330,4,41,2,2,allow
55586,17332,63048,17332,70,70,0,2,8,2,0,allow
44674,80,41945,80,1298,624,674,12,16,5,7,allow
60374,17432,21315,17432,564,318,246,9,18,5,4,allow
53283,443,23870,443,9121,2486,6635,22,45,13,9,allow
64772,53,2611,53,633,231,402,6,47,3,3,allow
59793,443,44894,443,41635,3977,37658,63,121,25,38,allow
42025,443,40368,443,2394,1365,1029,18,275,9,9,allow
62101,443,33220,443,1867,250,1617,8,120,4,4,allow
56429,443,9683,443,355939,9284,346655,365,121,125,240,allow
15503,21394,46725,21394,479,150,329,2,1200,1,1,allow
6882,24271,34047,24271,228,118,110,2,1200,1,1,allow
51726,18475,34444,18475,316,136,180,6,7,3,3,allow
40299,443,53474,443,9574,2600,6974,29,136,16,13,allow
64000,53,61132,53,214,102,112,2,30,1,1,allow
51108,53,64155,53,168,78,90,2,30,1,1,allow
57099,53,12968,53,278,102,176,2,31,1,1,allow
52208,80,51352,80,372,246,126,6,28,4,2,allow
56408,443,56408,443,4373,1466,2907,19,28,11,8,allow
10602,3389,10602,3389,3910,1805,2105,20,19,12,8,allow
50961,80,36404,80,5730066,61301,5668765,4686,81,891,3795,allow
50308,80,8289,80,1083,653,430,8,16,5,3,allow
58959,53,45652,53,307,86,221,2,30,1,1,allow
30654,51221,0,0,72,72,0,1,0,1,0,deny
63062,35440,0,0,62,62,0,1,0,1,0,deny
49150,51505,0,0,146,146,0,1,0,1,0,deny
61495,37965,0,0,66,66,0,1,0,1,0,deny
53479,23,0,0,60,60,0,1,0,1,0,deny
50696,445,0,0,66,66,0,1,0,1,0,drop
28584,37965,0,0,62,62,0,1,0,1,0,deny
21173,37965,0,0,145,145,0,1,0,1,0,deny
43704,465,0,0,60,60,0,1,0,1,0,deny
443,29326,0,0,82,82,0,1,0,1,0,deny
64382,44847,0,0,66,66,0,1,0,1,0,deny
50211,445,0,0,70,70,0,1,0,1,0,drop
57837,64147,0,0,66,66,0,1,0,1,0,deny
59241,62413,0,0,66,66,0,1,0,1,0,deny
4431,32480,0,0,66,66,0,1,0,1,0,deny
53051,44847,0,0,66,66,0,1,0,1,0,deny
50681,445,0,0,66,66,0,1,0,1,0,drop
50636,23117,0,0,62,62,0,1,0,1,0,deny
64880,64147,0,0,62,62,0,1,0,1,0,deny
4041,50584,0,0,62,62,0,1,0,1,0,deny
2704,37,0,0,60,60,0,1,0,1,0,deny
64279,23718,0,0,146,146,0,1,0,1,0,deny
50207,445,0,0,70,70,0,1,0,1,0,drop
62148,37965,0,0,62,62,0,1,0,1,0,deny
50968,443,1243,443,469,403,66,4,0,3,1,allow
50969,443,54163,443,469,403,66,4,0,3,1,allow
56942,443,61847,443,494,420,74,4,0,3,1,allow
47063,15503,0,0,62,62,0,1,0,1,0,deny
55278,445,0,0,70,70,0,1,0,1,0,drop
55276,445,0,0,70,70,0,1,0,1,0,drop
55275,445,0,0,70,70,0,1,0,1,0,drop
61706,64147,0,0,62,62,0,1,0,1,0,deny
50674,445,0,0,66,66,0,1,0,1,0,drop
50670,445,0,0,66,66,0,1,0,1,0,drop
50668,445,0,0,66,66,0,1,0,1,0,drop
50673,445,0,0,66,66,0,1,0,1,0,drop
50671,445,0,0,66,66,0,1,0,1,0,drop
50672,445,0,0,66,66,0,1,0,1,0,drop
50666,445,0,0,66,66,0,1,0,1,0,drop
50667,445,0,0,66,66,0,1,0,1,0,drop
50198,445,0,0,70,70,0,1,0,1,0,drop
50196,445,0,0,70,70,0,1,0,1,0,drop
50195,445,0,0,70,70,0,1,0,1,0,drop
50192,445,0,0,70,70,0,1,0,1,0,drop
12694,12446,0,0,145,145,0,1,0,1,0,deny
51085,56205,0,0,66,66,0,1,0,1,0,deny
50191,445,0,0,70,70,0,1,0,1,0,drop
54080,26467,0,0,62,62,0,1,0,1,0,deny
6057,51221,0,0,78,78,0,1,0,1,0,deny
6666,401,0,0,60,60,0,1,0,1,0,deny
60184,37965,0,0,66,66,0,1,0,1,0,deny
51948,37965,0,0,62,62,0,1,0,1,0,deny
443,29326,0,0,82,82,0,1,0,1,0,deny
50561,55777,0,0,62,62,0,1,0,1,0,deny
55273,445,0,0,70,70,0,1,0,1,0,drop
55265,445,0,0,70,70,0,1,0,1,0,drop
55261,445,0,0,70,70,0,1,0,1,0,drop
59059,80,0,0,62,62,0,1,0,1,0,deny
50184,445,0,0,70,70,0,1,0,1,0,drop
50654,445,0,0,66,66,0,1,0,1,0,drop
50652,445,0,0,66,66,0,1,0,1,0,drop
50653,445,0,0,66,66,0,1,0,1,0,drop
3352,50584,0,0,66,66,0,1,0,1,0,deny
55258,445,0,0,70,70,0,1,0,1,0,drop
25151,58833,0,0,62,62,0,1,0,1,0,deny
14903,10387,0,0,159,159,0,1,0,1,0,deny
50177,445,0,0,70,70,0,1,0,1,0,drop
55255,445,0,0,70,70,0,1,0,1,0,drop
50174,445,0,0,70,70,0,1,0,1,0,drop
45941,23386,0,0,60,60,0,1,0,1,0,deny
57107,64147,0,0,66,66,0,1,0,1,0,deny
55252,445,0,0,70,70,0,1,0,1,0,drop
55251,445,0,0,70,70,0,1,0,1,0,drop
55244,445,0,0,70,70,0,1,0,1,0,drop
5223,1210,0,0,103,103,0,1,0,1,0,deny
51716,44847,0,0,62,62,0,1,0,1,0,deny
50065,44847,0,0,62,62,0,1,0,1,0,deny
35849,30188,0,0,146,146,0,1,0,1,0,deny
50170,445,0,0,70,70,0,1,0,1,0,drop
36538,64147,0,0,62,62,0,1,0,1,0,deny
50169,445,0,0,70,70,0,1,0,1,0,drop
0,0,0,0,60,60,0,1,0,1,0,deny
0,0,0,0,480,244,236,4,0,2,2,allow
19416,23,0,0,60,60,0,1,0,1,0,deny
24037,53415,0,0,76,76,0,1,0,1,0,deny
50165,445,0,0,70,70,0,1,0,1,0,drop
57360,18375,0,0,66,66,0,1,0,1,0,deny
55235,445,0,0,70,70,0,1,0,1,0,drop
55236,445,0,0,70,70,0,1,0,1,0,drop
55231,445,0,0,70,70,0,1,0,1,0,drop
60441,5900,0,0,60,60,0,1,0,1,0,deny
50375,50584,0,0,62,62,0,1,0,1,0,deny
50163,445,0,0,70,70,0,1,0,1,0,drop
68,67,0,0,594,594,0,1,0,1,0,deny
53957,35440,0,0,62,62,0,1,0,1,0,deny
42995,26467,0,0,62,62,0,1,0,1,0,deny
11552,44847,0,0,62,62,0,1,0,1,0,deny
53960,30041,0,0,66,66,0,1,0,1,0,deny
50159,445,0,0,70,70,0,1,0,1,0,drop
50632,445,0,0,66,66,0,1,0,1,0,drop
55230,445,0,0,70,70,0,1,0,1,0,drop
55228,445,0,0,70,70,0,1,0,1,0,drop
52451,56205,0,0,66,66,0,1,0,1,0,deny
49386,64147,0,0,62,62,0,1,0,1,0,deny
3777,64097,0,0,146,146,0,1,0,1,0,deny
58446,56205,0,0,62,62,0,1,0,1,0,deny
39100,2767,0,0,62,62,0,1,0,1,0,deny
5223,1210,0,0,66,66,0,1,0,1,0,deny
50626,445,0,0,66,66,0,1,0,1,0,drop
50834,64147,0,0,62,62,0,1,0,1,0,deny
50622,445,0,0,66,66,0,1,0,1,0,drop
57763,52752,0,0,66,66,0,1,0,1,0,deny
42298,40002,11642,40002,724,550,174,4,30,2,2,allow
53471,8118,42759,8118,1745,1091,654,10,31,5,5,allow
57814,443,32836,443,6162,925,5237,18,108,10,8,allow
53004,80,58597,80,9956,2570,7386,21,335,10,11,allow
58700,443,30626,443,8124,1079,7045,16,26,8,8,allow
42298,51408,45869,51408,725,325,400,12,31,6,6,allow
49631,53,0,0,82,82,0,1,30,1,0,allow
52461,443,54450,443,16541,4900,11641,62,131,26,36,allow
57263,443,6071,443,7748,3859,3889,20,148,10,10,allow
52916,80,53748,80,4266,1776,2490,20,367,11,9,allow
60152,80,38610,80,1056,682,374,10,15,6,4,allow
53000,80,5659,80,1991,686,1305,10,335,6,4,allow
52096,443,12292,443,86745,6260,80485,121,32,58,63,allow
42298,40018,26921,40018,148,86,62,2,30,1,1,allow
12299,53,12299,53,229,89,140,2,30,1,1,allow
51167,443,46694,443,13777,1743,12034,26,31,12,14,allow
50301,80,40498,80,7979,802,7177,17,39,8,9,allow
63707,28423,64677,28423,564,382,182,9,16,6,3,allow
38725,80,37134,80,130,70,60,2,15,1,1,allow
49816,80,56471,80,130,70,60,2,15,1,1,allow
43314,443,11137,443,27958,21973,5985,77,403,43,34,allow
37780,443,20085,443,1403708,31893,1371815,1301,162,292,1009,allow
51728,55504,11641,55504,316,136,180,6,6,3,3,allow
39540,80,37629,80,130,70,60,2,15,1,1,allow
63728,11785,52016,11785,66,66,0,2,8,2,0,allow
42298,40031,35344,40031,1346,662,684,8,32,4,4,allow
56753,38028,14806,38028,156,66,90,2,5,1,1,allow
46981,443,34961,443,2809,1884,925,19,25,11,8,allow
51698,63846,26436,63846,66,66,0,1,5,1,0,allow
5588,5588,0,0,3562,1936,1626,48,191,24,24,allow
65045,53,53307,53,194,99,95,2,30,1,1,allow
35905,443,10061,443,8272,2091,6181,25,331,12,13,allow
42298,40001,24361,40001,140,78,62,2,31,1,1,allow
42298,40007,30822,40007,143,81,62,2,31,1,1,allow
50027,80,48247,80,3648,2069,1579,16,85,9,7,allow
53852,80,48149,80,130,70,60,2,15,1,1,allow
52999,80,62826,80,1991,686,1305,10,335,6,4,allow
52930,80,36918,80,76193,2105,74088,75,359,23,52,allow
52928,80,52040,80,1996,691,1305,10,359,6,4,allow
51699,37224,26533,37224,66,66,0,1,5,1,0,allow
57813,443,65376,443,6163,925,5238,18,109,10,8,allow
56754,14715,43516,14715,66,66,0,1,5,1,0,allow
35965,443,35465,443,14940,9434,5506,30,105,17,13,allow
50380,80,4994,80,3190,980,2210,13,30,7,6,allow
39796,443,27327,443,7425,2276,5149,24,16,12,12,allow
56876,443,56876,443,18542,1778,16764,30,17,15,15,allow
42298,40036,17125,40036,141,79,62,2,30,1,1,allow
34717,53,24183,53,168,78,90,2,31,1,1,allow
42298,40006,18530,40006,243,180,63,2,31,1,1,allow
54521,443,4685,443,1574197,46737,1527460,1590,34,557,1033,allow
56524,53,52908,53,711,87,624,2,31,1,1,allow
42298,40002,3434,40002,241,178,63,2,31,1,1,allow
55461,443,39176,443,2341,540,1801,9,121,5,4,allow
33624,443,6639,443,247438,52606,194832,305,237,124,181,allow
63587,443,60950,443,10576,3685,6891,46,92,24,22,allow
35087,443,32747,443,6053,3586,2467,17,135,8,9,allow
42298,40025,58686,40025,140,78,62,2,31,1,1,allow
42298,40019,18664,40019,597,79,518,2,31,1,1,allow
42298,443,10335,443,64,64,0,1,31,1,0,allow
50875,443,41381,443,1786,172,1614,7,121,3,4,allow
123,123,7719,123,184,94,90,2,31,1,1,allow
52797,443,2237,443,6876,3332,3544,22,140,11,11,allow
5938,37145,0,0,60,60,0,1,90,1,0,allow
55216,445,0,0,70,70,0,1,0,1,0,drop
51426,59737,0,0,100,100,0,1,0,1,0,deny
50146,445,0,0,70,70,0,1,0,1,0,drop
55212,445,0,0,70,70,0,1,0,1,0,drop
55211,445,0,0,70,70,0,1,0,1,0,drop
55207,445,0,0,70,70,0,1,0,1,0,drop
50620,445,0,0,66,66,0,1,0,1,0,drop
53314,64097,0,0,66,66,0,1,0,1,0,deny
50143,445,0,0,70,70,0,1,0,1,0,drop
21998,51221,0,0,62,62,0,1,0,1,0,deny
53233,51221,0,0,66,66,0,1,0,1,0,deny
62331,61689,0,0,66,66,0,1,0,1,0,deny
51769,80,52683,80,74039,4367,69672,91,19,40,51,allow
50877,80,27709,80,186520,11545,174975,222,141,96,126,allow
46417,443,30278,443,359878,6703,353175,325,36,88,237,allow
58972,80,64079,80,943,513,430,9,14,6,3,allow
52207,80,29595,80,372,246,126,6,27,4,2,allow
65045,53,16728,53,197,102,95,2,29,1,1,allow
56051,53,2559,53,249,102,147,2,29,1,1,allow
50935,80,3414,80,8167195,108448,8058747,7107,121,1531,5576,allow
34765,5222,48630,5222,10109,3480,6629,72,615,38,34,allow
51567,443,51567,443,1654,916,738,16,126,7,9,allow
49952,53,43225,53,196,94,102,2,30,1,1,allow
35190,80,55473,80,130,70,60,2,14,1,1,allow
50890,80,12548,80,290951,15209,275742,327,141,132,195,allow
52206,80,42642,80,372,246,126,6,27,4,2,allow
29025,53,29025,53,235,90,145,2,31,1,1,allow
61713,80,49521,80,134,60,74,3,5,2,1,allow
61707,80,47062,80,134,60,74,3,4,2,1,allow
53350,80,3605,80,1712,913,799,12,273,7,5,allow
47655,53,46246,53,168,78,90,2,29,1,1,allow
64045,53,1404,53,1011,232,779,6,55,3,3,allow
50876,80,52453,80,121344,7345,113999,144,141,61,83,allow
64735,53,29173,53,350,118,232,2,29,1,1,allow
49811,53,32866,53,308,110,198,2,29,1,1,allow
64382,53,40543,53,278,102,176,2,30,1,1,allow
65450,53,49502,53,336,110,226,2,30,1,1,allow
33954,53,7602,53,168,78,90,2,29,1,1,allow
52182,53,52182,53,832,106,726,2,30,1,1,allow
49232,53,52451,53,242,78,164,2,29,1,1,allow
51723,10622,43836,10622,70,70,0,2,8,2,0,allow
59601,443,24962,443,162,102,60,2,5,1,1,allow
53181,443,19571,443,2309,1443,866,16,17,8,8,allow
52607,80,12616,80,2543,691,1852,13,30,8,5,allow
42298,40022,6562,40022,148,86,62,2,30,1,1,allow
23331,53,23331,53,242,98,144,2,30,1,1,allow
53298,80,1119,80,12660,7492,5168,27,274,14,13,allow
56377,80,8742,80,1633,943,690,15,72,8,7,allow
55887,53,55333,53,212,94,118,2,30,1,1,allow
53002,80,19802,80,1601,761,840,10,334,6,4,allow
50892,80,51133,80,256436,14131,242305,283,141,111,172,allow
56862,443,9641,443,7819,1662,6157,20,76,11,9,allow
46746,443,33868,443,7002,4142,2860,46,1485,29,17,allow
57092,53,3743,53,228,102,126,2,30,1,1,allow
43705,443,47459,443,8060,2001,6059,24,19,14,10,allow
52626,80,56571,80,2820,1466,1354,20,534,11,9,allow
64351,53,15747,53,228,102,126,2,30,1,1,allow
37707,53,28750,53,168,78,90,2,30,1,1,allow
50886,80,22505,80,312952,13869,299083,347,141,138,209,allow
49976,53,5693,53,393,110,283,2,30,1,1,allow
42298,40007,6536,40007,148,86,62,2,30,1,1,allow
54367,3389,54367,3389,4365,2581,1784,20,32,11,9,allow
62768,443,53717,443,30902,6307,24595,86,269,36,50,allow
50883,80,64742,80,204646,11741,192905,240,141,104,136,allow
53006,80,12227,80,1988,742,1246,10,334,6,4,allow
52960,80,43936,80,82011,2937,79074,91,358,34,57,allow
59877,80,9809,80,1306,557,749,10,25,6,4,allow
55179,53,7582,53,194,102,92,2,33,1,1,allow
50873,80,11525,80,173653,9305,164348,189,141,73,116,allow
50414,80,48434,80,1657,1246,411,8,15,5,3,allow
49287,53,21721,53,405,90,315,4,59,2,2,allow
42298,40007,31436,40007,148,86,62,2,30,1,1,allow
65306,53,12072,53,244,94,150,2,30,1,1,allow
45725,443,40804,443,8600,4882,3718,44,225,23,21,allow
55028,443,3475,443,1403116,30089,1373027,1321,32,404,917,allow
43208,443,45939,443,4296557,96359,4200198,3781,143,838,2943,allow
50934,80,52977,80,10213447,100765,10112682,8215,121,1412,6803,allow
42298,40022,48973,40022,730,548,182,4,30,2,2,allow
60193,443,30919,443,677029,102078,574951,1152,455,559,593,allow
63712,21917,18745,21917,504,382,122,8,15,6,2,allow
52481,443,46031,443,6270,1368,4902,22,15,12,10,allow
53206,80,36804,80,2622,1074,1548,14,282,8,6,allow
52209,80,41464,80,372,246,126,6,27,4,2,allow
53107,44060,63943,44060,70,70,0,2,8,2,0,allow
43412,80,13841,80,78,78,0,1,4,1,0,allow
36927,80,32507,80,130,70,60,2,14,1,1,allow
65462,443,5746,443,92384,4519,87865,105,15,39,66,allow
52210,80,30096,80,372,246,126,6,30,4,2,allow
60470,443,16410,443,7289,1899,5390,29,317,16,13,allow
53886,443,35805,443,6074,1579,4495,18,125,11,7,allow
65045,53,56055,53,197,102,95,2,32,1,1,allow
63366,30365,36289,30365,70,70,0,1,4,1,0,allow
63704,28291,53778,28291,504,382,122,8,15,6,2,allow
50889,80,11268,80,397616,15684,381932,419,141,157,262,allow
65233,53,6826,53,448,130,318,4,44,2,2,allow
65169,80,56657,80,1516,481,1035,11,15,6,5,allow
47729,443,6419,443,15600,2166,13434,32,205,16,16,allow
54498,443,44231,443,8060,2001,6059,24,19,14,10,allow
64454,53,61289,53,293,110,183,2,29,1,1,allow
65309,53,47712,53,258,110,148,2,30,1,1,allow
57604,53,48752,53,290,86,204,2,29,1,1,allow
54385,53,14777,53,168,78,90,2,30,1,1,allow
50887,80,30027,80,256649,11414,245235,280,141,111,169,allow
56404,80,13755,80,17376,1687,15689,28,40,12,16,allow
55320,53,12991,53,239,102,137,2,30,1,1,allow
58151,53,58151,53,241,98,143,2,30,1,1,allow
42298,40020,48690,40020,148,86,62,2,30,1,1,allow
41910,443,63630,443,9358,2304,7054,39,120,20,19,allow
60520,53,60520,53,198,90,108,2,30,1,1,allow
55087,53,44618,53,344,110,234,2,30,1,1,allow
50388,53,36843,53,177,94,83,2,30,1,1,allow
42298,40038,63975,40038,148,86,62,2,30,1,1,allow
42298,40031,52392,40031,156,94,62,2,30,1,1,allow
57589,53,7858,53,165,78,87,2,30,1,1,allow
42298,40015,12335,40015,140,78,62,2,31,1,1,allow
42298,40022,41026,40022,717,551,166,4,31,2,2,allow
36567,443,58934,443,2341,1054,1287,20,299,7,13,allow
64575,53,36717,53,268,110,158,2,31,1,1,allow
53028,80,12775,80,3470,1464,2006,21,190,10,11,allow
60735,28080,14759,28080,70,70,0,1,5,1,0,allow
56376,80,29400,80,1635,945,690,15,72,8,7,allow
50884,80,30103,80,238059,13790,224269,276,141,113,163,allow
43465,80,31398,80,1352,848,504,13,255,8,5,allow
5588,5588,0,0,3498,1872,1626,48,195,24,24,allow
42298,40005,19733,40005,148,86,62,2,30,1,1,allow
42298,40017,13967,40017,148,86,62,2,30,1,1,allow
54942,53,0,0,168,74,94,2,30,1,1,allow
52951,80,38288,80,6266,4430,1836,22,358,13,9,allow
51697,60619,59919,60619,70,70,0,1,5,1,0,allow
57802,80,24943,80,2762,2628,134,8,17,6,2,allow
53271,443,53446,443,34908,2650,32258,52,45,23,29,allow
64006,53,16897,53,394,96,298,4,47,2,2,allow
65519,53,27344,53,321,102,219,2,30,1,1,allow
42298,40005,17939,40005,263,182,81,2,30,1,1,allow
42298,40039,50865,40039,602,86,516,2,30,1,1,allow
50882,80,51896,80,207895,10483,197412,229,141,90,139,allow
52946,80,56196,80,4085,2870,1215,23,358,14,9,allow
55004,443,32429,443,1334906,33112,1301794,1315,35,446,869,allow
52959,80,37640,80,122572,3630,118942,128,358,46,82,allow
53534,40960,13903,40960,320,140,180,6,6,3,3,allow
36486,80,36486,80,15249,1015,14234,24,29,9,15,allow
56375,80,51111,80,1609,919,690,15,72,8,7,allow
50874,80,33456,80,331828,15003,316825,363,141,140,223,allow
55350,53,18566,53,315,95,220,4,50,2,2,allow
41776,443,6550,443,32434,15588,16846,164,1128,83,81,allow
42298,40008,62209,40008,148,86,62,2,30,1,1,allow
42298,40042,16142,40042,148,86,62,2,30,1,1,allow
42298,40028,40095,40028,563,86,477,2,30,1,1,allow
10151,51413,40673,51413,460,150,310,2,1200,1,1,allow
42298,40032,22903,40032,720,549,171,4,30,2,2,allow
49899,53,23402,53,718,94,624,2,30,1,1,allow
52824,443,27899,443,4114,2920,1194,19,80,11,8,allow
39508,53,12625,53,78,78,0,1,30,1,0,allow
65454,53,35372,53,218,86,132,2,31,1,1,allow
27269,53,56522,53,199,94,105,2,31,1,1,allow
42298,40010,41895,40010,1082,86,996,2,31,1,1,allow
42298,40030,21853,40030,546,486,60,2,30,1,1,allow
42298,40014,14476,40014,148,86,62,2,31,1,1,allow
52431,443,19671,443,7396,3677,3719,16,120,8,8,allow
64744,53,33076,53,376,118,258,2,30,1,1,allow
42298,40014,10112,40014,140,78,62,2,31,1,1,allow
51221,6881,43660,6881,479,150,329,2,1200,1,1,allow
42298,40010,33875,40010,148,86,62,2,31,1,1,allow
57587,443,4519,443,15613,1408,14205,32,125,15,17,allow
59570,443,54074,443,6713,3052,3661,49,5974,15,34,allow
57588,53,31636,53,165,78,87,2,30,1,1,allow
49428,53,34747,53,267,94,173,2,31,1,1,allow
42298,40020,47579,40020,148,86,62,2,31,1,1,allow
42298,40021,40004,40021,148,86,62,2,31,1,1,allow
39992,443,33603,443,3470,1045,2425,13,121,6,7,allow
53512,23280,49318,23280,1950,957,993,17,17,10,7,allow
50291,80,56837,80,442,250,192,8,45,5,3,allow
59494,443,39878,443,448,78,370,6,25,1,5,allow
50881,80,32099,80,128327,7366,120961,154,141,67,87,allow
51510,443,23309,443,1047,560,487,10,16,6,4,allow
50938,80,32549,80,10272889,104948,10167941,8416,121,1525,6891,allow
49758,443,14307,443,17412,6917,10495,38,63,20,18,allow
44924,53,44924,53,235,90,145,2,32,1,1,allow
53522,24116,32649,24116,70,70,0,2,8,2,0,allow
55640,53,37187,53,797,208,589,6,67,3,3,allow
57959,21247,0,0,66,66,0,1,0,1,0,deny
55203,445,0,0,70,70,0,1,0,1,0,drop
55199,445,0,0,70,70,0,1,0,1,0,drop
55198,445,0,0,70,70,0,1,0,1,0,drop
55196,445,0,0,70,70,0,1,0,1,0,drop
50611,445,0,0,66,66,0,1,0,1,0,drop
50138,445,0,0,70,70,0,1,0,1,0,drop
50604,445,0,0,66,66,0,1,0,1,0,drop
50610,445,0,0,66,66,0,1,0,1,0,drop
50606,445,0,0,66,66,0,1,0,1,0,drop
5223,1210,0,0,66,66,0,1,0,1,0,deny
5223,1210,0,0,103,103,0,1,0,1,0,deny
50137,445,0,0,70,70,0,1,0,1,0,drop
45912,44847,0,0,62,62,0,1,0,1,0,deny
50603,445,0,0,66,66,0,1,0,1,0,drop
50602,445,0,0,66,66,0,1,0,1,0,drop
50601,445,0,0,66,66,0,1,0,1,0,drop
50135,445,0,0,70,70,0,1,0,1,0,drop
1025,64147,0,0,62,62,0,1,0,1,0,deny
31062,50584,0,0,62,62,0,1,0,1,0,deny
64177,44847,0,0,66,66,0,1,0,1,0,deny
55193,445,0,0,70,70,0,1,0,1,0,drop
55191,445,0,0,70,70,0,1,0,1,0,drop
55190,445,0,0,70,70,0,1,0,1,0,drop
52611,9571,0,0,62,62,0,1,0,1,0,deny
59942,22114,0,0,62,62,0,1,0,1,0,deny
50596,445,0,0,66,66,0,1,0,1,0,drop
56798,9571,0,0,66,66,0,1,0,1,0,deny
53030,56205,0,0,66,66,0,1,0,1,0,deny
54827,50432,0,0,109,109,0,1,0,1,0,deny
55187,445,0,0,70,70,0,1,0,1,0,drop
50595,445,0,0,66,66,0,1,0,1,0,drop
10494,23,0,0,60,60,0,1,0,1,0,deny
1773,11392,0,0,62,62,0,1,0,1,0,deny
50593,445,0,0,66,66,0,1,0,1,0,drop
50592,445,0,0,66,66,0,1,0,1,0,drop
55212,53733,0,0,66,66,0,1,0,1,0,deny
50128,445,0,0,70,70,0,1,0,1,0,drop
61670,57470,0,0,74,74,0,1,0,1,0,deny
2704,37,0,0,60,60,0,1,0,1,0,deny
50589,445,0,0,66,66,0,1,0,1,0,drop
4607,6004,0,0,70,70,0,1,0,1,0,deny
50126,445,0,0,70,70,0,1,0,1,0,drop
55919,64147,0,0,62,62,0,1,0,1,0,deny
50125,445,0,0,70,70,0,1,0,1,0,drop
50124,445,0,0,70,70,0,1,0,1,0,drop
55182,445,0,0,70,70,0,1,0,1,0,drop
50123,445,0,0,70,70,0,1,0,1,0,drop
49578,80,61645,80,25846,2486,23360,39,50,16,23,allow
50118,445,0,0,70,70,0,1,0,1,0,drop
50119,445,0,0,70,70,0,1,0,1,0,drop
55172,445,0,0,70,70,0,1,0,1,0,drop
55173,445,0,0,70,70,0,1,0,1,0,drop
26573,44847,0,0,66,66,0,1,0,1,0,deny
42469,30188,0,0,62,62,0,1,0,1,0,deny
29145,8168,0,0,62,62,0,1,0,1,0,deny
9775,30188,0,0,62,62,0,1,0,1,0,deny
50578,445,0,0,66,66,0,1,0,1,0,drop
9544,11392,0,0,62,62,0,1,0,1,0,deny
50105,445,0,0,70,70,0,1,0,1,0,drop
50104,445,0,0,70,70,0,1,0,1,0,drop
50100,445,0,0,70,70,0,1,0,1,0,drop
56564,9571,0,0,78,78,0,1,0,1,0,deny
56100,57470,0,0,62,62,0,1,0,1,0,deny
50095,445,0,0,70,70,0,1,0,1,0,drop
50094,445,0,0,70,70,0,1,0,1,0,drop
20939,60461,0,0,60,60,0,1,0,1,0,deny
61357,64147,0,0,62,62,0,1,0,1,0,deny
37234,44847,0,0,66,66,0,1,0,1,0,deny
20939,60461,0,0,60,60,0,1,0,1,0,deny
2904,44847,0,0,78,78,0,1,0,1,0,deny
50571,445,0,0,66,66,0,1,0,1,0,drop
55160,445,0,0,70,70,0,1,0,1,0,drop
2704,37,0,0,60,60,0,1,0,1,0,deny
45941,23386,0,0,60,60,0,1,0,1,0,deny
50568,445,0,0,66,66,0,1,0,1,0,drop
17916,23,0,0,60,60,0,1,0,1,0,deny
50082,445,0,0,70,70,0,1,0,1,0,drop
21294,57470,0,0,62,62,0,1,0,1,0,deny
58715,57470,0,0,66,66,0,1,0,1,0,deny
58635,51505,0,0,62,62,0,1,0,1,0,deny
53353,26467,0,0,62,62,0,1,0,1,0,deny
25342,8168,0,0,66,66,0,1,0,1,0,deny
7916,23,0,0,60,60,0,1,0,1,0,deny
50562,445,0,0,66,66,0,1,0,1,0,drop
51233,43890,0,0,66,66,0,1,0,1,0,deny
62588,57470,0,0,146,146,0,1,0,1,0,deny
50553,445,0,0,66,66,0,1,0,1,0,drop
50078,445,0,0,70,70,0,1,0,1,0,drop
2791,7302,0,0,62,62,0,1,0,1,0,deny
11967,57470,0,0,62,62,0,1,0,1,0,deny
6057,51221,0,0,78,78,0,1,0,1,0,deny
50067,445,0,0,70,70,0,1,0,1,0,drop
50069,445,0,0,70,70,0,1,0,1,0,drop
13160,7905,0,0,62,62,0,1,0,1,0,deny
50065,445,0,0,70,70,0,1,0,1,0,drop
50064,445,0,0,70,70,0,1,0,1,0,drop
55152,445,0,0,70,70,0,1,0,1,0,drop
55148,445,0,0,70,70,0,1,0,1,0,drop
55147,445,0,0,70,70,0,1,0,1,0,drop
55262,44847,0,0,62,62,0,1,0,1,0,deny
50061,445,0,0,70,70,0,1,0,1,0,drop
50546,445,0,0,66,66,0,1,0,1,0,drop
50544,445,0,0,66,66,0,1,0,1,0,drop
50545,445,0,0,66,66,0,1,0,1,0,drop
50543,445,0,0,66,66,0,1,0,1,0,drop
50542,445,0,0,66,66,0,1,0,1,0,drop
50539,445,0,0,66,66,0,1,0,1,0,drop
50540,445,0,0,66,66,0,1,0,1,0,drop
50538,445,0,0,66,66,0,1,0,1,0,drop
13179,57866,0,0,62,62,0,1,0,1,0,deny
42753,56205,0,0,62,62,0,1,0,1,0,deny
61600,56205,0,0,66,66,0,1,0,1,0,deny
57955,44847,0,0,62,62,0,1,0,1,0,deny
59586,57470,0,0,66,66,0,1,0,1,0,deny
443,63113,0,0,100,100,0,1,0,1,0,deny
11136,17500,0,0,145,145,0,1,0,1,0,deny
50055,445,0,0,70,70,0,1,0,1,0,drop
65528,62413,0,0,62,62,0,1,0,1,0,deny
55145,445,0,0,70,70,0,1,0,1,0,drop
55133,445,0,0,70,70,0,1,0,1,0,drop
55131,445,0,0,70,70,0,1,0,1,0,drop
35940,47808,0,0,60,60,0,1,0,1,0,deny
58023,47808,0,0,60,60,0,1,0,1,0,deny
50526,445,0,0,66,66,0,1,0,1,0,drop
50524,445,0,0,66,66,0,1,0,1,0,drop
50525,445,0,0,66,66,0,1,0,1,0,drop
0,0,0,0,600,306,294,6,0,3,3,allow
0,0,0,0,600,306,294,6,0,3,3,allow
0,0,0,0,600,306,294,6,0,3,3,allow
53771,37965,0,0,66,66,0,1,0,1,0,deny
33405,37965,0,0,62,62,0,1,0,1,0,deny
52321,26467,0,0,62,62,0,1,0,1,0,deny
55129,445,0,0,70,70,0,1,0,1,0,drop
50048,445,0,0,70,70,0,1,0,1,0,drop
65493,51221,0,0,62,62,0,1,0,1,0,deny
1487,35440,0,0,146,146,0,1,0,1,0,deny
54346,44847,0,0,66,66,0,1,0,1,0,deny
50046,445,0,0,70,70,0,1,0,1,0,drop
50,64147,0,0,66,66,0,1,0,1,0,deny
55127,445,0,0,70,70,0,1,0,1,0,drop
18592,44612,0,0,62,62,0,1,0,1,0,deny
55123,445,0,0,70,70,0,1,0,1,0,drop
55120,445,0,0,70,70,0,1,0,1,0,drop
55117,445,0,0,70,70,0,1,0,1,0,drop
46627,36237,0,0,62,62,0,1,0,1,0,deny
45941,23388,0,0,60,60,0,1,0,1,0,deny
37213,36237,0,0,66,66,0,1,0,1,0,deny
50041,445,0,0,70,70,0,1,0,1,0,drop
50040,445,0,0,70,70,0,1,0,1,0,drop
57226,51505,0,0,66,66,0,1,0,1,0,deny
3272,1433,0,0,60,60,0,1,0,1,0,deny
26799,50584,0,0,146,146,0,1,0,1,0,deny
60132,50584,0,0,66,66,0,1,0,1,0,deny
50036,445,0,0,70,70,0,1,0,1,0,drop
23650,37807,0,0,66,66,0,1,0,1,0,deny
49812,26467,0,0,62,62,0,1,0,1,0,deny
63786,35440,0,0,66,66,0,1,0,1,0,deny
62569,44847,0,0,66,66,0,1,0,1,0,deny
62348,51221,0,0,72,72,0,1,0,1,0,deny
50035,445,0,0,70,70,0,1,0,1,0,drop
55109,445,0,0,70,70,0,1,0,1,0,drop
55108,445,0,0,70,70,0,1,0,1,0,drop
55103,445,0,0,70,70,0,1,0,1,0,drop
47832,50584,0,0,62,62,0,1,0,1,0,deny
6666,3389,0,0,60,60,0,1,0,1,0,deny
8999,57470,0,0,146,146,0,1,0,1,0,deny
15313,34068,0,0,146,146,0,1,0,1,0,deny
50030,445,0,0,70,70,0,1,0,1,0,drop
19099,56205,0,0,62,62,0,1,0,1,0,deny
42298,4126,11425,4126,132,64,68,2,30,1,1,allow
50450,80,35672,80,2781,563,2218,11,125,6,5,allow
53189,80,57818,80,1873,713,1160,10,15,5,5,allow
48757,443,52585,443,6353,1075,5278,18,33,10,8,allow
50334,443,44789,443,8863,1567,7296,24,41,12,12,allow
50348,443,42997,443,1385,868,517,12,30,6,6,allow
50017,443,23366,443,56408,47400,9008,88,138,49,39,allow
58196,53,55117,53,578,286,292,9,16,5,4,allow
48758,443,1312,443,6353,1075,5278,18,33,10,8,allow
50388,443,13080,443,6734,4301,2433,21,29,12,9,allow
53525,34759,57554,34759,70,70,0,2,8,2,0,allow
57957,80,26267,80,3524,1945,1579,32,131,17,15,allow
54192,443,18650,443,17821,7006,10815,95,448,48,47,allow
42298,40018,41162,40018,629,83,546,4,31,2,2,allow
57170,53,64269,53,200,102,98,2,31,1,1,allow
50451,80,13158,80,2673,564,2109,11,125,6,5,allow
42298,58000,33594,58000,596,256,340,10,30,5,5,allow
61484,443,59400,443,9479,3507,5972,24,16,12,12,allow
53191,80,63359,80,1871,712,1159,10,15,5,5,allow
42298,40023,18178,40023,1531,729,802,10,31,5,5,allow
42298,40023,34639,40023,1188,567,621,6,31,3,3,allow
59513,53,30834,53,212,92,120,2,30,1,1,allow
57200,53,48391,53,711,87,624,2,30,1,1,allow
35041,80,18613,80,3515,1137,2378,12,30,7,5,allow
42298,40029,57945,40029,652,83,569,4,31,2,2,allow
50391,443,17235,443,5968,985,4983,17,29,8,9,allow
27735,53,27735,53,235,90,145,2,32,1,1,allow
39200,443,57759,443,8918,2361,6557,35,255,18,17,allow
53524,45395,6631,45395,70,70,0,2,8,2,0,allow
49473,80,51676,80,388,262,126,7,29,5,2,allow
48754,443,18594,443,6490,1145,5345,20,33,11,9,allow
50336,443,6025,443,8814,1579,7235,24,41,12,12,allow
50347,443,6764,443,1385,868,517,12,30,6,6,allow
48755,443,25931,443,6423,1145,5278,19,33,11,8,allow
53190,80,50867,80,1873,713,1160,10,15,5,5,allow
49272,7000,49272,7000,3132,815,2317,14,15,7,7,allow
54942,53,0,0,631,74,557,2,30,1,1,allow
50028,443,29629,443,15425,9901,5524,33,84,17,16,allow
57866,53,0,0,216,80,136,2,30,1,1,allow
5588,5588,0,0,3562,1936,1626,48,195,24,24,allow
42298,40009,62202,40009,148,86,62,2,30,1,1,allow
55587,32217,8141,32217,320,140,180,6,6,3,3,allow
50373,443,36496,443,4695,859,3836,17,30,9,8,allow
50374,443,25596,443,4749,859,3890,18,30,9,9,allow
50349,443,62395,443,1385,868,517,12,30,6,6,allow
60424,443,16988,443,1477,940,537,13,26,7,6,allow
50345,443,44342,443,1385,868,517,12,30,6,6,allow
33818,443,39799,443,16265,3132,13133,54,276,26,28,allow
50375,443,20024,443,4707,865,3842,17,30,9,8,allow
50346,443,6974,443,1385,868,517,12,30,6,6,allow
42298,40040,5414,40040,140,78,62,2,30,1,1,allow
48756,443,37837,443,6353,1075,5278,18,33,10,8,allow
42298,40027,29472,40027,144,82,62,2,30,1,1,allow
5588,5588,0,0,3498,1872,1626,48,195,24,24,allow
42298,40008,56571,40008,206,84,122,4,31,2,2,allow
123,123,49338,123,184,94,90,2,30,1,1,allow
59390,53,43106,53,184,86,98,2,31,1,1,allow
49608,53,10158,53,170,87,83,2,31,1,1,allow
55179,53,36377,53,188,96,92,2,31,1,1,allow
49160,9703,22798,9703,842,150,692,4,1200,2,2,allow
61741,443,4502,443,68851,3430,65421,93,121,35,58,allow
57470,5382,65418,5382,2411,1328,1083,19,1200,11,8,allow
53500,443,28730,443,3036,975,2061,14,136,7,7,allow
50503,445,0,0,66,66,0,1,0,1,0,drop
57750,37965,0,0,62,62,0,1,0,1,0,deny
55100,445,0,0,70,70,0,1,0,1,0,drop
55099,445,0,0,70,70,0,1,0,1,0,drop
51197,30188,0,0,66,66,0,1,0,1,0,deny
44746,37965,0,0,62,62,0,1,0,1,0,deny
42298,25161,56288,25161,138,70,68,2,30,1,1,allow
65196,53,4463,53,177,94,83,2,30,1,1,allow
64369,53,59649,53,240,110,130,2,30,1,1,allow
35414,53,44913,53,168,78,90,2,30,1,1,allow
50876,443,55719,443,1786,172,1614,7,120,3,4,allow
55718,27025,19303,27025,1778,1386,392,8,30,4,4,allow
38167,443,36158,443,6150,914,5236,18,16,10,8,allow
48731,443,51910,443,769074,31261,737813,876,165,356,520,allow
51861,53,51861,53,305,160,145,3,33,2,1,allow
63727,61557,39781,61557,312,132,180,6,6,3,3,allow
63976,53,54023,53,200,102,98,2,33,1,1,allow
42298,40028,3543,40028,148,86,62,2,29,1,1,allow
62332,53,0,0,633,75,558,2,29,1,1,allow
65196,53,58386,53,177,94,83,2,30,1,1,allow
49935,53,55130,53,458,111,347,4,59,2,2,allow
50305,80,32825,80,5500,2829,2671,19,34,10,9,allow
53527,45626,48951,45626,70,70,0,2,7,2,0,allow
50875,80,60669,80,141059,7791,133268,168,140,72,96,allow
48726,443,17212,443,6644134,184008,6460126,6659,204,2197,4462,allow
50931,80,59351,80,7978844,97517,7881327,6752,120,1393,5359,allow
60406,443,21053,443,8404,1892,6512,23,30,12,11,allow
33664,80,64127,80,3667,1654,2013,20,189,11,9,allow
53530,8999,38471,8999,70,70,0,2,7,2,0,allow
49838,53,62523,53,866,221,645,6,56,3,3,allow
42298,40005,13329,40005,148,86,62,2,29,1,1,allow
1156,53,45394,53,278,86,192,2,29,1,1,allow
64250,53,22733,53,314,102,212,2,29,1,1,allow
62486,53,33326,53,303,303,0,4,47,4,0,allow
64284,53,35627,53,306,94,212,2,29,1,1,allow
52107,53,0,0,621,77,544,2,29,1,1,allow
65482,53,17558,53,278,126,152,2,30,1,1,allow
42019,443,22698,443,21620,7973,13647,112,488,57,55,allow
55577,80,44269,80,70,70,0,1,5,1,0,allow
56751,32300,2097,32300,70,70,0,1,5,1,0,allow
38258,443,9287,443,5714,1536,4178,24,21,13,11,allow
49901,7000,49901,7000,3310,1535,1775,15,15,8,7,allow
53737,443,33568,443,12192,3674,8518,53,454,26,27,allow
49415,443,33045,443,29561,4857,24704,44,44,15,29,allow
42298,40016,11792,40016,148,86,62,2,30,1,1,allow
42298,40016,13493,40016,148,86,62,2,30,1,1,allow
42298,443,6175,443,70,70,0,1,30,1,0,allow
53182,443,48630,443,6094,1073,5021,19,15,10,9,allow
51499,443,64851,443,43980,3500,40480,65,16,31,34,allow
54991,53,33819,53,177,94,83,2,30,1,1,allow
52021,443,14701,443,7508,2350,5158,37,1323,21,16,allow
42298,40039,27373,40039,148,86,62,2,30,1,1,allow
52394,53,35816,53,168,78,90,2,30,1,1,allow
57353,443,37638,443,150,150,0,1,5,1,0,allow
51498,443,51057,443,29265,2836,26429,47,16,21,26,allow
50893,80,33062,80,149442,8423,141019,177,140,76,101,allow
50390,443,34358,443,1328,876,452,11,29,6,5,allow
50401,443,36442,443,1124,594,530,12,26,6,6,allow
50398,80,47950,80,318,192,126,6,26,4,2,allow
50400,443,29231,443,1124,594,530,12,26,6,6,allow
50379,443,5364,443,6748,1843,4905,21,29,11,10,allow
49472,80,16724,80,318,192,126,6,28,4,2,allow
2582,80,2582,80,8395,700,7695,17,15,8,9,allow
50395,443,41606,443,6205,2761,3444,25,28,14,11,allow
50394,443,25886,443,7584,1848,5736,19,29,10,9,allow
39609,53,46701,53,168,78,90,2,30,1,1,allow
34531,80,18192,80,467664,17895,449769,610,355,265,345,allow
35814,443,26348,443,5205,1251,3954,18,15,10,8,allow
39158,53,23110,53,168,78,90,2,30,1,1,allow
64803,53,24000,53,303,303,0,4,47,4,0,allow
50914,443,65485,443,6813,1729,5084,18,16,10,8,allow
42222,53,45931,53,209,86,123,2,30,1,1,allow
56825,53,3164,53,177,94,83,2,30,1,1,allow
39684,443,56331,443,5150,853,4297,16,34,9,7,allow
57839,53,57631,53,231,231,0,4,47,4,0,allow
42298,40008,65439,40008,140,78,62,2,30,1,1,allow
55776,53,24282,53,168,78,90,2,30,1,1,allow
42298,40001,45646,40001,156,94,62,2,30,1,1,allow
49855,53,54307,53,212,102,110,2,30,1,1,allow
65445,53,5000,53,718,94,624,2,30,1,1,allow
34430,53,54160,53,199,94,105,2,30,1,1,allow
57031,443,21412,443,2963,797,2166,10,120,5,5,allow
42298,40033,43978,40033,245,182,63,2,30,1,1,allow
33107,443,4785,443,3820081,140348,3679733,4457,136,1736,2721,allow
50444,443,13843,443,5593,996,4597,22,127,11,11,allow
49832,443,25686,443,8589,2871,5718,26,46,14,12,allow
50392,443,55310,443,1125,595,530,12,29,6,6,allow
50411,80,65137,80,1657,1246,411,8,15,5,3,allow
61229,53,16392,53,261,261,0,4,47,4,0,allow
59615,53,32493,53,320,94,226,2,30,1,1,allow
56825,53,56167,53,177,94,83,2,30,1,1,allow
42298,40031,8368,40031,157,94,63,2,30,1,1,allow
57170,53,47776,53,200,102,98,2,30,1,1,allow
50393,443,64712,443,1125,595,530,12,29,6,6,allow
50888,80,61019,80,538995,15959,523036,552,140,201,351,allow
50165,80,3536,80,17387,9304,8083,30,56,19,11,allow
41049,443,3441,443,197239,6098,191141,213,170,75,138,allow
50915,443,63177,443,9599,3465,6134,20,16,11,9,allow
40189,80,30791,80,5043,1656,3387,18,205,10,8,allow
50879,80,6049,80,15453,3281,12172,29,140,16,13,allow
56891,53,55899,53,226,110,116,2,30,1,1,allow
64737,53,9334,53,269,110,159,2,30,1,1,allow
42298,40042,19672,40042,148,86,62,2,30,1,1,allow
42298,40016,35583,40016,157,94,63,2,30,1,1,allow
52724,80,24269,80,9532,745,8787,18,113,9,9,allow
42657,443,20758,443,10204,2106,8098,37,255,19,18,allow
51502,443,28500,443,10204,5034,5170,45,16,25,20,allow
56758,40000,32207,40000,70,70,0,2,8,2,0,allow
56568,53,11893,53,306,306,0,4,47,4,0,allow
35497,443,49704,443,162,102,60,2,4,1,1,allow
51695,37590,12016,37590,70,70,0,1,5,1,0,allow
55575,31948,50458,31948,70,70,0,1,5,1,0,allow
47264,80,26226,80,1737,796,941,12,16,7,5,allow
50542,443,16831,443,5347,2537,2810,17,120,8,9,allow
50947,80,65255,80,5427472,61630,5365842,4509,79,894,3615,allow
64842,53,15693,53,340,95,245,4,47,2,2,allow
50945,80,53857,80,6920116,91852,6828264,6765,79,1277,5488,allow
50399,80,19756,80,318,192,126,6,26,4,2,allow
51157,443,53993,443,5378,1423,3955,19,22,11,8,allow
42658,443,41427,443,10170,2072,8098,37,255,19,18,allow
50292,80,5743,80,442,250,192,8,44,5,3,allow
53520,37553,50212,37553,70,70,0,2,7,2,0,allow
53528,20485,38765,20485,70,70,0,2,7,2,0,allow
53531,48908,54109,48908,70,70,0,2,7,2,0,allow
48729,443,23852,443,8504354,221135,8283219,8447,196,2721,5726,allow
51500,443,12798,443,49843,3506,46337,77,16,39,38,allow
65447,53,29961,53,330,105,225,4,37,2,2,allow
51630,80,41968,80,7679,5325,2354,15,29,8,7,allow
62597,53,49610,53,306,306,0,4,47,4,0,allow
49827,443,4607,443,21625,7638,13987,45,48,24,21,allow
50913,443,27670,443,5057,851,4206,15,16,9,6,allow
42298,40009,56378,40009,148,86,62,2,29,1,1,allow
50894,80,18419,80,53024,5569,47455,72,140,35,37,allow
27288,53,2459,53,199,94,105,2,30,1,1,allow
43057,80,9462,80,1195,401,794,9,16,5,4,allow
62332,53,0,0,170,75,95,2,29,1,1,allow
52107,53,0,0,210,77,133,2,29,1,1,allow
57866,53,0,0,627,80,547,2,29,1,1,allow
50388,53,14304,53,177,94,83,2,29,1,1,allow
42298,40012,32444,40012,148,86,62,2,29,1,1,allow
42298,40031,50162,40031,1341,657,684,8,30,4,4,allow
46295,443,11323,443,9938,1398,8540,9,128,1,8,allow
42298,40034,23763,40034,588,86,502,2,30,1,1,allow
42298,40013,37939,40013,205,83,122,4,30,2,2,allow
55875,53,42726,53,228,110,118,2,30,1,1,allow
42298,40023,18406,40023,1487,743,744,10,30,5,5,allow
30188,36914,20864,36914,2668,1950,718,16,7827,14,2,allow
42298,40003,32102,40003,206,84,122,4,30,2,2,allow
51576,443,48626,443,21523,4681,16842,37,149,18,19,allow
44816,80,47339,80,130,70,60,2,15,1,1,allow
56752,43888,19580,43888,70,70,0,1,5,1,0,allow
53185,443,12844,443,8020,1134,6886,23,15,11,12,allow
54951,443,4064,443,30123,21849,8274,65,77,38,27,allow
51496,443,41580,443,1177,624,553,12,16,7,5,allow
53183,443,26366,443,6094,1073,5021,19,15,10,9,allow
50958,53,30226,53,264,264,0,4,47,4,0,allow
53986,53,63410,53,306,306,0,4,47,4,0,allow
42298,40031,17629,40031,148,86,62,2,30,1,1,allow
53789,53,48550,53,168,78,90,2,30,1,1,allow
52074,53,21333,53,199,94,105,2,30,1,1,allow
42298,40022,65114,40022,148,86,62,2,30,1,1,allow
55866,53,14599,53,168,78,90,2,30,1,1,allow
42298,40037,29650,40037,208,86,122,4,30,2,2,allow
50407,80,54250,80,1388,917,471,11,26,6,5,allow
53105,61310,38041,61310,70,70,0,1,5,1,0,allow
51696,14370,13279,14370,70,70,0,1,5,1,0,allow
41050,443,28705,443,137809,4697,133112,153,170,55,98,allow
55593,53,39878,53,288,288,0,4,47,4,0,allow
55610,53,57817,53,181,94,87,2,30,1,1,allow
57171,53,25491,53,214,102,112,2,30,1,1,allow
49197,53,54717,53,214,102,112,2,30,1,1,allow
52838,53,22296,53,168,78,90,2,30,1,1,allow
42140,443,52282,443,12322,3893,8429,28,139,13,15,allow
50891,80,64394,80,136656,9764,126892,162,140,70,92,allow
51721,35426,42015,35426,70,70,0,2,8,2,0,allow
56745,56518,23267,56518,1556,588,968,11,16,6,5,allow
58472,53,35113,53,246,246,0,4,47,4,0,allow
42298,40013,31078,40013,140,78,62,2,30,1,1,allow
42298,40022,27294,40022,156,94,62,2,30,1,1,allow
64237,53,49326,53,227,110,117,2,31,1,1,allow
57470,39608,19893,39608,330,330,0,6,1199,6,0,allow
49608,53,36244,53,177,94,83,2,31,1,1,allow
42632,443,43354,443,4299,1870,2429,17,150,8,9,allow
62197,443,16977,443,3937,1210,2727,18,134,8,10,allow
57470,58210,46855,58210,2118,858,1260,28,1261,14,14,allow
64994,443,32046,443,3547,1351,2196,17,135,8,9,allow
61636,25735,61636,25735,3828,1516,2312,29,5271,18,11,allow
61279,443,45971,443,4076,1378,2698,14,136,7,7,allow
19473,6889,17971,6889,481,150,331,2,1200,1,1,allow
53514,8999,20953,8999,70,70,0,1,5,1,0,allow
49950,80,40840,80,51651,48866,2785,74,20,38,36,allow
56735,53283,31023,53283,4188,1648,2540,17,19,9,8,allow
50922,80,57250,80,9219616,105865,9113751,7687,120,1487,6200,allow
55664,53,23659,53,177,94,83,2,30,1,1,allow
63705,19652,30539,19652,70,70,0,1,5,1,0,allow
45813,5222,28803,5222,5723,3023,2700,58,548,32,26,allow
50872,80,50084,80,54441,4387,50054,75,140,37,38,allow
55708,8060,17338,8060,70,70,0,1,5,1,0,allow
51401,443,22599,443,202,70,132,3,11,1,2,allow
37953,1935,23472,1935,3623810,67493,3556317,3486,35,943,2543,allow
42298,40039,40294,40039,211,89,122,4,30,2,2,allow
42298,40035,3337,40035,207,85,122,4,30,2,2,allow
46346,35440,0,0,66,66,0,1,0,1,0,deny
25363,23,0,0,60,60,0,1,0,1,0,deny
56405,62413,0,0,66,66,0,1,0,1,0,deny
45908,3383,0,0,60,60,0,1,0,1,0,deny
47020,2323,0,0,60,60,0,1,0,1,0,deny
50497,445,0,0,66,66,0,1,0,1,0,drop
50017,445,0,0,70,70,0,1,0,1,0,drop
61329,51505,0,0,66,66,0,1,0,1,0,deny
6881,33720,0,0,157,157,0,1,0,1,0,deny
50494,445,0,0,66,66,0,1,0,1,0,drop
55088,445,0,0,70,70,0,1,0,1,0,drop
6881,6881,0,0,146,146,0,1,0,1,0,deny
55084,445,0,0,70,70,0,1,0,1,0,drop
55083,445,0,0,70,70,0,1,0,1,0,drop
55081,445,0,0,70,70,0,1,0,1,0,drop
50490,445,0,0,66,66,0,1,0,1,0,drop
50014,445,0,0,70,70,0,1,0,1,0,drop
57434,50584,0,0,62,62,0,1,0,1,0,deny
1574,50584,0,0,62,62,0,1,0,1,0,deny
18624,29434,0,0,148,148,0,1,0,1,0,deny
11842,35440,0,0,66,66,0,1,0,1,0,deny
49747,37965,0,0,62,62,0,1,0,1,0,deny
55701,55777,0,0,62,62,0,1,0,1,0,deny
55075,445,0,0,70,70,0,1,0,1,0,drop
34914,25604,0,0,145,145,0,1,0,1,0,deny
59785,14914,0,0,143,143,0,1,0,1,0,deny
50010,445,0,0,70,70,0,1,0,1,0,drop
55072,445,0,0,70,70,0,1,0,1,0,drop
55070,445,0,0,70,70,0,1,0,1,0,drop
55068,445,0,0,70,70,0,1,0,1,0,drop
17702,6881,0,0,66,66,0,1,0,1,0,deny
58912,11392,0,0,66,66,0,1,0,1,0,deny
50008,445,0,0,70,70,0,1,0,1,0,drop
50483,445,0,0,66,66,0,1,0,1,0,drop
43271,50584,0,0,62,62,0,1,0,1,0,deny
6666,21,0,0,60,60,0,1,0,1,0,deny
50482,445,0,0,66,66,0,1,0,1,0,drop
50479,445,0,0,66,66,0,1,0,1,0,drop
50477,445,0,0,66,66,0,1,0,1,0,drop
50006,445,0,0,70,70,0,1,0,1,0,drop
50475,445,0,0,66,66,0,1,0,1,0,drop
50474,445,0,0,66,66,0,1,0,1,0,drop
50472,445,0,0,66,66,0,1,0,1,0,drop
41447,26467,0,0,62,62,0,1,0,1,0,deny
30114,65151,0,0,60,60,0,1,0,1,0,deny
64106,64147,0,0,66,66,0,1,0,1,0,deny
33498,5529,0,0,145,145,0,1,0,1,0,deny
47398,7302,0,0,62,62,0,1,0,1,0,deny
55066,445,0,0,70,70,0,1,0,1,0,drop
55064,445,0,0,70,70,0,1,0,1,0,drop
55060,445,0,0,70,70,0,1,0,1,0,drop
40500,48009,0,0,146,146,0,1,0,1,0,deny
11136,15503,0,0,62,62,0,1,0,1,0,deny
50469,445,0,0,66,66,0,1,0,1,0,drop
55059,445,0,0,70,70,0,1,0,1,0,drop
4817,11392,0,0,146,146,0,1,0,1,0,deny
50467,445,0,0,66,66,0,1,0,1,0,drop
49999,445,0,0,70,70,0,1,0,1,0,drop
50465,445,0,0,66,66,0,1,0,1,0,drop
50464,445,0,0,66,66,0,1,0,1,0,drop
49997,445,0,0,70,70,0,1,0,1,0,drop
443,43775,0,0,97,97,0,1,0,1,0,deny
50461,445,0,0,66,66,0,1,0,1,0,drop
45908,33330,0,0,60,60,0,1,0,1,0,deny
50386,22114,0,0,66,66,0,1,0,1,0,deny
42576,30188,0,0,146,146,0,1,0,1,0,deny
59477,36829,0,0,66,66,0,1,0,1,0,deny
49996,445,0,0,70,70,0,1,0,1,0,drop
9544,7302,0,0,62,62,0,1,0,1,0,deny
49995,445,0,0,70,70,0,1,0,1,0,drop
49994,445,0,0,70,70,0,1,0,1,0,drop
49992,445,0,0,70,70,0,1,0,1,0,drop
49988,445,0,0,70,70,0,1,0,1,0,drop
26792,37965,0,0,62,62,0,1,0,1,0,deny
58725,7302,0,0,66,66,0,1,0,1,0,deny
55055,445,0,0,70,70,0,1,0,1,0,drop
37837,37965,0,0,62,62,0,1,0,1,0,deny
55049,445,0,0,70,70,0,1,0,1,0,drop
55044,445,0,0,70,70,0,1,0,1,0,drop
35718,20238,0,0,62,62,0,1,0,1,0,deny
50113,51505,0,0,66,66,0,1,0,1,0,deny
49976,445,0,0,70,70,0,1,0,1,0,drop
49975,445,0,0,70,70,0,1,0,1,0,drop
19394,44847,0,0,66,66,0,1,0,1,0,deny
53710,443,55386,443,499,425,74,4,0,3,1,allow
53711,443,24841,443,499,425,74,4,0,3,1,allow
53706,443,53579,443,499,425,74,4,0,3,1,allow
53705,443,11151,443,499,425,74,4,0,3,1,allow
49973,445,0,0,70,70,0,1,0,1,0,drop
50453,445,0,0,66,66,0,1,0,1,0,drop
49965,445,0,0,70,70,0,1,0,1,0,drop
49966,445,0,0,70,70,0,1,0,1,0,drop
37538,37965,0,0,66,66,0,1,0,1,0,deny
20706,37965,0,0,62,62,0,1,0,1,0,deny
2919,57866,0,0,66,66,0,1,0,1,0,deny
3428,22,0,0,60,60,0,1,0,1,0,deny
19963,2767,0,0,66,66,0,1,0,1,0,deny
22683,39210,0,0,60,60,0,1,0,1,0,deny
42969,8146,0,0,62,62,0,1,0,1,0,deny
62632,35440,0,0,66,66,0,1,0,1,0,deny
51973,44847,0,0,66,66,0,1,0,1,0,deny
50443,445,0,0,66,66,0,1,0,1,0,drop
42285,57470,0,0,62,62,0,1,0,1,0,deny
55031,445,0,0,70,70,0,1,0,1,0,drop
16762,61689,0,0,62,62,0,1,0,1,0,deny
15793,64147,0,0,66,66,0,1,0,1,0,deny
49954,445,0,0,70,70,0,1,0,1,0,drop
6057,51221,0,0,78,78,0,1,0,1,0,deny
50441,445,0,0,66,66,0,1,0,1,0,drop
52780,37965,0,0,66,66,0,1,0,1,0,deny
50432,445,0,0,66,66,0,1,0,1,0,drop
50424,445,0,0,66,66,0,1,0,1,0,drop
59374,51505,0,0,62,62,0,1,0,1,0,deny
49950,445,0,0,70,70,0,1,0,1,0,drop
56396,5900,0,0,60,60,0,1,0,1,0,deny
58318,15503,0,0,66,66,0,1,0,1,0,deny
63331,51221,0,0,62,62,0,1,0,1,0,deny
49941,445,0,0,70,70,0,1,0,1,0,drop
49939,445,0,0,70,70,0,1,0,1,0,drop
49935,445,0,0,70,70,0,1,0,1,0,drop
49936,445,0,0,70,70,0,1,0,1,0,drop
49570,5900,0,0,60,60,0,1,0,1,0,deny
49934,445,0,0,70,70,0,1,0,1,0,drop
55024,445,0,0,70,70,0,1,0,1,0,drop
55021,445,0,0,70,70,0,1,0,1,0,drop
55019,445,0,0,70,70,0,1,0,1,0,drop
43611,61903,0,0,148,148,0,1,0,1,0,deny
56927,64147,0,0,145,145,0,1,0,1,0,deny
50413,445,0,0,66,66,0,1,0,1,0,drop
50418,445,0,0,66,66,0,1,0,1,0,drop
50416,445,0,0,66,66,0,1,0,1,0,drop
50417,445,0,0,66,66,0,1,0,1,0,drop
50415,445,0,0,66,66,0,1,0,1,0,drop
50414,445,0,0,66,66,0,1,0,1,0,drop
50412,445,0,0,66,66,0,1,0,1,0,drop
50411,445,0,0,66,66,0,1,0,1,0,drop
0,0,0,0,320,320,0,5,0,5,0,allow
3630,26467,0,0,66,66,0,1,0,1,0,deny
25739,64147,0,0,62,62,0,1,0,1,0,deny
6916,52700,0,0,100,100,0,1,0,1,0,deny
3407,57866,0,0,66,66,0,1,0,1,0,deny
64191,44847,0,0,66,66,0,1,0,1,0,deny
10921,19847,0,0,62,62,0,1,0,1,0,deny
63503,42707,0,0,66,66,0,1,0,1,0,deny
12668,42707,0,0,62,62,0,1,0,1,0,deny
59586,56205,0,0,62,62,0,1,0,1,0,deny
49927,445,0,0,70,70,0,1,0,1,0,drop
16059,22114,0,0,146,146,0,1,0,1,0,deny
41812,8080,0,0,60,60,0,1,0,1,0,deny
41813,8080,0,0,60,60,0,1,0,1,0,deny
55012,445,0,0,70,70,0,1,0,1,0,drop
55010,445,0,0,70,70,0,1,0,1,0,drop
55003,445,0,0,70,70,0,1,0,1,0,drop
29022,23,0,0,60,60,0,1,0,1,0,deny
49818,37965,0,0,66,66,0,1,0,1,0,deny
49920,445,0,0,70,70,0,1,0,1,0,drop
50397,445,0,0,66,66,0,1,0,1,0,drop
50398,445,0,0,66,66,0,1,0,1,0,drop
50395,445,0,0,66,66,0,1,0,1,0,drop
49917,445,0,0,70,70,0,1,0,1,0,drop
26497,64147,0,0,66,66,0,1,0,1,0,deny
54955,7302,0,0,62,62,0,1,0,1,0,deny
55001,445,0,0,70,70,0,1,0,1,0,drop
54999,445,0,0,70,70,0,1,0,1,0,drop
49913,445,0,0,70,70,0,1,0,1,0,drop
54997,445,0,0,70,70,0,1,0,1,0,drop
54993,445,0,0,70,70,0,1,0,1,0,drop
54991,445,0,0,70,70,0,1,0,1,0,drop
49912,445,0,0,70,70,0,1,0,1,0,drop
55878,7302,0,0,66,66,0,1,0,1,0,deny
30559,64147,0,0,62,62,0,1,0,1,0,deny
36727,443,3578,443,27009,7414,19595,46,122,21,25,allow
63708,29685,60492,29685,66,66,0,1,5,1,0,allow
50304,443,23238,443,3565,1947,1618,19,15,9,10,allow
5588,5588,0,0,3562,1936,1626,48,195,24,24,allow
59735,443,59735,443,4730,1823,2907,19,28,11,8,allow
49181,443,9716,443,50097,3666,46431,79,256,36,43,allow
56980,53,42285,53,267,87,180,4,38,2,2,allow
51719,13715,5835,13715,70,70,0,2,8,2,0,allow
61474,443,20361,443,114674,4457,110217,127,48,46,81,allow
61483,443,51261,443,107901,5004,102897,127,46,53,74,allow
5588,5588,0,0,3562,1936,1626,48,192,24,24,allow
51718,55003,38571,55003,70,70,0,2,8,2,0,allow
59646,5223,10066,5223,139,139,0,1,5,1,0,allow
44223,443,7488,443,63895,4604,59291,80,276,34,46,allow
63697,25010,4091,25010,504,382,122,8,16,6,2,allow
56689,53,4538,53,177,91,86,3,38,2,1,allow
53486,443,39031,443,8879,2420,6459,32,255,17,15,allow
14112,443,14112,443,25629,5823,19806,44,179,25,19,allow
50303,443,45984,443,3051,1801,1250,18,15,8,10,allow
44908,443,9126,443,2931,1940,991,19,25,10,9,allow
56748,35148,18439,35148,66,66,0,1,5,1,0,allow
48979,15000,58069,15000,130,70,60,2,5,1,1,allow
51692,25565,11654,25565,66,66,0,1,5,1,0,allow
56747,42333,2469,42333,66,66,0,1,5,1,0,allow
52862,80,51424,80,3150,1478,1672,32,131,17,15,allow
41610,443,48992,443,9488,2196,7292,25,26,14,11,allow
61478,443,38710,443,45313,3360,41953,61,47,26,35,allow
61479,443,17440,443,104543,5227,99316,130,47,57,73,allow
60492,443,48948,443,81016,8373,72643,122,339,57,65,allow
42298,40026,9867,40026,212,90,122,4,30,2,2,allow
58301,53,36478,53,233,102,131,2,30,1,1,allow
61482,443,17696,443,49181,3553,45628,65,46,29,36,allow
63834,27037,60626,27037,1592,1386,206,6,31,4,2,allow
49900,7000,49900,7000,2958,1567,1391,15,15,8,7,allow
51717,63436,12791,63436,70,70,0,2,8,2,0,allow
61477,443,48304,443,30516,3311,27205,49,47,25,24,allow
52694,443,37161,443,10384,4563,5821,34,436,17,17,allow
47362,443,49001,443,8263,2100,6163,34,255,16,18,allow
63683,20299,57737,20299,502,380,122,7,19,5,2,allow
51002,443,58115,443,3536,2198,1338,18,332,9,9,allow
1063,7302,0,0,62,62,0,1,0,1,0,deny
58099,44847,0,0,62,62,0,1,0,1,0,deny
33215,37965,0,0,62,62,0,1,0,1,0,deny
59037,28370,0,0,62,62,0,1,0,1,0,deny
32974,37965,0,0,66,66,0,1,0,1,0,deny
45941,23386,0,0,60,60,0,1,0,1,0,deny
37230,554,0,0,60,60,0,1,0,1,0,deny
49908,445,0,0,70,70,0,1,0,1,0,drop
18889,50584,0,0,146,146,0,1,0,1,0,deny
46090,50584,0,0,66,66,0,1,0,1,0,deny
12549,50265,0,0,146,146,0,1,0,1,0,deny
49907,445,0,0,70,70,0,1,0,1,0,drop
60223,67,0,0,60,60,0,1,0,1,0,deny
1446,35440,0,0,66,66,0,1,0,1,0,deny
54981,445,0,0,70,70,0,1,0,1,0,drop
54979,445,0,0,70,70,0,1,0,1,0,drop
54975,445,0,0,70,70,0,1,0,1,0,drop
62673,34159,0,0,66,66,0,1,0,1,0,deny
49900,4500,1746,4500,78,78,0,1,5,1,0,allow
53098,30840,23341,30840,898,454,444,13,22,8,5,allow
37571,53,19977,53,164,78,86,2,30,1,1,allow
61030,53,15331,53,167,78,89,2,30,1,1,allow
49414,443,63863,443,43326,4905,38421,56,43,16,40,allow
62592,443,27957,443,11741,7040,4701,40,172,22,18,allow
56689,53,17079,53,264,91,173,4,38,2,2,allow
56594,80,5980,80,234,234,0,4,11,4,0,allow
58621,53,5007,53,256,94,162,2,29,1,1,allow
42298,40014,17083,40014,216,94,122,4,29,2,2,allow
42298,40042,61783,40042,273,73,200,4,29,2,2,allow
65164,53,40444,53,265,102,163,2,29,1,1,allow
60561,53,50880,53,343,86,257,2,30,1,1,allow
34517,443,44047,443,5996,1967,4029,17,99,10,7,allow
36836,443,63140,443,7195,1791,5404,18,99,11,7,allow
50958,80,62860,80,5730351,74236,5656115,4865,78,1088,3777,allow
55836,443,16714,443,3538,2015,1523,28,323,14,14,allow
36586,80,45063,80,1114,534,580,12,15,7,5,allow
56980,53,33367,53,267,87,180,4,38,2,2,allow
53513,51354,18257,51354,70,70,0,1,4,1,0,allow
123,123,49669,123,184,94,90,2,29,1,1,allow
50142,443,40604,443,9040,2349,6691,22,64,13,9,allow
50936,80,62610,80,10423067,111935,10311132,8558,119,1601,6957,allow
50960,80,58959,80,5533225,44880,5488345,4345,78,654,3691,allow
42298,40005,47580,40005,211,89,122,4,29,2,2,allow
51716,57137,62764,57137,70,70,0,2,8,2,0,allow
63710,54740,50464,54740,70,70,0,1,4,1,0,allow
60394,53,18080,53,330,94,236,2,30,1,1,allow
56765,443,20044,443,12038195,322404,11715791,12026,153,3435,8591,allow
55470,53,6327,53,197,102,95,2,30,1,1,allow
65461,53,1880,53,268,110,158,2,30,1,1,allow
51811,443,57601,443,18108,1782,16326,31,215,15,16,allow
57340,2258,57340,2258,156,156,0,3,8,3,0,allow
51693,56308,27101,56308,70,70,0,1,5,1,0,allow
41152,443,5083,443,1848,1139,709,14,579,8,6,allow
51497,443,45992,443,4945,1060,3885,21,15,12,9,allow
36256,443,43168,443,3871,2466,1405,22,95,12,10,allow
49164,53,4974,53,212,94,118,2,30,1,1,allow
49997,53,42386,53,264,102,162,2,30,1,1,allow
64354,53,25529,53,240,78,162,2,30,1,1,allow
57664,53,41830,53,168,78,90,2,30,1,1,allow
52558,443,32057,443,3530,1002,2528,12,120,6,6,allow
63691,53,63691,53,198,90,108,2,30,1,1,allow
46069,80,2181,80,2684,2550,134,7,17,5,2,allow
51720,51388,49576,51388,70,70,0,2,8,2,0,allow
38901,53,60941,53,168,78,90,2,30,1,1,allow
56980,53,28670,53,267,87,180,4,38,2,2,allow
50572,80,21152,80,132,132,0,2,8,2,0,allow
52481,443,2836,443,70,70,0,1,5,1,0,allow
43591,443,60892,443,1848,1141,707,14,566,8,6,allow
56917,443,25330,443,14033,1591,12442,26,132,10,16,allow
61665,443,16320,443,6279,1859,4420,25,16,14,11,allow
49520,53,55540,53,229,102,127,2,30,1,1,allow
49899,7000,49899,7000,758568,17631,740937,772,17,269,503,allow
54341,443,8795,443,10046,3300,6746,23,61,14,9,allow
36289,53,0,0,86,86,0,1,30,1,0,allow
56937,8200,52360,8200,78,78,0,1,30,1,0,allow
48857,53,48857,53,213,82,131,2,30,1,1,allow
35112,443,57886,443,3242,1248,1994,26,362,7,19,allow
55024,443,1691,443,552073,14113,537960,536,31,176,360,allow
49394,443,39992,443,6211,1869,4342,18,181,8,10,allow
64495,443,32988,443,1786,172,1614,7,120,3,4,allow
41128,443,53510,443,3474,2349,1125,29,3438,17,12,allow
64626,53,31838,53,326,102,224,2,30,1,1,allow
49608,53,46552,53,177,94,83,2,30,1,1,allow
55470,53,12953,53,197,102,95,2,33,1,1,allow
51691,5543,12224,5543,70,70,0,1,5,1,0,allow
36158,443,34202,443,9808,3005,6803,36,255,19,17,allow
52717,53,4391,53,277,94,183,2,30,1,1,allow
49700,53,14464,53,165,78,87,2,30,1,1,allow
33771,53,38746,53,506,316,190,3,30,2,1,allow
6881,41019,41697,41019,150,150,0,1,1200,1,0,allow
51147,443,55855,443,6162,925,5237,18,52,10,8,allow
47831,53,0,0,86,86,0,1,30,1,0,allow
61973,53,11068,53,222,94,128,2,30,1,1,allow
63811,443,59225,443,25707,7559,18148,53,121,24,29,allow
61431,443,56520,443,352310,324883,27427,389,300,270,119,allow
14641,443,14641,443,254281,66535,187746,336,317,183,153,allow
60441,443,36416,443,3211,1964,1247,25,263,13,12,allow
54961,53,55140,53,375,99,276,4,54,2,2,allow
47594,443,65055,443,5447,1074,4373,21,17,10,11,allow
52860,443,7208,443,7683,2076,5607,42,131,21,21,allow
53510,58706,37396,58706,492,306,186,8,16,5,3,allow
34169,443,8049,443,6507,1060,5447,22,255,12,10,allow
63698,59517,14181,59517,504,382,122,8,15,6,2,allow
50871,80,63200,80,94083,6192,87891,121,139,57,64,allow
42298,40013,38063,40013,209,87,122,4,29,2,2,allow
63711,47951,19949,47951,70,70,0,1,4,1,0,allow
63715,29834,21653,29834,70,70,0,1,4,1,0,allow
63714,48477,18811,48477,70,70,0,1,4,1,0,allow
53321,80,20263,80,3483,2072,1411,21,214,17,4,allow
42298,40007,10253,40007,273,73,200,4,29,2,2,allow
59486,53,24146,53,316,86,230,2,29,1,1,allow
54991,53,13574,53,177,94,83,2,29,1,1,allow
55317,53,22104,53,94,94,0,1,30,1,0,allow
55828,443,52104,443,5278,1026,4252,20,15,11,9,allow
64401,53,5392,53,293,94,199,2,30,1,1,allow
123,123,5546,123,184,94,90,2,29,1,1,allow
55664,53,60480,53,177,94,83,2,29,1,1,allow
54991,53,42971,53,253,87,166,4,29,2,2,allow
42298,40007,25770,40007,206,84,122,4,29,2,2,allow
42298,40024,27133,40024,207,85,122,4,29,2,2,allow
42298,40029,56928,40029,208,86,122,4,29,2,2,allow
42298,40036,28327,40036,205,83,122,4,29,2,2,allow
64254,53,25297,53,211,78,133,2,30,1,1,allow
64905,53,16169,53,245,94,151,2,30,1,1,allow
59165,53,3283,53,186,78,108,2,30,1,1,allow
61113,27045,20306,27045,1778,1386,392,8,30,4,4,allow
55179,53,63963,53,194,102,92,2,30,1,1,allow
64209,53,25156,53,277,94,183,2,30,1,1,allow
59610,53,54271,53,191,78,113,2,30,1,1,allow
55801,53,42672,53,222,102,120,2,30,1,1,allow
49529,53,23720,53,211,94,117,2,30,1,1,allow
53169,443,5040,443,6716,922,5794,20,20,10,10,allow
50136,443,32292,443,23193,8487,14706,57,55,28,29,allow
60972,443,43346,443,10208,5093,5115,46,15,27,19,allow
65383,53,42198,53,267,94,173,2,30,1,1,allow
62139,53,5155,53,291,78,213,2,30,1,1,allow
57067,53,11101,53,252,102,150,2,30,1,1,allow
33305,53,29793,53,168,78,90,2,30,1,1,allow
59393,443,45183,443,1664,914,750,15,275,7,8,allow
63692,42635,61565,42635,562,380,182,8,15,5,3,allow
55179,53,20932,53,194,102,92,2,35,1,1,allow
56980,53,33611,53,526,188,338,6,48,3,3,allow
62293,443,13135,443,4755,1142,3613,15,273,8,7,allow
21133,17068,30422,17068,481,150,331,2,1199,1,1,allow
52559,443,18708,443,4479,2526,1953,10,120,6,4,allow
63853,443,40585,443,3182,1568,1614,8,120,4,4,allow
6881,10385,61159,10385,118,118,0,1,1199,1,0,allow
6881,13234,11039,13234,324,150,174,2,1201,1,1,allow
53523,5362,54435,5362,320,140,180,6,6,3,3,allow
53521,443,39860,443,710,350,360,12,33,6,6,allow
47008,443,47008,443,4373,1466,2907,19,27,11,8,allow
23174,80,23174,80,490,264,226,8,31,5,3,allow
62640,443,62640,443,27723,5572,22151,59,47,31,28,allow
50932,80,42211,80,11381441,121813,11259628,9309,119,1741,7568,allow
64650,53,46185,53,257,126,131,2,30,1,1,allow
3497,53,3497,53,222,90,132,2,30,1,1,allow
65186,53,5333,53,285,94,191,2,30,1,1,allow
49942,53,42485,53,177,94,83,2,31,1,1,allow
53171,443,14871,443,3220,2010,1210,20,19,10,10,allow
50946,80,36199,80,5870176,83236,5786940,5053,78,1161,3892,allow
4960,53,26982,53,222,86,136,2,30,1,1,allow
49585,53,59933,53,718,94,624,2,30,1,1,allow
60739,40010,46673,40010,316,136,180,6,6,3,3,allow
52632,443,1395,443,4399,1857,2542,28,136,14,14,allow
49312,53,2239,53,184,86,98,2,30,1,1,allow
49878,53,64175,53,327,102,225,2,30,1,1,allow
65018,53,40867,53,198,94,104,2,30,1,1,allow
20345,57470,0,0,146,146,0,1,0,1,0,deny
30417,51505,0,0,146,146,0,1,0,1,0,deny
49902,445,0,0,70,70,0,1,0,1,0,deny
52668,51221,0,0,66,66,0,1,0,1,0,deny
46495,4607,0,0,60,60,0,1,0,1,0,deny
49418,57470,0,0,66,66,0,1,0,1,0,deny
59037,51505,0,0,66,66,0,1,0,1,0,deny
50602,26467,0,0,66,66,0,1,0,1,0,deny
50374,445,0,0,66,66,0,1,0,1,0,drop
5244,35440,0,0,66,66,0,1,0,1,0,deny
64757,52700,0,0,62,62,0,1,0,1,0,deny
54973,445,0,0,70,70,0,1,0,1,0,drop
54972,445,0,0,70,70,0,1,0,1,0,drop
59169,56205,0,0,62,62,0,1,0,1,0,deny
23807,44847,0,0,66,66,0,1,0,1,0,deny
26879,37965,0,0,145,145,0,1,0,1,0,deny
49889,445,0,0,70,70,0,1,0,1,0,drop
43329,50584,0,0,146,146,0,1,0,1,0,deny
51130,61689,0,0,66,66,0,1,0,1,0,deny
50368,445,0,0,66,66,0,1,0,1,0,drop
62941,57470,0,0,74,74,0,1,0,1,0,deny
50366,445,0,0,66,66,0,1,0,1,0,drop
61670,57470,0,0,74,74,0,1,0,1,0,deny
49886,445,0,0,70,70,0,1,0,1,0,drop
2995,26467,0,0,62,62,0,1,0,1,0,deny
54963,445,0,0,70,70,0,1,0,1,0,drop
64437,56205,0,0,66,66,0,1,0,1,0,deny
54958,445,0,0,70,70,0,1,0,1,0,drop
54955,445,0,0,70,70,0,1,0,1,0,drop
54951,445,0,0,70,70,0,1,0,1,0,drop
49160,63766,0,0,146,146,0,1,0,1,0,deny
5575,8889,0,0,495,495,0,1,0,1,0,deny
16370,56205,0,0,62,62,0,1,0,1,0,deny
50365,445,0,0,66,66,0,1,0,1,0,drop
11136,57587,0,0,62,62,0,1,0,1,0,deny
11136,17500,0,0,62,62,0,1,0,1,0,deny
49964,64147,0,0,66,66,0,1,0,1,0,deny
49882,445,0,0,70,70,0,1,0,1,0,drop
5223,13602,0,0,66,66,0,1,0,1,0,deny
54945,445,0,0,70,70,0,1,0,1,0,drop
49880,445,0,0,70,70,0,1,0,1,0,drop
61495,37965,0,0,66,66,0,1,0,1,0,deny
44411,37965,0,0,62,62,0,1,0,1,0,deny
54944,445,0,0,70,70,0,1,0,1,0,drop
54943,445,0,0,70,70,0,1,0,1,0,drop
54941,445,0,0,70,70,0,1,0,1,0,drop
49878,445,0,0,70,70,0,1,0,1,0,drop
50355,445,0,0,66,66,0,1,0,1,0,drop
6889,60888,0,0,139,139,0,1,0,1,0,deny
9717,22114,0,0,146,146,0,1,0,1,0,deny
45941,23388,0,0,60,60,0,1,0,1,0,deny
64382,44847,0,0,66,66,0,1,0,1,0,deny
50353,445,0,0,66,66,0,1,0,1,0,drop
50352,445,0,0,66,66,0,1,0,1,0,drop
50350,445,0,0,66,66,0,1,0,1,0,drop
50347,445,0,0,66,66,0,1,0,1,0,drop
50346,445,0,0,66,66,0,1,0,1,0,drop
50345,445,0,0,66,66,0,1,0,1,0,drop
50337,37965,0,0,66,66,0,1,0,1,0,deny
59241,62413,0,0,66,66,0,1,0,1,0,deny
7744,32480,0,0,62,62,0,1,0,1,0,deny
4431,32480,0,0,66,66,0,1,0,1,0,deny
6773,57470,0,0,62,62,0,1,0,1,0,deny
53051,44847,0,0,66,66,0,1,0,1,0,deny
44933,26467,0,0,62,62,0,1,0,1,0,deny
56564,9571,0,0,78,78,0,1,0,1,0,deny
64335,35440,0,0,62,62,0,1,0,1,0,deny
9756,26467,0,0,66,66,0,1,0,1,0,deny
54938,445,0,0,70,70,0,1,0,1,0,drop
54935,445,0,0,70,70,0,1,0,1,0,drop
54932,445,0,0,70,70,0,1,0,1,0,drop
49871,445,0,0,70,70,0,1,0,1,0,drop
30794,37965,0,0,62,62,0,1,0,1,0,deny
50343,445,0,0,66,66,0,1,0,1,0,drop
54931,445,0,0,70,70,0,1,0,1,0,drop
49869,445,0,0,70,70,0,1,0,1,0,drop
50339,445,0,0,66,66,0,1,0,1,0,drop
50337,445,0,0,66,66,0,1,0,1,0,drop
50335,445,0,0,66,66,0,1,0,1,0,drop
49868,445,0,0,70,70,0,1,0,1,0,drop
50333,445,0,0,66,66,0,1,0,1,0,drop
5637,37965,0,0,62,62,0,1,0,1,0,deny
42252,33306,0,0,60,60,0,1,0,1,0,deny
49867,445,0,0,70,70,0,1,0,1,0,drop
49866,445,0,0,70,70,0,1,0,1,0,drop
49864,445,0,0,70,70,0,1,0,1,0,drop
49861,445,0,0,70,70,0,1,0,1,0,drop
53828,2323,0,0,60,60,0,1,0,1,0,deny
54930,445,0,0,70,70,0,1,0,1,0,drop
54922,445,0,0,70,70,0,1,0,1,0,drop
54914,445,0,0,70,70,0,1,0,1,0,drop
49848,445,0,0,70,70,0,1,0,1,0,drop
49846,445,0,0,70,70,0,1,0,1,0,drop
49845,445,0,0,70,70,0,1,0,1,0,drop
49837,445,0,0,70,70,0,1,0,1,0,drop
49838,445,0,0,70,70,0,1,0,1,0,drop
30654,51221,0,0,72,72,0,1,0,1,0,deny
6057,51221,0,0,78,78,0,1,0,1,0,deny
53813,11392,0,0,62,62,0,1,0,1,0,deny
50325,445,0,0,66,66,0,1,0,1,0,drop
61023,26467,0,0,62,62,0,1,0,1,0,deny
56827,63710,0,0,62,62,0,1,0,1,0,deny
24504,37965,0,0,62,62,0,1,0,1,0,deny
52934,26467,0,0,66,66,0,1,0,1,0,deny
49487,60043,0,0,62,62,0,1,0,1,0,deny
50315,445,0,0,66,66,0,1,0,1,0,drop
54909,445,0,0,70,70,0,1,0,1,0,drop
49826,445,0,0,70,70,0,1,0,1,0,drop
5661,37965,0,0,66,66,0,1,0,1,0,deny
44147,64147,0,0,62,62,0,1,0,1,0,deny
57107,64147,0,0,66,66,0,1,0,1,0,deny
11136,15503,0,0,145,145,0,1,0,1,0,deny
40489,1433,0,0,60,60,0,1,0,1,0,deny
53912,26467,0,0,66,66,0,1,0,1,0,deny
9381,35440,0,0,62,62,0,1,0,1,0,deny
50313,445,0,0,66,66,0,1,0,1,0,drop
52328,44847,0,0,66,66,0,1,0,1,0,deny
9265,37965,0,0,66,66,0,1,0,1,0,deny
53358,23,0,0,60,60,0,1,0,1,0,deny
62914,11392,0,0,62,62,0,1,0,1,0,deny
50306,445,0,0,66,66,0,1,0,1,0,drop
49821,445,0,0,70,70,0,1,0,1,0,drop
50303,445,0,0,66,66,0,1,0,1,0,drop
13223,1310,0,0,62,62,0,1,0,1,0,deny
24021,6881,0,0,146,146,0,1,0,1,0,deny
52600,22,0,0,60,60,0,1,0,1,0,deny
51320,37965,0,0,62,62,0,1,0,1,0,deny
49812,445,0,0,70,70,0,1,0,1,0,drop
49810,445,0,0,70,70,0,1,0,1,0,drop
1027,23684,0,0,159,159,0,1,0,1,0,deny
49809,445,0,0,70,70,0,1,0,1,0,drop
49808,445,0,0,70,70,0,1,0,1,0,drop
49804,445,0,0,70,70,0,1,0,1,0,drop
64572,37965,0,0,66,66,0,1,0,1,0,deny
54894,445,0,0,70,70,0,1,0,1,0,drop
54891,445,0,0,70,70,0,1,0,1,0,drop
54892,445,0,0,70,70,0,1,0,1,0,drop
50285,445,0,0,66,66,0,1,0,1,0,drop
50289,445,0,0,66,66,0,1,0,1,0,drop
50290,445,0,0,66,66,0,1,0,1,0,drop
50286,445,0,0,66,66,0,1,0,1,0,drop
50284,445,0,0,66,66,0,1,0,1,0,drop
50288,445,0,0,66,66,0,1,0,1,0,drop
50287,445,0,0,66,66,0,1,0,1,0,drop
50282,445,0,0,66,66,0,1,0,1,0,drop
62739,21416,0,0,145,145,0,1,0,1,0,deny
49502,44847,0,0,66,66,0,1,0,1,0,deny
49798,445,0,0,70,70,0,1,0,1,0,drop
2609,35993,0,0,146,146,0,1,0,1,0,deny
14438,51505,0,0,62,62,0,1,0,1,0,deny
54889,445,0,0,70,70,0,1,0,1,0,drop
54880,445,0,0,70,70,0,1,0,1,0,drop
54875,445,0,0,70,70,0,1,0,1,0,drop
49791,445,0,0,70,70,0,1,0,1,0,drop
40078,44847,0,0,62,62,0,1,0,1,0,deny
49788,445,0,0,70,70,0,1,0,1,0,drop
51098,60043,0,0,62,62,0,1,0,1,0,deny
5938,35070,0,0,60,60,0,1,90,1,0,allow
14092,80,14092,80,3182,2082,1100,18,86,10,8,allow
51689,4765,24946,4765,66,66,0,1,5,1,0,allow
22345,80,22345,80,490,264,226,8,30,5,3,allow
64677,53,12416,53,172,88,84,2,31,1,1,allow
50366,80,53987,80,318,192,126,6,28,4,2,allow
50358,80,31825,80,318,192,126,6,28,4,2,allow
50369,80,41191,80,318,192,126,6,28,4,2,allow
53506,50144,41476,50144,492,306,186,8,15,5,3,allow
55216,53,59483,53,711,87,624,2,30,1,1,allow
58956,53,19380,53,213,89,124,2,30,1,1,allow
55850,443,8932,443,2883,642,2241,13,135,6,7,allow
64385,443,4632,443,3677,1168,2509,17,120,8,9,allow
56456,443,10392,443,3528,1162,2366,10,120,5,5,allow
51000,443,31109,443,41713,34380,7333,67,333,38,29,allow
51709,40705,43195,40705,70,70,0,2,8,2,0,allow
5394,23,5394,23,124,60,64,2,5,1,1,allow
50370,80,12726,80,318,192,126,6,28,4,2,allow
50359,80,41698,80,318,192,126,6,28,4,2,allow
41340,80,50400,80,2426,1540,886,14,23,8,6,allow
61308,443,22375,443,44341,5858,38483,102,195,42,60,allow
50367,80,15574,80,318,192,126,6,28,4,2,allow
30023,3389,30023,3389,4145,1976,2169,22,19,13,9,allow
55015,443,8354,443,1786,172,1614,7,120,3,4,allow
55726,27015,16348,27015,1173,924,249,6,30,3,3,allow
56457,443,49133,443,3654,1144,2510,10,120,5,5,allow
59021,443,44226,443,4596,1442,3154,24,154,11,13,allow
53518,29500,52778,29500,320,140,180,6,7,3,3,allow
51688,47961,35098,47961,66,66,0,1,5,1,0,allow
57031,53,9800,53,170,87,83,2,31,1,1,allow
60375,32277,60465,32277,70,70,0,1,5,1,0,allow
57904,443,64826,443,7912,3215,4697,23,20,12,11,allow
50343,80,49722,80,22233,10123,12110,37,28,16,21,allow
50360,80,16489,80,318,192,126,6,28,4,2,allow
50438,3389,50438,3389,3429,1474,1955,16,16,8,8,allow
50361,80,40866,80,318,192,126,6,28,4,2,allow
50368,80,46672,80,318,192,126,6,28,4,2,allow
49681,53,1706,53,170,87,83,2,30,1,1,allow
35608,443,62915,443,5776,1880,3896,19,272,11,8,allow
57137,53,7336,53,711,87,624,2,30,1,1,allow
5938,22455,0,0,60,60,0,1,90,1,0,allow
36226,60038,0,0,66,66,0,1,91,1,0,allow
49559,53,6355,53,164,84,80,2,31,1,1,allow
57292,53,56725,53,170,87,83,2,31,1,1,allow
58574,443,3429,443,3447,788,2659,13,135,6,7,allow
56985,53,45052,53,711,87,624,2,31,1,1,allow
50269,445,0,0,66,66,0,1,0,1,0,drop
50270,445,0,0,66,66,0,1,0,1,0,drop
50268,445,0,0,66,66,0,1,0,1,0,drop
56103,21247,0,0,66,66,0,1,0,1,0,deny
54874,445,0,0,70,70,0,1,0,1,0,drop
54013,37965,0,0,66,66,0,1,0,1,0,deny
49784,445,0,0,70,70,0,1,0,1,0,drop
49783,445,0,0,70,70,0,1,0,1,0,drop
42995,26467,0,0,62,62,0,1,0,1,0,deny
53314,64097,0,0,66,66,0,1,0,1,0,deny
55142,26467,0,0,66,66,0,1,0,1,0,deny
53848,36237,0,0,62,62,0,1,0,1,0,deny
65323,53,33275,53,356,118,238,2,30,1,1,allow
51710,43069,65147,43069,70,70,0,2,8,2,0,allow
63691,80,13237,80,314,192,122,6,15,4,2,allow
50964,80,13485,80,4680740,67312,4613428,4675,77,985,3690,allow
54871,445,0,0,70,70,0,1,0,1,0,drop
54870,445,0,0,70,70,0,1,0,1,0,drop
54867,445,0,0,70,70,0,1,0,1,0,drop
